Gabe Milde -- 
  Bändch -- 
  Beitrag L. Achim Arnim -- F. W. Gubitz -- Heraklius -- C. F. E. Ludwig -- 
  Wilh -- Müller -- L. Velhar Julius Voß -- 
  Bücher-Verloosung -- Vorteil hilflos Krieger -- herausgegeben F. W. Gubitz -- 
  Berlin -- 1818 -- 
  toll Invalide Fort Ratonneau -- 
  Erzählung L. Achim Arnim -- 
  Graf Dürande -- alt Kommandant Marseille -- sitzen einsam frierend kalt stürmend Oktoberabende eingerichteen Kamin prachtvoll Kommandantenwohnung rücken nah näh Feuer -- Kutsch Balle Straße vorüber rollen -- Kammerdiener Basset -- liebst Gesellschafter -- Vorzimmer heftig schnarchen -- 
  südlich Frankreich warm -- denken alt Herr -- schüttelt kopfe -- Mensch bleiben jung -- lebhaft gesellig Bewegung nehmen Rücksicht Alter -- Baukunst Winter -- 
  -- Chef Invalide -- -- siebenjährig Krieg -- Besatzung Marseille Fort ausmachen -- hölzern Bein Balle -- Leutnant Regiment Tanze brauchen -- 
  Kamine scheinen hölzern Bein höchst brauchbar -- Basset wecken -- Vorrat grün Olivenäst -- Seite hinlegen lassen -- allmählich Flamm schieben -- 
  Feuer Reiz -- knisternd Flamm grün Laube durchflochten -- halbbrennend -- halbgrünend erschein Blatt verliebt Herz -- 
  alt Herr denken Jugendglanz vertieft Konstruktion Feuerwerk -- Hof anordnen spekulieren -- mannigfach Farbenstrahl Drehung -- Geburtstage Königs Marseiller überraschen -- 
  leer kopf Balle -- 
  Freude Gelingen -- strahlen -- sausen -- prasseln -- still Größe leuchten -- Olivenäst Feuer schieben bemerken -- hölzern Bein Feuer gefang Drittteil abgebrannen -- 
  -- aufspringen -- Schluß -- aufsteige tausend Rakete Einbildungskraft beflügelt entflammen -- bemerken -- Polsterstuhl sinken -- hölzern Bein verkürzen Rest besorglich Flamme stehen -- 
  Not -- aufkommen -- rücken Stuhl Peekschlitt flammend Bein Mitte Zimmer -- rufen Diener Wasser -- 
  eifrig bemühen springen Augenblick Frau Hilfe -- Zimmer einlassen -- bescheiden Hust Aufmerksamkeit Kommandant ziehen suchen -- Erfolg -- 
  suchen Feuer Schürz löschen -- glühend Kohle Bein setzen Schürz Flamme Kommandant schreien wirklich Not Hilfe -- Leute -- 
  drang Gas herein -- Basset erwachen -- brennend Fuß -- brennend Schürze bringen lachen -- Wassereimer -- Basset Küche holen -- löschen Leute empfehlen -- 
  arm Frau trieft Wasser -- Schrecken erholen -- Kommandant lassen warm Roquelor umhängen -- Glas stark Wein reichen -- 
  Frau nehmen schluchzt Unglück bitten Kommandant -- Wort Geheim sprechen -- 
  schicken nachlässig Diener fort setzen sorgsam Nähe -- 
  -- Mann -- fremd deutsch Dialekte Französischen -- Mann Sinn -- Geschichte hören -- -- arm Mann -- spielen Teufel sicher Streiche -- 
  Kommandant fragt Manne Frau -- lieben Mann kommen -- Brief oberer Regiment Pikardie überbringen -- 
  oberer setzt Brille -- erkennen Wappe Freund durchlaufen schreiben -- -- Rosalie -- geboren Demoiselle Lilie Leipzig -- Sergeante Francoeur heiraten -- Kopf verwunden Leipzig gefangen liegen -- 
  Erzähl -- selten Liebe -- 
  Eltern -- legen Hindernis Weg -- 
  Mann scherzhaft Grill Folge Kopfwunde behalten -- Felddienst untauglich -- obgleich brav geschickte Sergeant -- Seele Regiment achten -- 
  Gnädiger Herr -- antworten Frau neu Betrübnis -- Liebe tragen Schuld Unglück -- Mann unglücklich Wunde -- lieb Teufel bringen plagen verwirrt Sinn -- 
  Stadt Soldat exerzieren -- fangen zuweilen -- ungeheuer -- Teufel eingegeben Sprung -- verlangen -- -- schneiden Gesicht -- Schreck Glied fahren -- verlangen -- rühren Regen neulich -- Faß Boden ausschlagen -- werfen kommandierend General -- affär Rückzug Regiment befehlen -- Pferd -- setzen Regimente Batterie fort -- -- 
  Teufelskerl -- rufen Kommandant -- Teufel kommandierend General führen -- Roßbach fürchten -- lieb Teufelsfabrik -- wünschen -- liebten Armee -- 
  -- fluch Mutter -- seufzen Frau -- 
  Vater -- 
  Mutter Mann -- aufwarten müssen -- einzig Arbeit -- 
  träumerisch achtet freundlich Rede Mann -- Mutter schützt Zudringlichkeit -- 
  Krieg Herr meist zerstreuen -- Mutter besuchen Hasardspiel heimlich spielen -- lebn Ärger einsam -- 
  Freund Feind verhassen -- Gabe bringen -- verwunden hungrig Haus vorübergehen -- 
  Leid einstmals besorgt Mittagsesse -- Wagen verwundeter vorüberzogen -- Sprache Franzose erkennen -- Preußen gefangen -- 
  fertig Essen hinunt -- fürchten Mutter -- Francoeur verbunden Kopf letzter Wagen liegen sehen -- wissen geschehen -- Mutter vergessen -- Suppe Löffel -- -- Wohnung abschließen -- eilt Wagen Pleißenburg -- 
  finden -- Abgestieg -- dreist redet Aufseher -- wissen verwundeten gut Strohlager erflehen -- 
  legen -- Seligkeit -- Notleidenden warm Suppe reichen -- 
  munt Auge schworen -- Heiligenschein Kopf tragen -- 
  antworten -- Haube -- eilig bemühen aufschlagen -- 
  -- Heiligenschein kommen Auge -- 
  -- Wort vergessen -- Herz -- schenken -- 
  wahr -- schön Wort -- Kommandant -- Rosalie fahren fort -- 
  schön Stunde Leben -- eifrig -- behaupten -- wohltue Ring Finger stecken -- fühlen reich -- niemals -- 
  glücklich Stille treten Mutter scheltend fluchend -- Nachsag -- nennen -- schämen -- wissen -- schuldlos böse glauben -- 
  fortreißen -- halten fest -- verloben sein -- trüge Ring -- 
  verziehen Gesicht Mutter -- war_es -- Flamm Hals brennen -- Auge kehren -- sehen wissen -- Verflucht übergeben feierlich Rede Teufel -- 
  hell Schein Auge laufen -- Francoeur sehen -- schwarz Fledermaus durchsichtigen Flügeldeck Auge legen -- Welt halb verschließen -- gehören -- 
  Herz verzweifelen müssen lachen -- 
  Hörst -- Teufel lachen -- Mutter triumphierend fort -- ohnmächtig niederstürzen -- 
  kommen -- wagen verwundeter verlassen -- Vorfall schlimm wirken -- trotzen heimlich Mutter Schaden -- Unglücklichen tun -- 
  schlich -- Francoeur sagen -- Abends Haus -- wagen klopfen -- treten Frau bedienen -- heraus berichten -- Mutter Sache schnell verkaufen -- fremd Herr -- Spieler -- fortgefahren -- wissen wohin -- 
  Welt ausgestoßen -- entfesseln Rücksicht arm Francoeur fallen -- 
  jugendlich Bekanntinne Stadt kennen -- Pfleg leben -- 
  arbeiten -- spitzenklöppeln Putze spielen -- schämt -- Handarbeit verkaufen -- bringen Bequemlichkeit Erquickung -- 
  müssen Mutter denken -- Lebendigkeit erzählen zerstreuen -- Mutter erscheinen schwarz flammend Auge -- fluchend innerer Auge -- 
  Francoeur sagen -- Herz schwer -- klagen Kopfweh -- -- Zahnweh -- fühlen -- weinen müssen -- 
  vertrauen -- Unglück -- jedesmal -- erzählen -- Fluch Mutter Teufel besessen glauben -- schließen Teufel Mund -- fürchten -- lieben können -- verlassen bloß Gedanke überleben -- 
  innerer Qual -- angestrengt Arbeit zerrütten Körper -- heftig Krämpfe -- verheimlicht -- drohten ersticken -- Arznei scheinen Übel mehren -- 
  herstellen -- Hochzeit anordnen -- 
  alt Geistlicher halten feierlich Rede -- Francoeur an Herz legen -- tun -- Vaterland -- Wohlstand Freundschaft Opfer bringen -- mütterlich Fluch gelad -- Not müssen teilen -- Unglück gemeinsam tragen -- 
  Manne schaudert Wort -- sprechen vernehmliches -- vermählen -- 
  selig Woche -- fühlen Hälfte leiden erleichtert ahnen -- Hälfte Fluch Manne übergegangen -- 
  klagen -- Prediger schwarz Kleide Auge stehen drohen -- heftig Zorn widerwillen geistliche -- Kirche heilig Bild empfinden -- fluchen müssen wissen -- Gedanke entschlag -- überlasse Einfall -- Tanze trinken Umtriebe Bluts -- 
  schieben Gefangenschaft -- obgleich ahnen -- Teufel -- plagen -- 
  auswechseln Vorsorge Obersten -- Regimente vermessen -- Francoeur außerordentlich Soldat -- 
  leicht Herz ziehen Leipzig bilden schön Zukunft unser Gespräch -- 
  Not -- um täglich Bedürfnis -- Wohllebe versorgt Armee Winterquartiere kommen -- steigen Heftigkeit Mannes -- trommeln Tagelang -- zerstreuen -- zankt -- Händel -- Oberst begreifen -- sanft Kind -- 
  Knabe entbinden -- Feldzug eröffnen -- Qual Geburt scheinen Teufel -- plagen -- bannen -- 
  Francoeur mutwillig Heftiger -- 
  oberer schreiben -- 
  Tollkühn Rasend -- glücklich -- Kamerad meinen -- zuweilen wahnsinnig fürcht kranke Invalide abgeben -- 
  Oberst Achtung -- hört Vorbitt -- Wildheit kommandierend General Abteilung -- erzählen -- Arrest bringen -- Wundarzt erklären -- leid Kopfwunde -- Gefangenschaft vernachlässigen -- Wahnsinn müssen paar warm Klima invalide zubringen -- Übel ausscheiden -- 
  -- Strafe Vergehen invalide kommen schied Verwünschung Regimente -- 
  bitten schreiben Obersten -- beschließen zutraulich eröffnen -- streng Gesetz -- Unglück -- einzig Ursache Liebe -- beurteilen -- abgelegen Ortschaft legen -- Stadt gered Leute -- 
  -- gnädig Herr -- Ehrenwort Frau fordern -- Dienst erweisen -- Geheimnis Krankheit -- ahnet -- Stolz empören -- unverbrüchlich bewahren -- 
  Hand -- rufen Kommandant -- eifrig Frau Wohlgefalle angehören -- -- Vorbitt dreimal erhören -- Francoeur dummen Streich -- 
  gute -- vermeiden -- schick Ablösung Fort -- Mann Besatzung brauchen -- finden Kind bequem Wohnung -- Veranlassung Torheit -- begehen bleiben verschweigen -- 
  Frau danken gütig Vorsorge -- küssen alt Herr Hand leuchten -- Knicksen Treppe hinunter -- 
  verwundert alt Kammerdiener Basset -- fahren Kopf -- alte ankommen -- brennend Frau Liebschaft stiften -- Einfluß nachteilig können -- 
  alt Herr Gewohnheit -- Abends Bette -- schlafen -- geschehen -- laut überdenken -- Bette Beicht abstatten -- 
  Wagen Balle rollten wach erhalten -- laueren Basset Zimmer -- hört Unterredung -- wichtig scheinen -- Francoeur Landsmann Regimentskamerad -- obgleich alt Francoeur -- 
  denken Mönch kennen -- Teufel ausgetrieb Francoeur hinführen -- Freude Quacksalber freuen -- Teufel austreiben sehen -- 
  Rosalie -- befriedigen Erfolg Besuch -- schlafen -- kauft Schürze treten Manne entgegen -- entsetzlich Gesange müd Invaliden Stadt führen -- 
  küßen -- heben Luft -- riechst trojanisch Brand -- -- schön Helena -- -- Rosalie entfärben halten nötig -- fragen -- eröffnen -- Wohnung Obersten -- Bein Flamme gestehen -- Schürz verbrennen -- 
  -- Ankunft warten -- vergessen tausend Späße brennend Schürze -- 
  stellen Leute Kommandant -- rühmt leiblich Gebrechen geistig Tugende artig -- alt Herr Wohlwollen erwerben -- meinen -- Frau lieben -- deutsche verstehen Franzose -- Franzose Teufel Leibe -- -- 
  lassen Zimmer -- nah kennen lernen -- finden Befestigungswese unterrichten -- entzücken -- 
  finden leidenschaftlich Feuerkünstler -- Regimente Art Feuerwerk ausarbeiten -- 
  Kommandant tragen Erfindung Feuerwerk Geburtstage Königs -- gestern Beinbrand stören Francoeur funkelnd Begeisterung -- 
  eröffnen alt -- Invaliden Besatzung Fort Ratonneau ablösen -- Pulvervorrat sollen Soldat fleißig Rakete füllen -- Feuerräd dreh Frösch binden -- 
  Kommandant Schlüssel Pulverturms Inventarium reichen -- fallen Rede Frau halten Wort fest -- 
  plagen Teufel stiften Unheil -- -- 
  Teufel Wand malen -- Spiegel -- antworten Francoeur gewiß Zutraue -- 
  Kommandant vertrauen -- reichen Schlüssel -- Inventarium Befehl jetzig Garnison -- auszuziehen -- 
  entlassen Hausflur fallen Basset Hals -- erkennen erzählt Kürze -- ergehen -- 
  Francoeur streng Militärische gewöhnen -- reißen -- bitten nächster Sonntag -- abkommen -- Gast Fort Ratonneau -- Kommandant -- Ehre -- 
  Einzug Fort fröhlich -- abziehend Invaliden schön Aussicht Marseille Überdruß nossen -- Einziehende entzücken Aussicht -- zierlich Werk -- bequem Zimmer Bett -- kauft Abziehende paar Ziege -- Taubenpaar -- Dutzend Hühner Kunststück -- Nähe Wild Stille belauern -- müßig Soldat Natur Jäger -- 
  Francoeur Kommando antreten -- befehlen sogleich Soldat -- Brunet Tessier -- Pulverturm eröffnen -- Inventarium durchzugeh -- gewiß Vorrat Feuerwerkerarbeit Laboratorium tragen -- 
  Inventarium beschäftigen Soldat Arbeit Feuerwerk -- Kano Mörser -- metallen polier -- eisern Schwarz anzustreichen -- 
  füllen hinlänglich Zahl Bombe Granate -- ordnen Geschütz -- stehen müssen -- einzig Aufgang Fort bestreichen -- 
  Fort nehmen -- rufen begeistert -- 
  Fort behaupten -- Engländer hundert tausend Mann landen stürmen -- 
  Unordnung -- 
  sehen überall Fort Batterien -- Tessier -- alt Kommandant Stelzfuß steigen -- Gottlob -- bis_jetzt Engländer eingefallen landen -- -- 
  -- rufen Francoeur -- Zunge verbrennen -- ehe zugeben -- Feind Marseille einäschern fürchten -- 
  Frau müssen helfen Mauerwerk Gras Moos reinigen -- abzuweiß Lebensmittel Kasematte lüften -- 
  fast schlafen -- treiben unermüdlich Francoeur Arbeit geschickt Hand fertigen -- wozu anderer Monat brauchen -- 
  Tätigkeit lassen Grill ruhen -- hastig -- fest Ziel -- Rosalie segnen -- hoch Luftregion bringen -- Teufel scheinen -- 
  Witterung Wendung Wind erwärmen erhellen -- neu Sommer begegnen scheinen -- täglich laufen Schiff Hafen -- grüßen begrüßen Fort Meer -- 
  Rosalie -- Meer -- glauben Welt versetzen -- Knabe freut -- hart Einkerkerung Wagen Wirtsstuben -- voll Freiheit eingeschlossen Garten Fort -- früh Bewohner Art Soldat -- Artillerist -- künstlichst mathematisch Linienverbindung Buchsbaum zieren -- 
  überflattert Fahne Lilien -- Stolz Francoeurs -- segenreich Zeichen Frau -- geboren Lilie -- lieb Unterhaltung Kind -- 
  Sonntag segnen Francoeur befehlen Frau -- mittag besorgen -- Freund Basset erwarten -- insbesondere Anspruch gut Eierkuche -- Hühner Fort legen fleißig -- liefern Zahl wild Vogel -- Brunet schießen -- Küche -- 
  Vorbereitung Basset hinaufgekeuchen entzücken Verwandlung Fort erkundigt Name Kommandant Feuerwerk erstaunt Zahl fertig Rakete Leuchtkugel -- 
  Frau Küchenarbeit -- Soldat ziehen Frucht Mahlzeit holen -- selig schwelg Zeitung vorlesen lassen -- Basset mitbringen -- 
  Garten sitzen Basset Francoeur stillschweigend -- fragt Ursache -- 
  -- sehen gesund tun -- vernünftig -- -- 
  zweifeln -- fragt Francoeur Aufwallung -- wissen -- -- 
  Basset suchen lenken -- Francoeur Furchtbares Wesen -- dunkl Auge befeuern -- Kopf erheben -- Lippe drängen -- 
  Herz arm Schwätzer Basset fallen -- sprechen -- dünnstimmig Violin -- Gerücht Kommandant -- 
  Teufel plagen -- gut Wille Ordensgeistlichen -- Vater Philip exorzieren lassen -- Tisch hinaufbestellen -- Vorwande -- Messe Gottesdienst entfernen Garnison Kapelle lesen müssen -- 
  Francoeur entsetzt Nachricht -- schworen -- blutig rächen wollen -- Lüge ausbringen -- wissen Teufel geben -- einwenden -- nirgends Ehre Bekanntschaft -- 
  Basset -- 
  unschuldig -- Sache vernehmen -- Kommandant laut sprechen -- Teufel Ursache -- Francoeur Regimente fortgekommen -- 
  bringen Kommandant Nachricht -- fragt Francoeur zitternd -- 
  euer Frau -- antworten -- Absicht -- entschuldigen -- wild Streich machten -- 
  scheiden -- schreien Francoeur schlagen Kopf -- verraten -- vernichten -- Heimlichkeit Kommandant -- unendlich tun gelitt -- unendlich wehe tun -- schuldig -- scheiden -- -- 
  allmählich scheinen still -- laut -- schwarz geistlich Auge -- tollen Hund gebissen Hund sehen -- treten Vater Philip Garten Heftigkeit -- fragen -- wollen -- 
  meinen Beschwörung anbringen -- redet Teufel heftig -- Hand kreuzend Linie Francoeur bewegen -- 
  empört Francoeur -- Gebot -- Kommandant Fort -- Platz sogleich verlassen -- 
  unerschrocken Philip eiferen heftig Teufel Francoeur sogar Stab erheben -- ertrug Francoeurs militärisch Stolz Drohung -- 
  wütend Stärke ergreifen Philip Mantel werfen Gitter -- Eingang schützen -- Mann Spitze Türgitter Mantel hängen bleiben -- schwer Fall steinern Treppe hinunter -- 
  Nahe Gitter Tisch decken -- erinnern Francoeur Essen -- 
  rufen Essen Rosalie bringen -- erhitzen Feuer -- fröhlich -- bemerken Mönch Gitter -- Schrecken erholen still betet -- Gefahr abwenden -- beachten -- Mann Basset finster -- verlegen Tisch blicken -- 
  fragt Soldat -- Francoeur -- nachessen -- Hunger -- Welt zerreißen -- 
  legen Suppe -- Basset Artigkeit Meiste -- Küche -- Eierkuche backen -- 
  Frau Kommandanten fallen -- fragt Francoeur -- 
  -- antworten Basset -- wünschen -- Gefangenschaft -- 
  -- antworten -- 
  Soldat -- fehlen -- fragen -- fehlen -- fragen -- suchen Diener Kommandanten gewinnen -- füllen euren Teller -- überfließen -- bieten groß Glas Wein -- geben Achtung -- bringen groß Stück Eierkuche -- 
  Fall -- stehen -- führen fort -- lassen -- 
  -- Basset antworten -- Augenblick treten Frau Eierkuche herein -- 
  Stück geschnitt -- Basset schieben Stück Wort Teller -- 
  gut Eierkuche finden Kommandant -- müßt Rühm -- -- 
  Finster blicken Francoeur Schüssel -- Lücke fast Stück -- bleiben -- stehen -- 
  -- scheiden -- 
  Wort Pulverturm -- schließen eisern Türe -- treten schließen -- 
  Frau verwirrt lassen Schüssel fallen -- 
  Gott -- plagen Böse -- Unheil stiften Pulverturm -- 
  -- Pulverturm -- rufen Basset -- sprengen Luft -- retten euer Kind -- 
  Worte laufen fort -- Mönch wagen Herein -- laufen -- 
  Rosalie eilt Wohnung Kind -- reißen Schlafe -- Wieg -- wissen -- bewußtlos Francoeur einst folgen -- entfloh Kind -- Kind -- tun deinetwegen -- sterben -- hagar -- gelitt -- verstoßen -- -- 
  Gedanke herab falsch Weg stehen sumpfig Ufer Fluß -- 
  Ermattung setzen Nachen -- -- an Ufer fahren -- abzustoßen lassen Fluß herabtreiben -- wagen umzublicken -- Hafen Schuß geschehen -- meinen -- Fort sprengen -- halb Leben verlieren -- verfiel allmählich dumpf fieberartig Zustand -- 
  unterdessen Soldat -- Äpfeln Traube bepacken -- Nähe Fort kommen -- Francoeurs stark Stimme rufen -- Flintenkugel Köpfe abfeueren -- -- 
  Sprachrohr -- hoch Mauer reden -- befehl leben -- Teufel fällen -- 
  wissen bedeuten sollen -- -- Wille Sergeante Folge leisten -- 
  gehen herab steil Abhange Fort -- hoch Mauer heißen -- angelangen -- sehen Rosalien Bette Kinde Wiege Seil niedersinken -- folgen Bett Gerät Francoeur rufen Sprachrohr -- 
  Eurige nehmen -- bett Wiege Kleid entlaufenen Frau bringen Kommandant -- finden -- -- schick Satana -- alt Fahne -- schand Kommandant decken -- 
  Wort werfen französisch Flagge -- Fort gewehen -- herab fahren fort -- Kommandant lassen hierdurch Krieg erklären -- waffn Abend -- Feuer eröffnen -- schon Schone Teufel -- Hand Ausstrecke -- fangen -- Schlüssel Pulverturm geben -- brauchen -- fassen meinen -- fliegen gen Himmel -- Himmel Hölle -- Staub geben -- -- 
  Brunet wagen reden rufen hinauf -- 
  Gedenkt unser gnädigst König -- stehen -- widerstreben -- 
  antwortet Francoeur -- 
  König Könige Welt -- Teufel Name Teufel sagen -- reden Wort -- zerschmettere -- -- 
  Drohung packten stillschweigend lassen übrige stehen -- wissen Steinmas anhäufen -- steil Felswand zerschmettern -- 
  Marseille Kommandant kommen -- finden Bewegung -- Basset unterrichten -- sendet Ankommende Wagen Fort -- Sache Frau drohend Regen sicheren -- senden -- Frau Kind finden -- Offizier versammelen -- überlegen -- -- 
  Besorgnis Kriegsrat richten Verlust schön Fort -- Luft sprengen -- Abgesandter Stadt -- Gerücht verbreiten -- stellen Untergang schönsn Teiles Stadt unvermeidlich dar -- 
  allgemein anerkennen -- Gewalt verfahren dürfen -- Ehre einzeln Mensch erringen -- ungeheur Verlust Nachgiebigkeit abwenden -- Schlaf Wut Francoeurs überwinden -- entschlossen Leute Fort erklettern fesseln -- 
  Ratschluss fassen -- Soldat einführen -- Rosalien Bett Gerät zurückgebracht -- 
  Bestellung Francoeurs überbringen -- Teufel verran -- Schlafe fangen -- warn Liebe Teufelskamerade -- Unternehmen brauchen -- ruhig verschlossen Pulverturm geladen Gewehr schlafen -- Türe erbrechen können -- längst erwachen Turm -- Schusse Pulverfässer -- zersprengen -- 
  -- Kommandant -- handeln -- aushungern -- -- 
  Wintervorrat hinaufgeschaffen -- bemerken Brunet -- halb warten -- -- vorbeifahrenden Schiff -- Stadt versorgen -- reichlich Zoll geben -- bohren Grund -- Zeichen Nacht fahren -- Bewilligung -- Abend Kugel Fluß sausen lassen -- 
  Wahrhaftig -- schießen -- rufen Offizier laufen Fenster oberen Stockwerk -- 
  welch Anblick -- ecker Fort eröffnen Kanone feurig Rachen -- Kugel sausen Luft -- Stadt versteckt Menge groß Geschrei einzeln Mut kühn Anschauen Gefahr beweisen -- 
  reichlich belohnen -- hell Licht schoß Francoeur Bündel Rakete Haubitze Luft -- Bündel Leuchtkugel Mörser -- Gewehr unzählig nachsandte -- 
  Kommandant versichern -- Wirkung trefflich -- gewagt -- Feuerwerk Wurfgeschütz Luft treiben -- Kunst gewissermaßen meteorisch -- Francoeur verdienen begnadigen -- 
  nächtlich Erleuchtung Wirkung -- keiner Mensch Absicht liegen -- retten Rosalie Kind Leben -- 
  ruhig Treibe Kahn eingeschlummeren Rosalie Traume Mutter innerlich Flamme durchleuchten verzehren fragen -- 
  leiden -- 
  laut Stimme Ohren rufen -- Fluch brennt -- lösen -- bleiben böse -- 
  sprechen -- Rosalie aufschrecken -- Bündel Leuchtkugel hoch Glanze -- hören Schiffer rufen -- 
  Steuert links -- fahren Boot Grund -- worin Weib Kind sitzen -- 
  Rauscht vorder Spitze Flußschiffe geöffnet walfischrachen -- wenden links -- Nachen seitwärts nachgerissen -- 
  helft arm Kind -- rufen Haken Stangenruder verbinden Schiff Anker werfen -- 
  Feuerwerk Fort Ratonneau aufgehen -- rufen Schiffer -- sehen böse Wille Grund segeln -- spät auf Wasser -- angeschrien -- 
  Rosalie beantworten schnell Frage bitten dringend -- Haus Kommandant bringen -- 
  Schiffer Mitleid Junge Führer -- 
  finden Bewegung Kommandant -- bitten Versprechen Eingedenk -- Manne Versehen verzeihen wollen -- 
  leugnen -- Versehen Rede -- Scherz Grill klagen -- teuflisch Ernst -- 
  -- Unrecht eur Seite -- Frau fassen -- fühlen schicksallos -- Zustand arm Mann anzeigen gefährlich Posten vertraut -- Geheimnis anloben -- Basset -- euren Diener erzählen -- törichn Klugheit Vorwitzigkeit Unglück stürzen -- arm Mann -- Unglück schuld -- müßt König Rechenschaft geben -- -- 
  kommandant verteidigen Vorwurf -- Basset erzählen -- gestehen -- selbstgespräch belauschen -- Schuld Seele schieben -- 
  alt Mann -- Fort wollen totschießen lassen -- König schuld Leben abzuzahlen -- Rosalie bitten -- übereilen -- mögen Bedenken -- Feuer retten -- 
  Zimmer Haus Kommandant angewiesen bringen Kind Ruhe -- Rate Gott flehen -- angeben -- Mutter Flamme Mann Fluche entreißen können -- 
  knien versank tief Schlaf kein Traum -- Eingebung bewußt -- 
  Kommandant -- früh Versuch Fort -- verdrießlich -- 
  Leute verlieren -- Francoeur Kugeln Geschicklichkeit links rechts hinsausen lassen -- Leben Schonung danken -- 
  Fluß Signalschüsse sperren -- Chaussee fahren -- -- Verkehr Stadt gehemmt Stadt drohen -- Kommandant vorsichtig verfahr -- Feind Land belagern denken -- Bürger aufbiet invalide fertig wollen -- 
  lassen Kommandant hinhalten -- Abend verherrlicht Feuerwerk -- Abend erinnern Rosalie Versprechen Nachsicht -- 
  Abend -- Sturm Mittag festsetzen -- Stadt geben -- Verkehr stören -- Hungersnot ausbrechen können -- 
  Eingang stürmen -- anderer Seite heimlich anzuckelten suchen -- Manne Rücken kommen -- ehe Pulverturm springen können -- Mensch kosten -- Ausgang ungewiß -- wollen Schimpf ablenken Feigheit toll Mensch Dünkel kommen -- Stadt trotzen -- groß Unglück -- Verdacht -- Angelegenheit Welt Gott ordnen suchen -- Rosalie Kind Testament vergessen finden -- 
  Rosalie fallen Fuß fragen -- 
  Schicksal Mannes -- Sturme gefangen -- 
  Kommandant wenden leise -- Tod unausbleiblich -- Wahnsinn Kriegsgericht erkennen -- Einsicht -- Vorsicht Klugheit Art -- nehmen -- Teufel Gericht ziehen -- leiden -- -- 
  strom Träne erholt Rosalie -- 
  Fort -- Blutvergießen -- Gefahr -- Gewalt Kommandant brächte -- Vergehen Wahnsinn Begnadigung finden -- -- 
  -- schwöre_es -- rufen Kommandant -- vergeblich -- hassen -- rufen gestern Vorpost -- wollen Fort übergeben -- Kopf Frau schicken können -- 
  kennen -- Frau -- Teufel beschwören -- Frieden geben -- sterben -- Gewinn -- Hand sterben -- vermählen heiligst Schwor -- 
  -- Kommandant bitten -- Bedenken -- erforscht Absicht -- Widerstand weder Bitte -- Hoffnung -- Weg gewiß Untergange entgehen -- 
  Vater Philip Haus eingefunden erzählen -- unsinnig Francoeur weiß Flagge ausgestecken -- Teufel malen -- Kommandant Neuigkeit wissen -- befehlen -- Rosalie -- beichten wollen -- 
  Rosalie beicht Ruhe gottergeben Gemüt ablegen -- bitten Vater Philip -- sicher Steinwall begleiten -- Kugel treffen können -- wollen Kind Geld Erziehung übergeben -- können lieben Kind trennen -- 
  versprechen zögernd -- Haus erkundigen -- sicher Schuß -- Glaube -- Teufel austreiben -- verlieren -- gestehen -- ausgetrieben -- Teufel -- gering Spuk -- 
  Rosalie kleiden Kind Tran wissen rot Bandschleif -- Arm schweigend Treppe hinunter -- 
  unten stehen alt Kommandant Hand drücken müssen umwenden -- Träne Zuschauer schämen -- 
  treten Straße -- wissen Absicht -- Vater Philip bleiben -- Mitgehens überhoben -- folgen Menge müßig Mensch Straße -- fragen -- 
  bedeuten -- 
  flucht Rosalie -- Francoeurs Frau -- Fluch berühren -- 
  Kommandant führen unterdessen Leute verborgen Plätzen -- Sturm eröffnen -- Frau Wahnsinn Mann beschwören -- 
  Tore verlassen Menge Rosalie -- Francoeur schoß Fläche -- Vater Philip klagen -- schwach -- müssen niederlassen -- 
  Rosalie bedauern zeigen Felsenwall -- Kind still Mantel nieder legen -- mögen suchen -- liegen sicher aufbewahren -- kehren können -- 
  Vater Philip setzen betend Fels Rosalie fest Schritt Steinwalle -- Kind tränken segnen -- Mantel wickelt Schlummer bringen -- 
  verlassen Seufzer -- Wolke brechen -- blau Hellung stärkend Sonnenbild bestrahln -- 
  hart Manne sichtbar -- Steinwalle Heraustrat -- Licht schlagen Tor -- Druck -- umstürzen müssen -- Rolle Luft -- Sausen -- mischen -- zeigen -- Tod nahe vorüber gehen -- 
  bang -- Stimme innerlich -- untergehen können -- bestehen Liebe Manne -- Kind regt Herzen -- Mann Festungswerk stehen laden -- Kind schreien hören -- tun leid Unglück -- schwer Weg schwer Gedanke Herzens -- 
  neu Schuß betäubt Ohr schmettern Felsstaub Gesicht -- betet Himmel -- 
  Betrat eng Felsgang -- verlängert Lauf -- Kartätsch geladen Kanon boshaft Geize Maß verderblich Schusses Andringend halten bestimmen -- -- 
  siehst Weib -- brüllt Francoeur -- sieh Luft -- Engel -- stehen Teufel Tod -- -- Tod -- Teufel trennen -- getrost -- Schritt hinauf Stufe -- 
  Weib -- schrie -- Mut Teufel -- helfen -- 
  -- blies Lunte -- verlöschen -- Schweiß stehen hellglänzend Stirn Wang -- Natur rangen -- 
  Rosalie Kampf hemmen vorgreifen -- vertrauen beginnen -- -- kniet Stufe nieder -- Stufe Kanon entfernen -- Feuer kreuzen -- 
  reißen Rock Weste Brust -- Luft -- greifen schwarz Haar -- verwildern Locke starren reißen wütend -- 
  öffnet Wunde kopfe wild Erschüttern Schlag -- Stirn führen -- Träne Blut löscht brennend Zundstrick -- Wirbelwind werfen Pulver Zündlöcher Kanonen Teufelsflagge Turm -- 
  schornsteinfeg Platz -- schreien Schornstein hinaus -- rufen -- decken Auge -- 
  Besann -- öffnet Gittertüre -- schwanken Frau -- heben -- küßen -- -- 
  schwarz Bergmann durchgearbeiten -- strahlen Licht Kopf Luft ziehen hindurch Liebe Feuer zünden -- frieren -- 
  Gott -- verbrochen -- 
  Laß feiern -- Stunde schenken -- Kind -- küssen -- frei -- sterben -- 
  Starb -- verlassen kommst -- Scheide nehmen -- unendlich Gefühl Dasein -- Augenblick genügen -- 
  leben Schuld groß Verzweiflung -- kenn Kriegsgesetz Gottlob Vernunft reuig Christ sterben -- 
  -- Rosalie Entzückung -- Träne fast ersticken -- sagen -- Verzieh -- Schuld Kind nahe -- 
  verbinden Wunde Eile -- ziehen Stufe hinunt Steinwalle -- Kind verlassen -- 
  finden gut Vater Philip Kind -- allmählich Felsstücken hingeschlich -- Kind lassen Hand fliegen -- Vater ausstrecken -- 
  umarmt halten -- erzählt Vater Philip -- Taubenpaar Schloß herunter geflattert Kind artig spielen -- anrühren lassen -- gleichsam Verlassenheit trösten -- 
  sehen -- Kind nahen wagen -- 
  -- Engel -- Kind Spielkamerad Fort -- treulich Aufgesucht -- sicher verlassen -- 
  umflog Taube freundlich tragen Schnäbel grün Blatt -- 
  sünd scheiden -- Francoeur Frieden schelten -- Friede tun -- 
  inzwischen Kommandant Offizier nähern -- glücklich Ausgang Fernrohr sehen -- 
  Francoeur übergeben Degen -- kündigen Francoeur Verzeihung -- Wunde Verstand berauben befehlen Chirurg -- Wunde untersuchen verbinden -- 
  Francoeur setzen nieder lassen ruhig geschehen -- Frau Kind -- 
  Chirurg wunderen -- Schmerz zeigen -- ziehen Knochensplitter Wunde -- ring umh Eiterung hervorbringen -- scheinen gewaltig Natur Francoeurs ununterbrochen allmählich Hinausschaffung arbeiten -- äußerer Gewalt -- Hand Verzweiflung äußerer Rinde durchbrechen -- 
  versichern -- glücklich Fügung unheilbar Wahnsinn unglücklich Francoeur aufzehren -- 
  Anstrengung schade -- Wagen legen Einzug Marseille glich Volke -- Kühnheit Güte wissen -- Triumphzug -- Frau werfen Lorbeerkränze Wagen -- drängen stolz Bösewicht kennen lernen -- tausend Mensch beherrschen -- 
  Mann reichen Blumenkränze Rosalie Kind rühmt Befreierin schwuren Kind reichlich vergelten -- Stadt Untergange retten -- 
  lassen Menschenleben selten erleben -- Mühe Erzählen wert -- Wiederbeglückt -- Fluchbefreit -- Ruhigere Umfang gewonnen Glück erkannten -- 
  alt Kommandant Francoeur Sohn Name übertragen -- lassen Vermögen Segen -- 
  Rosalie innig berühren -- Bericht -- Prag einlufen -- Freund Mutter anzeigen -- -- verzehrend Schmerz -- Fluch bereut -- Tochter ausgestoßen -- -- sehnlich wünsch Erlösung Leibes Seele -- Welt Überdruß leben -- Rosalien Treue Ergebenheit Gott krönen -- -- Strahl Inneren beruhigen -- gläubig Bekenntnis Erlöser selig entschlafen -- 
  Gnade lösen Fluch sünd -- Liebe treiben Teufel -- 