Geschichte brav Kasperl schön Annerl -- 
  Clemens Brentano -- Geschichte brav Kasperl schön Annerl -- 
  Clemens Brentano -- 
  Darstellung Schluß-Scene -- 
  Berlin -- 1838 -- Vereins-Buchhandlung -- Geschichte brav Kasperl schön Annerl -- 
  Sommersfrühe -- Nachtigalle sang Straße -- verstummt kühl Nacht -- fern Gewitter herwehen -- Nachtwächter rufen elft Stunde -- -- Haus gehend -- Tür Gebäude Trupp allerlei Geselle -- Bier kommen -- -- türstufen sitzen -- versammeln -- 
  Anteil scheinen lebhaft -- Unglück besorgen nähern -- 
  alt Bäuerin sitzen Treppe -- lebhaft Geselle bekümmerten -- lassen neugierig Frage gutmütig Vorschlag stören -- 
  Befremdend -- schi -- alt Frau wissen -- -- -- Kämmerlein -- mitten Leute frei Himmel Nachtruhe bequem -- 
  schürz Mäntelchen -- ziehen schwarz wachsleinen Hut tief Auge -- legen Bündel Kopf zurecht Frage Antwort -- 
  fehlen alt Frau -- fragt anwesenden -- kommen Antwort Seite -- Meile Wege Land -- -- wissen Bescheid Stadt -- Befreundet Stadt finden -- 
  führen -- -- Weg Hausschlüssel -- 
  Haus kennen -- -- 
  Frau liegen bleiben -- Neuhinzugetretener -- 
  platterdings -- antworten -- längst -- 
  wollen Haus bringen -- reden verwirrt -- betrunken -- -- 
  glauben -- blödsinnig -- 
  Fall bleiben -- wiederholen -- Nacht kühl -- 
  gered alte -- Taub blind -- ungestört Zubereitung fertig -- letzter abermals -- 
  bleiben -- erwidern -- wunderlich tief ernst Stimme -- 
  bleiben -- herzoglich Haus -- 
  achtzig alt -- Herzog gewiß Schwelle treiben -- 
  Sohn Dienst sterben -- einzig Enkel Abschied nehmen -- -- Gott verzeihen gewiß sterben -- ehrlich Grab liegen -- 
  achtzig Meile laufen -- sagen Umstehenden -- müde -- kindisch -- alt Mensch schwach -- 
  Mutter -- Schnupfe kriegen krank -- Langeweile -- sprechen Geselle beugen nah -- 
  sprechen alt tief Stimme -- halb bittend -- halb befehlend -- 
  O lassen Ruhe -- unvernünftig -- brauch -- Schnupfe -- brauchen Langeweile -- spät -- achtzig alt -- anbrech -- gehen Befreundet -- 
  Mensch fromm -- Schicksal -- beten -- paar arm Stunde hinbringen -- 
  Leute verlieren -- letzter -- stehen -- eilen hinweg -- Nachtwächter Straße Wohnung öffnen lassen -- 
  gegenwärtig -- 
  Straße ruhig -- 
  wandelen nachdenkend Bäume liegend frei Platz nieder -- Wesen Bäuerin -- bestimmt ernst Ton -- Sicherheit Leben -- achtzigmal Jahreszeit kehren sehen -- Vorsaal Bethause erscheinen -- mannigfach erschüttern -- 
  leiden -- Begierden Brust -- Stern ewig unbekümmert Weg -- wozu such Erquickung Labung suchen -- 
  suchen Liebe Erringe -- bringen -- ruhig -- fromm Seele -- Nacht Schwelle Haus zubringen -- erscheinen -- Freund finden -- -- 
  -- Stadt erreichen -- -- wegemüde -- Sand Tor umsinken Hand Räuber fallen -- 
  sprechen Lindengang alte nähern -- hören halb laut gesenkt kopfe beten -- 
  wunderbar rühren -- treten sprechen -- 
  Gott -- fromm Mutter -- ben -- -- 
  Wort Taler Schürze werfen -- 
  alte hierauf ruhig -- Hab tausend -- Herr -- Gebet erhören -- 
  glauben -- sprechen -- Mutter -- bitten -- wissen -- 
  fahren alte überrascht sprechen -- 
  Herr -- gehen Haus ben fein Lege schlafen -- 
  ziehen spät Gas herum -- jung Geselle nützen -- Feind -- Suchet -- erfangen -- 
  solch Nachtlauf verdorben -- suchen -- Herr -- Mensch Herz -- züchtig leben -- Gaß -- 
  Sucht Feind -- -- gehen hübsch Haus ben -- -- 
  Nacht -- 
  Wort wendeen ruhig Seite -- stecken Taler Reisesack -- 
  alt -- eigentümlichen ernst Eindruck -- sprechen -- lieb Mutter -- -- -- halten -- hört beten ansprechen -- gedenken -- 
  geschehen -- -- Lindengang wandeln -- bitten Gott -- mög Gedanke geben -- 
  -- gehen fein schlafen -- 
  setzen nieder Treppe -- ergriff Dürre Hand -- 
  Lasst sitzen Nacht hindurch -- erzählet -- woh -- Stadt suchen -- Hilfe -- Eurem alt Gott näh Mensch -- Welt verändern -- jung -- -- 
  wissen -- erwidern alt -- Lebetag einerlei finden -- jung -- verwundern -- vorkommen -- Freude ansehen -- Gott treulich meinet -- 
  gut Wille weisen -- Not tun -- lieb Freund ausbleiben -- andermal willkommen -- bleiben sitzen -- sehen -- helfen -- 
  erzählen -- Stadt weit Weg hertreiben -- 
  denken -- hierher -- 
  siebzig -- Haus Magd dienen -- Schwelle sitzen -- Stadt -- herumgehen -- Hand umwenden -- 
  Abend sitzen siebzig Schatz warten -- Garde stehen -- 
  versprechen -- 
  -- still -- Runde vorbei -- 
  heben gemäßigt Stimme -- jung mägde Dien schön Mondnächten -- Tür singen -- hören innig Vergnügen folgend schön alt Lied -- jung -- fallen Sternelein Erde -- 
  tote -- tote sollen auferstehen -- sollen jung Gericht -- sollen treten Spitze -- lieb Engelein sitzen -- lieb Gott gezog schön Regenbog -- kommen falsch Jude gehen -- führen einst unser Herr Christus gefangen -- hoch Baum ' erleuchn -- hart Stein zerknirschn -- 
  Gebetlein beten -- Bett Tag -- Seele Gott bestehen -- Himmel eingehen -- 
  Am -- 
  Runde nah -- alte rühren -- -- -- sechzehnen Mai -- einerlei -- -- Mütze -- Zopf -- 
  Tut -- wenn_es Herz -- 
  Offizier Runde bleiben stehen fragen -- spät schaffen -- Fähnrich Graf Großsinger -- bekannte erkennen -- 
  Handel -- -- Art Erschütterung -- Taler alt Rose -- -- Hand tragen -- alt Bauersleute Freude Blume -- 
  bitt alt -- Lied Feder sagen -- bringen -- 
  Liede trachten -- habhaft -- 
  hiermit scheiden -- Posten nahgelegen Hauptwach -- Platz begleiten -- rufen -- 
  -- 
  -- Wache Schlos -- sollen besuchen -- 
  alte -- Rose Taler -- 
  Rose ergriff rührend Heftigkeit befestigen Hut -- feiner Stimme fast weinend Wort sprechen -- Rose Blume Hut -- Geld -- -- Rosen Liebchen -- 
  -- 
  Ei Mütterche -- munt -- erwidern -- munter -- munt -- bunt Runder stehen -- Bergunter -- 'S Wunder -- 
  Schau -- Mensch -- -- sitzen bleiben -- einerlei -- glauben -- siebzig -- sitzen Türe -- flink Magd sang Lied -- 
  singen Lied jung Gericht -- Runde vorbei -- werfen Grenadier vorübergehen Rose Schoß -- -- Blatt Bibel liegen -- Bekanntschaft selig Mann -- 
  Rose vorgestecken Kirche -- finden -- -- 
  freuen -- Rose -- 
  Zeichen -- -- freuen herzlich -- 
  Sohn Tochter sterben -- vorgestern Enkel Abschied nehmen -- -- Gott helfen erbarmen -- -- verlassen Seele -- sagen -- Mitternacht vorbei -- 
  zwölf vorüber -- erwidern -- verwundern Rede -- 
  Gott geben Trost Ruhe Stündlein -- -- alt still -- Hand falten -- 
  sprechen -- erschüttert Wort Wesen -- 
  Stille bleiben Taler Offizier Schürze liegen -- -- Mutter -- stecken Taler -- könnten verlieren -- 
  wegleg -- Befreundet schenken letzter Not -- erwidern -- Taler nehmen Haus -- gehören Enkel -- genießen -- 
  sehen -- herrlich Junge -- halten Leib Seele -- Gott -- Seele -- -- 
  beten Weg -- -- lieb Herr lassen gewiß verderben -- 
  Bursch reinlichst fleißigst Schule -- Ehre erstaunlich -- 
  Leutnant sprechen -- Schwadron Ehre Leib -- sitzen Finkel Quartier -- 
  Ulanen -- 
  erstenmal Frankreich -- erzählen allerlei schön Geschichte -- Ehre Rede -- 
  Vater stiefbrud Landsturm kommen Ehre Streit -- zuviel -- -- 
  Gott verzeih schwer Sünd -- reden -- Bündel tragen -- 
  selig Tochter -- Mutter Tod arbeiten Faulpelz -- erschwing -- Schuld tilgen -- 
  Ulan erzählt Franzose -- Vater Stiefbruder -- Ulan -- Vater -- verstehen -- Ehre Leib -- stiefbrud tückisch -- Vater Ehre vorschwatzen -- Unteroffizier N -- -- -- sch Regiment -- verstehen -- Gemeiner -- 
  -- alt Finkel -- rebellisch -- vorlaut Bursch aufzählen -- Franzosen Compagnie -- fühlen -- Ehre -- 
  Rede Ulane weh -- 
  Stückche französisch Unteroffizier erzählen -- fällen -- 
  Unterm vorig König Prügel französisch Armee einführen -- 
  Befehl Kriegsministers Straßburg Parade -- Truppe hört Reih Glied Bekanntmachung still Grimm -- 
  Schluß Parade Gemeiner Exzeß -- Unteroffizier vorkommandieren -- zwölf Hieb geben -- 
  Streng befohlen -- müssen -- 
  fertig -- Gewehr Mann -- schlagen -- stellen Erde -- drücken Fuß -- Kugel Kopf fahren tot Niedersank -- 
  König berichten -- Befehl -- Prügel geben -- nehmen -- seht -- Vater -- Kerl -- Ehre Leib -- 
  Narr -- sprechen Bruder -- -- freße Ehre -- Hunger -- brummt Vater -- 
  Enkel Säbel Haus Häuschen -- erzählt weint bitter Träne -- 
  helfen -- Geschichte -- erzählen -- verwerfen -- zuletzt -- 
  Gib Gott Ehre -- 
  Segen -- Urlaub -- Meile umreit Ort -- Pate Edelhof dienen -- halten -- Hausen -- -- -- Gott Gebet erhören -- 
  Abschied nehmen -- Pate erhalten -- Aussteuer beisammen -- Hochzeit -- -- 
  alte still scheinen beten -- 
  allerlei Gedanke Ehre -- Christ Tod Unteroffizier schön finden dürfen -- 
  -- 
  Hinreichend -- 
  Wächter Anrief -- alt -- Stunde -- ei -- -- schlafen -- 
  arbeiten -- Meister Händel kriegen -- Handwerk -- Mensch -- 
  wissen -- deutlich -- Schriftsteller -- 
  Studierter sagen -- lügen -- 
  wunderbar -- deutsch schämt -- sagen -- 
  Schriftsteller -- Leute unterer Ständen ungernst -- schriftgelehrt Pharisäer Bibel einfallen -- 
  Name Schriftsteller einbürgern -- hommen de lettr Franzose -- Schriftsteller zünftig -- Arbeit hergebracht Gesetz -- fragen -- ou Avez vous Fait votre Philosophie -- Philosophie -- franzos gemacht Manne -- 
  deutsch Sitt -- Wort Schriftsteller schwer Zunge -- Tore Charakter fragen -- gewiß innerer Scham halten -- Gefühl -- befällen -- frei geistig Gütern -- unmittelbar Geschenk Himmel Handel treiben -- 
  Gelehrt brauchen schämen Dichter -- gewöhnlich Lehrgeld geben -- meist Amt Staat -- spalten grob Klötz -- arbeiten Schacht -- wild Wasser auszupumpen -- 
  sogenannter Dichter übelsen -- meistens Schulgart Parnaß entlaufen -- verdächtig Ding Dichter Profession -- nebenher -- 
  sagen -- 
  Herr -- Mensch -- Hirn -- Herz -- Magen -- Milz -- Leber dergleichen -- Poesie Leib -- Glied überfütteren -- verfüttern -- mästen -- hinüber treiben -- Erwerbzweig -- schämen übrig Mensch -- 
  -- Poesie leben -- Gleichgewicht verlieren -- übergroß Gänseleber -- schmecken -- setzen krank Gan voraus -- 
  Mensch -- Brot Schweiß angesichts verdienen -- einigermaßen schämen -- fühlen -- Tinte -- sagen -- Schriftsteller -- 
  denken Allerlei -- besann -- alte sagen -- -- zögern verwundern -- anschauen sprechen -- 
  Welcher Handwerk treiben -- Frage -- sagen -- treiben Handwerk -- greif -- golden Boden -- 
  Henker Spion -- ausholen -- Meinet halben -- sagen -- -- 
  säße -- glauben -- Lehnerich -- Tagedieb -- Haus lehnen -- umfallen Faulheit -- 
  fallen Wort -- Brücke Verständnis schlagen -- 
  lieb Mutter -- -- Schreiber -- 
  -- -- sagen -- Mann Feder -- gehören fein Kopf schnell Finger -- Herz -- drauf klopfen -- 
  Schreiber -- Bittschrift aufsetz Herzog -- gewiß erhören -- liegen bleiben -- 
  Bittschrift -- lieb Mutter -- sprechen -- aufsetz -- Mühe geben -- eindringlich abfassen -- 
  -- brav -- erwidern -- Gott lohnen -- lassen alt -- -- geben Alter geruhig Mut schön Nacht Rose Talern -- -- Freund -- Bittschrift -- Not tun -- 
  gehen Haus -- Freund -- kaufen Bogen Papier schreiben Bittschrift -- warten -- Stunde -- gehen Pat -- mitgeh -- freuen Bittschrift -- 
  gewiß Herz -- Gott Gericht wunderbar -- 
  Wort alte still -- senkt Kopf scheinen beten -- 
  Taler liegen Schoß -- 
  weinen -- 
  lieb Mutter -- fehlen -- tun weh -- weinen -- sprechen -- 
  weinen -- Wein Taler -- wein Bittschrift -- Wein -- 
  helfen -- -- Erde -- Mensch verdienen -- gallenbitt Träne süß -- 
  Seh golden Kamel drüben -- Apotheke -- Gott herrlich wunderbar schaffen -- Mensch erkennen -- solch Kamel eher Nadelöhr -- Reicher Himmelreich -- 
  -- sitzen -- gehen -- Bogen Papier kaufen -- bringen Bittschrift -- 
  lieb Mutter -- -- Bittschrift -- -- hinein schreiben -- 
  sagen -- erwidern -- freilich Kunst -- wundre -- Schreiber nennen schämen -- sagen -- 
  -- Mögliches -- 
  Setz Bittschrift -- Liebende ruh Anatomie bringen -- Glied beisammen -- -- tote -- tote sollen auferstehen -- sollen jung Gericht -- 
  fing bitterlich weinen -- 
  ahnen -- schwer Leid müssen lasten -- fühl Bürde einzeln Moment schmerzlich rühren -- 
  Weint klagen -- Wort ruhig kalt -- 
  bitten nochmals -- Veranlassung Reise Stadt erzählen -- sprechen -- Enkel -- Ulan -- erzählen -- Pate leiben -- vorher -- sprechen schön Annerl -- Leute glatt Spiegel nannn -- Ehre -- -- sollen Ehre halten -- Ehre -- 
  kriegen Mädchen Apart Gesicht Kleidung Ehre -- fein manierlich -- Dirn -- 
  sitzen knapp Leibe Bursche derb Tanze anfaßte hoch Steg Baßgeige schwingen -- bitterlich weinen -- sprechen -- 
  wider Ehre -- 
  -- Annerl Mädchen -- manchmal -- Mensch versehen -- fahren Hand Schürz reißen Leib -- Feuer -- fing entsetzlich weinen -- Ursache -- zähnen hingerissen -- Feind ruhen -- 
  Kind stets Ehre -- unser lieb Gott halten -- lassen -- Not -- seinetwill schand Verachtung ertragen -- Menschenehr -- 
  Herr gewiß erbarmen -- -- -- gewiß -- Gott Wille geschehen -- 
  Ulan stehen Frankreich -- schreiben -- glauben fast tot weinen -- 
  Hospital schwer Blessur krank geleg Kamerad -- Unteroffizier ernennen -- fallen -- Stiefbruder über Maul fahren -- 
  Gemeiner Vater Korporal -- Geschichte französisch Unteroffizier Annerl Ehre reden -- Abschied nehmen -- 
  verlieren Ruhe kriegen Heimweh Rittmeister -- Leid fragen -- -- Herr Rittmeister -- -- zähnen Haus zögen -- 
  lassen heimreit Pferd -- Offizier traun -- 
  kriegen Monat Urlaub Remonte -- 
  eilt -- Pferd wehe -- pflegen -- jemals -- anvertrauen -- 
  treiben entsetzlich -- Haus eilen -- Sterbetage Mutter -- laufen Pferd -- riefe -- Kasper -- tun Ehre -- 
  -- sitzen Grab -- denken -- Kasper -- Blümchen Vergiß Kranz binden eingesunken Kreuz hängen -- maß Platz umher -- denken -- liegen -- Kasper liegen -- Gott Grab Heimat schenken -- fein beisammen -- -- tote -- tote sollen auferstehen -- sollt jung Gericht -- 
  Kasper -- wissen -- nahe -- 
  treiben eilen -- Frankreich denken -- Kranz schön Goldbluma mitbringen -- Grab Mutter schmücken -- Kranz Annerl -- Ehrentage bewahren -- 
  --- alt still schüttelt Kopf -- letzter Wort wiederholen -- Ehrentag bewahren -- -- fahren fort -- wissen -- erflehen -- -- Herzog wecken dürfen -- -- 
  wozu -- fragen -- welch Anliegen -- Mutter -- 
  ernst -- 
  O -- liegen Leben -- Nähme -- liegen Leben -- ewig -- 
  fahren Erzählung fort -- 
  Kasper Mittag unser Dorfe ankommen -- morgens Wirt Stalle zeigen -- Pferd drücken -- -- 
  Freund -- Reiter Ehre -- 
  Wort Kasper tief empfinden -- legen Sattel hohl -- -- Wunde heilen -- setzen Reise -- Pferd Zügel führend -- Fuß fort -- 
  spät Abend Mühle -- Meile unser Dorf -- Müller alt Freund Vater kennen -- sprechen -- Gast Fremde empfangen -- 
  Kasper ziehen Pferd Stall -- legen Sattel Felleis Winkel -- Müller Stube -- 
  fragt Seinig -- hören -- alt Großmutter leben -- Vater Stiefbruder gesund gehen -- sein gestern Getreide mühl -- Vater Roß Ochsenhandel legen Gedeihe -- halt Ehre -- gehen zerrissen umher -- 
  Kasper herzlich froh -- schön Annerl fragen -- Müller -- 
  kennen -- -- Rosenhof dienen -- -- gehören -- Hauptstadt vermieten -- eher lernen können Ehre -- Knecht Rosenhof gehören -- 
  freut Kasper -- leid -- sehen -- hofft Hauptstadt fein Schmuck finden -- -- Unteroffizier -- Ehre -- Sonntag spazieren -- 
  erzählen Müller mancherlei Frankreich -- aßen tranken -- helfen Korn aufschüten -- bringen Müller Oberstube Bett -- legen unten Säck Ruhe -- 
  Geklapper mühl Sehnsucht Heimat lassen gut Kasper -- müde -- fest einschlafen -- 
  unruhig dachen selig Mutter schön Annerl -- Ehre -- bevorstehen -- Unteroffizier seinigen treten -- 
  entschlummert Leis -- ängstlich Träum aufschrecken -- mehrmals -- tret selig Mutter bäten händeringend Hilfe -- -- sterben begraben -- gehen Fuß Toter Grab -- schön Annerl gehen Seite -- Wein heftig -- Kamerad begleiten -- Kirchhof kommen -- Grab Mutter -- Annerls Grab -- geben Annerl Kränzlein -- mitbringen hängen Mutter Grab -- umgeschaut sehen -- Annerl Schürz Grab gerissen -- Grab steigen -- -- -- letzter Ehre antun -- Grab schießen brav Soldat -- Pistole ziehen Grab schießen -- 
  Schuß wacht groß Schrecken -- klirren Fenster -- Stube -- hören Schuß fallen -- hören Getöse mühl Geschrei Geklapper -- 
  springen Bett -- greifen Säbel -- Augenblick Tür -- Vollmondschein Mann berußt Gesicht Knittel zustürzen -- setzen Wehr -- Hieb Arm -- entflohen -- Tür -- außen aufgehen Riegel draußen -- verriegelten -- 
  Kasper versuchen umsonst -- nachkommen -- gelingen -- Tafel Tür eintreten -- 
  eilt Loch Treppe hinunter -- hören Wehgeschrei Müller -- knebeln Kornsäck liegend finden -- 
  Kasper behen -- eilt Stall -- Pferd Felleise -- beide rauben -- 
  groß Jammer eilt Mühle klagen Müller Unglück -- all Hab -- anvertraut Pferd stehlen -- letzterer zufrieden geben -- 
  Müller stehen voll Geldsack -- Oberstube Schranke holen Ulan -- Kasper -- zufrieden -- verdank Rettung Vermögen -- Sack -- Stube liegen -- Räuber münzen -- Verteidigung danken -- stehlen -- Pferd Felleisen Stall finden -- ausgestellt Diebeswach -- zeigen Schuß -- Gefahr -- 
  wahrscheinlich Sattelzeug erkennen -- Kavallerist Haus Herberge -- 
  meinethalben Not -- Mühe geben Geld sparen -- Gaul finden -- finden -- kaufen -- teuer -- 
  Kasper -- schenken nehmen -- Ehre -- Notfall siebzig Taler vorschießen -- kriegen Verschreibung -- schaffen -- 
  hierüber einig -- Ulan trennen -- Dorfe eilen -- Gerichtshalter umliegend Edelleute wohnen -- Sache berichten -- 
  Müller bleiben -- Frau Sohn erwarten -- Dorfe Nähe Hochzeit -- 
  Ulane nachkommen -- anzeig Gericht -- 
  denken -- Herr Schreiber -- Betrübnis arm Kasper Weg unser Dorfe eilen -- Fuß arm -- stolz einreien -- fünfzig Taler -- erbeuten -- Patent Unteroffizier -- Urlaub -- Kränze Mutter Grab schön Annerl stehlen -- 
  verzweifelt Mute -- Nacht Heimat -- pocht Tür Gerichtshalters -- Haus Dorfe -- 
  einlassen Anzeige -- rauben -- 
  Gerichtshalter tragen -- sollen Vater -- einzig Bauer Dorfe -- Pferd -- sollen Bruder Gegend herum patrouillieren -- Räuber Spur kommen -- indessen wollen Leute Fuß aussend -- Müller -- kommen -- Umstand vernehmen -- 
  Kasper Gerichtshalter weg -- väterlich Haus -- hütte vorüber müssen -- Fenster hören -- geistlich Lied singen -- Gedanke selig Mutter schlafen -- pocht -- 
  Gelobt Jesus Christus -- lieb Großmutter -- Kasper -- 
  -- 
  fahren Wort Mark Bein -- stürzen Fenster -- öffnen küßte drückt unendlich Träne -- 
  erzählt Unglück Eile -- Auftrag Vater Gerichtshalter -- müssen -- Dieb nachzusetzen -- Ehre hängen -- Pferd erhalten -- 
  wissen -- Wort Ehre fahren Glied -- wissen schwer Gericht bevorstanden -- 
  Tue Pflicht -- gib Gott Ehre -- -- eilt Finkel Hof -- Dorfs liegen -- 
  sinken -- fort -- Knie -- beten Gott -- mögen Schutz nehmen -- -- beten Angst niemals -- müssen sagen -- Herr -- Wille geschehen Himmel Erde -- 
  Kasper laufen Vater entsetzlich Angst -- 
  steigen hinten Gartenzaun -- hören Plumpe -- hören Stall wiehern -- fahren Seele -- stehen still -- Mondschein -- Mann wuschen -- Herz brechen -- sprechen -- verflucht Zeug herunter -- -- kommen Stall -- Gaul Schwanz abzuschlag Mähn verschneiden -- 
  Felleise tief unter Mist begraben -- 
  -- -- 
  gehen Stall -- Kasper -- Jammer Rasend -- springen hervor schließen Stalltür schreien -- 
  Name Herzog -- ergeben -- widersetzen -- schießen nieder -- 
  -- Vater Stiefbruder Räuber Pferde gefangen -- 
  Ehre -- Ehre verlieren -- schreien -- Sohn ehrlosen Diebe -- 
  Stall Wort hören -- bös Mute -- schrien -- Kasper -- Kasper -- Gotteswill -- bringen Elend -- 
  Kasper -- sollst -- selig Mutter Wille -- Sterbetag -- erbarm Deines Vater Bruder -- 
  Kasper verzweifelt -- schreien -- Ehre -- Pflicht -- Gewalt Tür erbrechen -- Fach Lehmwand einstoßen -- entkommen -- schoß Pistole Luft -- schreien -- Hilfe -- Hilfe -- Dieb -- Hilfe -- 
  Bauer -- Gerichtshalter erwecken -- herannaht -- verschieden Weg bereden -- Einbrecher Mühle verfolgen -- stürzen Schuß Geschrei Haus -- 
  alt Finkel flehen -- Sohn sollen Tür öffnen -- -- 
  Soldat Gerechtigkeit dienen -- 
  treten Gerichtshalter Bauer heran -- 
  Kasper -- Gott Barmherzigkeit Wille -- Herr Gerichtshalter -- Vater -- Bruder Diebe -- o -- gebären -- Stall gefangen -- Felleise liegen Miste vergraben -- 
  springen Bauer Stall banden alt Finkel Sohn schleppen Stube -- 
  Kasper grub Felleise hervor Kranz heraus -- Stube -- Kirchhofe Grab Mutter -- 
  angebrochen -- 
  Wiese -- Kasper Kränze Blümchen Vergiß geflochten -- denken -- 
  Grab Mutter schmücken -- Ritt -- 
  hören allerlei ungewohnt Lärm Dorf -- Getümmel -- liebsn -- um_das Dorf herum Kirchhof -- 
  fallen Schuß -- Dampf Höhe steigen -- eilt Kirchhof -- o Heiland -- erbarme -- 
  Kasper liegen tot Grab Mutter -- Kugel Herz schießen -- Kränzlein -- schön Annerl mitbringen -- Knopfe befestigen -- Kranz Herz schießen -- 
  Kranz Mutter Kreuz befestigen -- 
  meinen -- Erde täten Anblick -- stürzen schreien -- Kasper -- o unglückselig Mensch -- tun -- -- elend erzählen -- o -- lassen -- ehe -- 
  Gott -- arm Vater -- Bruder sagen -- finden -- 
  wissen -- Leid angetan -- glauben -- Ursache -- 
  arg -- Gerichtshalter Bauer bringen alt Finkel Sohn Stricken binden -- Jammer erstickt Stimme Kehle -- Wort sprechen -- Gerichtshalter fragen -- Enkel sehen -- 
  zeigen -- liegen -- treten -- glauben -- wein Grab -- schütteln -- Blut niederstürzen -- 
  Jesus Marie -- rufen -- Kasper Hand legen -- 
  sehen gefangener schrecklich -- Leib Kasper tragen Haus Gerichtshalters -- Wehgeschrei Dorfe -- Bauernweiber führen -- 
  -- schrecklichste Weg Leben -- 
  alte still -- lieb Mutter -- euer Leid entsetzlich -- Gott leiben -- hart schlagen -- liebsen Kind -- 
  -- lieb Mutter -- bewog -- weit Weg hierher -- Bittschrift einreichen -- 
  Ei -- denken -- fahren ruhig fort -- ehrlich Grab Kasper schön Annerl -- Kränzlein Ehrentag mitbringen -- Kasper Blut unterlaufen -- sehen 
  -- 
  ziehen Kranz Flittergold Bündel zeigen -- anbrechenden sehen -- Pulver schwärzen Blut besprengen -- 
  zerrissen Unglück gut alte -- Größe Festigkeit -- womit tragen -- erfüllt Verehrung -- 
  -- lieb Mutter -- -- arm Annerl Elend beibringen -- Schrecken tot niedersinken -- Ehrentag -- Annerl traurig Kranz bringen -- 
  Mensch -- sprechen -- kommen -- begleiten -- geschwind fort -- finden -- 
  unterwegs erzählen -- 
  stehen -- betet Morgenseg ruhig -- bringen Kleid Ordnung -- Bündel hängt Arm -- morgens -- graut wandelt still Gasse -- 
  Sehen -- erzählt alt fort -- Finkel Sohn einsperren -- müssen Gerichtshalter Gerichtsstube -- tot Kasper Tisch legen Ulanenmantel bedeckt hereingetragen -- müssen Gerichtshalter sagen -- wissen Fenster -- 
  schreiben Papier nieder -- liegen -- Schreibtafel -- Kasper finden -- stehen mancherlei Rechnung -- Geschichte Ehre französisch Unteroffizier -- Bleistift schreiben -- 
  alt Brieftasch -- lesen folgend letzter Wort unglücklich Kasper -- 
  schand überleben -- Vater Bruder Diebe -- bestohlen -- Herz brechen -- müssen gefangen nehmen Gericht übergeben -- Soldat Fürst -- Ehre erlauben Schonung -- 
  Vater Bruder Rache übergeben Ehre Wille -- -- bitte -- -- fallen -- ehrlich Grab Mutter vergönnen -- 
  Kränzlein -- erschießen -- Großmutter schön Annerl schicken grüßen -- -- tun leid Mark Bein -- Sohn Diebe heiraten -- Ehre halten -- 
  Liebe schön Annerl -- mögest erschrecken -- gib zufrieden -- jemals warst -- reden -- 
  schand -- 
  Mühe geben -- Ehre bleiben Leben -- Unteroffizier Ruf Schwadron -- gewiß Offizier -- Annerl -- verlassen -- Vornehm Gefreit - Sohn Diebes -- Vater Ehre fangen richten lassen -- Schande überleben -- 
  Annerl -- lieb Annerl -- nimm Kränzlein -- treu -- Gott gnädig -- 
  geben Freiheit -- tun Ehre -- heirat -- schlecht -- -- -- bitte -- ehrlich Grab Mutter erhalten -- unser Ort sterben Solltest -- lassen begraben -- Großmutter -- beisammen -- 
  fünfzig Taler Felleise -- Interesse legen Kind -- 
  silbern Herr Pfarrer -- begraben -- 
  Pferd -- Uniform Waffe gehören Herzog -- Brieftasch gehören -- 
  adie -- herztausend Schatz -- adie -- lieb Großmutter -- beten leben -- Gott erbarme -- -- Verzweiflung -- 
  letzter Wort gewiß edel unglücklich Mensch bitter Träne lesen -- 
  --- Kasper Mensch -- lieb Mutter -- alte -- Wort stehen bleiben Hand drücken tief Bewegter Stimme -- -- gut Mensch Welt -- 
  letzter Wort Verzweiflung schreiben -- bringen ehrlich Grab -- bringen Anatomie -- 
  -- Schreiber -- hierin helfen -- 
  -- lieb Mutter -- fragt -- letzter Wort beitragen -- 
  gewiß -- erwidern -- Gerichtshalter -- 
  Befehl Gericht ergehen -- Selbstmörder Melancholie begraben -- -- Verzweiflung Hand legen -- Anatomie -- Gerichtshalter -- Kasper -- Verzweiflung eingestehen -- Anatomie schicken müssen -- 
  wunderlich Gesetz -- -- Selbstmörder Prozeß anstellen -- Melancholie Verzweiflung entstehen -- dauern müssen -- Richter Advokat drüber Melancholie Verzweiflung fallen -- Anatomie kommen -- 
  trösten -- lieb Mutter -- Herzog Herr -- Sache hören -- arm Kasper gewiß Plätzch Mutter vergönnen -- 
  geben Gott -- erwidert alt -- sehen -- Mensch -- Gerichtshalter Papier bringen -- Brieftasch Kranz schön Annerl -- gestern hierher laufen -- Ehrentag Trost Weg geben -- -- 
  Kasper sterben -- wissen -- närrisch Betrübnis -- 
  schön Annerl -- fragt alt -- -- Stunde -- sprechen Ehrentag -- Trost gewinnen euer traurig Nachricht -- heraus -- Hochzeit halten -- tot -- krank -- 
  wissen -- Bittschrift setzen -- 
  erwidern alt -- 
  -- Schreiber -- -- Gott Wille geschehen -- sehen -- Kasper -- froh -- Kasper Leben -- traurig -- überleben -- Gott erbarmt größerem Leid -- 
  -- sagen -- Stein Herz legen -- Eisbrecher -- Schmerz -- Grundeis stürzt Herz gewiß abstoßen -- zerbrach Stein treiben kalt vorüber -- 
  erzählen -- betrüben -- 
  Patchen -- schön Annerl -- Mutter verlieren -- Bas Meile wohnen -- krank Frau -- 
  Witwe arm Bauer -- Jugend Jäger leiben -- wild Leben nehmen -- 
  Jäger solch Elend kommen -- Tod Leben Mord gefangen sitzen -- 
  erfahren Base Krankenlager weh -- täglich schlimm Todesstunde -- lieb schön Annerl Patchen übergeben -- Abschied -- letzter Augenblick -- 
  Liebe Anne Margret -- Städtchen kommst -- arm Jürge gefangen liegen -- lassen sagen Gefangenenwärter -- bitte Todesbett -- 
  sollen Gott bekehren -- herzlich beten letzter Stunde schön grüßen lassen -- -- 
  Wort sterben Bas -- begraben -- Annerl -- alt -- Arm Haus -- 
  Städtchen -- müssen -- Scharfrichterei vorüber -- Meister berühmt Viehdoktor -- Arznei mitnehmen unser Schulze -- 
  treten Stube Meister -- -- antworten -- Boden folgen sollen -- Kräuter liegen -- helfen aussuchen -- 
  lassen Annerl Stube folgen -- 
  Stube treten -- stehen Annerl Schranke -- Wand befestigen -- sprechen -- Großmutter -- Maus -- hören -- klapperen -- Maus -- 
  Rede Kinde Meister ernsthaft Gesicht -- reißen Schrank sprechen -- 
  Gott gnädig -- 
  Richtschwert -- Schranke Nagel hing -- wanken -- 
  Schwert herunter schauderen -- 
  lieb Frau -- -- lieb Annerl leiben -- erschrecken -- Schwert -- ring Hälschen -- Haut aufritzen -- Schwert wanken -- Blut verlangen -- Hals ritzen -- stehen Kind Elend Leben bevor -- 
  fassen Kind -- entsetzlich schreien beginnen -- Schrie reißen Annerl -- 
  treten Bürgermeister Städtchen herein -- Jagd Richter krank Hund Heilung bringen -- 
  fragt Ursache Geschrei's -- Annerl schreien -- 
  umbringen -- Entsetzen -- 
  Richter erzählen Bürgermeister Ereignis -- 
  verweisen Aberglaube -- nennen -- heftig scharf Drohung -- Richter bleiben ruhig sprechen -- 
  haben_es Vater halten -- halten -- 
  sprechen Bürgermeister -- Meister Franz -- glauben -- euer Schwert rühren -- hiermit Anzeige -- früh Jäger Jürge köpfen -- verzeihen -- lieb Kind schließen -- unvernünftig toll -- Mensch Verzweiflung bringen -- Alter -- Jugend geschehen -- 
  Mensch Versuchung führen -- -- 
  kein Richter Schwert -- Meister Franz -- hing Schwert Schrank -- 
  küßte Bürgermeister Annerl Semmel Jagdtasche fragen -- -- herkomme wollen -- Tod Base erzählen -- Auftrag Jäger Jürge -- -- Sollt ausrichten -- führen -- hart Herz -- Andenken gut Sterbende letzter Stunde rühren -- 
  Herr Annerl Wagen -- Tür halten fahren Städtchen hinein -- 
  heißen Köchin -- kriegt Essen -- Abend arm Sünder -- letzter Wort Bas erzählen -- fing bitterlich weinen -- schreien -- Gott -- 
  Weib -- kommen -- 
  begehrn -- sollen Herr Pfarrer bitten -- wollen beten -- 
  versprechen Bürgermeister -- loben Sinnesveränderung fragen -- Tod Wunsch -- erfüllen können -- 
  Jäger Jürge -- -- bitten alt Mutter -- Töchterlein selig Base zugegen -- Herz stärken letzter Stunde -- 
  bitten Bürgermeister -- graulich -- arm elend Mensch abschlagen -- 
  müssen Hand geben feierlich Versprechen sinken weinend Stroh -- 
  Bürgermeister Freund -- Pfarrer -- nochmals erzählen wissen -- ehe Gefängnis begeben -- 
  Nacht müssen Kind Bürgermeister Haus schlafen -- schwer Gang Hinrichtung Jäger Jürge -- 
  stehen Bürgermeister Kreis -- Stäblein brechen -- halten Jäger Jürge schön Rede Leute weinen -- Annerl -- stehen -- beweglich -- küßen Meister Franz -- Pfarrer beten -- Auge verbinden -- knien nieder -- 
  Richter Todesstreich -- 
  Jesus -- Maria -- Joseph -- schreien -- Kopf Jürgen fliegen Annerl zähnen Kind Röckche -- entsetzlich schreien -- reißen schürz Leib werfen scheußlich Kopf Meister Franz eilen herbei -- reißen -- sprechen -- Mutter -- Mutter -- -- kenn Schwert -- lebendig -- -- 
  niedergesunk Schreck -- Annerl schreien entsetzlich -- 
  Bürgermeister bestürzt lassen Kind Haus fahren -- schenkt Frau Kleid Kind -- Nachmittag schenken Bürgermeister Geld -- Leute Städtchen -- Annerl sehen -- Taler Kleid bekommen -- 
  Abend Pfarrer Haus reden -- Annerl Gottesfurcht erziehen -- betrübt Zeichen geben -- Schlingen Satans -- verachten müssen -- schenkte schön Bibel Annerl -- -- lassen Bürgermeister -- -- Meile Haus fahren -- 
  Gott -- eintreffen -- alte schweigen -- 
  schauerlich Ahnung ergreifen -- Erzählung alten zermalmen -- 
  Gott Wille -- Mutter -- rufen -- arm Annerl -- helfen -- 
  zähnen gerissen -- alt -- richten -- Verzweiflung tun -- Ehre -- Ehre liegen Sinn -- Schande kommen Ehrsucht -- verführen Vornehm -- sitzen lassen -- Kind ersticken Schürz -- Kopf Jäger Jürge werfen -- heimlich entwenden -- -- zähnen gerissen -- Verwirrung tun -- 
  Verführer Ehe versprechen -- -- Kasper Frankreich bleiben -- verzweifelt böse tun -- Gericht angeben -- 
  richten -- 
  schreiben -- 
  -- Kränzlein Gruß arm Kasper bringen -- Rose -- Nacht erhalten -- trösten -- 
  -- Schreiber -- Bittschrift auswirken -- Leib Kasper unser Kirchhof bringen -- 
  -- versuchen -- rufen -- Schloß laufen -- Freund -- Rose -- Wache -- Herzog wecken -- Bett knien -- Pardon Annerl bitten -- 
  Pardon -- alte kalt -- zähnen ziehen -- hören -- -- Freund -- Gerechtigkeit Pardon -- helfen Pardon Erde -- Gericht -- tote -- tote sollen auferstehen -- sollen jung Gericht -- 
  Seht -- Pardon -- anbieten -- Vater Kinde nennen wollen -- Annerl -- 
  Kind ermorden sterben -- unglücklich -- Strafe leiden -- Kind kommen -- verderben -- nennen -- 
  Schwert zuerkennen -- 
  Gehen Herzog -- bitte Kasper Annerl Grab -- 
  Gehen -- sehen -- Herr Pfarrer Gefängnis -- ansprechen -- hinein schön Annerl nehmen -- 
  eilen -- draußen Gericht Trost bringen -- ehrlich Grab Kasper Annerl -- 
  Wort Prediger zusammengetroffen -- alt erzählt Verhältnis gefangener freundlich Gefängnis -- 
  eilen -- laufen -- Schloß -- tröstend Eindruck -- Zeichen Hoffnung -- Graf Großsingers Haus vorüberstürzt -- offen Fenster Gartenhause lieblich Stimme Laute singen hören -- 
  Gnade sprechen Liebe -- Ehre wachen -- wünschen voll Liebe -- Gnade Ehre Nacht -- 
  Gnade nehmen Schleier -- Liebe Rose -- Ehre grüßt Freier -- Gnade lieben -- 
  -- gut Wahrzeichen -- hundert Schritt finden weiß Schleier Straße liegend -- raffen -- voll duftend Rose -- 
  halten Hand laufen -- Gedanke -- Gott -- Gnade -- 
  Ecke bog -- Mann -- Mantel verhülln -- vorüber eilt heftig Rücken wenden -- sehen -- 
  nötig -- hören innere -- -- Gnade -- Gnade -- stürzt Gittertor Schloßhof -- 
  Gott -- fähndrich -- Graf Großsinger -- blühend Kastanienbäume Wache -- treten entgegen -- 
  Graf -- Ungestüm -- Herzog bringen -- Stelle -- spät -- verlieren -- 
  scheinen verleg Antrag -- 
  fallen -- ungewohnt Stunde -- 
  -- Parade -- vorstellen -- 
  brannt Boden Fuß -- 
  -- rufen -- -- 
  -- betreffen Leben Mensch -- 
  -- erwidern Großsinger scharf absprechend -- betreffen Ehre -- untersagen -- Nacht Meldung -- 
  Wort Ehre verzweifeln -- denken Kasper Ehre -- Annerls Ehre -- -- vermaledeit Ehre -- letzter Hilfe leisten -- Ehre übrig lassen -- Herzoge -- melden Schreie laut Herzog -- 
  rühren -- Großsinger heftig -- lassen Wache werfen -- Phantast -- kennen Verhältnis -- 
  O -- kenn Verhältnis -- schrecklich Verhältnis -- 
  Herzoge -- Minute unerkauflich -- versetzt -- melden -- Eile -- 
  Wort Treppe -- Gemächern Herzog hinaufführen -- Nämliche -- Mantel Verhüllt -- begegnen -- Treppe eilend -- bemerken -- 
  Großsinger drehen Gewalt -- sehen -- 
  -- Törichter -- flüstert -- schweig -- ruhen -- unglücklich -- 
  halten Mann -- hinauf -- -- Dringenderes vorbringen -- -- 
  -- dringend -- -- -- 
  betreffen Schicksal unglücklichen verführt arm Geschöpf -- 
  Großsinger erwidern -- Mann hinauf sehen -- Wort äußeren -- Klinge -- -- hinauf -- hinauf -- Herzog Geschäft -- 
  erleuchtet Fenster Herzog -- 
  Gott -- Licht -- -- -- sprechen -- Himmel Wille -- lassen -- schrei Hilfe -- 
  Großsinger fassen Arm -- -- betrunken -- Wache -- Freund -- schlafen -- sagen Lied -- alt Nacht Türe singen -- Runde vorüber führen -- Lied interessieren -- 
  alt Ihrig Herzoge sprechen -- rufen -- 
  alte -- versetzt Großsinger -- sprechen -- Herr -- Sinn -- geschwind Wache -- 
  fortzeiehen -- schlagen Schloßuhr halb -- Klang schneiden Schrei Not Seele -- schreien voll Brust Fenster Herzog hinauf -- Hilfe -- Gott Wille -- Hilfe elend -- verführt Geschöpf -- 
  Großsinger unsinnig -- Mund zuhalen -- Rang -- stoßen Nacken -- schimpfen -- fühlen -- hören -- 
  rufen Wache -- Korporal eilt etlicher Soldat herbei -- greifen -- Augenblick Herzog Fenster -- rufen herunter -- 
  fähndrich Graf Großsinger -- Skandal -- bringen Mensch herauf -- Stelle -- 
  warten fähndrich -- stürzt Treppe hinauf -- fallen nieder Füßen Herzog -- betreffen unwillig aufstehen heißen -- 
  Stiefel Spore -- Schlafrock -- sorgfältig Brust halten -- 
  tragen Herzoge -- alt Selbstmorde Ulanen -- Geschichte schön Annerl erzählen -- drängen -- Not erforderen -- flehen Aufschub Hinrichtung Stunde ehrlich Grab Unglücklichen -- Gnade unmöglich -- -- 
  -- Gnade -- Gnade -- rufen -- gefunden weiß Schleier voll Rose Busen ziehen -- Schleier -- Weg hierher finden -- scheinen Gnade verheißen -- 
  Herzog greifen Ungestüm Schleier -- heftig bewegen -- drückt Schleier Hand Wort aussprechen -- arm Mädchen Opfer falsch Ehrsucht -- Vornehmer verführen -- Ehe versprechen -- -- -- sterben -- nennen -- unterbrach Herzog Träne Auge -- -- schweigen -- um Himmel Wille -- schweigen -- wenden Fähndrich -- Tür stehen -- dringend Eile -- Fort -- eilend Pferd Mensch -- reit Pferd tot -- Gericht -- heft Schleier Deg -- winken schreien Gnade -- Gnade -- 
  kommen -- 
  Großsinger Schleier -- verwandeln -- Gespenst Angst Eile -- stürzt Stall -- sitzen Pferd ritt Galopp -- stürmt Wahnsinniger Tor hinaus -- 
  Schleier Degenspitze heften -- schreien -- Herr Jesus -- Schwester -- 
  verstehen -- -- 
  stehen Bügel -- weht Schrie -- Gnade -- Gnade -- 
  sehen Hügel Menge Gericht versammeln -- 
  Pferd scheut wehend Tuch -- 
  schlecht Reiter -- Großsinger einholen -- fliegen schnellsen Karriere -- 
  strengt Kraft -- 
  Traurig Schicksal -- Artillerie exerziern Nähe -- Kanonendonn unmöglich -- Geschrei Ferne hören -- 
  Großsinger stürzen -- Volk stob auseinander -- Kreis -- Stahlblitz früh Sonne - Gott -- Schwertblitz Richter -- 
  -- sprengen heran -- hören Wehklage Menge -- 
  Pardon -- Pardon -- schreien Großsinger stürzen wehend Schleier Kreis -- Rasend -- Richter halten blutend Haupt schön Annerl entgegen -- wehmütig anlächeln -- 
  schreien -- Gott gnädig -- 
  fallen Leiche Erde -- töten -- töten -- Mensch -- verführen -- Mörder -- 
  rächend Wut ergriff Menge -- weiber Jungfraue dringen heran riss Leiche -- treten Fuß -- wehren -- Wachen wütend Volk bändigen -- 
  erheben Geschrei -- Herzog -- Herzog -- -- offen Wagen fahren -- blutjung Mensch -- Hut tief Gesicht drücken -- Mantel hüllen -- sitzen -- 
  Mensch schleifen Großsinger herbei -- Jesus -- Bruder -- schreien jung Offizier weiblichsen Stimme Wagen -- 
  Herzog sprechen bestürzt -- schweigen -- 
  springen Wagen -- jung Mensch folgen -- Herzog drängen schier Unsanft -- befördert Entdeckung -- jung Mensch -- Offizier verkleiden -- Schwester Großsinger -- 
  Herzog lassen mißhandelt -- blutend -- ohnmächtig Großsinger Wagen legen -- Schwester Rücksicht -- werfen Mantel -- weiblich Kleidung -- 
  Herzog verlegen -- sammeln -- befahl Wagen sogleich umzuwenden -- Gräfin Bruder Wohnung fahren -- 
  Ereignis Wut Menge einigermaßen stillen -- 
  Herzog laut wachthabend Offizier -- Gräfin Großsinger Bruder Haus vorbei reiten sehen -- Pardon bringen freudig Ereignis beiwohnen -- Zweck vorüber fahren -- stehen Fenster -- bitten -- Wagen mitzunehmen -- gutmütig Kind abschlagen -- 
  Mantel Hut Bruder -- Aufsehen erregen -- -- unglücklich Zufall überraschen -- Sache abenteuerlich Skandal -- 
  -- Herr Leutnant -- unglücklich Grafen Großsinger Pöbel schützen -- gräßlich Fall -- -- Pferd stürzend -- spät -- -- 
  Mißhandler Grafe verhaften bestrafen wissen -- 
  Rede Herzog erheben allgemein Geschrei -- 
  Schurk -- Verführer -- Mörder schön Annerl -- -- elend -- schlecht Kerl -- 
  Seite tönt Prediger Offizier Gerichtsperson bestätigen -- Herzog tief erschüttern -- -- -- entsetzlich -- entsetzlich -- o elend Mensch -- 
  treten Herzog blaß bleich Kreis -- Leiche schön Annerl sehen -- 
  liegen grün Rasen weiß Kleide schwarz Schleife -- alt Großmutter -- vorging bekümmeren -- Haupt Rumpf legen schrecklich Trennung Schürz bedeckt -- beschäftigen -- Hand Bibel falten -- Pfarrer Städtchen Annerl schenken -- golden Kränzlein band Kopf stecken ros Brust -- Großsinger Nacht geben -- wissen -- -- 
  Herzog sprechen Anblick -- Schöne -- unglücklich Annerl -- schändlich Verführer -- kamsen spät -- -- arm alt Mutter -- treu bleiben -- Tod -- 
  Wort Nähe -- sprechen -- sagen letzter Wille Korporal Kasper -- -- 
  wendet alte -- -- 
  arm Mutter -- geben Brieftasch Kasper -- Se -- Durchlaucht letzter Wille lesen -- 
  alt -- bekümmeren -- mürrisch -- -- 
  Haus bleiben -- 
  Bittschrift -- 
  spät -- arm Kind Trost geben -- Kasper ehrlich Grab -- -- Vorgelog -- glauben -- 
  Herzog unterbreachen sprechen -- gelog -- Mutter -- Mensch Möglichst tun -- Sturz Pferd schuld -- ehrlich Grab Mutter Kasper -- brav Kerl -- Leichenpredigt gehalt Wort -- 
  geben Gott Ehre -- 
  Kasper fähndrich begraben -- Schwadron dreimal Grab schießen -- Verderber Großsinger Degen Sarg legen -- 
  Wort ergreifen Großsinger Degen -- Schleier Erde liegen -- Schleier herunter -- bedeckt Annerl sprechen -- 
  unglücklich Schleier -- Gnade bringen -- Ehre geben -- begnadigen sterben -- Schleier begraben -- 
  Degen Offizier Wache Wort -- Befehl Bestattung Ulan arm Mädchen Parade empfangen -- 
  lesen letzter Wort Kasper laut vieler Rührung -- alt Großmutter umarmt Freudenträne Fuß -- glücklich Weib -- 
  -- geben zufrieden -- Pension selig -- Enkel Annerl Denkstein setzen lassen -- 
  befehlen Prediger -- alte -- Sarge -- Gerichtete legen -- Wohnung fahren -- Heimat bringen Begräbnis besorgen -- 
  Adjutant Pferd kommen -- -- geben Adjutant Name -- rufen lassen -- schön menschlich Eifer zeigen -- 
  Adjutant schreiben Name Schreibtafel -- verbindlich Kompliment -- 
  sprengen Herzog -- segenswünsch Menge begleiten -- Stadt -- 
  leiche schön Annerl gut alt Großmutter Haus Pfarrers bringen -- folgend Nacht fahren Heimat -- 
  Offizier treffen -- Degen Großsingers Schwadron Ulanen -- folgend Abend -- 
  brav Kasper -- Großsinger Degen Bahre Fähndrichs-Patent -- schön Annerl -- Seite Mutter begraben -- 
  hingeeilen führen alt Mutter -- kindisch Freude -- reden -- Ulanen Kasper Mal Grab schießen -- fallen tot arme -- Grab Ihrig empfangen -- 
  Gott geben freudig Auferstehung -- 
  treten Spitze -- lieb Engelein sitzen -- lieb Gott ziehen -- schön Regenbog -- Seele Gott bestehen -- Himmel eingehen -- 
  Amen -- 
  Hauptstadt -- hören -- Graf Großsinger sterben -- 
  Gift nehmen -- Wohnung finden Brief -- -- danken -- schand -- Herz abnagen -- bringen -- 
  Lied alte kennen -- Annerl vorgesagen -- unbeschreiblich edl Geschöpf -- 
  elend Verbrecher -- schriftlich Eheversprechen verbrennen -- 
  dienen alt Tante -- litt Melancholie -- 
  gewiß medizinisch -- Magische -- Seele bemächtigen -- -- 
  Gott gnädig -- -- 
  Ehre Schwester retten -- Herzog lieben -- Günstling - Geschichte erschüttern -- Gott helfen -- Gift nehmen -- 
  Joseph Graf Großsinger -- 
  Schürz schön Annerl -- Kopf Jäger Jürge Enthauptung gebissen -- herzoglich Kunstkammer bewahren -- 
  -- Schwester Grafe Großsinger Herzog Name -- Voil de Grace -- deutsch -- Gnadenschleier -- Fürstenstand erheben vermählen -- 
  nächster Revue Gegend D -- -- -- -- Monument Gräber unglücklich Ehrenopfer -- Kirchhof Dorfs -- errichten einweihen -- Herzog Fürstin zugegen -- 
  ausnehmend zufrieden -- Idee Fürstin Herzoge erfinden -- 
  stellen falsch wahr Ehre -- Kreuze beiderseits tief Erde beugen -- Gerechtigkeit stehen geschwungen Schwerte Seite -- Gnade Seite werfen Schleier heran -- 
  kopf Gerechtigkeit Ähnlichkeit Herzoge -- kopf Gnade Ähnlichkeit Gesichte Fürstin finden -- 
  folgend Schrift erscheinen -- 
  lärmen -- Joseph Freiherrn v. Eichendorff -- -- mehrere Wehmüller ungarischen Nationalgesichter -- 
  Clemens Brentano -- 
  Novelle --    5 -- 6    Thlr -- 
  Barinka -- -- 
  rot Schenke -- Dr. Schiff -- 
  -- Nüs -- Clemens Brentano -- 
  Volks-Erzählung --    1 -- 3    Thlr -- 
  Leben Taugenicht Marmorbild -- 
  Novelle -- nebst Anhing Lied Romanz -- Joseph Freiherrn Eichendorff -- 1 2 -- 3    Thlr -- 
  Elendsfell -- 
  Novelle Balzac -- -- I . 
  Elendsfell -- II -- 
  Herzlose -- III -- 
  gutherzige -- -- 
  Dr. Schiff -- 1 Tlr -- 
  Agnes Bernauerin -- 
  dialogisiert historisch Novelle -- 
  Dr. Schiff -- 
  ½ Thlr -- 
  Stern Psitiger -- 
  Novelle -- 
  K. a. Varnhag Ense -- 
  ½ Thlr -- 
  Pomeranzenbäumche -- -- 
  golden Knopf -- -- 
  wild Schwein -- 
  historisch Erzählung -- Gustav Nieritz -- 
  ¾ Thlr -- 
  Druckfehler -- 
  Erzählung -- 
  Gustav Nieritz --    2 -- 3    Thlr -- 
  Erbsünder -- 
  Novelle Emerentius Scävola -- 
  Teil -- 21 -- 2 Thlr -- Gundlingen -- 
  --- Johann Faust Paris -- 
  -- Alban Alba -- 
  -- Kristall -- -- 
  Fliege Klappe -- 
  Novelle Nicht-Novell Dr. Schiff --    2 -- 3    Thlr -- 
  Erzählung -- märch Schwänk -- 
  F. W. Gubitz -- ¾ Thlr -- Vereins-Buchhandlung -- 