Urika -- Negerin -- 
  französisch Herzogin * * * -- 
  This -- to Alone -- this -- this -- Solitude -- 
  Byron -- 
  Frankfurt Main -- Verlag Heinrich Wilmans -- 
  1824. Einleitung -- 
  weniger Monat Montpelli -- ausübend Arzt Paris -- Morgens St. Jakobs Vorstadt rufen -- jung Ordensschwester Kloster besuchen -- 
  Kaiser Napoleon -- Kurzem -- Wiederherstellung Kloster erlauben -- dasjenig -- wohin begeben -- Erziehung Jugend widmen -- gehören Orden Urselinerinn -- 
  Gebäude Revolution verwüsten -- 
  Kloster liegen -- Niederreißung alt Kirche -- Bogen -- Seite frei -- 
  Nonne führen -- Weg -- durchwandelen -- Steinplatt -- Pflaster Gang bilden -- 
  bemerken -- Grabstein -- sämtlich Inschrift -- größtenteils erloschen -- 
  stein Revolution zertrümmeren -- Schwester bemerkbar -- -- -- herstellen lassen -- 
  innerer Kloster sehen -- Schauspiel neue -- 
  Kloster kommen Garten -- Nonne -- krank Schwester hingebrachen -- 
  Laubengang -- 
  finden sitzend -- lang schwarz Schleier verhülln beinahe gänzlich -- 
  -- Arzt -- -- Schwester -- entfernt Augenblick -- 
  nahen furchtsam -- Anblick vieler Grab beengt Herz -- stellen -- neu Opfer Kloster sehen -- 
  Vorurteil Jugend erwachen -- Anteil -- besuchen kommen -- erhöht Grade vermeintlich Unglück -- 
  drehen -- seltsam überraschen -- Negerin sehen -- 
  erstaunen vermehrt Artigkeit -- womit empfangen -- Wahl Ausdruck -- bedienen -- 
  -- sehen -- -- -- -- krank Person -- 
  wünsche Genese -- -- nachteilig -- -- 
  Befrag Krankheit -- 
  fühlen -- -- -- -- beständig Beklemmung -- Schlaf -- Fieber verlassen -- -- 
  Anblick bestätigen traurig Beschreibung Zustand -- außerordentlich abgemageren -- feurig -- Auge -- blendend weiß Zahn einzig Lichtteil Gesicht -- Seele lebendig -- Körper zerrütten -- tragen Merkmal lang heftig Kummer -- 
  Unaussprechlich rühren Beschloß versuchen -- retten -- 
  fing -- Notwendigkeit reden -- Einbildungskraft beruhigen -- zerstreuen schmerzhaft Empfindung entfernen -- 
  -- glücklich -- -- -- -- Beruhigung Glück finden -- -- -- 
  Ton Stimme verraten Aufrichtigkeit -- sanft Stimme betrügen -- 
  erstaunen wachsen Augenblick -- 
  -- denken -- -- -- tragen Zeichen lang leiden -- -- 
  -- -- -- erwidern -- -- Ruhe Herzens spät finden -- glücklich -- -- 
  -- -- Wohlan -- -- heil -- hoffen -- gelingen -- heil -- kennen -- -- 
  -- -- -- -- erwidern -- -- Torheit -- -- 
  Wort benetzt Tran Wimper -- 
  -- sagen -- glücklich -- -- rufen -- 
  -- -- -- -- -- erwidern Entschlossenheit -- -- Glück Lose vertauschen -- einst beneiden -- 
  Geheimnis -- Unglück Geschichte Leben -- 
  Augenblick -- Haus treten -- gelitt -- Gesundheit zerrütten -- 
  Freude welken -- Zukunft lassen Hoffnung erblicken -- 
  Gedanke strafbar -- sehen bestrafen -- leben wünschen -- -- -- 
  beruhigen -- flößt Hoffnung nah Genesung -- tröstend zusprach -- leben verheißen -- wissen -- Vorgefühl verkünden -- spät -- Tod Opfer erkoren -- 
  besucht jung Schwester mehrmals -- 
  scheinen Anteil rühren -- beweisen -- 
  Tages Gegenstand -- worauf bringen wünschen -- 
  -- leiden -- erdulden -- -- -- -- sonderbar erscheinen -- Widerwille empfinden -- mitteilen -- 
  leiden Anderer urteilen -- vertraute fast Ankläger -- -- 
  -- -- Fürcht -- -- -- -- sehen -- Zerstörung Kummer hervorbringen -- Ihrig aufrichtig halten -- -- 
  -- aufrichtig finden -- -- erwidern -- -- vernünftig vorkommen -- 
  zugeben -- sagen -- -- versetzen -- -- Mitgefühl ausschließen -- -- 
  -- -- fast -- -- antworten -- indessen -- heil -- nötig -- leiden -- Gesundheit untergraben -- mitteilen -- sobald kennen lernen -- -- 
  häufig Besuch Kloster -- 
  Behandlung -- vorschreiben -- scheinen Wirkung hervor bringen -- 
  -- letzter Sommer Tag Laube nämlich Bank finden -- Mal sehen -- knüpft Unterhaltung -- erzählen folgen -- 
  Urika -- 
  Urika -- 
  alte -- Herr Chevalier B. -- Senegal -- Gouverneur -- mitbringen -- 
  erbarmt Tag -- Sklav Negerfahrzeug einschiffen -- Hafen verlassen -- 
  Mutter tot -- bringen -- ungeachtet Schreien -- Schiff -- 
  Herr B. kaufen -- Ankunft Frankreich -- übergeben Marschallin B. -- Tante liebenswürdig Frau -- erhabenst Eigenschaft rührendst Güte verbinden wissen -- 
  Sklaverei retten -- Frau B. Wohltäterin geben -- heißen zweimal Leben schenken -- 
  undankbar Vorsehung -- glücklich -- -- Glück Erzeugnis Gabe Intelligenz -- -- 
  vielmehr Gegenteil glauben -- 
  Wohltat Erkenntnis wünsche bezahlen -- unwissend bleiben -- Fabel -- Galathe Glück finden -- Leben empfangen -- 
  erfahren nachh Geschichte Jugendzeit -- 
  entferntest Erinnerung erstreckt Zimmer Frau B. hinaus -- 
  bringen -- gelieben -- schmeicheln verdorben Freund -- Geschenk überhäufen -- rühmen -- geistreich liebenswürdig Kind erheben -- 
  halten Gesellschaft fest Grundsätze -- Festigkeit -- Geschmack ausschließen wissen -- Übertreibung ähnlich -- 
  loben -- loben -- entschuldigen -- Gelegenheit Tadel Darbot -- -- liebenswürdig Geschicklichkeit -- wandelen Fehler Eigenschaft -- 
  Erfolg Mut -- 
  gelten Frau B. -- gelten -- -- legen -- wissen -- Freund Eigenschaft -- 
  hören -- -- glauben ähnlich -- 
  morgenländisch Tracht kleiden -- Fuß Frau B. sitzend -- hören verstehen -- Unterredung ausgezeichnetesten Mann -- 
  Ungestüme anderer Kind -- nachdenkend -- ehe denken -- glücklich Seite Frau -- -- 
  Wonn -- hören -- gehorch -- -- anzublicken -- 
  Verwunderung regen -- mitten Aufwand leben -- geistreichsten liebenswürdigsen Mensch umgeben -- kennen Anderer -- 
  -- wissen -- fassen Geringschätzung -- Kreis zugehören -- leben -- 
  Geschmack Geist -- Ton richtig Gehör -- 
  Kind Mangel Geschmack zuwider -- fühlen -- ehe erklären -- Gewohnheit notwendig -- 
  Anlage gefährlich -- Aussicht Zukunft -- Zukunft -- ahnen -- 
  erreichen Alter zwölf Idee -- glücklich können -- -- 
  leid -- schwarz -- -- Allerliebst -- lassen hierin Nachteil sehen -- 
  Kind fast -- einzig Freund -- schwarz Farbe hindern -- leiben -- 
  Wohltäterin Enkel -- Kind früh verstorben Tochter -- 
  Karl -- jung -- beinahe gleich Alter -- 
  auferzogen -- Verteidiger -- Ratgeber Helfer Versehen -- begehen -- 
  Kolleg -- 
  weinen -- verlassen -- Kummer -- 
  denken Karln -- fast -- 
  studieren -- Seit lernen -- Frau B. Gefallen -- -- vollkommen Erziehung gehören -- 
  -- Talent besitzen -- 
  Stimme -- geschicktest Meister bilden -- 
  finden Geschmack Malerei -- berühmt Maler Freund Frau B. leiten Versuch -- 
  lernen Englisch -- Französisch -- Frau B. bekümmert Lektüre -- 
  leiten Verstand -- bildet Urteilskraft -- 
  sprechen -- Reichtum Seele entdecken -- fühlt Meinig erheben -- Bewunderung eröffnen Weg Erkenntnis -- 
  -- 
  ahnen -- angenehm Studie bitter Folge -- 
  gedacht Frau B. fallen -- beifällig lächeln Lippe Zukunft -- 
  las indessen -- 
  Dichter hauptsächlich sprechen jugendlich Einbildungskraft -- Zweck -- Plan lassen ausschweifend Gedanke frei Lauf -- Jugend Selbstvertrauen -- Frau B. glücklich wissen -- 
  Zärtlichkeit -- Leben -- führen -- -- halten Irrtume -- entschuldigt Verblendung -- 
  Sorgfalt Auszeichnung anführen -- Gegenstand -- 
  -- sehen -- Mühe kosten glauben -- Schönheit Wuchse berühmt -- 
  Frau B. rühmen -- Anmut nennen -- Wunsch gemäß -- vollkommen tanzen lernen -- 
  Talent glänzen lassen -- Wohltäterin Ball veranstalten -- Enkel Vorwand dienen -- eigentlich Zweck -- Quadrille Weltteil -- worin Afrika vorstellen -- Vorteil zeigen -- 
  ziehen Reisebeschreibung Rat -- durchblätteren Buch -- Völkertracht schreiben -- las gelehrt Werk afrikanisch Musik -- wählen Koma -- Nationaltanz Land -- 
  Tänzer schwarz Flor Gesicht -- -- -- 
  nötig meinig nehmen -- Betrachtung -- 
  Vergnügen Ball hingegeben -- tanzt Koma -- gut Erfolg -- Neuheit Schauspiel Wahl Zuschauer erwarten -- groß -- Freund Frau B. -- Begeisterung hingerissen fühlen -- Vergnüge glauben -- Gefühl Lebhaftigkeit hingaben -- 
  Tanz anziehend -- 
  bestehen Wechsel schön Stellung abgemessen Schritt -- stellen Liebe -- Schmerz -- Triumph Verzweiflung -- 
  kennen heftig Bewegung Seele -- wissen -- Instinkt erraten lassen -- -- gelingen -- 
  klatscht Beifall -- umringen -- Sicherheit beunruhigen -- wiegen -- 
  Balle -- Unterredung -- zufällig zuhören -- Auge öffnet Kindheit -- 
  befinden Ansprachzimmer Frau B. -- lackieren spanisch Wand -- 
  verdeckt Türe -- reichen Fenster -- Wand Fenster stehen Tisch -- bisweilen zeichnen -- 
  Tag besonderer Aufmerksamkeit Miniaturgemälde vollenden -- 
  Arbeit vertiefen -- unbeweglich bleiben -- Frau B. glauben Zweifel -- hinaus gehen -- Freundinne -- Marquise * * * ankündigen -- 
  Dame kalt Vernunft -- scharfem verstand -- Trockenheit zuverlässig -- 
  entwickelt Charakter freundschaftlich Verhältnis -- 
  Aufopferung -- Freund -- kosten -- lassen Anhänglichkeit teuer stehen -- 
  ausforschend wunderlich -- glich Anmaßung Zuneigung -- -- Freundin Frau B. -- minder liebenswürdigste -- 
  fürchten -- gütig -- Weise -- 
  auszufragen -- streng auszufragen -- Zeichen Anteil -- 
  -- 
  Wohlwollen verwöhnen -- Gerechtigkeit fürchterlich vorkommen -- 
  -- -- -- Marquise Frau B. -- -- Urika sprechen -- 
  reizend -- Verstand völlig ausbilden -- 
  sprechen -- voll Talent -- anziehend -- -- -- -- 
  -- -- -- -- Frau B. -- -- Gedanke beschäftigen -- gestehen -- Kummer -- 
  lieben -- Tochter -- -- glücklich -- dennoch Lage nachdenken -- finden -- Rettung -- 
  arm Urika -- 
  sehen -- sehen verlassen stehen -- Leben -- -- 
  unmöglich -- Wirkung schildern -- weniger Wort hervorbrachten -- 
  schnell Blitz -- 
  -- Negerin -- abhängig -- verschmähen -- Vermögen -- Stütze -- Wesen Art -- Schicksal knüpfen können -- Spielzeug -- Unterhaltung Wohltäterin -- Welt zurückgestoßen -- -- 
  fürchterlich Herzklopfe befiel -- Auge verdunkelen -- Schlag Herzen machen Augenblick unfähig -- zuzuhören -- -- 
  erholen -- Verfolg Gespräch hören -- 
  -- fürcht -- -- Marquise -- -- unglücklich -- 
  -- befriedigen -- Lebenstage traulich Verein Gesellschaft zubringen -- -- 
  -- -- -- bleiben -- -- Frau B. -- -- -- -- versetzen Marquise -- -- Kind -- 
  -- fünfzehn alt -- verheirat -- Ausbildung Erziehung -- geben -- -- 
  schwarze heiraen -- Geld verstünd -- schwarz Kind bekommen -- gemein Mensch -- Mensch niedrig Verhältnis -- unglücklich -- 
  -- begehren -- -- 
  -- -- -- Frau B. -- ahnen -- glücklich -- hoffen -- Anhänglichkeit -- -- Beurteilung Lage abhalten -- 
  glücklich wissen -- gemein Weib -- 
  glauben aufrichtig -- unmöglich -- 
  Wohlan -- 
  hinlänglich bemerkbar -- Schicksal erheben -- bleiben -- -- 
  -- leer Hoffnung -- -- Marquise -- -- Philosophie erheben Mißgeschick -- 
  vermögen Übel -- Überschreitung Ordnung entspringen -- Natur vorschreiben -- 
  Urika Geschick erfüllen -- 
  Erlaubnis Gesellschaft drängen -- Gesellschaft rächen -- -- 
  -- sicher unschuldig Vergehen -- -- Frau B. -- -- streng arm Kind -- -- 
  -- -- -- -- -- versetzen Marquise * * * -- -- wünsch Glück befördern -- stürzen verderben -- -- 
  Frau B. antworten heftig -- Veranlassung Streite Freundin -- Besuch ankündigen -- 
  schlich spanisch Wand fort -- entwischen -- 
  eilt Zimmer -- Tränenflut arm Herz Augenblick Linderung gewähren -- 
  Veränderung Leben vorgehen -- Blendwerk -- womit umgeben -- Auge fallen -- 
  Täuschunge -- Licht Tag gleich -- verlieren -- verschwinden -- 
  Gewirre Idee -- einstürmn -- finden -- beschäftigen -- Abgrund all Schrecken -- 
  Verachtung -- womit verfolgen -- Gesellschaft -- gehören -- Mensch -- Geld einwillig -- schwarz Kind bekommen -- Gedanke steigen Gespenster klammert Furie -- vorzüglich -- Abgeschiedenheit -- Überzeugung -- stehen Leben -- -- Frau B. -- Augenblick wiederholen -- -- -- -- 
  vorherigen -- liegen -- -- 
  wissen -- fühlen -- brauchte -- lieben -- denken -- -- lieben bedürfen -- 
  Auge öffnen -- Unglück Mißtrauen Seele werfen -- 
  Frau B. -- Veränderung erstaunt -- 
  fragen -- 
  -- krank -- glauben -- 
  Frau B. lassen Barth rufen -- sorgfältig ausforscht -- Puls fühlen -- barsch äußern -- fehlen -- 
  Frau B. beruhigen -- versuchen -- zerstreuen unterhalten -- 
  Wag gestehen -- undankbar Aufmerksamkeit Wohltäterin -- Herz gleichsam verschließen -- 
  Wohltat -- empfangen angenehm -- -- Herz vergelten vermögen -- 
  meinig voll bitter Empfindung -- außen ergießen -- 
  Unendlichkeit verwandt Idee beschäftigen immerwährend -- erzeugt tausend verschieden Form -- 
  Einbildungskraft lieh finstersen Farbe -- 
  bringen Nacht weinen -- 
  erschöpfen Mitleide -- 
  Gestalt flößt Abscheu -- wagen -- Spiegel beschauen -- 
  Auge schwarz Hand fallen -- glauben Aff sehen -- 
  vergrößert Häßlichkeit -- Farbe erscheinen Zeichen Verworfenheit -- 
  -- Wesen Gattung abschied -- verdammen -- -- nimmer lieben -- 
  Mensch -- Geld -- verstehen -- schwarz Kind bekommen -- 
  Herz empört Unwille Gedanke -- 
  Augenblick Idee -- Frau B. bitten -- Vaterland schicken -- 
  -- gehören -- verstehen -- 
  -- 
  gehören -- Fremdling menschlich Geschlecht -- 
  spät nachher begriff Möglichkeit -- Schicksal ergeben -- 
  Frau B. Betschwester -- 
  verdankt ehrwürdig geistliche -- Kommunion vorbereiten -- religiös Gesinnung -- 
  aufrichtig -- Charakter -- wissen -- Frömmigkeit -- fruchtbringend -- all unser Handlung verweben -- 
  meinig Augenblick tags beschäftiget -- Übrig fremd bleiben -- 
  Beichtvater heilig -- argwöhnisch Greis -- 
  mal jährlich -- einbilden -- Vergehen -- grämen -- Kummer -- 
  fühlt nachteilig Einwirkung Gesundheit -- -- sonderbar -- Verstandeskraft nehmen -- 
  Weiser Orient -- 
  -- gelitt -- wissen -- -- 
  -- Unglücke wissen -- 
  Eindruck Gefühl -- urteilen -- lieben -- 
  Rede Handlung -- Person -- gefiel mißfiel Herz -- 
  Verstand unwillkürlich Gemütsbewegung trennen -- 
  Kummer wirken -- Entfernung -- lassen Gegenstand Zusammenhang beurteilen -- 
  fremd fühlen -- schwierig -- tadelnd untersuchen fast -- woran Gefallen finden -- 
  Stimmung Frau B. entgehen -- 
  erfahren -- Ursache erriet -- 
  fürchtet Kummer vermehren -- erlaubt auszuschütten -- erweisen Güte vorher -- 
  sprechen gänzlich Hingebung -- Sorge zerstreuen -- unterhalten -- 
  Herz beurteilen -- Idee Wohltäterin notwendig -- nützlich -- Leben knüpfen -- 
  Gedanke -- meisten verfolgen -- -- Welt stehen -- sterben -- jemand bedauern erregen -- 
  ungerecht Frau B. -- lieben -- beweisen -- Interesse -- weiten vorgingen -- 
  beneidet Zärtlichkeit -- Sohn -- vorzüglich Karln -- -- wünschen -- ebenfalls -- Mutter -- sagen -- 
  Familien-Verhältnisse machen schmerzlich Eindruck -- -- weder Schwester -- Gattin -- Mutter -- 
  stellen Bande süß -- Wirklichkeit -- vernachlässigen -- erlauben -- bloß erstere erreichen -- 
  Freundin -- besitzen Zutrauen -- 
  Frau B. fühlen vielmehr unbegrenzt Verehrung -- Neigung -- glauben -- Karln Empfand -- Bruder empfinden -- 
  Schule -- verlassen -- Reise beginnen -- 
  reisen alt Bruder Hofmeister -- Deutschland -- England Italien sehen -- Abwesenheit dauern -- 
  Karl Abreise erfreuen -- betrübt letzter Scheidung Moment -- freuen -- Vergnügen -- 
  Idee äußern -- beschäftigen -- 
  niemals -- geraume brauchen -- Ursache leiden erklären -- 
  gewiß -- verstehen -- 
  sanft ernst Mien -- Anlage Spöttelei -- furchtsam -- 
  Wahrheit üben lächerlich Anmaßung -- Ernst entwaffnen -- 
  demnach -- 
  Abreise Zerstreuung -- glauben -- -- -- gewöhnlich Schmerz grämen -- 
  Abreise Karls -- Revolution ernster Charakter annehmen -- 
  hören Ansprachzimmer Frau B. -- moralisch politisch Interesse reden -- Revolution Ursprung Bewegung setzen -- 
  handeln -- groß Geist Zeit beschäftiget -- 
  fähig -- Idee erweitern ausbilden -- Schauspiel Kampfplatzes -- ausgezeichnetsen Mann auf Frage verhandelten -- entscheiden betrachten -- 
  erschöpft Gegenstand -- steigen Ursprung Institution hinauf -- erschüttern -- zerstören -- 
  glauben -- -- jung -- fremd Interesse Gesellschaft -- stille geheim Wunde nährend -- Revolution Veränderung Idee bringen -- Augenblick leiden vergessen -- Herz Hoffnung erfüllen -- 
  suchen emsig -- Trost gereichen -- 
  schweben dunkel -- Unordnung Platz finden können -- Reichen stürzen -- Stände verschmolzen -- Vorurteil verschwinden -- Zustand Ding herbeigeführen können -- fremd bleiben -- -- Überlegenheit Verstand -- verborgen Eigenschaft besäße -- schätzen wissen -- Farbe mitten Gesellschaft absonderen -- 
  widerstrebt Eigenschaft -- finden hoffen -- Täuschung -- hingeben -- wünschen -- böse geschäh -- persönlich Nutzens halber -- 
  Seite lächerlich Mensch -- Herr Begebenheite aufwerfen -- 
  Kleinlich Charakter -- Erriet geheim Absicht -- falsch Philanthropie hören täuschen -- Hoffnung -- -- mitten Widerwärtigkeiten Verachtung übrig bleiben -- 
  indessen groß Anteil lebhaft Erörterung -- verlieren -- groß Reiz ausmachen -- 
  -- gefallen wünschen -- Bedingung Gelingen -- Triumph Eigenlieb vergessen -- 
  Revolution aufhört schön Theorie -- innigst Interesse berühren -- artet Gespräch Zänkereie -- Erbitterung Persönlichkeit nehmen Stelle Vernunft -- 
  traurig -- ergötzn dennoch bisweilen heftig Ausbrüche -- Grund fast anderesr -- Anmaßung -- Verstellung -- Furcht -- 
  Fröhlichkeit -- Auffindung Lächerlichen Grund -- tun Herzen -- 
  liegen Bosheit Fröhlichkeit -- Herz erfreuen -- unschuldig Freuden Gefallen finden -- 
  spöttelnd Fröhlichkeit besitzen -- aufhören -- unglücklich -- 
  Unglück hierzu aufgelegt -- Bitterkeit -- wovon Seele nähren -- gewöhnlich Nahrung traurig Vergnügen -- 
  zerstört Hoffnung -- Revolution eingeflößt -- Gemütsstimmung verändern -- 
  mißvergnügt Schicksal -- leiden Zutrau Güte Frau B. versüßen -- 
  mitten politisch Unterhaltung -- Heftigkeit Einhalt vermögen -- bisweilen traurig -- 
  Blick Balsam Herz -- scheinen sagen -- Urika -- verstehst -- 
  fing Befreiung Negersklav reden -- 
  unmöglich -- Frage lebhaft berühren -- 
  Täuschung -- abermals gerne hingeben -- Gleichen -- 
  unglücklich -- halten -- Schicksal Anteil -- 
  -- 
  enttäuschen -- 
  Metzeleie St. Domingo verursacht -- heftig Schmerz -- 
  hierhin kränken -- geächtet Menschenklas anzugehören -- schämt Verwandtschaft Ras Barbar Mörder -- 
  Revolution indessen schnell Fortschritt -- 
  erschrecken -- heftig Mensch Platz bemächtigen sehen -- 
  scheinen -- Mensch entschlossen -- -- 
  fürchterlich 20. Junis 10. August müssen vorbereiten -- 
  Gesellschaft Frau B. übrig bleiben -- zerstreut Epoche -- 
  flüchtet Verfolgung fremd Land -- versteckt ziehen Provinz -- 
  Frau B. weder -- -- 
  Herz beschäftiget -- Heimat ketten -- bleiben teuer Erinnerung getreu -- Nähe Grabmal -- 
  leben Monat Einsamkeit -- Jahr 1792 Dekret Einziehung Emigranten-Güter erscheinen -- 
  mitten Unglück Frau B. Verlust Vermögen zählen -- enkeln angehören -- vermöge Familien-Übereinkunft -- hiervon Nießbrauch -- 
  entschließen Karln -- jung Bruder -- zurückkommen lassen -- alt -- ungefähr zählen -- Condeisch Armee schicken -- 
  Italien -- -- verschieden Umstand -- unternommen Reise vollenden -- 
  Karl Anfang Februar 1793 -- Tod König -- Paris -- 
  Verbrechen Frau B. lebhaftesen Schmerz verursachen -- 
  überlassen -- Seele stark -- abscheulich Freveltat Unermeßlichkeit beurteilen -- 
  schwer Bekümmernis alt Auffallend -- ansehen Vernunft -- 
  Frau B. leiden Heftigkeit Karakterstärke -- 
  Gesundheit gelitten -- bilden -- versuchen können -- tröst -- zerstreuen -- 
  weinen -- schließen Gesinnung -- suchen Seele erheben -- ihrig nah bringen -- leiden -- 
  denken -- Schreckenszeit dauern fast Kummer -- geschämt -- Gegenwart Mißgeschicke unglücklich finden -- fühlen überdies -- unglücklich -- 
  Meinung gleichen Stück vaterland -- Gemeingut -- erfreuen -- Bruder behaupten -- verteidigen -- 
  bisweilen -- -- obgleich arm Negerin -- dennoch Bedürfnis Gerechtigkeit -- gemeinschaftlich fühlen -- Seele gemeinschaftlich knüpfen -- -- Tugend Wahrheit triumphieren -- Triumphs -- -- fernen -- 
  sobald Karl angelangen -- reisen Frau B. auf Land -- 
  Freund halten verbergen -- flüchten -- 
  Gesellschaft beinahe alt Abbe beschränken -- Religion bespötteln hören -- zornig -- geistlich Gut verkaufen -- hierdurch tausend Livre Rente verlieren -- 
  Abbe St. Germain -- 
  Umgang sanft -- vielmehr ruhig -- liegen Ruhe Sanftmut -- eher Erzeugnis Denkweise -- Seelenfriedens -- 
  Frau B. jeher Lage -- Dienst erweisen -- 
  freundschaftlich Verhältnis Herr Choiseul -- vermögen -- lang Ministerium Mensch nützlich -- 
  Mensch -- einflußreichsen Schreckenszeit -- Frau B. Verbindlichkeit schuldig -- erinnern erkenntlich -- 
  stets Auge behaltend -- lassen Gefahr aussetzen -- wagen einigemal Leben -- ihrig Wut Revolutionsmänner retten -- bemerken -- traurig Periode heftig Parteihäupter -- Gefahr -- ausüben -- 
  scheinen -- verheert Erde Übel regieren können -- Gewalt -- 
  Frau B. Gefängnis -- vorwand mißlich Gesundheitsumstände Haus bewachen -- 
  Karl -- Abbe bleiben -- widmet Sorgfalt -- 
  vermögen Zustand Angst Schrecken schildern -- zubracht -- Abend Tagblättern Verurteilung Hinrichtung Freund Frau B. lasen -- Augenblick zitteren -- Beschützer Gewalt -- nämlich Schicksal bewahren -- 
  erfuhren -- nahe -- umkommen -- Tod Robespierre's Gräueln -- 
  atmen -- Wachen verlassen Haus Frau B. -- bleiben -- -- nämlich Einsamkeit -- -- -- denken -- Plage finden -- entgehen -- 
  glauben -- Bande sein Unglück eng knüpfen -- fühlen lernen -- Fremd -- 
  süß Augenblick Leben kennen lernen -- Täuschung Kindheit verlieren -- Zeitraum -- verhängnisvollen folgen -- 
  Frau B. besitzen hoch Grade -- Reiz häuslich Leben ausmachen -- 
  nachsichtig verträglich -- Gegenwart äußeren -- erraten -- sagen -- -- 
  erkältet streng falsch Auslegung Zutrauen -- Gedanke gelten -- gelten -- verantwortlich -- 
  Eigenschaft Frau B. Freund beglücken -- besessen -- 
  Vorzug besitzen überdies -- 
  unterhalten -- fühlt leer Langeweile -- dienen -- Unterhaltung beleben -- 
  Anteil geringfügig Ding -- gemein Mensch Nichtswürdigkeit -- ausgezeichnet Person Quelle mannigfaltig Vergnügen -- überlegen Kopf -- -- 
  gewöhnlich Idee fruchtbar -- Mund Frau B. -- Verstand wissen tausenderlei Farbe auszuschmücken -- 
  Karl Charakterähnlichkeit Frau B. -- glich Verstand ihrigen -- -- -- ihrig -- gerecht -- entschlossen ausbreiten -- Beschränkung -- Jugend kennen -- 
  bös -- Klippe Alter -- -- weder vollkommen -- finden -- 
  Karl besitzen schön Leidenschaft Alter -- nämlich -- Gerechtigkeit Wahrhaftigkeit -- 
  -- Schatten Verstellung vermeiden -- Fehler -- bisweilen sehen -- -- 
  gewöhnlich zurückhaltend -- zutrauen schmeichelhaft -- -- -- Frucht Hochschätzung -- Neigung Charakter -- 
  bewilligen -- Wert -- fast unwillkürlich -- -- 
  halten -- Gedanke -- sogleich mitteilen -- 
  Abends -- Tisch versammeln sitzen -- Gespräch mannigfaltig Art -- 
  alt Abbe Platz -- 
  vollständig Geweb falsch Idee bilden -- behaupten vieler Treuherzigkeit -- unerschöpflich Quelle Belustigung Frau B. -- scharfsinnig -- hell Geist Albernheit arm Abbe' vortrefflich herauszuheben wissen -- aufbringen -- 
  Witz bringen nämlich Ideen-Ordnung Querhiebe -- berühmt Säbelhiebe Ritter Rolands Charlemagne vergleichen -- 
  Frau B. Spaziergängerin -- 
  Walde St. Germain -- Begleitung Abbe's -- Arm lieh -- 
  Karl folgen weit -- 
  -- sprechen -- beschäftigen -- Plan -- Hoffnung -- Ding -- Mensch Begebenheite -- 
  verhehlen -- denken -- anvertrauen -- 
  zählen lang -- Freundschaft Gewohnheit -- Leben -- Genoß -- empfinden -- verlangen weder Anteil -- Aufmerksamkeit -- wissen -- -- sprechen -- -- sprechen -- -- -- 
  Reiz Zutrauen ersetzen -- Glück -- 
  denken -- Karln sagen -- leiden verursachen -- 
  fragen -- erinnern -- -- bildet -- Geheimnis -- 
  wohnen leiden sehen -- Frau B. Glück -- glauben -- glücklich -- 
  -- -- klagen Undankbarkeit Torheit -- 
  wissen -- wagen gestehen -- Grade unheilbar Übel -- Farbe -- unglücklich -- 
  Demütigende -- widerstreben -- Notwendigkeit unterwerfen -- nehmen Schmerz -- Seele bemächtigen -- Charakter Verzweiflung -- 
  Karln furchtsam -- streng Ideenrichtung -- 
  Gespräch Abend Mitleide richten -- fragen -- Kummer Resultat Ursache Anteil erwecke -- 
  Karl Ursache aussprechen -- glauben -- Schmerz vernünftig -- 
  -- Vernunft -- 
  Welt -- 
  Herzen Bedürfnis -- Unglück Entbehrung desjenigen -- Herz bedürfen -- -- 
  selten führen Abendunterhaltung Weise Betrachtung -- trachtet denken -- 
  Spiegel Zimmer entfernen -- tragen beständig Handschuhe -- Kleid verbergen Hals Arm -- Ausgehe tragen Hut Schleier -- Haus ablegen -- 
  -- 
  Betrog -- Kind verschließen Auge -- glauben -- sehen -- 
  Jahr 1795 Schreckenszeit vorüber -- fing -- finden -- 
  Trümmer Gesellschaft Frau B. vereinigten -- 
  Schmerz Kreis Freund erweitern -- 
  Stellung Welt mißgriffen -- -- jemehr Gesellschaft natürlich Ordnung zurückkehren -- desto verstoßen finden -- 
  Person Frau B. eintreten -- Empfand Qual -- 
  Verachtung gemischt Ausdruck Erstaunen -- Gesicht wahrnehmen -- fing beunruhigen -- 
  sicher Gegenstand geheim Flüstern fensternisschen -- müssen erklären lassen -- Negerin -- auserwählt Gesellschaft Frau B. aufnehmen -- 
  leiden Erklärung Märtyrthum -- 
  barbarisch Vaterland bringen -- mitten Wilder -- bewohn -- minder fürchten -- Gesellschaft -- grausam -- Übel verantwortlich -- wovon alleinig Ursache -- 
  mehrere hindurch verfolgt Erinnerung höhnisch Gesicht -- Traume -- erscheinen Augenblick -- schweben -- Bild -- 
  -- -- Schimären -- hinreißen lassen -- 
  Gott -- 
  hattest lehren -- Phantom bannen -- wissen -- Ruhe suchen -- 
  Herzen Karl's suchen Trost -- 
  stolz Freundschaft -- Tugende -- 
  bewundert Vollkommenst -- Erde kennen -- 
  ehemals glauben -- Karln Bruder lieben -- litt -- -- altern -- Liebe Mutterlieb glichen -- 
  Mutter leidenschaftlich verlangen empfinden -- glücklich wissen -- gerne Leben hingegeben -- Augenblick Kummer ersparen -- 
  Eindruck -- hervorbracht -- glücklich -- bekümmern -- 
  -- 
  fürchten -- beständig Unruhe einflößen -- Gedanke anderer Mensch empfinden -- 
  harmoniert Schicksal -- meinig Mißstimmung -- 
  morgens alt Freund Frau B -- 
  Heirats-Antrag Karln beauftragen -- 
  Fräulein Themines grausam Weise reich Erbin -- 
  Familie Schafotte verlieren -- bleiben Großtante übrig -- Nonne -- -- Vormünderin Fräulein Themines -- Pflicht halten -- verheiraten -- 
  glauben eilen -- achtzig zählen -- sterben -- Nicht hülflo Welt lassen fürchten -- 
  Fräulein Themin vereinigt Vorzug Geburt -- Vermögen Erziehung -- 
  sechzehn alt -- schön -- 
  einwenden -- 
  Frau B. besprach Karln -- Anfang erschrak -- Frühe verheiraten -- 
  wünschen Fräulein Themines sehen -- 
  Zusammenkunft finden Stadt -- unentschlüssig -- 
  Anais Themines besitzen -- Karln fallen -- 
  artig -- wissen -- ruhig Bescheidenheit -- -- Natürlichkeit herrlich Tugend verdanken -- 
  Fräulein Themines erlauben Karln besuchen -- leidenschaftlich verlieben -- 
  unterhalten Fortschritt Liebe -- 
  ungeduldig schön Anai sehen -- Karls Glück -- 
  St. Germain -- 
  Karl sprechen -- verächtlichen -- forschend Blick ertragen -- wehe tun -- vielmehr Miene Engel Güte -- 
  geloben -- Karln glücklich -- beruhigt Jugend -- -- zwanzigst Vernunft reifer Alter besitzen -- 
  beantwortet Frage -- -- wissen -- Karln Jugend kennen -- 
  süß -- erzählen -- müde -- sprechen -- 
  Berichtigung vorläufig hierzu nötig Geschäft verschieben Abschluß Heirat Woche -- 
  Karl fahren fort Fräulein Themines besuchen -- bleiben Paris -- 
  Abwesenheit betrübt -- unzufrieden -- -- Glück demjenigen Karls vorzog -- lieben -- gewohnen -- 
  -- -- Festtag -- 
  erzählen -- Beschäftiget -- Herzen Anai Fortschritt -- freuen -- 
  tages erzählt Weise -- leben wollen -- 
  -- -- -- -- -- zutrauen verdienen suchen -- meinigen -- 
  verhehlen -- Gedanke wissen -- Bewegung Herzen kennen lernen -- wünsch -- zutrauen herrschen -- unsrig -- Urika -- -- 
  unsrige -- 
  Wort wehe -- erinnern -- Karl einzig Geheimnis Leben wissen -- benehmen Lust -- anvertrauen -- 
  dauern Karls Abwesenheit lang -- Verweilt beinahe Augenblick St. Germain -- 
  Pferd -- unterwegs zuzubringen -- kehren Nachmittag Paris -- -- Abend zubrachten -- 
  Frau B. scherzt Abwesenheit -- wünschen -- -- 
  tages gehen Walde spazieren -- 
  Karl beinahe Woche abwesend -- 
  gewahren plötzlich Allee -- gehen -- Pferd eilfertig -- 
  erreichen -- steigen -- 
  Minute allgemein Unterhaltung -- bleiben -- fangen -- unterhalten -- 
  Bemerkung -- 
  -- -- -- rufen -- -- ah -- welch Unterschied -- 
  sagen -- 
  scheinen -- Monat leben anfangen -- 
  Urika -- sagen -- empfinden -- 
  bisweilen glauben fühlen -- Seele ihrigen verschmilzen -- 
  anblicken -- atme -- erröten -- Füßen werfen anbeten -- 
  denken -- Beschützer Engel -- Leben -- Schicksal anvertrauen -- stolz meinig -- 
  glücklich -- Vater Mutter ersetzen -- verlieren -- Gatte Liebhaber -- 
  Liebe schenken -- Herz meinig ergießen -- Leben fahren -- zugeben -- Lauf lang sagen -- Stunde verleben -- glücklich fühlen -- 
  Wonn -- Urika -- denken -- Mutter Kind -- Schoße Anai Leben empfangen -- 
  Mild -- schön -- 
  -- o Gott -- Glück verdienen -- -- 
  -- 
  richten Himmel Augenblick Frage entgegen gesetzt Art -- 
  leidenschaftlich Wort wecken Augenblick unerklärbar Gefühl -- 
  Gott -- Zeuge -- Glücke Karl's glücklich fühlen -- arm Urika Leben geben -- 
  sterben Negerfahrzeug -- entrissen -- Schoße Mutter -- 
  Afrikanischer Sand bedeckt -- Last -- 
  Welt liegen -- Urika leben -- 
  leben verurteilen -- 
  -- leben -- -- nimmer lieben -- 
  O Gott -- gib -- 
  Nimm arm Urika Erde -- 
  bedürfen -- stehen einsam Leben -- 
  fürchterlich Gedanke ergreifen heftig -- zuvor -- 
  wanken -- fallen Knie -- Auge schließen -- glauben sterben -- 
  Wort endigen -- scheinen Beklemmung arm Nonne zuzunehmen -- Stimme schwach -- Träne rollt verwelkt Wang -- 
  bitten -- Erzählung verschieben -- weigern -- 
  -- -- -- -- -- Kummer Herz anhaltend -- Wurzel abschneiden -- 
  Gott Mitleider -- 
  Abgrunde entziehen -- fallen -- kennen lieben -- 
  vergessen -- glücklich -- -- -- -- fügen hinzu -- -- -- -- 
  Zeitraume -- wovon sprechen -- leiden ertragen -- Gesundheit schwächen -- Art Herrschaft behaupten -- 
  Kummer -- Wurm -- Frucht zernagen -- Herz anfangen -- inneren tragen Keim Zerstörung -- äußerlich Leben scheinen -- 
  Unterhaltung gefiel -- Streitfrage beleben -- Art Fröhlichkeit beibehalten -- Freude Herzen verlieren gehen -- 
  Zeitraume -- wovon sprechen -- stark leiden -- fühlen -- leiden Oberhand gewinnen -- 
  Karl bringen arm Haus -- Hilfe leisten -- -- 
  Auge aufschlagen -- Frau B. Seite Bettes -- 
  Karl halten Hand -- 
  bedienen -- la Gesicht Mischung Bangigkeit Innere gehend Schmerze -- 
  fühlt Leben wiederkehren -- Träne fließen -- 
  Frau B. trocknen sanft -- -- Frage -- 
  Karl überhäufen -- 
  wissen -- antworten -- schreiben Zufall Hitze -- Länge Wege -- 
  glauben -- Bitterkeit kehrt Herz -- -- glauben -- 
  Träne trocknen -- 
  -- täuschen -- Teilnahme anderswo fesseln -- ziehen Hand -- halten -- versuchen ruhig -- 
  Karl reisen -- gewöhnlich -- -- verwunden -- wünschen -- meinethalben unruhig -- litt -- 
  dennoch abgereisen -- zwingen -- -- -- Glück Abends verdanken -- Gedanke trösten -- 
  hüten -- Karln Bewegung Herzen sehen lassen -- 
  zart Gefühl Art Schamhaftigkeit -- bleiben unvollständig -- erraten -- 
  sagen -- empfinden -- -- 
  Karl abgereisen -- heftig Fieberanfall bekommen -- folgend zunehmen -- 
  Frau B. verpflegt gewohnt Güte -- Lage Unmöglichkeit -- Paris bringen lassen -- wohin Karls Hochzeit Tag nötigen -- äußerst bekümmert -- 
  Arzt sagen Frau B. -- Leben stehen -- St. Germain lassen -- 
  entschloß hierzu -- bezeugt Abschied zärtlich Liebe -- Augenblick Herz beruhigen -- 
  gänzlich Abgeschiedenheit -- -- Abreise -- erstenmal Leben befinden -- versetzen verzweifelt Stimmung -- 
  Lage verwirklichen -- Einbildungskraft vorgemalen -- sterben -- lieben -- Ohr traurig stöhnen vernehmen -- 
  -- 
  Freude stören -- 
  -- fern sterbend Urika -- Wonnetrunkenheit Glück überlassen -- 
  Urika Leben -- Urika nötig -- bedürfen -- -- 
  fürchterlich Gefühl Überflüssigsein -- menschlich Herz meister zerreisset -- 
  Abscheu Leben -- aufrichtig wünschen -- Krankheit -- danieder liegen -- sterben -- 
  sprechen -- fast Lebenszeichen -- einzig Gedanke schweben klar -- 
  sterben -- 
  Moment Bewegter -- erinnert Wort letzter Unterhaltung -- Karln Walde -- -- Meer Wonne schwimmend -- schildern -- verlassen sterben -- einsam Tod -- Leben -- 
  Idee peinlich Schmerz -- erdulden -- 
  erschuf eitel Träumerei -- Gefühl entsprechen -- 
  stellen Karln -- St. Germain zurückkommend -- 
  -- tot -- 
  glauben -- Schmerz freuen -- 
  rächen -- wofür -- Gott -- -- schützend Engel Leben -- 
  grausam Gefühl flößt Abscheu -- 
  Idee nehmen hiernach Richtung -- versuchen überwinden -- Stärke finden -- Gefühl bekämpfen -- bewegen -- sucht Stärke -- finden -- 
  schämt Undankbarkeit -- 
  sterben -- -- sterben -- dulden -- gehässig Leidenschaft Herz nähern -- 
  Urika enterbt Kind -- Unschuld bleiben -- Undankbarkeit entweihetn -- 
  Erde wandeln -- Schattenbild -- Grabe Friede -- 
  O -- Gott -- genieß Seligkeit -- wohlan -- gib Urika's Anteil -- laß hinsterb Blatt -- Herbste sinken -- gelitten -- -- 
  gena Krankheit -- Leben Gefahr setzen -- Zustand Siechtum fallen -- woran Kummer Anteil -- 
  Frau B. lassen -- Karls Hochzeit -- St. Germain nieder -- 
  Begleitung Anais -- niemals -- 
  leiden -- -- 
  wissen -- Bild Glückseligkeit Unglück fühlbar -- Gegenwart Karls Andenken alt Freundschaft erneuern -- 
  suchen bisweilen finden -- erkennen -- 
  dennoch ungefähr -- -- jetzig Freundschaft glich -- künstlich Blume natürlichen gleichen -- 
  -- Leben Wohlgeruch ausnehmen -- 
  Karl schreiben Zerrüttung Gesundheit Veränderung Charakter -- 
  glauben -- Frau B. traurig Gemütszustand beurteilen -- erriet -- insgeheim quälen -- lebhaft bekümmern -- vorbei -- trösten -- mitleiden -- -- 
  Anais schwang kehrt Paris -- 
  Traurigkeit -- 
  innerer friedlich Glück -- süßen Familienbande -- lieb Unschuld -- zärtlich leidenschaftlich -- Schauspiel Unglückliche -- bestimmen -- traurig Leben Abgeschiedenheit hinzubringen -- sterben lieben -- Bande kennen lernen -- Abhängigkeit Mitleiden -- 
  -- Monat fließen -- Unterhaltung -- Ausübung Talent aufgeben -- Lektüre leiden -- 
  -- worin unvollkommen Gemälde leiden finden glauben -- nagten -- 
  bereiten neu Gift -- berauscht Träne -- überlassen -- einsam Zimmer -- Stunde Schmerz -- 
  Geburt Sohnes setzen Karls Glücke Krone -- eilt -- benachrichtig -- Rausche Freude erkennen Ankläng alt Vertraulichkeit -- 
  O -- weh tun -- 
  -- 
  Stimme Freund -- verlieren -- Erinnerung Vergangenheit kehren Stimme -- auf Wunde aufzureissen -- 
  Karls Kind schön Anais -- gemäld jung Mutter Sohne rühren -- sonderbares Schicksal verdammen -- Bitterkeit betrachten -- 
  Herz verschlingen Bild Glückseligkeit -- kennen lernen -- Neid nagt Geier Inneren -- 
  tun -- retten glauben -- Land Verbannung führen -- 
  lassen Schicksal folgen -- 
  -- 
  Negersklavin reichen Kolonist -- Sonne verbrennen -- baut Land -- Hütte -- Abend bergen -- Gefährten Leben -- Kind Farbe -- -- Mutter -- zuriefen -- Abscheu Mund Stirn drücken -- Kopf Busen ruhen -- arme einschlummern -- -- 
  -- verdammen -- süß Bande erfreuen -- Herz schaffen -- 
  O Gott -- nimm Welt -- fühlen -- Leben ertragen -- 
  Zimmer hingekniet -- richten gottlos Gebet Schöpfer -- Türe öffnen hören -- 
  Freundin Frau B. -- Marquise * * * -- Kurzem England kommen -- mehrere zubringen -- 
  Schrecken -- Anblick erinnern beständig -- Schicksal verkünden -- -- Leidensquelle öffnet -- reichlich schöpfen -- 
  Paris -- erregen Anblick schmerzlich Gefühl -- 
  -- kommen besuch sprechen -- lieben Urika -- -- -- 
  wissen -- Kindheit lieben -- wahrhaften Kummer Schwermut sehen -- Versenk -- 
  -- -- verstand Ihrig -- gut Partie Lage ziehen wissen -- -- 
  -- Verstand -- Madam -- -- antworten -- -- dienen meist -- wahr Übel vermehren -- lassen mannigfaltig Gestalt sehen -- -- 
  -- -- -- -- erwidern -- -- übel unheilbar -- Torheit -- darein füg Notwendigkeit ankämpfen -- 
  stärkeren -- -- 
  -- -- -- -- -- scheinen -- Fall Notwendigkeit Übel -- -- 
  -- -- zugeben -- Urika -- Alsdann Vernunft raten verzichten zerstreuen -- -- 
  -- -- Madam -- zerstreuen -- sonstwo Hoffnung erblicken -- -- 
  -- -- können versuchen -- Beschäftigung Geschmack abgewinnen -- ausfüllen -- -- 
  -- -- Geschmack -- Madam -- Beschäftigung abgewinnen -- Anstrengung Vergnügen -- -- 
  -- -- -- -- -- besitzen Talent -- -- 
  -- -- Talente Hilfsquelle -- -- antworten -- -- gewiß Zweck vorsetzen -- Talent Blume englisch Dichter gleich -- Wohlgeruch Wüste ausduften -- -- 
  -- -- vergessen Freund -- erfreuen können -- -- 
  -- Freund -- Madam -- Beschützer -- Unterschied -- -- -- 
  Urika -- -- -- -- unglücklich -- unnütz Weise -- -- 
  -- -- Leben unnützen -- Schmerz -- -- 
  -- bitter Wort aussprechen -- Urika -- 
  -- hingebend bezeigt -- -- Schreckenszeit -- Frau B. bleiben -- -- -- 
  -- Madam -- 
  bös Genie -- Unglück Gewalt -- Glück vertreiben -- -- 
  -- -- vertrauen Geheimnis -- teuer Urika -- öffn Herz -- nehmen groß Anteil -- wirken -- -- 
  -- -- Geheimnis -- Madam -- -- antworten -- -- Lage Farbe einzig Unglück -- wissen -- -- 
  -- -- Weg -- -- erwidern -- -- leugnen -- Innerst Seele schwer Kummer bergen -- 
  sehen -- hiervon überzeugen -- -- 
  bestehen -- wiederholen -- -- 
  ungeduldig heben Stimme -- 
  -- Wetter losbrechen -- 
  -- Wahrhaftigkeit -- -- -- -- Aufrichtigkeit -- worum rühmen -- 
  Urika -- nehmen -- Zurückhaltung führen bisweilen Falschheit -- -- 
  -- -- -- anvertrauen -- -- -- -- hauptsächlich -- voraussehen -- Unglück Lage entspringen -- 
  wenigster neue hierüber sagen -- -- 
  -- niemals glauben -- -- erwidern -- -- zutrauen versagen -- versichern -- Geheimnis -- wohlan -- Urika -- 
  nehmen -- sagen -- einer -- 
  -- Urika -- all Gram -- all Schmerz rühren unglücklich Leidenschaft -- törichn Leidenschaft -- Karln toll Weise verlieben sein -- finden wissen -- Negerin -- 
  Leben -- Urika -- 
  gehen -- erklär -- minder Teilnahme -- mitbrachen -- -- 
  Wort verlassen Zimmer -- 
  vernichten -- 
  entdecken -- 
  fürchterlich Licht Abgrund leiden werfen -- 
  Gott -- Licht -- tief Hölle drang -- unglücklich Bewohner Finsternis desto fühlbar -- 
  -- 
  hegt verbrecherisch Leidenschaft -- 
  -- Herz nagen -- 
  verlangen -- Platz Kette Wesen einnehmen -- Bedürfnis Bande Natur -- Schmerz Alleinsein Gram frevelhaft Liebe -- Vorbild Glück beneiden glauben -- Glück -- Gegenstand gottlos Wunsch -- 
  -- hoffnungslos Leidenschaft befallen glauben -- 
  unmöglich -- Leben Unschuld lieben -- 
  Gefühl -- Mutter beseelten -- Löwe Rachen stürzen -- Sohn retten -- 
  Geschwister -- Schafott sterben wünschen -- Gott beten -- ehe bestiegen -- frevelhaft Liebe vereiniget -- 
  Erzeugt Menschlichkeit täglich erhaben Beispiel Hingebung -- 
  Karln -- Gespiel Kindheit -- lieben -- dennoch wissen -- Stimme Inneren zurufen -- -- schuldig -- 
  Gott -- Gewissensbiß trostlos Herz aufnehmen -- 
  Urika Kelch Bitterkeite trinken -- leiden schmecken -- 
  -- Träne Zukunft verbrecherisch -- 
  verbieten denken -- -- 
  Wagen -- Härmen -- 
  Born to blush unseen And wasen its sweetness to -- desert Air -- grey -- 
  grausam Betrachtung werfen -- Tod ähnlich -- Zustand -- 
  Nacht bekommen Fieber -- verzweifelt Leben -- 
  Arzt erklären -- Augenblick verlieren -- heilig Sakramente empfangen -- 
  schicken Beichtiger -- wenige tot -- 
  Frau B. lassen Geistlichen Pfarre rufen -- 
  letzter Ölung -- befinden Stand -- Viaticum empfangen -- liegen Bewußtsein -- erwartet Tod Augenblick -- 
  Zweifel Gott Erbarme -- erhalten Leben -- Erwartung dauern Kraft -- 
  leiden Weise ungefähr vierzehn -- wonach Besinnung erhalten -- 
  Frau B. verlassen -- Karl scheinen ehemalig Liebe finden -- 
  geistliche fahren fort -- besuchen -- Augenblick benutzen -- Beicht hören -- 
  verlangen -- 
  wissen -- innerer Bewegung Gott hintrieb Bedürfnis -- Arm werfen Ruhe suchen -- 
  Priester hört Geständnis Vergehen -- erschrecken Zustand Seele -- 
  kennen -- alt Steuermanne -- Sturm -- 
  fing -- Leidenschaft trösten -- worüber anklagen -- 
  -- Herz -- -- -- -- rein -- wehe tun -- strafbar -- 
  Gott Glück Rechenschaft abfordern -- anvertrauen -- 
  tun -- 
  Glück liegen Hand -- bestehen Erfüllung Pflicht -- 
  -- 
  Gott Mensch Endzweck -- Ihrige -- 
  Verlier Mut -- bitn Gott -- gegenwärtig -- Arm aufnimmen -- weder schwarz weiß Mensch -- Auge Herz -- Ihrige verdienen würdig -- -- 
  Weise -- ehrwürdig geistliche arm Urika Mut einsprachn -- 
  schlicht Wort goss Seele -- wissen -- Frieden -- -- 
  denken anhaltend -- fruchtbaren Ader -- gehen Betrachtung hervor -- 
  Wahrheit -- Pflicht -- Gott Einsamen -- Mensch vorschreiben -- Welt leben -- 
  Bande Blutes versagen -- Menschheit Familie geben -- 
  barmherzig Schwester -- -- Leben -- entsagen -- Familie Wahl schaffen -- Mutter Waisen -- Tochter arm Greise -- Schwester Unglücklichen -- -- 
  Weltmänner freiwillig Einsamkeit wählen -- 
  Gott -- verzichten Vergnügung -- Einsamkeit rein Quelle gut Glück anzubeten -- arbeiten geheim Gedanke -- Seele würdig -- Herr erscheinen -- 
  -- o Gott -- schön Herz veredeln wohlgefällig Tugende -- Festtag ausschmücken -- 
  -- 
  tun -- -- 
  unbesonnen Spielzeug eigenwillig Bewegung Herzens -- Freude Welt nachgejagen -- Glück vergessen -- 
  spät -- 
  Gott -- fremd Land führen -- bestimmen -- 
  entziehen Erniedrigung Sklaverei -- lassen Gebot kennen -- 
  Gebot zeichnen Pflicht -- bezeichnen Weg -- -- 
  Wohltat mißbrauchen -- -- o Gott -- beleidigen -- Vergehung anklagen -- 
  Gesichtspunkt -- Lage betrachten -- bringen Herz Beruhigung -- 
  wunderen Frieden -- Sturm folgen -- 
  Strom Ausweg verschaffen -- Ufer verwüsten -- besänftigt Wog ruhig Meer tragen -- 
  entschließen Nonne -- 
  sprechen Frau B. -- 
  betrüben -- -- 
  -- böse -- -- glauben -- Entschluss widersetzen -- -- 
  Karl heftig Widerstand -- bitten -- beschwören bleiben -- -- 
  Laß -- Karl -- einzig Ort -- erlauben -- beständig denken -- -- 
  brechen Nonne Erzählung -- 
  fahren fort -- Sorgfalt widmen -- unglücklich Weise vergeblich -- 
  sterben Oktober -- fallen letzter Blatt Herbst -- 
  Buchdruckerei Heinrich Wilmans Naumann Frankfurt a. M. 
  Verzeichni Verlags-Bücher Weinrich Wilman Frankfurt Main -- 
  Augar -- C. W. -- Antonio Felippo -- Licht Schatten Süden -- 
  Nachtstück unesren -- 
  8. 2 Rthlr -- 
  6 gr . 4 fl . 3 kr -- 
  Bauer -- Samuel -- Leben -- Meinung Schicksal berühmt denkwürdig Person Zeitalter -- Jugend bearbeiten -- 5 Bde -- 
  Kpfrn -- 
  8. 1817 -- 1821 -- 
  Schreibpapier -- heften -- 9 Rthlr -- 12 gr -- 17 fl . 6 kr -- -- Druckpapier Kupf -- 7 Rthlr -- 12 fl . 36 kr -- 
  Beulwitz -- Carl -- wirklich Leben romantisch Darstellung -- 2 Bde -- 
  Kpfrn -- 
  8. 1817 -- heften 3 Rthlr -- 
  8 gr . 6 fl -- 
  Bleibtreu -- Ludwig -- Darstellung Sternhimmel Anweisung Kenntnis Gestirne Selbstunterricht -- 
  3 Abbildung Steindruck -- 
  12. heften 1 Rthlr -- 
  6 gr . 2 fl . 15 kr -- Görres -- I. -- altdeutsch Volk Meisterlieder -- 
  Titelkupfer -- gr -- 8. 1816 -- heften 2 Rthlr -- 3 fl . 36 kr -- 
  Grimm -- A. L. -- Christblumen -- Weihnachtsgabe Kind -- 
  Titel -- 
  Sammlung Geschichte zart Alter -- 
  1r Bd -- 
  6 illuminiert Kpfrn -- 
  8. binden 1 Rthlr -- 12 gr . 2 fl -- 42 kr -- -- Lina's Mährchenbuch -- 2 Band -- 
  8 Kpfrn -- 
  8. 1816 -- 
  Velinpap -- -- geheften 2 Rthlr -- 3 fl . 36 kr -- -- Druckpap -- Kupfer 1 Rthlr -- 
  8 gr . 2 fl . 24 kr -- -- Märchenbibliothek Kind -- 
  märch Zeit Volk auswählen erzählen -- 
  Titel -- märch Tausend Nacht -- Kind -- 6 Bde -- 
  Kpfrn -- 
  8. Velinpap -- -- geh . 9 Rthlr -- 16 fl . 12 kr -- 
  Band einzeln 1 Rthlr -- 12 gr . 2 fl -- 42 kr -- -- Druckpapier -- Kupfer -- 
  8. 6 Rthlr -- 10 fl . 48 kr -- 
  Band einzeln 1 Rthlr -- 1 fl . 48 kr -- 
  -- fortsetzen -- -- 
  Guts-Mut -- I. L. F. -- Turnbuch Sohn Vaterlande -- 
  4 Kpfrn -- gr -- 8. 1817 -- 1 Rthlr -- 
  4 gr . 2 fl . 6 kr -- 
  Guts-Mut -- I. L. F. -- Katechismus Turnkunst -- Leitfade Lehrer Schüler -- 8. 1818 -- 
  12 gr -- 54 kr -- 
  Horst -- Edmund -- Eugenie Steinfels -- Carl Friedrich Regiomontanus -- 
  Kpfrn -- 
  8. 1816 -- 1 Rthlr -- 
  4 gr . 2 fl . 6 kr -- 
  Kirchner -- a. -- Christenlehr -- reif Zöglinge evangelisch Kirche -- Erinnerungsbuch erwachsene -- gr -- 8. 1820 -- 
  16 gr . 1 fl . 12 kr -- 
  Pattberg -- Auguste -- Blume einsamen Lebenspfad -- 
  Festgeschenk Deutschland edel Tochter -- 
  8. 1820. geh -- 10 gr -- od -- 45 kr -- Poppe -- Dr. I. H. M. -- Larunda Schutzgeist Lieben vielfältig Gefahr Leben -- 
  Lehr- Lesebuch Eltern Kind -- 
  Kupfer -- 8. 1820 -- 
  Velinpap -- -- geh -- 18 gr . 1 fl . 21 kr -- -- Druckpapier -- Kopf -- 
  14 gr -- od . 1 fl . 3 kr -- 
  Schiebe -- August -- Lehre Wechselbriefe -- theoretisch praktisch darstellen -- gr -- 8. 1818. geh . 1 Rthlr -- 18 gr . 3 fl . 9 kr -- -- kaufmännisch Briefsteller -- gr -- 8. 1824. geh . 1 Rthlr -- 12 gr . 2 fl -- 42 kr -- 
  Schopenhauer -- Johanna -- Johann van Eyck Nachfolger -- 2 Bde -- 8. 1822. geh . 2 Rthlr -- 12 gr . 4 fl . 30 kr -- 
  Schopenhauer -- Johanna -- Tante -- 
  Roman 2 Band -- 
  8. heften 4 Rthlr -- 7 fl . 12 kr -- 
  Schreiber -- Aloys -- Geburt Erlöser -- 
  3 Kupfer -- 
  8. 1817 -- 
  Velinpapier -- heften 18 gr . 1 fl . 21 kr -- -- Druckpapier -- Kupfer 10 gr -- 45 kr -- 
  Wedekind -- Freiherrn -- Such Freimaurer -- 
  Bruchstück Trauerversammlung s. e. ▭ Johanni Einigkeit -- Aufgange Frankfurt a. M. 22 XII -- 5818. gr -- 8. 1819. geh . 4 gr -- 18 kr -- 
  Werner -- Chr. -- Rechenbuch Stadt Landschule -- 8. 1818 -- 
  10 gr -- 45 kr -- -- Resultate Aufgabe Übung Rechenbuch Stadt Landschule -- 8. 1818 -- 2 gr . 9 kr -- 
  Westrumb -- Dr. Joh -- Friedr -- -- Beschreibung vorteilhaft Essigfabrik erforderlich Gerät -- 
  Nebst Anleitung Verfertigung vielfach Essig-Art -- 
  Fabrikant Haushaltung -- 
  Kupfer -- gr -- 8. 1818 -- 
  10 gr -- 45 kr -- 
  Wintergart -- 
  Herausgegebe Dr. St. Schütze -- 6 Band -- 
  Kupfer -- 
  8. 1817 -- 1822 -- 
  Band einzeln 1 Rthlr -- 12 gr . 9 Rthlr -- 16 fl . 12 kr -- 