Virginia Kolonie Kentucky -- 
  Wahrheit Dichtung -- 
  Herausgegebe Jerta -- 
  -- 
  Kupfer Bollinger -- 
  Berlin -- August Rücker -- 1820 -- Virginia -- Kolonie Kentucky -- 
  -- 
  Virginia Adel -- 
  Philadelphia -- Dezember 1814 -- 
  grüßen -- tausend Mal grüßen Welt -- Adel -- 
  Gefühl Einwohner Weltteil reden -- fallen Augenblick ordentlich schwer auf Herz -- Lebensverrichtung denken -- tun Adel -- 
  -- Gegenstand Gegenstand -- betrachtend -- Irre -- gedenken -- schläfst -- Bild begegnen dein Träum -- 
  Sonne strahlend Meer aufgehen -- neu Lebenslust durchströmen -- ruf sanft Schlummer -- sinken fern blau Gebirg -- bringen Morgengruß -- O -- verschieden -- denken -- bleiben einig unveränderlich -- 
  Göttlich Abkunft Geist -- unabhängig Raum -- 
  Anblick Vaterlande fremd wundersam -- 
  Küste Europa's meist unbewachsen -- bieten fast überall offen Landstrich dar -- ziehen dunkel Urwald häufig Meer -- Küste bewachsen -- buschig -- Eindruck romantisch -- Ernst -- 
  Ufer delawar Stadt Ansiedelung schmücken -- überall herrschen Fleiß Tätigkeit -- vermissen Lebendigkeit -- heimisch Küste ergötzen -- 
  Philadelphia schön -- Regelmäßigkeit Anlage -- sprechen sogleich deutlich Geist Ordnung Gesetzlichkeit -- herrschen -- 
  Ellison Familie einführen -- patriarchalisch Wohlwollen empfangen -- 
  Aufenthalt lang nehmen gedenken -- Person -- leben -- 
  Ellison -- Vater -- hager Mann -- klug Auge -- tätig Kaufmann meist Kontore einheimisch -- 
  Geschäft Charakter Quäker behaupten -- -- Kleidung Sitt -- streng Regel halten -- höchst selten Versammlung besuchen -- 
  Frau wohlbeleiben lebendig Matrone -- herrlichst weiblich Eigenschaft einzig stark Beimischung Pedanterie verdunkeln -- 
  wirtschaftlich -- verbrannt Schwefelfad entflammt heftigst Zorn -- geputzt Licht -- gezogen Rouleau -- veranlassen Ordnungslieb längsten Strafpredigt -- 
  Wäsche -- löblich Sitt -- nummeriert -- nackt -- Schlafhaube Nr. 15 hemd Nr. 14 anziehen -- Nr. 4 Nr. 2 folgen lassen -- 
  neulich brechen Tochter gewaltig Ungewitter -- entdecken -- Tasche -- . 9 Schnupftuch -- -- 10 tragen -- 
  sogleich Revision Wäsche verhängen -- finden Strümpfe -- -- 10. bezeichnen -- Sturm stark Unwille brechen -- 
  arm Verbrecherin verteidigen vergebens -- unversehen Pfütz treten -- Schreck Tuch fallen lassen -- 
  sogleich Stunde angezogen Hemde wechseln -- Tasche -- Halstuch -- Schlafhaube u. S. W. Ungebraucht Wäsche liefern -- 
  Gelegenheit Beschmutzen -- erfolgt Predigt geziemend Ehrbarkeit -- denkbar -- -- Blick fest Boden hefen -- Pfütz übersehen -- 
  Mädchen -- einzig Tochter Haus -- leiden vorzüglich Pedanterie Mutter -- 
  lieb -- froh Geschöpf Alter -- bildschön Blonde Namens Philippine -- 
  freuen meister Anwesenheit -- Erleichterung verschaffen -- 
  Ellison -- Sohn -- angelegentlich empfehlen -- lieben Bruder -- verdienen -- 
  Umgebung betrachten -- stellen schön fremd Erscheinung dar -- bemerken Liebe -- womit umfassen -- womit begegnen -- Sohn Haus -- 
  Familie Bemerkung -- Mal heiter jemals Reise heimkehren -- scheinen -- fast Art Dankbarkeit -- neigen -- verlegen -- 
  Szene verändern -- Wirkung -- 
  finden -- gehörig Bescheid wissen glauben -- -- morgens Inhalt bewußt Kästchen Vater Ellison Comptoir begeben -- Ehrlichkeit Industrie bringen -- 
  überraschen -- wohlbehaglich -- 
  voll Stunde unterhalten verschieden Fonds -- Geld -- ansehnlich Vorteil -- arbeiten können -- 
  bitten -- Angelegenheit beruhen lassen -- glauben schwerlich -- Stande -- Wort pünktlich erfüllen -- 
  gastfreundlich Ton rücksichtlich -- 
  anfänglich ansehen Wohlwollen Art Ehrerbietigkeit übergegangen -- bemerkbar -- 
  Mutter Ellison überhäufen Liebkosung -- Gewohnheit sinnreich -- Zerstreuung verschaffen -- 
  veranlassen Spazierfahrt Sohn Tochter -- fordern letzterer täglich -- dorthin -- zeigen -- 
  Philippine Entzück Freiheit Gebrauch -- lieben aufrichtig -- Schöpferin Freude -- 
  William Ellison heit -- trübe Wolke lagern Stirn -- Fremdes -- scheinen treten -- 
  gestern -- Ufer Delawar spazieren fahren -- blicken schweigend Flusse entgegen -- 
  nachdenkend William -- -- legen Hand Arm -- 
  fahren Träum -- preßen Hand -- halb erwachen -- 
  Washington untergegangen -- 
  schön -- rufen Philippine lachend -- können lieblich Winterlandschaft erfreuen -- 
  -- lakonisch Weise -- Virginia -- schwimmen -- 
  lassen Gespräch fallen -- 
  William -- Virginia retten -- nackt Leben -- scheinen Hinderni Wunsch -- 
  O -- -- zartsinnig Mann -- freudig Fluß werfen -- dein Arm -- 
  türmen Scheidewand -- siehst -- Ahndest -- selber hinweg schieben -- stark -- Hand legen -- 
  Sieh -- William leiben -- -- -- stundenlang denken -- glücklich Gattin leben -- einfallen -- Gattin -- versinken plötzlich -- Zanberschlag -- Gemälde -- Mucius Bild erscheinen Stelle -- drohen wehmütig lächeln -- 
  Mucius -- 
  -- Ewigkeit -- 
  sprechen -- 
  William -- nimmer -- 
  Schwüre brächen -- Bürgschaft hättest -- 
  Leben -- Länge Stadt langwetlig -- 
  Gesellschaft Freund -- woraus groß Einwohner bestehen -- brav rechtlich Mensch -- pedantisch Sitte -- 
  Stimme meister Grundsatz Einrichtung innig Überzeugung -- begreifen -- Geist Fröhlichkeit unvereinbar -- 
  hoch Wesen wohlgefällig -- lauter ernst traurig Gesicht blicken -- Tanz Spiel wahr Tugend zuwider -- 
  Mensch Wahn Übertreibung fallen -- geistig stolz Winke Lehrerin -- Natur -- achten -- 
  hoch Glück finden -- völlig Freiheit Meinung -- 
  niemals hören -- weder religiös politisch Streit -- Rückhalt Urteil -- hören ruhig entgegengesetzt -- 
  -- -- scheinen -- irren -- äußern -- Tropfen Wermut fallen Becher Freundschaft -- 
  Mäßigung bewundernswürdig gegenwärtig Augenblick -- Krieg entsprungen Unglücksfälle -- Gemüt gewöhnlich spannen -- 
  ruhig Volke -- Freiheit Sitz aufschlagen -- Weg Blut bezeichnen -- 
  ausruhen -- all Weh -- arm Herz letzter unaufhörlich bestürmen -- lang Pilgerschaft -- Quarantäne halten -- 
  freilich ergötzlich -- sichern Gesundheit -- Geist willkommen -- 
  schütteln ungeduldig Schwing -- ziehen tragen -- erhaben Bundesstadt -- Kapitolium bauen -- Schutz Hut köstlich Freiheit -- 
  -- got Albion -- Frevlerhänd -- entstehend Heiligtümer legen -- weilen Nähe -- 
  tief empfinden -- hoffen Frieden herstellen sehen -- empfangen Wunde heilen -- 
  Europa sträuben -- Welt -- kurz -- riesenstark Manneskraft gelangen -- wehe Europa -- jemals Gedanke fassen -- Beleidigung rächen -- Kindheit erfahren -- 
  Norden frei -- Süden schütteln überseeisch Kette -- 
  -- Panier Freiheit wehen Hudsonsbay Magellanischen Meerenge -- Schatten blühen Wissenschaft Kunst -- übrig Weltgegende verpflanzen -- 
  schön Hoffnung tausend gut Wunsch beginnen -- 
  -- Unterredung William -- unser unsicher Standpunkt -- Maße feststellen -- 
  schicken -- Sitte Vaterlande -- Korb voll auserlesenst Treibhausfrücht Blume -- -- übrig Familie -- künstlich Arbeit verfertigen -- neu -- Bewunderung erregn -- 
  vorzüglich erhalten -- 
  -- vieler Freude danken -- 
  Verbindlichkeit gut Wille -- ablehnend -- -- -- 
  -- fragen -- 
  -- können unendlich gewähren -- wünschen dürfen -- 
  hören -- William -- -- Bruder erbon -- lassen geschwisterlich vertrauen bewahren -- 
  Geschwisterliches -- kleinlauen -- 
  -- fahren fort -- Schwester reden -- 
  besitzen -- retten -- legen fern Wert -- wissen Zufälligkeit Erdengüt würdigen -- schätzen Geist -- 
  kennen Ihrig -- meinig verwanden -- 
  -- rücken freudig nah -- -- 
  verwanden Geist -- fahren fort -- Bande -- spät lösen -- 
  Frühere Bande -- rufen erschrocken -- 
  -- -- unmöglich -- Vaterland willig verlassen -- können Fremde heit -- 
  fremd Erdkreis -- -- Heimat lang -- 
  Tod -- fragt -- -- 
  Tod -- erwidern -- fassen -- erzählt Geschichte Herzens -- 
  hört Teilnahme -- glänzt Träne Auge -- 
  Schwiege -- enden -- beugt Hand -- empor richten -- fliegen Schimmer Freude Gesicht -- 
  edl tote Neigung schön Herzen teilen -- scheinen selig -- -- Region Lichts fordern Eigentum -- 
  scheinen -- antworten -- widersprechen unerklärlich Gefühl augenblicklich verstand -- 
  Lasse -- William -- Zwiespalt Inneren lösen -- -- -- ausfallen wollen -- Freund bleiben -- fest unzertrennlich Leben -- 
  halten Hand -- schlagen versichernd -- 
  Heiterer -- hoffen -- 
  heg Hoffnung -- fühlen erleichtern -- vertraulich umgehen -- 
  Brust herrschen tief Friede -- lieben verlorener fließen einsam Tran -- trocknen Bewußtsein Wiedersehen -- 
  übrig Vergangenheit selten erinnern -- meide fast -- lieb Frankreich hören -- 
  Vaterhaus abgebrannen -- überfällen Grauen -- Brandstatt sehen -- Stelle Palast aufbauen -- freundlich Wohnung -- woran schön Erinnerung haften -- 
  Nachricht -- sehnen vergebens -- böse Krieg hemmen frei Verkehr Land -- 
  William längst See gehen -- Kund verschaffen -- liegend -- ungeheuer Pack Geschriebenes -- sicher Hand befördern -- 
  fortfahren -- 
  günstig Geschick dein Hand bringen -- 
  O tätest Gleich -- 
  Leben Treiben Paris denken -- -- 
  Schauspiel -- Maskerade -- kirchlich Gepränge -- Musik -- Familien-Feste -- Theezirkel -- häufig spazierengeh Fahr -- 
  Gegend schön -- Winter mäßigen -- südlichsen Frankreich -- 
  scheiden -- Landschaft entzückend -- ernst grüne Zeder Tann hell Laub Platanus -- zahllosen Nußbaum mischen -- 
  ankommen falbes bräunlich ansehen -- 
  freu Kind -- Aufkeimen jung Pflanzenwelt -- -- wohin flüchten -- Leben rauh berühren -- 
  duften heilend Balsam Wunde -- Odem Frieden haucht zart Halm Blüte -- 
  überall belebt Natur zeigen widrig Bild kämpfend Leidenschaft -- Pflanze blühen friedlich beisammen -- liebend neigend -- strebend -- zart Ranke umarmen -- 
  grüßen freundlich Blumenwelt -- säuselnd Baum -- zart Halme Grases -- Stundenlang lageren -- innig Lust Wanderung glänzend Käferch -- Spiel bunt Schmetterling zusehen -- übrig Welt vergessen -- 
  Nirgend Erdenrund Virginia unglücklich frei -- Natur öde -- 
  Mensch Anstalt -- glücklich zu_sein -- bedürfen -- -- 
  Nachricht -- Frühling voll Pracht einziehen -- 
  meinetwill malerisch gelegen Landhau unweit Stadt beziehen -- fast froh -- einst Durance -- 
  groß Tag Philippin -- Vater Comptoir -- geschäftig Mutter Hauswesen verlassen -- 
  William besorgen Befrachtung Schiffes Europa segeln gedenken -- Friede abschließen -- 
  Tisch versammeln Familie -- Feiertag -- köstlich Spazierfahrt Delawar -- Schamuni -- Besuch freundlich Pflanzung -- 
  morgens schwärm Philippinen umh -- kehr -- ermüden -- Meierhofe ehrlich Quäker -- Besitzung Neger -- -- Unterschied -- gleich Herzlichkeit empfangen -- 
  schwarz Pflanzer stehen Betriebsamkeit weiße -- 50 Vermögen ziemlich nahe -- fleißig Schule besuchen anfangen -- Bildung Nähe Stadt merklich fortschreiten -- 
  Unfer Paris auffallen -- jung Mädchen -- Morgenkleid Sonnenhute -- Feld Gehölze streifen sehen -- -- schuldlosen Sitte Land -- ungewöhnlich -- 
  treuherzig Pensilvanier grüßen überall freundlich Unbefangenheit -- reden vertraulichen -- hören -- Kindheit allgemein vernehmen -- 
  Philippin leidenschaftlich Liebe hängen -- umfaß hold Mädchen schwesterlich Zärtlichkeit -- freilich Sinn -- Familie erwarten scheinen -- 
  Kehrseite glücklich Leben -- voraussetzen -- wovon entfernt fühlen -- 
  Vater voll Eifer Benutzung Vermögen -- listig Anmerkung -- nennen lieb Töchterchen -- verstehen -- einst dreifach Reich -- 
  geschäftig Mutter schüren emsig -- sprechen weitläufig künftig häuslich Einrichtung -- 
  arm William Kohl -- wenden all Fleiß -- Gespräch abzubrechen -- weshalb unwillig Gesicht Mutter erhalten -- Fluß Rede unterbrechen -- 
  Sturm befürchten -- 
  William erklären nächstens See gehen -- rechnen zuvor Verbindung unauflöslich -- 
  sagen sehen -- Fall -- -- erfahren -- Reise Washington -- See Niagara -- gedenken -- 
  William -- eingehen -- Freude -- Reise stille Anstalt treffen -- 
  bedienter -- treu erfahren Mensch -- Strich gegender durchreist -- ehrlich schwarze -- verlassen -- Vater Sohn -- 
  Vater -- John -- früh Jugend Sklave Virginien -- entlaufen streng Herr -- geraten wilde -- aufnahmen -- 
  -- lernt Sprache Sitte vollkommen -- 
  Krieg ziehen Stamm -- befinden -- Engländern Hilfe -- Gefecht Amerikaner zerstreuen -- John geraten Irrweg Pennsylvania -- menschenfreundlich Begegnung gefiel -- Aufenthalt -- 
  finden Arbeit -- erwerben Eigentum -- heiratet frei schwarz -- Vater Kind -- Sohn -- Töchter -- verheiraten -- jung Tochter -- -- Bruder ebenfalls begleiten -- 
  Hütte Feld Grenze nahe Ellison Landhaus -- kennen William frühest Jugend -- alte -- fast Kind -- lieben -- 
  Anhänglichkeit unerschütterlich Treue vorzüglich Karakterzug gut -- unterdrückt Menschengattung -- 
  Wohlwollen Aufmerksamkeit blicken lassen -- innig Liebe versichern -- 
  unser Morgenstreiferei schwarz Bube herzen -- alte freundlich reden -- Hurone reisen -- Gefahr abwend -- letzter Lebenshauch verlassen -- 
  Zittre -- lieb Adel -- Schrecknissen Reise können -- 
  Land wüsen -- früh Reisebeschreibung kennsen -- 
  regelmäßig Landkutschen Baltimore Washington -- Landstraße Wirtshäuser Richtung anlegen -- Gegend See aufhören -- romantisch Reise -- 
  leicht Fuhrwerk kaufen -- Fußreise hinreichend Kraft Lust -- 
  Brief erhältst -- William heilig loben -- Monat -- Hand liefern -- denken -- Wasserfalle sitzen -- wohin Herz unwiderstehlich Sehnsucht ziehen -- Wilde -- Geist anzubeten -- 
  Abschiedsstund graut Herz -- 
  arm William Hoffnung ziehen lassen -- Hoffnung geben -- 
  melden -- Schiff segelfertig liegen -- Wind günstig wenden scheinen -- 
  Auge feucht -- Gedanke Freund Beschützer Leben verlieren -- Drang schmerzlich -- 
  trocknen schnell Träne Tuche -- drücken Lippe -- 
  Sollst begleiten -- stärken -- rufen -- Niedergeschlagenheit mächtig -- 
  William -- -- Träne fließen stark -- wünschen -- geben -- 
  wünschen -- -- erblassend -- 
  -- 
  -- 
  Reise beendigen -- 
  verändern -- 
  -- o -- William -- 
  Leben stehen still -- -- Monden -- verändern Erde -- 
  Herz -- Herz -- Virginia -- rufen heftig -- 
  O Aussicht eröffnen -- 
  kennen seltsam Lage Herzen -- -- niemals Gefühl verhehlen -- -- fast lächerlich Gedanke bergen -- 
  scheinen nämlich -- können Fall Niagara Zwiespalt lösen -- Seele erheben -- Schutz leben -- 
  Wunsch Entfernung -- -- traurig kopfschütteln -- 
  -- -- rufen -- verlassen Schmerz -- unerklärlich reißen fort -- 
  Niagara -- tönen Träumen -- Pilger gen Osten wenden -- scheinen Westen -- Sonne Verheißung glänzen -- 
  Weg Osten -- o freundlich Morgenröte Herz Hoffnung schimmern -- 
  lassen Hoffnung Rück -- erwidern -- 
  -- Meer ziehen -- ehemals -- ewig Wechsel -- 
  -- Nachricht verschaffen -- unternehmen -- letzter -- 
  still Reiz heimatlich Leben -- sprechen mächtig Herzen -- Sinn streben Weite hinaus -- 
  Lohn Weltumsegler -- welteroberers -- 
  Ruhm -- kalt Ruhm -- 
  Glück -- 
  -- Glück ewig fliehen -- wohnen still Hütte -- treu Weib lächeln -- munter Kind spielen -- 
  -- -- rühren -- kennen selig Frieden begrenzt Heimat -- Herz sehnen -- Paradiese Unschuldswelt -- 
  feindselig Geschick vernichten Eden -- -- Trümmer zerstört Welt -- irr Raum -- Pol finden Bahn -- 
  glaubt Ruhe finden -- halb Vorwurf -- 
  glauben -- hoffen Mensch -- erwidern -- 
  finden -- 
  fühlen Vorhof Heiligtum -- Balsamdüfte Paradiesesblüthe wehen Herüber -- o lassen -- Eingang suchen -- 
  Wunsch -- -- verneigt Entsagung -- heißest Glück -- 
  fassen -- verlieren -- Gedanke übersteigen Kraft -- 
  denken -- rufen -- ergriff Hand -- empfangen Schwor -- -- Verhältnis wend -- lieb Nähe trennen -- Tod scheiden -- 
  O -- Virginia -- rufen -- heben Hand gefaltet Hand empor -- welcher himmlisch Trost geben Reisegefährt -- 
  Nimmer verlangen -- selber wünschen -- 
  freudestrahlend Gesicht verlassen -- 
  Familie Abreise ankündigen -- mißvergnügen Gesicht augenscheinlich Zusatz aufhellen -- letzter Fahrt sollen -- Lebensart aufgeben -- Vater ungern zulassen -- 
  hoffen Handlungshau gewinnen -- glauben trügen -- Williams Sinn streben Stille Landleben -- fehlen spekulativ Geist Kaufmann bedürfen -- 
  Blatt schließen siegeln -- glücklich gelangen -- Adel -- 
  Haucht entgegen -- nimm freundlich tausch Hand -- worauf sehnlich hoffen -- 
  Gib Kunde dein -- vorzüglich gut Mutter -- grüßen herzlich -- 
  Schreibe -- -- weniger Wort -- armes -- lieb Frankreich -- 
  glücklich scheinen -- Ausgewanderte -- 
  verbreiten Gerücht -- Glaube beimessen -- Schiffernachricht öfters falsch -- 
  übermorgen reise Gefolge -- 
  Mutter schütteln Kopf Wallfahrt -- sorglich Geschäftigkeit bemühen -- ordnen herbei schaffen -- Bequemlichkeit nötig scheinen -- 
  Vater Empfehlungsschreiben Baltimore Washington -- 
  Philippine weinen voraus -- Trennung -- trösten Versprechen -- bleiben wollen -- 
  schwer -- Mädchen freundschaftlich Haus trennen -- Zug Westen stark Freundschaft -- stark Vernunft -- 
  Leben Adel -- 
  tausend Mal Leb -- 
  William eilen Bord -- nehmen Abschied vonDeiner Virginia -- 
  Virginia Adel -- 
  Baltimore -- 
  glücklich Gefolge angelangen -- Handelsfreund Ellison abhalten lassen -- nehmen -- 
  Reise verschied Reise Frankreich -- kultiviern Distrikt -- Philadelphia -- waldig Land -- -- Baumwuch üppig -- saftvoll -- Viehzucht -- zerstreut Besitzung -- 
  Gemisch verschiedenfarbigen Mensch reisend anfangs auffallen -- gewöhnen -- 
  Washington -- Nachbildung Kapitols sehen -- wohin Geist tragen -- jemals sehen -- Hoffnung entschwunden -- 
  kehr -- Wanderung See antreten -- 
  Baltimore freundlich -- vieler lebhaft Philadelphia -- 
  wohnen Franzose -- 
  Wirtsleute jung -- Frau -- Irländerin -- voll Lebhaftigkeit -- beweglich Quecksilber -- 
  erzählen unaufhörlich -- schade -- verständigen -- sprechen Englisch vaterländisch Mundart -- französisch -- 
  wünschen Erzählung vollständig unterrichten -- seltsam anziehen -- 
  sprechen nämlich Freiwillig Baltimore -- vorig Washington Hilfe ziehen -- mehrere Ausländer -- 
  erwähnen jung Franzose -- Haus gewohnen -- 
  Beschreibung scheinen -- wunderbar Weise -- Mucius passen -- Nahme aussprach Ähnlichkeit -- fest Unmöglichkeit Leben überzeugen -- nehmen töricht Herz Anteil Erzählung -- Unruhe erfüllen -- 
  näheres Fremdling erfahren -- ferner Schicksal -- jetzig Aufenthalt wissen -- wissen Davson -- verstehen -- 
  mal Bestimmtheit erfahren -- Freiwilligen kehren -- sprechen -- jung Herr gehen -- 
  entschließen -- Schamröte -- Mann befragen -- 
  Frau -- fragt finster Blick -- sehen -- 
  wissen Betty -- setzen hinzu -- interessiert -- 
  brechen Gespräch -- knüpfen wagen -- 
  fremd Zankapfel Ehepaar -- bemerken -- 
  weshalb beunruhigen -- Schönheit jung Frau auffallend -- bemerk halb Neid -- fallen Lebhaftigkeit doppelt -- fremde sprechen -- 
  -- wahrhaftig -- Virginia kindisch -- lach tüchtig -- schilen -- 
  scheinen eifersüchtig Schatten -- lebend Mucius -- 
  Fall Umstand Abreise Washington beschleunigen -- 
  drängen Schauplatze -- unbekannte kämpfen -- bluten -- 
  Vergib William -- töricht -- undankbar Mädchen verlassen -- jagen Truggebilde krank Phantasie -- Urbild Stern leben -- 
  William -- 
  fürchten -- -- 
  Gefolge zufrieden -- reisen -- 
  Neger fällen städtisch Aufenthalt -- 
  Corally -- schwarz Mädchen -- begreifen -- Ort einsperren können -- Rasenplatz tanzen -- Blütengebüsche Haustür -- 
  Bruder Jsmael horchen Erzählung Vater -- Lebensart Wilden -- 
  hoffen Stämmen Ontario Erie begegnen Auge treiben sehen -- 
  sehnen Frau Bube -- 
  Corally heimlich vertraut -- jung schwarz leiben -- arm -- müssen verdienen sparen -- Vater Feld können Familie ernähren -- 
  Kind Natur -- bedürfen -- beglücken -- Land -- Hütte -- paar Kuh -- Rückkunft fehlen -- 
  Washington -- 
  gestern eingezog Hauptstadt frei Amerika -- bestimmen -- dereinst Welt Gesetz -- Sprache Sitte geben -- Rom vormals alten -- 
  Möge Rom Üppigkeit Übermut erheben -- einst sinken -- 
  Vergleichunge -- Erinnerung Betrachtung bieten Schritt dar -- 
  Kühn Entwurf Bundesstadt -- Riesenbund frei Staat -- 
  Gebe Schicksal Gedeihen -- Saat vollwichtig -- Seemänner voll redlich Eifer Sonnenschein Frieden Not -- 
  Hagelwetter jüngst vorüber fliegen -- viele zerstören -- 
  prachtvoll Gebäude stehen dachlos ausgebrennen -- Mond scheinen verwundert leer Raum hinab blicken -- 
  Säule Kapitols beschädigen feindlich Geschütz -- säul Republik trotzen Anfall -- Karthago brechen -- 
  Kampf Riesenkind Freiheit gebären -- Kampf Gefahr stärken Kraft -- ziehen -- jung Eich mitten Stürme empor wachsen -- 
  still Ehrfurcht vollendet Denkmal Mann besuchen -- Nahme -- Stadt -- spät Nachwelt überliefern -- Andenken Herz jeder Amerikaner leben -- 
  Wahrlich -- beneidenswert Sterblicher -- Gegner verunglimpfen wagen -- 
  einfach Sitte Land -- ruhig Art hiesig Entwicklung -- bewahren kühn Aufflug -- französch Adler -- 
  Napoleon übertreffen Washington Geist Energie -- Mäßigung still Bürgertugend übertroffen -- 
  Washington Cincinnatus tugendhafn Rom -- Napoleon Cäsar verderbn -- 
  Beider Charakter leiden Vergleichung -- Lage Umgebung -- 
  Gewühl Hafen -- Tätigkeit -- womit Brandstatt abräumt -- Schaden heilen streben -- mehrere ergötzen fest halten -- Forschung unbekannte anstellen -- 
  Humphry Dyk -- Bedient Ellison nützlich -- Mensch leiben gewinnen -- Diensteifer -- 
  -- vergebens -- wissen schwarzlockig Franzose -- Freiwilligen Baltimore befinden -- 
  Behörde befragen -- Krankenanstalt besuchen -- -- leben -- 
  -- rufe trotzig -- verlach kindisch Grille -- helfen -- Gedanke -- 
  gut -- entfern -- Anstalt Reise wechselnd Gegenstand zerstreuen -- 
  Virginia Ruhe Herz finden -- 
  Baltimore -- 
  -- voll Geschäftigkeit Zug -- 
  -- -- Entdeckungsreise rüsten -- 
  Humphry fürchterlich Vorstellung Ungastlichkeit gegender wohin -- lassen -- beiläufig romantisch Gedanke -- Wildnis irren -- geheim Vergnügen -- 
  Wagen -- Pferd bespannen -- kaufen -- Zweck zurichten lassen -- 
  Regen Sonne Art Zelt schützen -- Seite Höhe wunden -- abnehmen -- Stang vergrößern -- 
  Wagen sitzen Corally Sitzkast -- Deck Wäsche anfüllen -- 
  befinden Fächerkorb voll Lebensmittel -- tüchtig Flaschenfutter Wein Rum -- Bratspieß -- nebst gehörend blechern Pfanne -- Teller Silberblech -- kupfern Kessel -- Messer -- Gabeln Löffel -- leer Korbflasche -- hörnern Becher -- Beil -- Matratze Tragekorb -- 
  wandernd Haushaltung -- 
  John halten fürstlich ausstatten -- Humphry hinzu tun -- 
  John befinden -- Bedeckung -- Pferd -- gut Flint bewaffnet -- reichlich Pulver Blei versehen -- Jsmael Kutscher -- 
  -- Frühe -- Wallfahrt antreten -- 
  Reiseschreibzeug versehen -- ordentlich -- gerichtet Tagebuch halten -- einst Erhältst -- 
  hüpfen Herz Freude -- Gedanke Pilgerfahrt -- 
  -- ungekannt Leben reizen -- Nacht schlafen -- Kind -- Leben meist fremd -- Spazierfahrt schlafen -- 
  O -- selig Kind -- 
  ziehen Blumenhügel -- erreichen -- schließen blau Berg Meer Sehne -- 
  20st Junis -- 
  aufbrechen -- Morgenkühle reisen -- 
  Sonnenhitze Mittagsstunden unerträglich -- schattig Ort rasen -- Wasser Nähe -- Weide Pferd -- 
  treffen artig Meiereium -- herrlich Milch eiern versahen -- -- nebst frisch Fleisch -- Baltimore bringen -- lecker Mahlzeit geben -- 
  Nacht Haus Pflanzer Halt -- 
  Gefolge draußen -- Vieh Gerät -- Corally Haus schlafen -- 
  möchten Obdach finden -- Gebirg -- desto sparsam Wohnung -- Weg vorziehen -- Albany -- Gegend romantisch -- 
  Kind unser Wirt sehen neugierig -- Schein Küchenfeuer schreiben -- 
  machen -- fragen Knabe -- 
  sprech Schwester -- erwider -- Wasser wohnen -- Finger -- -- sehen Kopfschüttelnd -- 
  zeichn Wort Papier -- Pferd Kohle Wand malen -- geben Antwort -- 
  blicken hinein -- -- 
  mußen Pferd -- Vogel -- Baum -- Haus denken -- kennen einzig deinen Wort -- 
  26st Junis -- 
  Landschaft wild -- unbeschreiblich schön -- 
  tagereisen -- Vieh Hitze schonen -- 
  Wohnung antreffen -- Geflügel -- Milch -- Ei Frucht kaufen -- 
  Nacht bringen Mal Freie -- Saum Wald -- klar Quell vortrefflich Wasser versorgen -- schreiben -- lagern Fuß Berg dicht Ahorn weiß Zeder bewachsen -- hundert Schritt -- brausen Waldstrom Bergschlucht hinab -- 
  John Humphry Jagd gehen -- Jsmael drehen Bratsyieß -- Korally Wasser schöpfen unser Kessel -- bereiten Lager -- stehen Küche -- Pferd weiden -- 
  glaubst -- eigentümlich Reiz nomadenleben -- kultiviert Mensch -- wundre -- eingeboren verlassen -- 
  30st Junis -- 
  irr Gebirge umher -- bloß Sonne gestirn richtend -- worauf John verstehen -- 
  denken -- ängstigen Würdest -- Weintest ehemals fast jeder Mal -- unser Spaziergang Turmspitze Chaumerive verstecken -- Furcht verirren -- 
  unbesorgt -- Wildnis überraschend schön -- verlassen -- 
  Waldvögel unser Häupter -- lassen hundertfältigen -- fremd seltsam Stimme hören -- Erdbeeren Beeren anderer Rankengewächse röt Rasen Abhäng Berg -- Wipfel neugierig Gazelle hernied blicken -- 
  leben Ertrage Jagd -- mühsam -- Wild scheu furchtsam zeigen -- Ei Wasservögel häufig sumpfig Stelle finden -- 
  Schlafe Zelt -- nächt kalt -- entzückend schön -- Klarheit -- Vergnügen betrachten Sternbild -- Himmelskart antreffen -- 
  Schlaf vortrefflich -- Rum -- Wasser -- Ei Zucker vermischen -- Frühstück -- -- Anbruch Morgenröte -- Weg -- 
  5t Julius -- 
  -- mancherlei Umweg -- südlich Spitze Erie-See glücklich erreichen -- Rasttag halten -- Pferd ziemlich erschöpfen -- 
  Land letzter Tagereise flach -- 
  See gewähren schön Anblick -- jenseitig Ufer einzeln nebelig Punkt bemerkbar -- 
  John mehrere Wasservögel schießen -- Mahlzeit würzen -- 
  spähen überall wilden umher -- wiedersehen Herz liegen -- selber Zusammentreffen höchst gespannt -- 
  8t Julius -- 
  Wunsch erfüllen -- 
  Zufall -- Stamm -- John verschwistern -- Trupp Mann Weiber Kanot See -- Rehjagd -- Fuße Allegany-Gebürges ergiebig -- 
  John Bruder erkennen -- Freude Seite unbeschreiblich -- 
  zeigen Kind -- erklärt -- ihrigen sein -- 
  bringen Gastfreiheit Beute Jagd Geschenk -- bewirtet Rum gekocht Speise -- teilen unser Vorrat Reis Zwieback -- Mann geben groß Tabak -- 
  schmücken Weiber -- Glasperl -- einfach Ring -- Bänder entbehrlich Tücher besitzen -- Freundschaftsbündnis kurz eng knüpfen -- 
  lagert Nähe -- geleitet Strecke -- 
  Abschied scheinen wehe -- tröstet Hoffnung -- -- Rückkunft Wasserfalle -- wohin Meinung wallfahrt Geist anzubeten -- wider sehen -- 
  John rühren Scheid herzlich Kind Natur -- nachher wiederholt versichern -- Frau Kind daheim -- Versuchung widerstehen -- Land kehren -- 
  begreifen -- anziehend ungebunden Lebensart -- Sprache Volk kennen -- Bedürfnis ihrigen hinaus steigern -- 
  11t Julius -- 
  mittelmäßig Meierei gelangen -- ufern Flusses liegen -- ungefähr Stunde Erie-See ergießen -- 
  Boden fruchtbar -- Mais stehen vortrefflich -- versprechen Fünfzigfältchen Ertrag -- 
  Obstbaum umgeben nied Wohnung -- verstecken fast -- beugen Zweig Last Frucht -- 
  Kirsche -- Aprikose -- Birn -- Melon vorzüglich Güte -- Pfirsich röten -- Cider gewiß trefflich reichlich gewinnen -- vorig Herbste -- 
  trinken -- fast geleert Flaschenfutter füllen -- 
  herrlich Gemüse -- 
  Kuh weiden umh -- Geflügel fehlen -- 
  Natur versorgen glücklich Familie Überfluß -- physisch Leben angenehm -- 
  Wöchentlich bringen alt Sohn Haus -- Produkt -- verzehren -- einspännigen Karren Venago Stunde entfernen -- 
  Familie bestehen -- samt Kind -- 19 Person -- worunter deutsch Knecht befinden -- 6 vermieten -- ärmerer Ausgewandert gebräuchlich -- 
  Ablauf Dienstzeit -- erhalten Summe Gelde -- Vieh -- Getreide dergleichen -- ansiedeln -- 
  völlig Familie rechnen -- söhn Haus behandeln -- nähren -- kleiden -- 
  Heiterkeit Frohsinn malen Gesicht hiesig Hausbewohner -- glücklich preisen -- Abgeschiedenheit tausend Plag Gesellschaft sicher stellen -- 
  selten kehren Reisender -- groß Gastfreundschaft empfangen -- gedenken -- 
  seltenes bemerken -- Woche fremde -- nebst Führer -- -- gleichfalls Wasserfall wallfahrten -- 
  scheinen Maler -- Landschaft zeichnen -- Tochter Stück Arbeit Andenken schenken -- 
  munter Mädchen loben meister -- alt Schwester schwermütig Gefährt rühmen -- 
  Menge frisch Lebensmittel versehen -- gelingen -- gut Leute wahr Wert aufzudringen -- 
  13ten Julius -- 
  3 Stunde Niagara entfernen -- hören Fall -- Rolle mächtig Donner -- 
  gestern tönt Getöse Ferne -- Nacht hindert Schlaf -- 
  Halt -- Stelle -- fest Geburtstage aufgespart -- 
  tausend Erinnerung Gefühl einstürmen merkwürdigen -- Kraft Volkes hochaufschäumen -- Flut -- türmend Fels überwand -- -- Abgrund fallen -- 
  mächtig Welle -- folgen -- 
  unleiben reisend -- fänd -- Woodhouse erzählen -- -- 
  sehen ziemlich Entfernung menschlich Figur Hügelspitze sitzen -- 
  Jsmael -- Auge weitesten tragen -- behaupten schreiben -- Abends pflegen -- wahrscheinlich zeichnen -- 
  Herz fühlen hingezog -- mächtig wirken Trieb Geselligkeit Mensch überall -- -- -- treffen -- -- abzumach gedenk Herz -- 
  Leben -- Bild geliebter -- vorüber -- 
  Trauerfest feiern teuer verlorene -- -- roh Irokes beten Geist -- beten erleucht -- Not tun -- 
  erhalten Ahnung -- Wendepunkt Gefühl -- schlafen -- unruhig Erwartung -- 
  klopfen Herz hoch -- schnell Puls - Kind -- wird_es -- 
  Kühlende trinken -- Corally schwatzen -- schreiben erhitzen -- 
  Leb -- Adel -- 
  Gedenke Virginia -- 
  14t Julius -- 
  O Himmel Erde -- Adel -- ist_es -- 
  Welt -- Mond -- Gestirn -- 
  ist_es -- Ahnung -- unbekannte -- Geliebte -- Eins -- 
  Laß -- schwindeln -- 
  Glück Fülle mitteilen -- Schmerz -- Hand zittern -- 
  namens bedürfen -- hundert Mal ruf Echo Fels -- Echo antworten -- teilen Gefühl -- 
  antworten -- Adel -- 
  rufen -- Mucius -- 
  Mucius -- tote kehren -- 
  O könnten wiederkehren -- Vater -- Emil -- Mutter -- 
  umfasse lieben Wiedergefunden -- Adel -- Vater -- Bruder Freund -- 
  Vaterland -- Mucius atmen -- Welt -- 
  Kopf wüst -- Stunde ruhen -- 
  hoch Glück fast schwer tragen heftigste Schmerz -- 
  Welch -- Mal Leben -- Glück -- Ziel Wunsch schenken -- 
  Schlafe -- Adel -- vermögen -- 
  -- 
  -- 
  Seligkeit vergeß zählen Sonne auf untergehen -- 
  kranke berechnen Stunde -- gefangener zeichnen Unglückstag Wand Kerker -- 
  schreiben Unglückliche Leidensgeschichte -- Glücklich erzählen -- Feder teilen Wonne langsam -- 
  schreiben -- erfahren sollst -- Kenntnis brächte -- Stündchen aufopfern -- Glück Kenntnis geben -- innig Anteil nehmen -- -- 
  Erzählung unterbrechen -- ziemlich Weile verlaufen -- ehe Blatt erhältst -- Bruchstücke gestalten -- fang Wunderreich -- Wiedersehen -- 
  früh -- letzter Ort unser Nachtlager verlassen -- fahren Fuß Fels Niagara stürzen -- lassen Vieh Gerät Jsmael Obhut -- John führen steil Fußpfaden Höhe -- betäubenden -- Beschreibung übertreffend Wassersturz übersehen -- 
  ergriff einzig Schauspiel -- 
  donnernd stürzen Strom Fels Fels -- himmelhoch spritzen Schaum empor -- Sonne durchschienen -- Goldrege -- hundertfältig Regenbog bilden Dichter herabfallend Gewässer -- 
  Sprache mangelhaft Eindruck geben -- Auge fassen vermögen -- 
  Sprachlos stehen -- staunen -- Dienerschaft Winke verstehen -- Abstufung Felsen Begleitung hinunt steigen wollen -- wohin bequem Pfad führen -- Wölbung kühl Aufenthalt bieten scheinen -- ungestört -- 
  Ecke bog -- erblicken männlich Wesen -- Gedanke verlieren scheinen -- treten -- 
  fremd gewahr -- Seit gleichfalls Bewegung -- Ort verlassen -- entgegen gesetzt Richtung auswichen -- Schüchter rückwärts sehend -- 
  hundert ungewiss Schritt -- treten Anhöhe hinauf -- stehen -- Bildsäul -- -- 
  Gestalt -- zitteren -- 
  Fremde beugen vorwärts -- heben Arm -- -- geben Grab tote -- -- rufen bekannt Stimme -- Mucius Geist -- fragen fast gleich -- liegen arme -- verlieren Brust Bewußtsein -- 
  erwachen befinden Schatten Felsenüberhanges -- Mucius halten umfassen -- Korally kniet Füßen suchen kalt Hand Küsse erwärmen -- 
  Erhöhte Lebenskraft Wärme kehren Körper -- sobald Auge aufschlagen -- blicken Himmel -- 
  Weine bedurft -- ehrlich John herbeiholen -- 
  Miß Virginia Bruder -- fragt Humphry befremden -- 
  Bruder -- Vater Vaterland -- rufen -- umschlang Heißgeliebt -- 
  -- Korally schlauem lächeln -- Humphry blicken zweifelnd finster -- 
  Mucius bitten John -- Gefährt sehen -- tief Wasserwand hinab steigen -- führen -- Korally setzen schweigend entfernt Stein -- 
  -- unermeßlich Seligkeit -- fast Busen zersprengen -- Träne -- Wort Küssen Luft -- 
  unfähig Wonn glücklich Stunde schildern -- 
  Sinn ungehofft Glück Wiedersehen -- Erinnerung trüben unser sonnenhell Himmel -- 
  langt Führer Mucius Freund -- sogenannter Indianer-Leiter hinunt steigen -- östlich Wasserfall Nähe sehen -- Mucius vorziehen -- Einsamkeit Gedanke Raum geben -- 
  wissen Fest -- wehmütig Erinnerung begehen -- 
  seltsam -- wunderbare Weg führen liebend Vorsicht -- nimm Glückswurf blind Zufall halten -- 
  Virginia -- rufen Mucius Freund entgegen -- 
  bloß Nahme erklären -- stürzen jauchzend Mucius Brust -- 
  Gebenedeit Jungfrau -- Jungfraue gleichen -- rufen toll Lustigkeit -- auge lachen -- Mund seufzen -- Leben preise all Laun -- Tück -- Fastnachtsposse -- 
  Fremd -- jung Maler Bassano Venezianischen -- Mucius Spanien kennen lernen -- Regimente dienen -- vorstellen -- 
  schön freundlich Gesicht -- voll unerschöpflich heiter Laune -- 
  treu Freundschaft Muster Altertum Seite setzen -- 
  Glück Freund seinig -- Last Dasein ertragen helfen -- 
  Geräusch falls fallen Redelust beschwerlich -- kehren -- Wunsch -- Fuhrwerk -- 
  mal lagern -- Jsmael bereit halten -- erzählt Freund abwechselnd Schicksal -- französisch Sprache -- geläufigste -- unser Leute verständlich -- 
  Pinelli lernen Mucius Hoffnung kennen -- rosenfarbigsen Bild heimatlich Zukunft schaffen -- 
  Freund heit Laune erhöht hell Farbe schön Gemäld -- fangen -- unentbehrlich -- 
  setzen gänzlich Ausbleib Brief Mucius Unruhe -- Pinelli trösten Möglichkeit -- 
  Kriegsvorfälle Ursache -- -- leidenschaftlich Gemüt Liebende -- Trübe erfahren -- fürchten ärgster -- 
  Tag Sturm spanisch Festung anschicken -- Mucius Soldat gewahr -- Landsmann aix erkennen -- kurz Korps eintreffen -- 
  Nähe reitend -- fragen -- Besitzer Chaumerive kennen -- 
  freilich kenn gut Herr -- aix -- 
  weißen -- fragt Mucius zitternd -- 
  Avignon -- entgegnen -- Tochter sterben -- 
  Virginia -- schreien Mucius entsetzen -- 
  Name wissen -- -- beklagen -- Güte Wohltätigkeit -- allgemein früh Hintritt -- 
  Leben Mutter -- stammeln Mucius -- 
  glauben -- sprechen Soldat -- 
  Sekunde Unglückliche Kanonenkugel zerschmettern -- 
  Mucius Zustand halb Geisteszerrüttnng -- 
  sturmmarsch schlagen -- 
  springen Mucius Pferde -- ergreifen gewaltsam Adler -- eilt Brücke hinauf -- schwankend halb bewußtlos Menge hinab drängen -- 
  Pinelli -- groß Unruhe -- Freund folgen -- stürzen -- ehe gelangen -- Stimme Freundschaft hörend werfen Pferd herum -- jagt Ufer reißend Fluß entlang -- 
  Minute Mucius auftauchen -- matt Welle kämpfen -- Strom schlingen Strudel -- 
  bleiben fast entseelt Kleid Gesträuch hängen -- groß Mühe gelingen Freund -- an Ufer ziehen -- groß -- völlig Leben rufen -- 
  Viertelstund Festung entfernen -- 
  Lage plötzlich Abteilung englisch Reiterei umringen -- gefangen nehmen -- 
  Mucius fühlen Begriff -- vorging -- glich Seelenlose -- Freund müssen denken handeln -- 
  Zustande Lissabon bringen -- -- mehrere gefangener -- Transportschiff England führen -- 
  Kapitän scheinen gerührt tief Niedergeschlagenheit -- aufopfernd Freundschaft -- behandeln Freund Auszeichnung -- Pinelli erkundigt Schicksal -- Ankunft England bevorständen -- 
  Antwort allgemein -- -- Subaltern -- nebst Soldat -- Gefangeneschiff bringen -- 
  wassergefängnissen furchtbar Vorstellung -- Nacht sann -- Freund elende entziehen -- 
  Glück -- Schicksal -- erleichtert Vorhaben -- 
  Hitze -- Hand Frevler -- sprengen weniger groß Wasserfässer Fahrzeug -- trennt Windstoß Konvoi -- treiben französisch Küste -- 
  Verlegenheit ziehen Kapitän amerikanisch Flagge -- Reede La Rochelle Anker -- französisch Fahrzeug Bedeutung liegen -- amerikanisch Fregatte befinden -- 
  halten Batterien entfernen -- schicken Schaluppe Land -- Vorrat Wasser nehmen -- 
  Amerikaner kümmern Ankömmling -- beschäftigen Anker lichten -- Segel setzen -- umsetzend Winde See -- 
  Mond aufgehen -- erhellten wechselnd wolkig Himmel -- Freund Verdeck -- betrachten eilend Gewölk -- 
  blitzen Pinelli's Seele Gedanke Rettung -- 
  Unvermerkt ergriff liegend Tau -- schlingen Freund -- stürzen mutig Bord -- 
  Welle schlagen -- kühn Schwimmer arbeiten mächtig empor -- ziehen Gefährten -- begriff -- ebenfalls Kraft anstrengen -- folgen -- 
  Gewölk verdunkelt Mond -- Schwimmer Schiff gewahr -- 
  nehmen Richtung absegelnd Fregatte -- erreichen -- -- aufblitzend Lichtstrahl -- bemerken -- 
  werfen Tau -- bringen glücklich Bord -- 
  geben Kunde Schicksal -- falsch Flagge Engländer -- Rettung vollenden -- 
  Fregatte weniger Minute Gesicht Schiffes -- ohnehin Verfolg denken -- 
  Fahrt Boston -- Abenteuer einlufen -- 
  Freund hinreichend Golde versehen -- richten genügsam -- 
  Pinelli's froh Mut Lebenslust -- helfen schwermütig Mucius tragen -- 
  bringen -- Zerstreuung -- Reise innerer Vorschlag -- Denkmäler Vorzeit Ohio -- Wildenvölkern Missouri -- Reise günstig Einfluß Mucius gramvoll Gemüt -- 
  sprechen Entzück -- Schönheit südlich Provinz -- verlieren philosophisch Betrachtung -- Urzustand Weltteils -- untergegangen Kultur zersprengen Stamm -- 
  fast kehrt Pilger Boston -- Barschaft indessen verringern -- 
  Pinelli suchen Kunst -- Glück -- geltend -- 
  führen Reise entworfen Landschaft groß fleiße -- finden Käufer -- 
  Porträtmalerei üben -- entzücken eigentümlich Charakter Idealisierung -- Physiognomi -- Ähnlichkeit -- geben wissen -- 
  Mucius befördern Reise -- Altertumsforschung -- Druck -- Unterricht alt Sprache -- 
  mitten Beschäftigung -- erhalten Nachricht Umwälzung vaterlande -- Wunsch Rückkehr benahmen -- 
  betrachten nunmehr fremd -- frei Amerika Heimat -- eilen -- Verteidigung -- Waffe ergreifen -- Engländern Inneren bedrohen -- 
  Baltimore Mucius Haus Herr Davson wohnen -- ahndend Herz -- -- 
  Mistriß Davson fühlen sanft -- freundlich Schwermut ergreifen -- schön jung Mann anziehend -- 
  Herr Davson fing Eifersucht hegen -- Freund veranlaßn -- Rückkehr Gegend Washington -- Reise Wasserfälle unternehmen -- 
  durchstrich umliegend Gegende -- 
  Mucius losreißen wildromantisch Natur -- -- Nahrung Schmerz suchen -- finden Heilung -- 
  laut danken Gott -- Endigung Erzählung -- väterlich Führung -- nächst treu Pinelli -- -- Schutzgeist Mucius -- sehen -- 
  O -- unendlich teuer Freund -- 
  -- Rücksicht -- Mann leiben gewinnen -- 
  leben Freund -- hegen gefühlvoll Herz Welt -- 
  Laune unerschöpflich -- Unannehmlichkeit wissen heit Seite gewinnen -- 
  Reisegesellschaft allgemein lieben -- 
  unterhalten Humphry -- lassen Amerika belehren -- bewundern Kenntnis -- John wild Stämmen erzählen -- schütteln treuherzig Hand -- ehrlich Jsmael umarmt -- Korally tausend schmeichelhaft Ding -- 
  gewinnen -- notwendig Ausdruck heiter Herzen warm Menschenlieb -- nehmen -- 
  Mucius -- bloß Liebe beschäftigen -- Herz Reisegefährt Rang -- Humphry's Auge begegnen sogar zuweilen zweideutigen -- vorwurfsvollen Blick -- 
  -- -- Gedanke Korally's Voraussetzung gehen -- ehrlich Kerl wehe -- gewöhnen -- still Braut Herr betrachten -- 
  stumm Vorwurf erinnern Ängstlichkeit Ellison -- meinetwegen Meer durchkreuzt -- 
  William sagen zurückkehren -- 
  sprechen Gewissen frei -- täuschen -- Hoffnung nieder schlagen -- werfen fast klein freundschaftlich Äußerung -- dankbar Herz zeigen -- fürcht unangenehm Empfindung Familie -- Güte getäuscht Hoffnung lohnen -- 
  Glück eher rein -- gut Mensch Zufriedenheit herrschen -- 
  Mucius nehmen Sache leicht -- meistens Mann -- 
  William Vergänglichkeit Liebe hoffen -- sprechen -- begriff Herz Virginia -- kennen wahr Liebe -- 
  früh Neigung überwinden hoffen -- Überwindlichkeit seinigen schließen -- 
  Eltern -- 
  lohnst Gastfreundschaft Dankbarkeit -- Aufwand vergüen -- welcher hoch Forderung -- 
  Geliebte tröstend sprechen -- Vernunft einwenden -- Herz hören -- ängstlich schlagen sehen -- Reise lang verzögern -- 
  Fort Niagara kurz Tagereisa -- meist Fuß -- gelangen -- 
  Mucius Pinelli beritten -- Führer verabschieden -- Lebensmittel eingehandeln -- 
  See Ontario hinauf ziehen -- mehrere herrlich Pflanzung verweilen -- 
  Woodhouse zurückkehren -- lauter Freude empfangen -- -- inständig bitt Familie -- Rasttage halten -- 
  einzeln Niederlassung unbeschreiblich Reiz -- Mucius -- -- neu Umwälzung unser vaterlande -- Zeitgeiste Europa entzweiet -- 
  mal -- wahr Liebe -- Bild einsam Kolonie -- Geisteskultur gebildet Welt -- Einfachheit Sitte golden Zeitalter bewahren -- 
  Pinelli unerschöpflich Einfällen Entwürf unser Lieblingsgedanke -- Wirklichkeit verwandeln -- gleichgestimmt Mensch träfen -- 
  begleit jung Mitglied Familie leicht Arbeit -- 
  Abend Vater Haus ländlich Ball -- wobei Geig vieler Leichtigkeit spielen -- 
  tanzen sämtlich kurz -- eben Rase -- gleich -- herzlich Fröhlichkeit -- 
  Rümpfe Näschen -- lieb Adel -- Art Vergnügung -- ziehen euren glänzend Hoffbälle -- 
  welch selig Gefühl -- Mensch -- 
  Gräfin Montorin -- ewig Virginia -- Philadelphia -- 
  schreiben -- Adel -- 
  Desto öfter denken sprech -- Freundschaft leiden -- Busen einzig vertraute -- 
  gewiß freuest verlassen -- glücklich -- überreich Virginia -- 
  -- Umweg -- glücklich ankommen -- 
  Mucius Pinelli Wohnung mieten -- gleich tun -- Ellison kränken glauben -- 
  Haus verändert Gesicht -- vorzüglich Seite Mutter -- offen Erzählung ungläubig Kopfschüttel anhört -- spitz Anmerkung begleiten -- 
  halten Begebenheit offenbar Fabel -- Reise Zusammentreffen heimlich verabredet Plan -- schmerzen tief -- 
  William -- sagen -- Freundin Gerechtigkeit widerfahren lassen -- 
  hierüber Gewißheit -- 
  Philippin alten -- 
  werfen -- Freudengeschrei -- arm -- Mucius vorstellen -- Hüpfte kindlich Fröhlichkeit entgegen -- schüttelen freundlich Hand -- 
  finden Mädchen liebenswürdig -- -- Pinelli schwören -- mythologisch Götter -- jung Grazie -- 
  fürcht -- künftig Gestalt malen -- Nymphenwuch -- lieblich griechisch Profil -- Philippinchen sehen munter Jüngling -- 
  Mensch -- Erröt -- sehen klar Auge Seele hinein -- 
  -- wissen Seite Glück erblühen -- Schicksal entscheiden -- 
  Brief -- Adel -- London -- 
  Neuigkeit -- unerwartet Begebenheite -- 
  Arm flüchten -- heimatlos -- 
  welch prophetisch Geist sprechen -- ständest glimmend Vulkan -- 
  täuschen Gesinnung Landsleute -- -- sagen -- hundert Mann erobern Reich weniger -- 
  Geschichtsforkünftiger Jahrhundert schließen -- Thron Mahle besteigen -- bloß Namen Liebe Volk -- Thrones unwürdig können -- Million irr Interesse -- Neigung -- 
  auftretend Held Sturme widerstehen -- sogleich Nähe erheben -- ehe Stellung Festigkeit gewinnen -- 
  zweifle -- beklag unglücklich Frankreich -- 
  Neuigkeit zufrieden -- England Europa beschäftigen -- lassen Frieden -- 
  sagen -- Frankreich Schicksal -- kehren Nimmer -- 
  nunmehr Vaterland -- -- land Freiheit -- europäisch Staat messen -- Wort bedeutungslos -- 
  schreibst -- Freude -- 
  liebst -- Hauptsache -- 
  Brief Marseille erhalten -- -- kauffahr Ausfluß Delaware -- Schicksal beruhigen -- 
  Mutter zürnen -- erlauben -- London schreiben -- 
  -- fast hoffen -- 
  möge Vater lebenslang streng Stillschweig beobachten -- niemals erinnern -- 
  denken Heirat -- möge Wahl glücklich -- mögest glücklich -- hoffen -- 
  gibst doppelt Adresse schreiben -- 
  unbeschreiblich Freude -- danken tausend Mal Maßregel -- 
  scheinen -- sein trennen -- höchstens Meile -- Berg -- Fluß -- 
  -- Schnellsegler Gedanke weniger Woche überbring -- schnell Antwort erhalten -- 
  Mucius grüßt auf herzlichster -- 
  lieben Bild -- -- -- entwerfen -- wozu Ähnlichkeiten Philippinen borge -- -- Stück -- vergleichen -- 
  Ähnlichkeite lieben Mädchen ziehen -- 
  leben selig -- obwohl erwartungsvoll Leben -- sehnen Seite Williams Ankunft -- Mutter fürchten -- hoffen -- 
  gewiß Gegenwart Spannung lösen -- verbergen suchen -- 
  Philippin Pinelli scheinen heimlich Verwendung rechnen -- 
  wünsche stehen leserlich Mien schreiben -- Eltern geben ansehen -- verstehen -- reden wagen -- Philippin stumm -- Schüchternheit -- fremd schweigen -- Mangel -- 
  -- Freund Bekanntschaft zwei trefflich Mann -- Schweizer deutsch Namens Staufach -- Walter -- einführen -- fallen -- 
  jung Apotheker -- -- leidenschaftlich Liebe Gewächskunde -- südlich Provinz -- Mexiko durchwanderen -- stammen hannoverisch Familie -- studieren Hofwyl Landwirtschaft -- Staufach -- 
  Mutter gewinnen einst englisch Lotterie ansehnlich -- wüsste Länderei Ohio -- 
  Entfernung -- lang Krieg -- Nachforschung fruchtlos -- 
  nennen Besitzung -- scherzend -- Gut Monde -- 
  Vater tot -- Bruder bleiben Krieg -- Mutter folgt Liebe kurzen -- hinterlassen jung Sohne Vermögen -- nebst urkunde amerikanisch Länderei -- 
  Walter nahen verwandte -- lockend Aussicht bedrängt Land alt Welt -- Eigentum -- folgen schweizerisch Freund lustig -- 
  unzertrennlich Gefährt Wanderung -- durchstreift Besitzung -- 
  Lage ergiebig Boden entzücken -- 
  -- Aufsicht Ohio-Gesellschaft -- verwalten -- äußerst nachlässig -- Eigentümer melden -- fünfzig urbar -- dennoch finden hinreichend Unterhalt sicheren -- 
  eilt -- rechtmäßig Besitzer ausweisen -- denken -- Stand setzen -- angenehm bequem leben -- 
  Angelegenheit -- Hauptunterhaltung jung Mann -- woran nehmen -- 
  Italiener nennen jung Mann -- scherzend -- Fürst Walter -- Walter Robinson -- Staufach Mucius nennen Penn Kentucky -- 
  Woche -- 
  Freude -- gedrängt Neuigkeit Begebenheite -- 
  erzählen -- Reihefolge -- 
  -- Herz beschäftigen -- fangen -- 
  William ankommen -- lieben Brief erhalten -- 
  William -- Atme -- voll leicht Brust -- 
  Nachricht Hafen einlaufen -- Washinton gehen Anker -- erblaßten -- Herz schlagen hörbar -- 
  edel Mensch -- fest Haltung -- Zimmer treten -- freundlich -- Zutrau fordernd Auge werfen -- plötzlich Ängstlichkeit verschwinden -- eilt schwesterlich Zärtlichkeit entgegen -- 
  bewillkommt alt Herzlichkeit -- Blick ruhen -- überflog Versammlung -- 
  finden glücklich -- -- Freundschaft wünschen -- Gesundheit scheinen Reise blühende -- Kreis Freund angenehm vermehren -- 
  alt finden -- erwidern -- Augenglick werfen Mucius Brust -- bitten rührend schön Stimme -- 
  O lassen ihrig -- edl Mann -- 
  William betreffen -- fragen -- 
  Mucius -- -- 
  ist_es -- 
  Verlorener -- gefunden Mucius -- rufen -- 
  blicken -- leicht Krampf zucken Mund -- Bläs überflog plötzlich Gesicht -- schnell Übergang schoß gehemmt Blutstrom verdoppeln Wang -- schließen -- Heftigkeit -- Arm -- rufen -- willkommen Herz eur Bruder -- 
  grüßt Übrig -- beantwortet Frage Vater gewohnt Klarheit Ruhe -- 
  Mutter betrachten unvermerkt Seite -- schüttelen heimlich Kopf -- scheinen froh -- gefürchten Augenblick vorüber -- 
  erzählen erkundig -- Mitternacht -- unbemerken -- Versammlung herein brechen -- 
  hört Mucius Unerwartetes -- 
  einzig Schlag entscheiden -- freilich voraus sehen -- enden müssen -- Frankreich -- schnell enden -- 
  Held Trauerspiel verschieden beurteilen -- 
  Extreme -- denken -- liegen Wahrheit ziemlich Mitte -- -- Endurteil sprechen -- erscheinen -- 
  Ort künftig Aufenthalt interessiert -- kenn glücklich Insel -- 
  O -- Ruhe geben -- glücklich leben -- 
  freilich Gedanke -- gefangen -- Änderung -- Fessel Weise frei -- königlich gefangener -- gebieten Wächter -- 
  neu Begebenheit Europa erschüttern -- spüren Wirkung He Ausgewandert -- hiesig Hafen landen -- 
  möwen -- drohend Sturme -- Ufer eilen -- verlaß Mensch gehrend Weltteil fliehen unser Friedensküst -- 
  Ellison Schiff interessant Flüchtling Bord nehmen -- niederländisch Hafen ankern -- deutsch Mechaniker Namens Franke -- nebst Frau Schwester -- Baumeister Verona -- florentinisch Arzt -- Schwester -- niederländisch Kunstgärtner -- Frau -- sämtlich gebildet Mensch -- jung Lebensfroh -- bess fortkommen -- freieres suchen -- 
  Reise William eng befreunden -- Mädchen unschuldig Freundlichkeit entgegen -- 
  zeichnen jung deutsch -- einig Wohlgefallen -- -- 
  Philippin innig vergnügen Zuwachs weiblich Gesellschaft -- Wirtin vieler Anmut -- fremd einheimisch finden -- 
  gestern Abend munter Kreis verstören -- Unpäßlichkeit Vater Ellison -- 
  Symptom bedenklich -- Florentiner fürchten gelb Fieber -- ermahnen -- Aufenthalt wählen -- weichen kranke -- Beistand Hausarztes bitten -- 
  Gesellschaft versammeln Landhause -- 
  Nacht Stadt zubringen -- Philippinen ablösen -- -- nebst Mutter vorig Nacht durchwachen -- 
  Mucius William verhindern -- stellen -- Schlacht Seesturm bestehen -- fest Treue Beruf -- 
  Weibe Beruf -- krankenbett Pflege leisten -- setzen hinzu -- 
  Lage gefährlich -- 
  gelb Fieber bezweifeln -- Mutter hüten Bett -- 
  Haus sperren -- Gemeinschaft Landhause gänzlich aufheben -- wozu freiwillig meister beitragen -- 
  Mucius -- Philippine William Gefahr wissen -- 
  erster Zeile beschwören -- Geschwister Gewalt halten Eltern wünschen -- Vorsicht walten -- 
  Krankheit ergreifen -- Nachtwach geschehen -- hoffen Mut -- vernachlässigen keiner -- Salvito -- Florentiner -- empfehlen -- 
  halten treulich -- 
  Studium Kunst verdrängen -- Rücksicht -- beseeln Dankbarkeit Freundschaft -- gut alte fremd -- bezahlt Wärter wissen -- teil Pflege -- 
  zufrieden winken -- Bewußtsein -- lohnen -- 
  vorüber -- 
  Übel enden schnell -- 
  Armer William -- arm Philippin -- verwaisen -- Verwaist -- Herz bluten -- 
  Schmerz empfinden -- 
  viele glücklich -- -- trauern gemeinschaftlich -- 
  Schaffnerin verödet Haus -- fremd Fuß betreten wagen -- 
  -- still Mitternacht -- Salvito dichtverschlossen Särge verstorben Gatte Gruft geleien -- 
  verhüllt -- scheu Leichenträger einzig Begleiter -- John -- treu John -- abhalten -- Wohltäter mal sehen -- 
  William -- verhindern -- 
  Philippine liegen krank -- John -- Gott verhüt fürchterlich Krankheit ergreifen -- Ausbreitung Gesundheits-Polizei -- Wachsamkeit -- verhindern streben -- 
  -- Hofe Haus -- sämtlich Mobiliar -- wäsch Kleidungsstück -- verbrennen -- 
  Bad nehmen -- unmittelbar frisch Wäsche Kleid hüllen -- außen reichen -- 
  verlassen traurig Haus Tod -- aufzuleben Arm Liebe -- leidend Freund stehen -- Salvito John begleiten -- 
  Landhause -- 14 -- 
  glücklich überstehen -- 
  trotz beobachtet Vorsicht -- Besorgnis Lieb -- nähern -- weit Umweg -- Läng ufern Delawar -- 
  sämtlich gesund bleiben -- Philippinen Krankheit Wirkung bewegt Gemüt -- Freund Trost gewinnen -- 
  trauern gemeinschaftlich Tod gastfreundlich Paar -- Schwäche -- irdisch Hülle ablegen -- 
  glücklich preisen -- -- lang Vereinigung -- fast schnell -- Erde verlassen -- 
  wünschen -- dereinst Gefährten Leben -- Hand Hand -- Reise treten -- 
  förmlich einrichten -- freundlich Kolonie -- undenkbar -- trennen -- 
  Plan -- Walter Ohio ziehen -- gewinnen Festigkeit -- Ellison -- Schwester Vermögen Handlung nehmen -- begleiten -- 
  Mann gedenken Herbst Reise -- nötig ordnen -- 
  zärtlich Dulzineen Rückkunft Sehnsucht erwarten -- Herz stehen sämtlich Amors -- Frühling Eheband knüpfen -- 
  Philippin Pinelli Mucius Altar begleiten -- wahrscheinlich William sanft Marie Frank -- Salvito werben Therese Frank -- Antonio -- Veroneser -- scheinen schön Florentinerin Rosalva lieben -- 
  liebend Paar -- -- kommen -- Dupont -- Franzose -- jung Braut flüchten -- Bündnis schließen -- Heimat Hindernis Weg stehen -- 
  Protestant -- beginnend Verfolgung Glaubensgenosse -- droht katholisch geliebter trennen -- 
  welch Verein jung munter Kolonist -- 
  Staat -- günstig Vorbedeutung -- gründen -- 
  kühler Herbstluft Fieberstoff zersetzt -- Besorgnis Ansteckung verschwinden -- zeigen Spur -- 
  geliebter abgereisen -- John Söhnen begleiten -- Humphry unser Schutz bleiben -- 
  verlassen Frau vertreiben -- lassen -- fahren -- Musik -- arbeiten -- 
  Stoff Unterhaltung fehlen -- 
  furchtsam Weibch zittern Gefahr -- Mann wüssen Land treffen können -- nehmen tausend Frage Zuflucht -- Heldin -- Mut zuspricht -- 
  reden -- -- Gebirge durchreist -- Wasserfall sehen -- Wilder -- Gazelle Wölfe -- Entfernung Bären -- leben -- 
  -- sehn Urwald -- Freiheit golden Zeitalter -- 
  Beredsamkeit reißen fort -- wünschen herbei -- Völkerzug beginnen -- unfehlbar geschehen Frühlingstag -- 
  scheinen jung Kolonist nehmen -- 
  jung Frank Vanhusen niedlich Weibch Hoffnung -- 
  Mädchen vereinigen -- Ankömmling förmlich Aussteuer bereiten -- Wetteifer sticken -- Strick nähen -- Lust -- unser emsig Zirkel sehen -- flammend Kamin bilden -- dampfend Teetisch -- gaukelt freundlich Kose -- manch nackend Wort Lippe schalkhaft Weibche röten Wang Mädchen -- 
  Zephyrin -- jung -- munter Landsmännin -- vergilen Arg Argem -- überflügeln Witz -- 
  lieblich Mädchen Neigung vorzüglich Maß -- 
  nennen verzogen Kind -- spielen tausend Eulenspiegelstreiche -- lieben desto -- 
  gleichen Namensbrud -- Westwinde -- Blume spielen -- Balsamdüfte stiehlen -- 
  Freude Freude -- 
  Ritter glücklich kehren -- froh Nachricht bringen -- vortrefflich finden -- 
  Ellison Mucius Bezirk hinzu kaufen -- wovon kultiviern Walter Erbschaft hangen -- 
  John Söhne zurückbleiben -- Arbeiter Aufsicht führen -- wozu Walter Tagelöhner Louisville gedungen -- 
  Baumeister Riß vorläufig Gebäude entwerfen -- -- Fleiß reichlich bezahlt Handwerker -- fertig finden -- 
  Außenhülfe entsag -- jung Kolonie Bedürfnis sorgen -- 
  hierzu nötig Vorkehrung treffen -- 
  voll Leben Tätigkeit -- Gedanke begeistern -- 
  Mucius entwerfen Plan Staat -- Freiheit Gleichheit verwirklichen -- Abschnitt Entwurf Generalversammlung -- Weiber halb Stimme -- vorlegen -- Stimmenmehrheit -- annehmen -- abgeändern -- denken -- Verfassung Stande -- woran mehrere Menschenalter flicken finden -- 
  Ewig -- Sonnensystem bekommen jahrtausenden Polarster -- 
  jung Weibche munter Knabe entbunden -- 
  -- Name beilegen -- Vermählung sämtlich Paar feiern -- erwarten gänzlich Wiederherstellung Mutter -- 
  beschicken Haushalt -- einfach -- äußerst bequem einrichten -- Kleidung gänzlich umgestalten -- 
  Mechanikus beschäftiget -- erfunden Maschine zweckmäßigsten wählen -- jung Kolonie unbestritten Vorteil -- Menschenkraft Hand ersparen -- 
  sprechen -- Seemaschin -- Dreschmaschin -- Spinnmaschin -- Webemaschine -- u. S. W. Seite -- ziehen Walter Erkundigungen -- Art Rindvieh -- Schaf -- u. S. W. -- 
  Vanhuse handeln Sämereien -- Setzbaum -- Pfropfreiser -- 
  John Familie -- -- Korally verheiraten -- nebst Schwäg Kind -- rüst Aufbruch -- begleiten -- sechzehn Neger Negerinne -- Kind ungerechnen -- 
  Dörfchen -- Nähe unsrigen -- beziehen -- Feldbau Hand -- meister vollkommen verstehen -- 
  hinreichend Länderei Vieh erhalten -- setzen -- -- wohlhabend Grundbesitzer -- fast leben -- 
  scharenweise ankommend deutsch Ausgewandert -- Walter Frank tüchtigen wack Handwerker auswählen -- Familie gleichfalls Dorf Nähe -- Landeigentum vorteilhaft Bedingung erhalten -- 
  sowohl -- Neger -- Vertrag schließen -- hoffen -- -- Ablaufe -- Seite -- verlängern -- 
  scheinen Sonne wärmend jung -- Tulpenbaum unser Garten treiben Tulp beet Wette -- gesellig Sangvögel kehren wärm Zone Zederngebüsch -- 
  Feier Hymenäen -- vereinen öffentlich Schwor -- ewig -- Mucius -- 
  O -- Könntest sehen -- selig Vorfeier -- 
  jeder Auge glänzt Mal hell -- Rede klingen Jubelhymne -- 
  Versammlung scheinen närrisch -- 
  Pinelli Philippine -- Dupont Zephyrin -- Salvito Therese -- tanz Wette -- Antonio Rosalva verstecken suchen Lauben -- William sanft Marie -- Walter -- Freund -- Schweizer -- paar schön Mädchen -- Jugendgespielinn Philippinen -- -- inner Seligkeit voll -- Hand -- drücken -- schweigend blau Auge schauen -- 
  Mucius müssen eigentlich sprechen -- Meinst -- 
  -- lieb Adel -- Schellenkäppchen fehlen -- bemühen -- Anstande tragen -- alt Liebesleute geziemt -- 
  Stürme Schicksal möglicher tun -- Blütenstaube schmetterlingsflügeln Liebesgötter streifen -- lächeln Ehepaar sehen -- lose Bube überall hervorgucken -- 
  O könntest Brautkranz winden -- traut Adel -- 
  Mucius übernehmen au Stadt -- Verlobte flichen verlobten -- 
  Lebe Freundin Kindheit -- letzter Mahl schreiben Mädchen Virginia -- nächster Mal Mucius Gattin -- 
  rüst Abreise -- 
  verlassen gastlich Gegend -- leise Reue -- 
  Hand geliebter wandeln freudig Unterwelt -- still Paradiese entgegen -- finden hoffen -- 
  Walter Staufach Gattinne -- Fanny Lucia -- verlassen verwandte -- Schmerz -- 
  Familie Trennung -- Lyon Avignon zöge -- 
  Wanderungslust fast ansteckend -- 
  Amerikaner hangen weiten fest Erdscholle -- gebären -- Europäer -- lieben Ortsveränderung -- 
  Kolonie Fall -- Reichtum Boden -- Ansiedler mächtig inneren ziehen -- häufig verlassen mühsam angebaut Pflanzunge -- suchen weiterhin fett Erdstrich -- gleich Anstrengung Anbau beginnen -- 
  Pflanzer unser nunmehrig Besitzung -- Freude verkaufen -- Louisiana Missouri ansiedeln -- mitten wild Kriegeich Stämmen -- 
  Geist jung Kolonie bemächtigen -- 
  glauben -- 
  glücklich -- vereinzelt Pflanzer -- Kind Boden lieben -- glücklich Kindheit durchspielen -- Verfassung -- Vorteil genießen -- unser Grenze vergebens suchen -- 
  Kennst fröhlich Gesellschaft -- Marsch setzen -- 
  wahrlich Völkerzug -- 
  sämtlicher Mann Pferd -- Frau Gerät -- Proviant Maschine -- sechzehn Wagen -- Herde -- Leitung Neger -- 
  Handwerker bestehen Schmied -- Stellmacher -- Zimmermann -- Tischler -- Schuhmacher -- Töpfer -- Glasmacher -- Kupferschmied -- Leinweber Tuchweber -- sämtlich verheiraten -- -- halb erwachsen Kind -- rüstig Mensch -- Feldbau Nutzen -- 
  Humphry Herr trennen -- ansiedeln -- hübsch deutsch Mädchen Wahl -- 
  Virginie -- Fuß Gebirge -- 
  Weideplatz Vieh bestimmen unser Weg -- weshalb Stadt -- groß Teil Pflanzunge vermeiden -- Eigentumsrecht Streitigkeit zuziehen -- 
  frisch Proviant einhandeln Seiten-Patrouille abgeschicken -- meister verschaffen Jagd -- 
  lagern frei Himmel -- Reise gewohnen -- Gefährtinnen anfangs sonderbar vorkommen -- 
  Zephyrin nennen -- Zigeunerhorde -- Mucius Hauptmann -- 
  äußerst -- drollig -- Abends Feuer gaukelt -- angenommen Zigeuner-Karakter -- wahrsagen -- 
  possierlichsen -- deutsche geraten -- verständlich -- Wort verstehen -- 
  O -- schön Natur -- 
  Tulpenbaum stehen voll Blüte -- zart Akazie weiß duftend Blütenbüschel -- schattend Plantan Bruder -- Zuckerahorn -- schütz Strahl brennend heißen Sonne -- Jasmin -- Geißblatt Rose bilden Lauben Wand -- erfüllen Luft Balsamdüft -- Höh Zeder -- Tann Eiche bekränzen -- überall vermählen Norden heißer Süden -- 
  unser lau Tal schön Ohio -- 
  Louiswill -- Bedürfnisse versehen -- geht_es Eldorado -- Landschaft taufen -- nimmer verlassen -- 
  -- Eldorado Candide -- Fremden unauffindbar -- 
  Goldstück -- Rubinen entwenden finden -- Ruhe Frieden unterbrechen -- Wohnsitz aufschlagen -- 
  fern unruhig Treibe Welt -- fließen -- Wiesenbach Welle -- Sturm empört -- Ehrgeiz gelddurst -- Herz bewegen -- Liebe sanft Gefühl Freundschaft schlagen -- politisch Meinung fremd -- Religionsstreitigkeit -- Modetorheit berühren -- Nicht Streitigkeit veranlassen -- Fürst Befehl erteilen -- Priester unser Glaube meistern -- 
  golden Patriarchalische heben -- Mensch Bruder -- Schatz Kenntnisse Fertigkeit nehmen Leben hinüber -- 
  gestalten -- Urzeit menschlich Kindheit -- 
  Eldorado -- Junis 1816 Angelangt edens blühend Garten -- 
  erzürnt Engel wehrt Eingang -- freundlich Grenzgott -- freundlich friedlich Lar empfangen -- 
  müssen Kentucky hinauf -- fast Ursprung -- Übergang finden Paradies -- 
  sehnsüchtig blicken hinüber -- einst Kind Israel blau Berg -- glückseligen Arabien trennen -- 
  Zephyrin verglich hundert Mal -- Mucius Führer Gesetzgeber -- 
  fröhlich Laune -- reich Anspielung Gleichnisse -- nennen Walter Staufach Josua Kaleb -- golden Traube zeigen -- geduldig Wüste folgen möchten -- Rind salzspendenden Hirt -- deutsche -- meinen -- sein ägyptisch Ziegelstreicher Fronknecht -- lang Zug geläuteren müssen -- würdig -- Gründung Kolonie -- 
  bitten -- Prüfungszeit vierzig ausdehnen mögen -- wünsch -- gelobt Land Bundesaltar tanzen -- ehe Runzel -- Krücke bedürfen -- 
  fahren Fluß -- Tagereis -- Hügelkette ziemlich Höhe -- 
  Spitze letzter Berg -- rufen Walter -- 
  Ziel -- 
  unser Fuß liegen grün beblümt Savann -- gestickt Teppich -- links dunkl Urwald -- rechts blau Kentucky silberpappeln babilonischen Weide besäumen -- 
  allgemein Freudenruf -- tönt Lüfte -- springen gleich -- laufen ausgebreitet arme jauchzend Berg hinunter -- 
  -- Grenze unser Gebiet -- fallen -- namenlos Entzück -- heilig Boden nieder -- Sturm verschlagen Seefahrer -- Ufer wertbaren Eiland -- 
  umarmt Pflanze -- umarmt -- Busen schlagen -- Träne süßest Freude träufeln Blume herab -- 
  dauern ehe selig Rausch Betrachtung Gegenstand auflösen -- 
  kalt deutsche -- ungebildet schwarze teilen schwärmerisch Freude -- umarmt -- 
  Augenblick Volke -- Unterschied Farbe -- Heimat -- Bildung -- vernichten -- Bruder -- gleich gleich Pflicht -- 
  fröhlich Zug Läng Kentucky -- geraume Wegweiser bleiben -- 
  folgend verließ reich Ufer -- Ahornwald nähern Weg unser Wohnung nehmen -- letzter Schimmer Abendsonne liegen sehen -- Größe unser Gebiet schließen -- 
  Norden Kentucky -- Westen Ohio -- Süden Schawanoe begrenzen -- Ost-Nord schließen Hügelkette -- undurchdringlich Waldung lehnen -- Schall Axt gehören -- Alter jung Umgestaltung Erde hinauf reichen -- 
  Baumgeschlechter gehen -- wachsen Trümmer -- stark frisch empor -- 
  Wohnort liegen Schawanoe -- unweit Eiufluss Ohio -- schön -- Name führen -- lachend Ebene -- Fruchtbarkeit Beschreibung übertreffen -- 
  freundlich Gebüsch wechseln grasreich Matt -- bepflanzen Hügel durchlaufen Ährengefilde -- 
  jenseits Ohio erheben dichtbewachsen Gebirgsrücken Nordwestwind schützen -- Milde unser Klima beitragen -- 
  einzeln -- abgetrennt Überbleibsel Gebirges -- lehnen einzeln Fels Schawanoe reichen unser Wohnung -- Lage malerisch -- romantisch Anblick -- 
  ergreifen -- Pinelli -- müde -- verschieden Ansicht zeichnen -- 
  John Sohn empfing hoch Freude -- 
  notwendigsten Arbeit vollenden -- Arbeiter entlassen -- 
  sehen lauter wohlbekannt Gestalt -- kennen lernen -- bleibend Gegenstand -- 
  Abschied glücklich Erdstrich gehören -- einst Abschied Reise schönerer Land -- 
  freudig Rührung führen Mann Familie blütenumrankt Haus -- 
  zündet Feuer Kamin -- werfen Weihrauch gastlich Flamm -- umarmt -- danken laut Schöpfer Welt -- Asyl -- fleht -- glücklich vereinigen erhalten -- 
  treten unser Hütte -- gehen vereinigen Halle -- gemeinschaftlich Küche Versammlungssaal enthalten -- 
  Herde Feuer entzünden -- Weihrauch Mais hinein streuen -- weihend Herd Milch Wein besprengen -- 
  mal gemeinsam bereiten -- gemeinsam lang -- Blume bestreut Tafel verzehren -- 
  Mond blicken hell offen Fenster -- leuchten spät unser verschwiegen Hütte -- 
  Sonne Lager enteilen -- kleiden -- Übereinkunft -- gewählt Landestracht -- 
  Mann tragen weit -- Beinkleider baumwollen Zeuge -- Weste Hemdsärmel -- Fuß kurz Schnürstiefel -- Strümpfe -- Kopf leicht Strohhut -- 
  Frau hingegen weiß kattunen Hemd -- offen Ärmel -- Knöchel reichen -- Brust Finger breit Hals bedeckt -- farbig griechisch Gewand -- Ärmel -- Knie herab fallend -- Busen gürten -- Haar geflochen -- Sonnenstrahl schützen Strohhut -- Fußbekleidung Geschlecht -- 
  einfach Tracht unabänderlich -- Mode ewig Zeit Eingang verwehren -- 
  Regen -- rauh Witterung -- Geschlecht Tuchmantel tragen -- schmutzig Arbeit Überwurf grau Leinwand -- 
  glaubst -- unbeschreiblich reizend griechisch Kolonie ausnehmen -- rötlich besonnt Tal -- Blumenkranz Hand -- Tempel-Weihe ziehen -- 
  Glänzend Morgensonne -- liegen sanft Anhöhe -- heit Tempel -- 
  Stufe fahren Ringsum hinauf -- zwölf Säule tragen einfach rund Kuppel -- Wand wehren Licht -- Mitte stehen Altar -- Gebäude -- Inschrift -- Unbegreifliche -- Ewig -- Einzig -- breit Marmorrand schließen -- Vertiefung -- Opferflamm loderen -- 
  hing Kranz Altar Säule -- Mucius zünden Feuer -- sprechen -- -- weih Tempel Ewig -- Schöpfer Regierer Weltall -- Menschenbrust wohnen -- 
  weih Herz -- 
  erkennen -- menschlich Vernunft -- erheben -- -- Ewigkeit Unendlichkeit klar Begriff vermögen -- verschieden Vorstellung Mythen Volk menschlich Erkenntnis -- minder irren -- Wahrheit herrschen -- 
  Schöpfer Erhalter -- Geber gute -- Dankbarkeit Ergebung schuldig -- -- 
  knieen heilig Flamm -- still -- heiß Gebet erheben Herz Ewig -- 
  Fröhlich kehren einfach Frühmal -- 
  durchging nächster Umgebung -- wahr Paradies -- fast Zone Erdkreises verbinden scheinen -- 
  Jtalien Orangenbaum duft dicht deutsch Eiche -- Dattelpalm Asien südlich Koko verschmäh Nachbarschaft nordisch Tanne -- Libanon Zeder prangen heimisch Tulpenbäum -- Zipresse -- Lerchenbäume Pappel -- ahorn -- Buche -- Platane -- weiß Birk Sumach Tamarinde -- Kastanien-Nuß- Mandelbaum stest Einzel mischen -- malerisch Gruppe -- 
  Obstart bekannt Welt gedeihen hoch Grade Veredelung -- 
  Kirsche -- Aprikose -- Apfelsin -- Pfirsich -- Pflaume -- Birn -- Äpfel -- Pisang Banane groß Menge -- Stauden Rankengewächse -- voll Blüte Beeren -- laden Sinn Genuß -- 
  Myrt Rosengesträuch bilden Hecke umhegt -- Sorgfalt angelegt Pflanzunge -- Vanhuse köstlichst Anana Melone ziehen -- 
  Kaffebaum chinesisch Theestaude Mühsam hierher verpflanzen -- Hoffnung gedeihen -- 
  Mais stehen breit Blatt Manneshöhe -- wallend Korn neigen schwer Ähren Boden -- 
  Kartoffel Jam wetteifern Ergiebigkeit -- Baumwollenstaude -- Lein Hanf streiten Vorzug -- feiner Gemüse fehlen -- entzücken -- Oel Maulbeerbaum Provence -- köstlichst Rebenhügel wider finden -- 
  können -- Moses Mensch -- Leben Mühe Arbeit führen -- Bedürfnis überreich Natur Überfluß sorgen -- 
  Dattel -- Kokos -- Kartoffel -- Jam -- Kastanie -- Mangel leiden lassen -- saftigst Frucht wachsen Pflege -- Zuckerahorn Palm bieten -- süß Saft -- Schawanve führen schmackhaftesen Fisch Krebs -- Herde Geflügel suchen finden Nahrung -- Wald wimmeln Wild -- 
  wahr Glück Tätig wohnen -- wohltuendste Gefühl Gefühl erfüllen Beruf -- 
  -- klüglich Arbeit Erholung -- verschieden Zweig gemeinsam Haushaltung teilen -- 
  Mucius -- Walter Ellison Besorgung Ackerbaues übernehmen -- Pinelli -- Staufach Vanhuse warten Baumpflanzung -- Gartengewächse Rebenhügel -- Salvito Dupont führen Aufsicht Herde -- Frank Antonio sorgen Wildbret Fisch -- 
  Mutter Küchengeschäft nehmen lassen -- rasch Therese besorgen Milchkammer -- Zephyrin Philippine -- Hühnerhof -- Rosalva Fanny sammeln Frucht -- Bereitung Baumwolle -- Lein Hanfs stehen Marie Lucien Aufsicht -- 
  -- besonderer Neigung Fähigkeit -- angewiesen -- hüpfend singend leicht Arbeit vollbringen -- 
  Maschine -- Verbesserung Vermehrung -- Frank -- Walter Antonio vieles beraten -- meister Geschäft beschwerlich -- 
  verschieden Art Pflug Hack fast entbehrlich -- Zugstieren Überfluß -- 
  milchgewölb Felsengrotte sprudelnd Quelle ergießen -- 
  jetzig Hitze stellen Gefäß Milch Stunde flach Bach -- schnell Gerinn verhüten -- 
  tieferen Stelle leer Gefäß spülen -- zuvor heiß Wasser reinigen -- 
  Schritt -- bilden Bach Wasserfall -- Frank Treibung Rad benutzen -- Buttermaschine Bewegung setzen -- 
  Butter waschen -- Presse bringen -- kammähnlich Instrument -- Faser säubern -- 
  Mühe -- köstlichst Butter bereiten -- 
  Käse-Stelle -- Schöpfe Presse -- leicht Vorrichtung erfinden -- 
  gleichen Wohlgeschmack unser Milchwerk Käse -- Therese freuen -- Frühstück lauten Lobeserhebungen ausbrechen -- 
  Herde Neger ihrigen hüten -- Milchvieh Negerinne gemolken -- dicht Grotte -- 
  Staufach Walter versichern -- Schweizervieh fettest Alpen Milch liefern -- -- 
  Schafmilch vorzüglich -- Ziegenkäse unübertrefflich -- 
  bedürfen Vieh hindurch Wartung -- 
  John Aussage -- fallen Winter hindurch einzig Mal Schnee -- Regentage bilden Übergang Jahreszeit -- folgen Reif leicht Frost -- Spur Sonne weniger Stunde verschwinden lassen -- 
  Wintertemperatur dauern Woche -- worauf Baum neu treiben -- jung Gras alten hervor wachsen -- 
  Kleinigkeit Heu sammeln -- geschehen -- Tier -- gut Erhaltung Gesundheit -- Regentag Reif fallen -- Morgenfutter geben -- 
  Solltest sehen -- lieb Adel -- nett Geschäftigkeit kleiden -- 
  vergleich Mädchen Odyssee Laban Töchtern -- Brunnen schöpfen -- Lorbeer säuseln -- 
  Zephyrin vorzüglich reizend gefiedert Reich -- Futterkörbchen hinein treten -- Heer jubelnd umringen -- Täubche setzen Schulter -- Koset -- anmutigsen -- treten ansehen Königin kämpfend Hähn -- trennen -- 
  herzig -- munter Philippin erfreut Spiel reizend Gefährtin -- tändeln Kindesunschuld Stunde -- 
  sanft Marie stille Lucia Baumwolle -- wenden röstenden Lein Hanf -- bringen Klopf- -- Schwing- Hechelmaschinen -- freuen Geweb -- Anfsicht -- bleichen -- 
  Rosalva Fanny sammeln -- Morgenfrüh -- Gemüse Frucht Küche -- Abend Vorratsgrotte -- 
  Hausmütterche bereiten Mittagsmahl -- wobei beistehen -- Geschäft früh vollenden -- bedürfen -- 
  Mittag versammeln froh Gesellschaft -- dichtbelaubt Platane -- steinern Tisch -- 
  Gerät einfach -- Tischzeug fehlen -- Speise trefflich bereiten -- 
  Fein Gemüse -- saftig Fleisch -- herrlich Braten Geflügel Wild -- Fischspeisen Backwerk Art -- Nachtisch auserlesenst Frucht verwöhntest Schmecker genügen -- 
  Becher umher beleben Scherz -- 
  mitgebracht Vorrat füllen -- künftig perlt Wein -- Palmensekt -- Birk Ahornwasser -- -- Jet Milch Quell Kristall -- Stelle -- gesund -- 
  Nachmittagsstunde gehören Ruhe Erholung -- 
  Sonne tief sinken -- kühler Lüftchen wehen -- widmen paar Stunde nötig Arbeit -- 
  untergange hören Geschäft -- versammeln kalt Abendkost -- Milch -- Eier -- Butter -- Käse -- Honig Backwerk bestehen -- 
  Musik -- tanzen -- spielen -- Mond Stern spät Ruhe leuchten -- 
  fließen einförmig reich Freude -- 
  Einrichtung deutsche -- Neger -- unsrigen -- 
  Mucius erwerben Ausbildnng hoch Verdienst -- festgesetzen -- -- Form freundschaftlich Betrachtung -- zweckmäßigsen Lehre -- 
  sorgen Erziehung Jugend -- Bildungsanstalt gründen -- -- künftig unser Kind gemeinschaftlich -- Unterricht erhalten -- 
  Lehrstunde -- Mann Lieblingsfache unterrichten -- 
  alte nehmen Stunde Unterricht -- Frau -- 
  künftig Winter geschickt Weberinn besitzen -- 
  Material fallen fast Hand -- Schafschur Erwartung günstig -- Baumwolle Gattung -- Leiu fein stark -- Spinnmaschin liefern Gar -- 
  Witterung Sommermonde -- Seidenraupe Freie fortkommen -- Versuch genügend ausfallen -- Mühe -- Kokon sammeln -- Haspelmaschin bringen -- 
  Arbeit -- Hand Mal erfordern -- helfen deutsch Neger gemeinschaftlich -- Bereitwilligkeit -- Dienstleistung eher ablehnen -- erbitten -- 
  helfen -- Not tun -- Gut Natur teilen -- benutzen Vorteil Maschine Mühlenwerk -- -- -- 
  behandeln Bruder -- betrachten Mann fast Vater -- 
  Getreide-Ernte überreich -- 
  Dreschmaschinen Gange -- kornmühle klapperen -- aufgespeichert liegen golden Kolbe Mais -- Traube schwellen -- Äpfel röen -- versprechen köstlich Cider -- 
  Erntefest feiern -- herbstfest Wanderung Läng südlich Grenze unternehmen -- meister Mann kennen -- 
  Frau Mut -- begleiten -- Scheu Chikassah's Irokesen -- Grenznachbarn -- 
  Zephhrin Philippine -- erbon -- Gefahr bestehen -- Hühnerhof Korally Sorgfalt übergeben -- mutig Rosalva -- sanft Marie anschließen -- Liebe William -- letzter natürlich Furchtsamkeit siegen -- 
  Bark Schawanoe hinauf fahren -- schiffbar -- leichtest Art Lebensmittel führen Partie Tabak -- -- beiläufig -- vortrefflich geraten -- Geschenk wild -- benachbart Stamm begegnen -- 
  Leben Bewegung Ausflucht -- gebrat backen -- gelten Reise Welt -- zwölf Meile -- Einöder -- mancherlei Krümmung -- 
  Schifffahrt -- Wanderung glücklich vollenden -- 
  Ellison Führer -- Marie bleiben mutig Seite -- John Humphry begleiten -- 
  Weg anderthalb Meile fließen Schawanoe dicht Wald -- vielmehr entgegen -- Stelle faßen blühend Wiese Ufer -- 
  Abend landen -- bemerkt nah Gebüsch Wilde -- John entgegen geschickt -- Nacht brechen -- kehren -- 
  geraten lebhaft Unruhe -- schlafen abwechselnd -- erwartet Sehnsucht -- 
  Herrlich Sonne Wildnis -- vielartig Papagoyen durchhüpft Zweig sonnt Morgenstrahl bunt Gefieder -- unruhig Schönheit Schauspiel fast verlieren -- 
  mehrstündig harr -- Saum Gebüsche vergebens durchspähen -- jauchzen sehnlich erwartet Entfernung -- 
  -- Begleitung wilde -- sichtbar -- -- Meile entfernt Lager gestern Abend führen -- 
  wild gehören Stamm Chikassah's -- Oberhaupt befinden -- 
  John notdürftig unterreden -- obgleich Mundart Stamme abwich -- aufnehmen -- 
  Tatoirung erkennen -- Aufnahme erhalten -- behandelt Bruder -- 
  freundschaftlich begrüßen -- rauchen unser Mann Bundespfeif -- erfuhren -- Tagereis jenseits Fluß Salzquelle befinden -- Menge Salz gewinnen -- freilich Reinigung bedürfen -- vortrefflich -- 
  schenkten Beutel voll geben Tabak -- Backwerk -- bunt Töpfer-Gerät -- Tausch höchst zufrieden scheinen -- 
  erklären gut Nachbar -- -- Süden grenzen -- wahrscheinlich Spanier -- 
  -- klagen -- sein Pocke mitteilen -- jährlich brüder hinraffen -- Geschlecht Untergang drohen -- 
  Salvito lassen -- Gegenstand -- John Hilfe -- lang Gespräch -- 
  suchen Nutzen -- Kuhblattern-Impfung begreiflich -- lassen Narbe sehen -- fast arme tragen -- 
  Sache scheinen leucht -- Salvito Zureden -- entschließen jüngern -- Weiber -- Krankheit -- impfen lassen -- 
  Salvito tragen -- löblich Vorsicht -- Gläsche Lymphe nötig Impfgerät -- 
  Ehe Abschied nehmen -- Fluß hinauf fahren -- versprach -- Rückweg anlegen -- lassen Wort geben -- Alsdann einzufinden -- sowohl Kind Stamme -- erwachsene -- Krankheit -- bringen -- 
  Fahrt belustigen Fischfang Stunde -- schießen Jäger mehrere Wasservögel -- Mittag landen -- Mal bereiten -- schifft Kühle Abends -- 
  vermögen -- folgend -- seicht werdend Fluß Baracke tragen -- verlassen -- verteilt Lebensmittel wandern fröhlich Ufer -- 
  Eintritt Nacht -- machen Vergnügen -- Fackelschein Krebs fangen -- 
  malerisch schön wirkt Erleuchtung dunkel Waldgruppe -- Pinelly enthalten -- herrlich Nachtstück aufnehmen -- 
  nächster führen Haufen Irokese -- -- Rehjagd -- Grenzwald besuchen -- 
  ehemals Gegend gehören -- späterhin Ohio-Gesellschaft abkaufen -- Bevölkerung abnehmen -- 
  kennen Weg Wald Wechselplätze Wild -- Begleitung gehen beträchtlich Stück durchdringlich Wildnis hinein -- 
  Ur-Amerikaner -- Wilde nennen -- äußerst gutmütig Mensch -- Sitte beschäm Europäer -- 
  nördlich Kanada Not rauhern Natur gefühllos roh -- treffen Züg sanftest Menschlichkeit -- 
  Kultur freilich rückwärts gehen -- sagen Denkmäler Ohio deutlich beweisen -- 
  Schauderhafter Gedanke -- einst Europa Verfeinerung schwächst Spur -- verschwinden -- liegen ewig Wechsel Ding -- Möglichkeit sprechen -- 
  leben -- dreihunderen -- mächtig Volk -- Stadt Tempel erbaut befestigen -- Theater Kunst besitzen -- Lapidarschrift kennen üben -- 
  -- welcher Wechsel -- 
  Europäer Nachbarvölker verdrängen -- Schwert Hunger -- Pocken-Krankheit Genuß berauschend Getränk -- unbedeutend Häufche geschmolzen -- flüchten Überrest -- gescheucht Wild -- tief nahrungslosen einöder -- 
  Rührend Klage -- Gesang -- sagen Volk tönen -- 
  John Hilfe -- Sprache verstehen lernen -- 
  erinnern Ossian -- Reise -- ernst Wälder -- leben -- 
  daheim unser Wohnsitz spielen heit -- griechisch Kinderlebe -- Einöder herrschen Trauer untergegangen Welt -- 
  Vogel Nacht stöhnen tief -- durchdringend -- fremd Klagetöne -- fern Grabgeläute klingen -- Zephyrin Rückweg treiben -- 
  Salvito suchen gut Irokese Weise verständlich -- Pocken Krankheit belehren -- Heilkräfte einheimisch Kräuter -- warnen Genuß Branntwein -- Ernst -- scheinen überzeugen -- 
  führen gebrannt Wasser -- Wein -- wovon Kosten geben -- 
  finden Geschmack -- nehmen Geschenk Tabak vieler Freude -- 
  Salvito impfen -- weitläufig Anweisung -- -- bestimmt Zahl -- Impfstoff mitteilen -- Weise Lymphe erhalten -- Stamm Ansteckung wirklich Blatter sicheren können -- 
  trennen -- Freundschaftsbezeugung -- -- kehren Bark -- 
  Fahrt hinab schnell Bequemer -- 
  Chikassah's wartet Ankerplatz -- zahlreich Mal -- 
  Impfung gut Erfolg -- fortsetzen -- ferner Unterricht erteilen -- 
  Menge Salz mitbringen -- erhalten Lebensmittel -- entbehren -- 
  festgesetzen -- jährlich -- -- unser Mann hierher -- Salz Tabak Produkt eintauschen -- 
  Chikassah's machen Bedingung -- Salviro -- Halbgott halten -- -- Geboren impfen -- 
  trennen wahrhast nachbarlich Gesinnung -- 
  folgend Abend -- langn fröhlich unser Wohnung -- Freundin entgegen kommen -- 
  unendlich schön finden unser reizend Aufenthaltsort -- Rückkunft wilderen Gegende -- gleichwohl Preis sehen -- 
  Hausmütter geben festlich Schmaus -- begrüßt Mondenschein Gegenstand umh -- vorzüglich Lieb -- 
  schwärmt Palme -- Tempel umgeben -- Schatten -- beleuchtet weiß Säule -- Geistergestalt wiegen -- 
  freudig springen Stufe hinauf -- umfaßt Altar -- Wort -- gelten -- fühlen -- Unerforschliche gewiß heiß Gebet -- 
  Frucht eingesammeln -- Traube keltern -- Bienenkörbe verschnitten -- Herbsfest feiern -- Ewig danken reich Segen -- 
  John Humphry bereit -- Überfluß Erzeugnis -- Ohio hinauf -- Louisville führen -- 
  bringen weniger Bedürfnis -- Anfänger fehlen -- Überschuss Geld Handlungshause nieder legen -- 
  eins Grundgesetze Republik -- Umkreise Gebietes -- Geld umläufen -- 
  unselig Metall -- Vierteil Erdkreises verbinden Entzweit -- Einfluß erlangen -- 
  Ellison ehemalig Vermögen übrig bleiben -- stehen fortgeführt Handlung Vater Ellison treu Buchhalter übergeben -- bleiben -- Summe jährlich Louisville sammeln -- etwaig künftig Bedürfnis Kolonie -- unberührt -- 
  Gemeingut -- Zustimmung Mitglied -- verfügen -- 
  möchten Kind Enkel niemals Fall -- Gebrauch -- 
  Reise beraten einleiten -- schreiben -- hiesige wissen möchtesen -- 
  Humphry Briefpaket Louisville -- Umschlag Haus Ellison -- Philadelphia senden -- tun dein Brief gleich -- 
  Art jeder Mal -- -- Nachricht erhalten -- einzig -- europäisch Welt interessiert -- 
  Mann bekommen Weg Kenntnis Ereignissen Begebenheite Welttheater -- letztverflossenen -- lesenswert Fächern Wissenschaft -- -- scheidend -- ehrlich Handelsherr ausmachen -- 
  Stoff kurz Winterzeit -- Natur -- leicht Schlummer -- schön bleiben -- 
  Abend Herd -- Kamin versammeln -- Erzählung nächster ferner Vergangenheit Stunde kürzen -- 
  Winterzeit sparen einzig Tee Kaffee -- Mann Genuß gebrannt Wässer erlauben -- Staufach Vollkommenheit bereiten verstehen -- -- erwähnen -- Jahreszeit Bier brauen -- getrunken -- Frühlinge kehren Milch -- 
  beschließen -- nächster Frost -- Eis nah Gebirg holen -- tief Grotte Felsen Eiskeller legen -- -- Hitze -- Gefrorenem laben -- 
  14t Julius Jahres Geburtstag feiern -- Grundgesetze Kolonie Einwohner Dorf Tempel vorgelesen -- Behältnisse Altare nieder legen -- 
  auf verlesen -- -- merkwürdig -- besonderer beziehungsreich -- fern Zeit weihen -- 
  Gesetz -- vielmehr Grundsatz -- einfach -- Einrichtung -- -- 
  bestehen Anerkennung Gott -- menschlich Verstand klar dar stellen vermögen -- Dienst -- Erhebung Herzens -- Ergebung Wille -- vertrauen -- Dankbarkeit -- -- Streben menschlich handeln -- Götzendienst -- Symbol erhaben Idee entweihen -- 
  Prophet heilige -- achtungswert Mensch Andenken teuer bleiben -- 
  leben rein Idee -- minder klar -- Strebt -- Volke teilen -- verstehen -- rein Wahrheit bunt Zierat umhehen -- sogar Prophet -- zeigen -- Bild -- hoch halten -- Geist -- dar stellen vermögen -- göttlich Mensch -- Gott erheben -- 
  Tempel Ort -- feierlich Handlung Stadt finden -- 
  bringen Frühlingsfest schön Blume -- Erntefest -- vollst Ähren Art -- umhäng Säule Altar -- werfen -- Weihrauch vermischen -- leuchtend Flamm -- 
  Herbstfeste brennen Olive -- Kastanie Datteln Altar -- Traubensaft besprengen -- Neujahrsfest loderen hoch Flamm -- Zweig Art köstlichst Harze -- entzünden -- 
  Lobgesäng -- Preis Ewig -- Chör singen -- -- Altar kniend -- steigen vereint -- heiß Gebet Allgütig -- 
  Abschnitt Jahreszeit -- Stiftungsfest -- einzig verordnet öffentlich Fest -- 
  stehen Einzeln -- hierzu Beruf fühlen -- Ewig rufen beten -- 
  Abteilung Woche mosaisch Einrichtung beibehalten -- Arbeitstage folgen Ruhetag -- 
  sobald Sonnabende letzter Strahl Licht blau Gebirge verschwinden -- verläßn Tagewerk -- tragen Arbeitsgerät Säule Tempel -- 
  lehnen Pflüger Pflugschar Joch Stier -- Schnitter hängen Sichel -- Binderin Reche -- 
  Kniet setzen Stufe nieder -- danken Ewig -- Beistand -- still laut Gebet -- -- Gesellschaft befinden -- 
  Feiertag Unterhaltung Spiel hingebrachen -- Geschäft vornehmen -- Wartung Viehs -- Beschickung Herd ausnehmen -- wobei gemeinschaftlich helfen -- 
  Montage holen -- Frühe -- Gerät Obhut Tempels -- fangen Wochenwerk dankbaren Gedanke Gott Schutz Führung -- 
  Priestertum laut Quelle Überzeugung trüben -- 
  -- schüttelst mißtrauisch Kopf -- Adel -- 
  O -- wissen -- glauben -- Lehre Deismus können groß Gesellschaft Anwendung finden -- Wahn -- einst widerlegen -- 
  bestehen tatarisch Horde -- gering Grade Bildung -- Priestertum -- Pensilvanier keiner -- brav -- Welt Muster aufstellen können -- 
  entlehnen -- treffen -- finster Ernst finden Eingang -- 
  Griechenland kindlich Frohsinn spielen unser Tempel -- schön lichen Bild schweben Notwendigkeit -- ernst Schicksal Blicket mild Schleier sanft Menschlichkeit -- 
  Grundsatz Verfassung -- völlig Freiheit Gleichheit vereint Familie -- Oberhaupt herrschen -- einst -- besonder Zweck -- notwendig -- wählen -- erlischen Erreichung Zweck -- 
  Angelegenheit Stimmenmehrheit entscheiden -- 
  Verwaltung Geschäft Kolonie verteilen -- Überfluß gemeinschaftlich Zweck verwenden -- 
  Genuß gleich Anteil gleich -- 
  Gebrauch Gelde Umkreise Staat untersagen -- Eigentum -- Gemeingut -- 
  Mitglied -- vollendet zwanzigst Lebensjahr -- Grenze Republik verlassen -- Kolonie bestimmt Anzahl Einwohner wachsen -- übersteigen -- bilden alt Sohn -- Umfang Besitzung -- 
  -- Endzweck -- jährlich Anzahl urbar -- bestellen -- Ackerstück Ruhe legen -- 
  Töchter-Kolonie führen Ökonomie -- übrig -- gleich Grundsatz gleich Vorteil -- eng Muttergesellschaft verbinden -- etwanig Überschuss fließen Kasse -- 
  Mensch -- Grenze Republik -- Brüder betrachten -- 
  Lebensweise passen unsrigen -- -- ihrig entscheiden -- -- Streit entstehen -- 
  harmlos Friedlichkeit ehren -- Denkart Nachbaren edel -- 
  glaublich -- Mann jemals zwingen -- unser rechtmäßig erworben Boden -- Waffe Hand -- verteidigen -- 
  Geschähe -- Sieg gewiß -- Seite strengsen -- Mut Geschicklichkeit Mann fesseln wissen -- 
  Wahrheit Gerechtigkeit Hauptgrundsatz einfach Moral -- Ausübung -- Lebensweise -- unser Kind notwendig -- Atemhol -- 
  Wahrheit Gerechtigkeit -- einzig sicher Stütze häuslich gesellschaftlich Glück -- Schutz Freiheit vollkommen gedeihen -- 
  Sieh -- Adel -- denken -- leben -- 
  mitleidig lächeln -- Gedanke einfach Gewand Republikanerinn euren Modekleider vergleichen -- tauschen -- Klima fordern -- gering Aufwand Mühe kleiden -- 
  kunstreich Nadel Ruhet -- verzieren -- Hilfe -- zuweilen Saum Gewänder -- Hauptsache -- ändern -- Kunstfertigkeit untergehen lassen -- Mann bedenken -- Wissenschaft pflegen -- 
  mal vorsetzen -- Aufgabe lösen -- Kultur Sitteneinfalt eng verbinden -- Ziel erreichen -- künftig Jahrhundert entscheiden -- 
  fest richten Blick -- Wohlsein künftig Geschlecht -- säen mutig Samen Schoß -- Gott sehen gewiß wohlgefällig unser redlich Wille -- unser heilig Eifer herab -- 
  Reiseanstalte vollenden -- Blatt schließen -- 
  leben -- traut Adel -- 
  Himmel überschütt Glückseligkeit -- gehrend Europa -- -- zerfallenes -- Frankreich bieten -- 
  Gedenke -- -- 
  Sorge Geschick -- 
  Freundlich lächeln Zukunft entgegen -- Morgensonne freundlich begrüßen -- 
  Kentucky's Hainen säuseln ewig Friede Schawanoe herrschen süß Ruhe -- O -- leben hochherzig Vater -- leben Emil Palme -- Seufzer jemals Busen heben -- 
  wandeln himmlisch Palme -- harren freundlich -- 
  Mucius -- teuer Mucius Ersatz -- 
  grüßt tausend Mal -- herrlich Mensch -- 
  O schildern -- -- 
  hehr -- leiben -- 
  tragen Schicksal Welt Brust -- Gatte -- Freund -- Geist unser Gefährte -- Bescheidenst -- lieben -- 
  selten Mensch -- fühl Seligkeit -- Gedanke liegen -- 
  schnell siegeln -- Mucius Wort lesen -- stolz Feind -- schmerz -- Gegenstand meinigen -- 
  Leb -- Adel -- 
  tausend Mal Lebewohl -- 
  erhälst froh Botschaft Virginia -- 
  Eldorado -- Kentucky -- 
  Julius 1817 -- 
  grüßen -- Freundin Herzens -- 
  -- Busen ehemals Klage ergießen -- nimm Überström Entzücken gleich Teilnahme -- 
  Glückliche bedürfen Ohres Freundes -- Unglückliche -- lassen Schmerz unterdrücken -- Freude -- 
  vernimm Wiederholung -- Zeitraume Jahr beseligen -- 
  Leben fortlaufend Kette glücklichen -- zeichn wichtig Ereignis -- 
  denkwürdigst -- Republik jung Bürger gebären -- 
  -- Adel -- wieg lieblich Knabe Schoß -- Mucius Ebenbild -- Kind Kind -- 
  arme seinigen -- forscht Gesicht -- Ähnlichkeite -- ähneln -- einzig Veranlassung -- freundlich Streitigkeit -- 
  unser Knabe 18 Kind Lauf Maimonat gebären -- nämlich 4 Negern -- 6 deutsch Dorfe 8 -- Knabe Mädchen -- Hausmütterch -- erwart Monat Niederkunft -- 
  Leben Republik -- 
  verführen Vater Lärm jung Mitbürger -- Pinelli -- lachen -- Wiegenlied Mutter bilden ordentlich Konzert -- 
  Klima begünstigen -- Wohlgemut entbunden -- 
  -- Salvito -- Mutter -- Säugling arm -- Tempel -- 
  Altar Blume bedeckt -- Mutter legen Kind Blume nieder -- dankt Ewig kniend teuer Geschenk -- bitten Erhaltung zart Leben -- 
  Vater treten hinzu -- segnen Kind -- -- nennen -- Versammlung zeigend -- laut Name -- Mutter -- 
  unseren -- Andenken Großvater -- Leo nennen -- ähnlich -- 
  Ost Erziehung erwägen -- 
  -- Meinung -- einfach -- 
  Liebe -- Strafe Ermahnung -- hinreich -- spielend Kraft Kind -- sowohl lieblich -- geistig -- ausbilden -- Geschlecht -- zwölfen -- beschäftigen -- unterrichten -- Kleidung -- farbig Überwurf -- Wade reichend -- 
  klettern -- ringen -- fechten -- wettlauf -- tanz -- schwimmen -- Arbeit -- Kraft -- nehmen -- 
  Lese -- schreiben -- rechnen -- lernen -- gesellschaftlich Vergnügung -- Stunde Muße -- schattend Platane -- flammend Kamin -- Musik Zeichne behandeln -- 
  Naturbeschreibung Erzählung vortragen -- Spaziergäng -- leidenschaftlich Botaniker Staufach benutzen -- 
  Erdbeschreibung -- -- anschließen -- Geschichte spätesten lehren -- 
  Mucius Weltgeschichte ausarbeit Philadelphia drucken lassen -- 
  treu -- Gesichtspunkt aufgefassen -- Geschichte Volk Führer -- 
  Held Lorberkränze entziehen -- Eichenkranz Bürger -- friedlich Ölzweig -- hoch Bedeutung erhalten -- Hauch Freiheit Werk wehen -- angeben -- wodurch Menschengeschlecht Himmelstochter Flur scheuchen -- Paradies verlieren -- 
  zwölfen -- Mädchen Haushaltung künstlich Arbeit Nadel Webestuhl anführen -- Knabe lernen hoch Wissenschaft -- tot Sprache -- lebend -- täglich -- frühest Jugend Gelegenheit -- Französisch -- Italienisch -- Deutsch Englisch abwechselnd sprechen -- 
  französische allgemein Sprache -- Englisch Mahl Teetisch reden -- Liebe Ellison -- Lucia Fanny -- Italienisch lassen Rosalva -- Antonio Pinelli aussterben -- Knabe Frank's Vanhusen Menge liebkosend Wort stammeln lehren -- Spielgefährte -- halb Dutzend deutsch Kind -- reden deutsch -- 
  hoch Wissenschaft gelehrt Sprache -- lernen -- wozu Neigung treiben -- wozu entschieden Fähigkeit entdecken -- notwendig -- 
  Lehrer Mann Lieblingsfache -- 
  unterrichten spielend deutsch Knabe paar munter Negerbube -- künftig unsrig Erzog -- 
  lächerlich einst unser Jüngling Kastengeist erscheinen -- groß Erdkreises kämpfen -- 
  körperlich Erziehung Knabe zunehmend Sorgfältiger fortsetzen -- versäumen -- abzuhärten -- 
  Fähigkeit kriegerisch Volk erlangen -- wissen -- besonnenen Mut -- Ausdauer Verachtung Gefahr -- Bäre Wolfs-Jagde Gränz- Waldung lernen -- Spiel kriegerisch -- jemals Wort Krieg hören -- Regel Taktik Regel Spiel geläufig -- 
  Dämon jemals Wald dringen -- waffenfähig Volk finden -- Frieden -- Welt lieben -- jeder Unrecht abwehren wissen -- stark Mädchen Webestuhl verlassen -- Waffe -- Spielgerät Kindheit -- Freiheit Ehre verteidigen -- 
  -- Genius Menschheit still Täler schützen -- 
  Leben -- treiben -- -- vorigen schildern -- 
  nirgends Lücke bemerken -- hoffen -- alt Mütterche -- sagen -- -- 
  glücklich -- 
  Frühjahr machen Zuckerernt Ahornwäldern -- legen Hand -- Kind Ertrag reichlich -- -- verschwenderisch Verbrauch -- Bedarf sichern -- 
  schicken Hälfte Louisville -- Tabak Farbkräuter -- Erzeugung Staufach emsig beschäftigen -- schön Garn Geweb färben -- 
  Frank erwerben Maschinenwese unsterblich Verdienst -- Antonio Speicher rein antiken Stil erbauen -- vanhuser Gehilfe seltenst Frucht Blume ziehen -- herrlichst Gruppe Baum Berg -- Rand Savan pflanzen -- mancherlei Heilkräuter -- Salvito Anweisung -- anbauen -- 
  Schutzgott Nachbar -- versprochen Reise Schawanoe hinauf -- -- Rat -- gestiftet berechnen -- 
  chemisch Kenntnis überall Statten -- Kelter -- 
  Wein versprechen vorzüglich -- Palmensekt Birkewasser ziemlich haltbar -- 
  Feldbauer -- nebst weiß schwarz Gehilfe -- Überfluß erzeugen -- Maria Lucia bleich schön Gespinst Sonnenstrahl Schimmer Mond -- Seidenwürmer Wette gesponnen -- Arbeit Proben Louisville -- 
  Vieh Gedeihet herrlich -- 
  milchgewölb Überfluß -- ungeachtet Hälfte Mutterviehe Kälber säugen -- 
  Schoße Überflusses -- liebend lieben -- frei Frieden Welt -- ruhig Vergangenheit -- heit Zukunft blickend -- beneidenswerteren Lage -- 
  O -- gepreßt Welt zurufen -- flüchten Wildnisse Amerika -- 
  Missisippy -- Missouri -- Wäldern Louisiana wohnen Friede -- lächeln Glück -- 
  Gemüt bringen -- Kenntnis Tätigkeit -- finden Eden -- nirgends -- 
  erfahren -- Landsleute Weltteil wenden -- Joseph Napoleon Willens -- nahe Baltimore -- Stadt gründen -- 
  -- -- Trojaner fliehen brennend Mauer -- mehrere Gegende -- Aeneas rettet Heiligtümer prasselnd Flamme bergen Silvius dunkel -- nächtlichen Hain -- 
  Laß kühn Gedanke -- Mucius Freund Aeneas -- Gefährt -- Schicksal fällen Wiederholung -- 
  hierher -- Wald Kentucky retteen Götterbilder -- einst -- Troja's Götter -- -- frei hochherzig Volk verbinden -- 
  O -- Ewiger Stern -- hoffen -- 
  Josephs Stadt Rom -- Schauspielhaus Kirche bauen -- Kaffeehaus Tanzsal errichten -- kokettieren -- kabalieren -- scheinen -- schmeicheln -- repräsentieren -- ehemals -- 
  Lehre Geschlecht verlieren -- fern Gemeinschaft -- 
  Napoleon -- bewundernswern -- unser Freistaat unwillkommen -- Mal Taumelkelch Herrschaft berauschen -- taugen schwerlich jemals Mensch Platz harmlos Bürger -- 
  -- Feuergeist -- schaffen -- -- wild Partei zerspalten Volk vereinen halten -- Erde Alleinherrschaft bringen -- wahr Freistaat passen -- 
  einst Frieden Welt -- Vereinigung Volk -- Weg -- herbei führen -- 
  glauben -- Plan Schicksal Lauf Ding sehen -- plötzlich verwandeln Welttheater -- lassen bestimmt Inhalt nächster Akt sagen -- Knoten schürzen -- Entwicklung hinaus schieben -- 
  wünsche -- Wunsch -- bleiben -- Friede Freiheit Welt -- Wahrheit Gerechtigkeit herrschend -- physisch letzter Sterblich -- hart Sorge Not -- sichern -- 
  müssen Wunsch -- Hoffnung -- Stützpunkt geben -- hinab ziehen Untergang -- 
  finden -- verzeihen kühn Gedanke -- suchen -- Kolonie Kentucky -- 
  Kultur -- Sitteneinfalt Bund -- -- Verborgenheit -- Geschlecht ziehen -- einst Volk Vorbild Vereinigungspunkt dienen -- 
  mächtig Troja fallen vereint Kraft Grieche -- Aeneas retten Schutzgötter Reich -- jung Gefährt -- gründen Alba barg Heiligtümer dichtverwachsen Hain -- 
  schwach Häuflein wachsen -- Urenkel erbaut Siebenhügelstadt -- heilbringend -- ziehen Gott Ahn -- -- 
  Dienst unentweihen bestehen -- Rom glücklich -- 
  Wehe -- -- glücklich Rom Versank -- woran mahnen Erinnerung ewig Wechsel -- 
  Entwicklung Menschengeschlecht ewig Kreislauf -- Zustand niemals Dauer erhalten -- 
  Blatt Geschichte ewig vergebens schreiben -- 
  Verzweifel -- -- müssen -- unwandelbar Gesetz anerkennen -- -- denken -- 
  köstlich Frucht bedürfen reife -- 
  rauh Stürm streifen Blüte -- liegen hart Schal verbergen -- mitten Ungewitter -- Fröste Nacht -- sengenden Strahl Mittag überdauern -- mild Sonne Herbste -- Schal öffnen -- süß Kern dringen gezeitigen hervor -- 
  möge dauern -- Herbst -- 
  gestern freundlich Fest feiern -- Humphry Hochzeit sanft -- deutsch Mädchen -- 
  führen -- feierlich Aufzug -- Myrten Rosen gekränzen Brautpaar Tempel -- 
  wechseln Altar Ring -- sprechen laut Schwor ewig Treue -- Eltern Braut segneen -- betet Glück -- 
  froh Mal -- Plan -- vereint Kolonie -- Becher fleißig umh -- herzlich Trinkspruch ausbringen -- 
  Heil europäisch Bruder vergessen -- Gesundheit Becher leeren -- 
  Tanz -- Neger leidenschaftlich lieben -- dauern spät Nacht -- Neuvermählten -- trotz Mondlicht Frührothsschimmer -- Fackel -- Wohnung führen -- 
  gewähren -- schön Anblick -- Zug -- hell Fackelschein -- Tal wallen -- Licht Baumgruppen erhellt -- Schatten werfen -- 
  schön Vorwurf Pinell Kunst -- fleißig üben -- 
  Humphry Wohnung liegen deutsch Dorfe Viertelstund -- 
  sobald Vermählten Kammer betraen -- Fackel Schwelle Haus löschen -- rufen Hymen -- 
  Hymenäus -- Zug Haus -- 
  kindlich Nachahmung altgriechisch Sitte -- schmeicheln Phantasie schön Zeitalter hinüber -- menschlich Göttlichen verschwistern -- dünkelvoll Erdensohn losgeriss leitend Bande Mutter Natur -- -- Mucius -- Dupont Zephyrin -- ziehen griechisch Lebensform mächtig -- Sitte Ahn -- Abkömmlinge Messenier -- Marseille gründen -- Provenzal geheim Stolz rühmen -- Erinnerung namenlosen Reiz -- 
  Lieblingsunterhaltung -- alt griechisch Dichter Prosaiste lesen -- Mucius meisterhaft an Stegreif übersetzen -- kurz leicht Winter -- angenehm ausgefüllt -- 
  selten Ossian Reihe -- obschon meister übrig lieben -- Auslegung verstehen -- 
  stehen hoch Wert -- wenngleich Stimmung selten ziehen -- 
  Ossian Sänger Schwermut -- ring -- herrschen heit Lebensfreude -- 
  Lethe versenken -- Bild -- düstern Vergangenheit -- Sonne -- neu aufgehen -- 
  Europa schnitzeln künsteln Form -- werfen -- mutig Wurf -- Verwirrung herrschen berühren -- 
  arm Adel -- retten -- 
  -- 
  fürcht -- Opfer tyrannisch Willkür -- 
  Wärst Europa -- selten denken -- denken ungern dortig Getreibe -- 
  vernehmen -- beruhigend -- Streit abschließen -- -- -- Menschenalter überdauern -- 
  Furchtbar Krämpfe erschüttert kreißend Welt -- erfolgen unzeitig Geburt -- wirklich Götterkind liegen tief verbergen Schoße Mutter -- stark Wehe einst Tageslicht fördern -- 
  -- stehen Buch mächtig Schicksal -- 
  Wehe arm Geschlecht Geburtshelfer Kreißende stehen -- Heil -- Wieg Neugeborenen tanzen -- 
  Jung -- kräftig Leben entwickeln Zerstörung Tod -- Trostgedanke untergehend Geschlecht -- Blick Zukunft -- sinkend Mut erheben -- 
  -- vermögen Spanne Raum hinweg blicken -- Sohn Staube zerstäuben -- Geist -- Eins fühlen Unendlichen -- ewig -- Ewig -- sehen kleinlich Sorge Gegenwart berühren irdisch -- hinüber schwingen Palme ewig Friede -- 
  Liebling Schicksal säuseln hienied friedlich Palme -- säuseln delphisch Lorberhain -- 
  O -- Adel -- einführen erquickend Schatten -- dein Name tragen glatt Stamm weiß Birk Buche -- blühend Tulpenbaume -- Ohio -- Kentucky -- Schawanoe -- dein teuer Name rufen stündlich zahm Papagei -- lehren wild Brüdern -- Hain hüpft -- dein Name Leo stammeln sobald Vater rufen -- 
  O -- könntest freundlich Hain sehen -- Knabe segnen -- 
  Tue Ferne -- Adel -- segnen -- Mucius -- 
  Zephyrin Philippin grüßen -- erstern Landsmännin -- letzterer -- Verglich -- Ellison grüßt -- 
  Vorteil -- kennen -- stimmen Ost Wunsch -- möchtesen Unser -- seist wert -- -- wiedergefunden eden schmücken -- -- lebst -- trägst Brust -- 
  Laß Nimmer Raube -- nimmer besseer Gefühl ertöen pesthauch Selbstsucht kleinlich Eitelkeit -- 
  Wahlspruch Wahrheit Gerechtigkeit -- Kolonie Kentucky verbünden -- 
  Lebe Geräusch Welt -- 
  Vergiß Sorge arm Bewohner Chaumerive -- 
  mal empfehlen Herz gut Mutter -- 
  Laß Blume Grab meinigen ersterben -- 
  O -- Vater -- Emil begrünt Hügel ruhen -- 
  legen -- Sommer -- Kranz Erinnerung Mutter Grab -- Geist Mal freundlich begegnen -- 
  wachsen Heldenbildern Griechenwelt -- Kentucky schließen einst lächelnd Auge -- Lebensbilder Unschuldswelt umflattern -- 
  Leb -- 
  Leb -- Adelr -- 
  Frieden -- 
  fried Welt -- 
  Virginia -- 
  -- 