Virginia Kolonie Kentucky -- 
  Wahrheit Dichtung -- 
  Herausgegebe Jerta -- 
  -- 
  Kupfer Bollinger -- 
  Berlin -- August Rücker -- 1820 -- 
  Leser -- 
  malen Zauberbilde Kopf Welt -- 
  Jndusstrande Belt schmücken Blume Gefilde -- 
  Regung bringen Frühlingsmorg -- düstre Winternacht -- 
  Dichter -- scheinbar frei -- denken -- Müssen Umgebung borgen -- 
  Zürnt -- 
  Bild wählen Unglücksjahr wüstem Drang -- 
  Nebel Licht rang -- Wahrheit -- Irrtum vermählet -- 
  Zürnet -- erfund -- empfangen Außenwelt -- -- Schau -- Rahmen aufstellen -- Muße launevollen Stunde -- 
  Heldin wollet schelten -- ahnungsvoller gebar -- gespenstig Bild Gefahr gescheucht fern fremd Welt -- 
  irren -- finden Gespiel Zeit dunkl Labyrinth -- 
  Wahn -- Flamme Kind -- Menschheit Glorie spielen -- 
  fliehen Selbstsucht hart Bande -- Wahrheit fliehen Heuchelei -- Hochsinn -- zart Treue -- Rettend fern Friedensland -- 
  Sendet frisch Morgenwinde Mild Wunsch Busen dehnen -- -- suchen sehnen -- verloren Eden -- finden -- 
  Virginia -- Kolonie Kentucky -- 
  -- 
  Virginia Adel -- 
  Bord Washington -- 
  Hafen Marseille -- 20. August 1814 -- 
  erschrocken -- arm Adel -- Zimmer leer fandest -- 
  verstohl steigend Angst erkundigen -- fast fürchtend Spur finden -- verlieren -- 
  Glaube -- Vorstellung quälen -- 
  Vorhaben vertraut -- 
  süß -- Mal scheidend Brust legen -- oftmals stumm Träne barg -- 
  wagen -- Last Geheimnisse zart Seele wälzen -- 
  woher hättest Fassung nehmen -- Mutter gewöhnlich -- kindlich fröhlich Mädchen zeigen -- Unbefangenheit Späherblicke Deines Vater begegnen -- 
  -- Angst ersparen -- glauben vielmehr -- abkürzen -- 
  sorglos schliefest -- ahndetest -- hofftest -- zweifeltest -- trennen Berg Täler -- -- Brief erhältst -- liegen Weltmeer -- Gewalt Mensch -- Gewalt Gott Element -- 
  -- Allmächtig -- übergeben -- Willkür Mensch widerstreben Herz -- roh Hand gelitten -- 
  triumphierend Blick können Grab treiben -- 
  Triumphierend -- worüber -- 
  Verdienst -- 
  O -- 
  Schlechtigkeit -- Rank mitwirken -- überheben -- 
  Schlechtigkeit Gegner -- Selbstsucht -- zufällig Ereignis -- -- wissen -- 
  Gott -- 
  -- -- 
  Zulassung geschehen -- 
  zulassen -- wozu -- 
  liegen -- 
  Beantwortung meisten fertig -- ewige beratschlagen -- fühlen lebendig -- irren gemein Sterblich -- halb künftig Jahrhundert -- Ewigkeit begreifen -- 
  arme klar -- nimmermehr geschehen -- P -- -- O -- s Vorsälen Bourbonide glänzen möchten -- M -- -- R -- -- ehemalig Schloß schwelg Bauer quälen können -- 
  Gut Montorin Polignys Hand einfach Virginia zierlich Louis vermählen -- 
  Vergib -- teuer Adel -- Bruder -- Herz -- 
  -- Nimmer -- Nimmer -- 
  wohnt Seele fremd Bild -- -- nimmer -- Nimmer -- 
  Sohn Vaterlande -- Gefühl verstehen -- Schon -- verdammen -- 
  O armes verraten -- zerrissen -- verlassen Vaterland -- 
  Virginia verlassen -- blutendem Herzen verlassen -- 
  Mann -- bleiben kämpfen -- nützen -- wäre_es Blut -- 
  Weib -- unterjocht Weib -- qualvoll -- nutzlos Leben -- stehen Kampf Partei -- beobachten Miene -- mißhandeln unfreiwillig Tran -- beargwohnen jeder Wort -- meister duldend schweigen -- 
  -- Vaterland -- verlassen -- 
  schweigen -- 
  -- reden -- reden Sinn -- 
  -- 
  Bekehrungsgeschicht Inneren müssen erlügen -- verdammend anklag angeboren Gefühl -- abschwörend dartun ererbt Ansicht trefflich Vater -- 
  Unglücklich Weib -- 
  Mann kämpfen Meinung Bahn -- Weib Meinung -- -- 
  -- fröhlich Adel -- beneiden -- Gedanke eng Raum letzter Oper nächster Ball durchliefen -- strafen sogleich -- scheinen -- bess Selbstgefühl -- 
  begriffst -- Wange erblassen -- Auge weinen sahsen -- lieben herzlich -- kindlich unbekümmert Gemüt -- Erkenntnis -- zufällig Umstand verschieden bilden -- lieb Güte -- ungleich binden -- 
  O -- Adel -- sehen -- Mal über Meer herüber kommen warst -- Hand Mutter Zimmer tratest -- freundlich -- engelschön Kind -- alt -- 
  fliegen Herz entgegen -- jung lieblich Schwester -- dankt Vater -- rastlosen Eifer Rückkehr bewirken -- 
  O -- wäret nimmer scheiden -- 
  Hättest verstehen lernen zunehmend -- spät Ereignis sein unbekannt -- 
  reißen Lebenswoge -- zwölfte vollenden -- selten -- gefährlich Briefwechsel bedeutend vertrauen -- stets beobachtet Gespräch letzter Monden Wiedervereinigung -- 
  treiben unwiderstehlich Drang -- Innerst zeigen -- 
  Folge -- Einsamkeit Seereise voll Muße -- 
  -- Seereise -- 
  -- -- 
  Land Freiheit schiffen hinüber -- 
  Vater Jüngling kämpft Panier Freiheit -- hochherzig Oheim -- blutend -- sterben -- Vaterland -- 
  Amerika -- 
  Amerika -- 
  erheben frisch Ostwind -- eilen Bord -- 
  leben Adel -- 
  Brief an Land -- 
  -- letzter Mahl sehen mütterlich Boden -- gebar -- freundlich Rebenhügel -- froh Treibe Hafen Marseille -- 
  letzter Mahl schall munter Lied Fischer herüber -- 
  O -- schwer Heimat scheiden -- 
  schwer -- sterben -- 
  sterben Reise unbekannt Küste -- Wiederkehr -- 
  Leb -- Adel -- 
  Leb -- Frankreich -- 
  -- 
  Höhe Gibraltar -- 
  Sonne tauchen freundlich Flut herauf -- 
  beleuchten Blick letzter Mahl dämmernd Europa -- 
  Träne benetzen Wang -- unwillkürlich streck Arm heimisch Gestade -- -- schwinden Minute Minute -- 
  Wein -- -- Adel -- Wein -- 
  Weiblichkeit behaupten voll -- drängen männlich Mut Hintergrund -- -- 
  Augenblick Kajüte flüchten -- Einsamkeit weinen -- 
  Schmerz beruhigen Mensch -- erheben Kraft -- 
  mitleidig Tröster -- Verdeck versammeln -- tun weher -- 
  allgemein zusprech -- fein Ursache Rührung kennen -- ausgesprochen kennen -- 
  verwanden Ton treffen -- Mißklang Einklang auflösen -- 
  sogar freundlich Kapitän verweisen -- schön Stimme voll Rührung -- 
  -- Liebe -- schön Miß -- verlassen Land voll Unruhe Verwirrung -- Vaterland -- heilig Land Freiheit -- Tochter aufnehmen -- bangen Träne trockenen -- 
  Betrachte Bruder -- gebieten -- Bruder nennen -- -- 
  Mann -- Gefühl Gelassensein -- beklemmen -- 
  säl Tuilerie verwaist erscheinen -- 
  sehen -- Träne Schreiben trocknen -- Mut kehren -- 
  hinauf -- Aufenthalt verschlossen Raume nachteilig -- 
  Seekrank -- vermeiden -- 
  Krankheit wirken Geist -- Geist beherrschen Körper -- 
  meinig Aufheiter stark -- 
  Abschiedsblick Wiege Kindheit -- Gräber Lieb -- teilnehmend leben Gegenwart -- Vergangenheit mal wiederholen Adel -- 
  leben gleichen Jäger Träumen -- waldbekränzt Hügel ruhen -- 
  Entschlief mild Strahl Sonne -- Liebe -- Jagden Wonne -- erwachet Stürme Wut -- 
  Sohn Hügel -- fragen -- 
  verlöschn Ronkatlin hell Schein -- 
  Meer glühe end Stern verschlungen -- 
  Selmas Bardenharf verklungen -- Toskar Tochter klaget -- 
  -- Malwina wandeln Halle -- Staubumschleiert lehnen Schild Speer -- 
  empfangen geisterhaft Grausen -- Mensch Sohn drinnen hausen -- Held finden -- 
  kehren Luta sanft Mädchen -- Gespielin Jagd -- Wenden Tränenblick voll Trauer Torlutha moosbewachsen Mauer -- Eichen Flamm lachen -- 
  siehsen -- lieb Adel -- Ossian treu Begleiter -- 
  vergessen -- 
  Geschenk -- 
  Lieblingsdichter -- teuer -- lieb -- Schiffbruche retten -- 
  verstehen -- Klaggesängen schweigen Leid Busen -- 
  stehen Abends einsam Mast lehnen -- betrachten Gewölk -- untergegangen Sonne nachziehen -- 
  bedünken -- lagert Held vergangen Zeit rötlich Saum -- 
  teuer Gestalt -- begleiten Virginia Land -- einst ruh moosig Stein -- Hand Fremdling mitleidvoll Hügel legen -- 
  Grab reden -- traut Adel -- Blatt anfing -- Eintritt Leben -- -- -- 
  Vater -- schön -- herrlich Mann -- 
  erinnerst hoch männlich Wuchs -- stolz Stirn -- Adlernase -- sanft blau Auge -- freundlich Mund -- 
  weißen -- ernst fest -- wild freundlich gleich -- 
  jung Sohn Ritter Montorin -- Rechtsgelehrsamkeit bestimmen -- studiert Kollegium aix -- Freiheitskampf Amerika Herzen europäisch Jugend Bewegung setzen -- 
  alt Bruder -- Militär anstellen -- wissen bringen -- Regimente versetzen -- -- Lauf Kriege -- Verstärkung französisch Hilfstruppe eingeschiffen -- 
  Oheim -- Erbe -- Wunsch lebhaftesen wiedersetzen -- 
  jugendlich Enthusiasmus siegen -- 
  Einschiffung münscht alt jüngern Bruder sehen -- Umweg aix -- 
  ergriff Vater unwiderstehlich verlangen -- geliebt Bruder ehrenvoll Kampf begleiten -- 
  Plutarch Xenophon sechzehnjährigen Jüngling Manne reifen -- 
  raffen -- Aufsehen fortbringen lassen -- folgen heimlich Bruder -- Freiwilliger Feldzug -- 
  erreichen glücklich Hafen Marseille -- Flotte bereit liegen -- aufnehmen -- 
  leicht Herz verlassen Frankreich -- 
  Welle -- kehren -- Rücken Washington tanzen -- tragen fröhlich ersehnt Ziel -- 
  hochklopfend Busen landen Jünglinge -- beginnen Kampf stolz England -- 
  fochten -- wechselnd Glück -- umschweben meistens Sieg Fahne -- 
  Heldenherz riss schwierig Unternehmung voran -- 
  Gefahr -- fochten Bruder -- 
  Eutav wankt Bataillon -- alt Oberst kommandieren -- Augenblick -- 
  mörderisch Kartätschenfeuer Engländer trennt Glied -- entreißen Oheim weichend Fähnrich Panier -- 
  -- lieben Ehre -- -- rufen -- Folge -- 
  Freiheit Sieg -- 
  Freiheit Sieg -- -- 
  Wort stürmt rasch Lauf feindlich Batterie -- 
  -- Freiheit Sieg -- -- rufen Vater -- -- Freiheit -- Sieg Oberst -- -- tönt Glied -- 
  stürmen -- 
  Batterie nehmen -- tödlich verwunden erreichen edl Oheim Ziel Anstrengung -- 
  Schuß Brust halb Lauf treffen -- 
  halten linker Hand fest Wunde drücken -- fließend Blut Augenblick aufhalten -- pflanzt bebend flatternd Fahne feindlich Geschütz -- sinken sterbend nieder -- 
  -- Wunsch erfüllen -- schwach Stimme -- -- Sieg -- 
  Freiheit Menschenrecht dereinst glücklich Land erkämpfen helfen -- 
  Wein -- Bruder -- weinen -- Kamerad -- sterbe schön Tod -- -- 
  Wort haucht jugendlich Held arme Bruder Seele -- 
  einfach -- Hügel irdisch Rest errichten -- Pantheon Ort -- fallen -- heilig Ehrfurcht -- Spartanerin Passe Thermopylä -- wallen -- 
  kämpft zweideutig Kampf Land Besitztum -- fochen fremd Glück -- Menschheit -- Gott Busen -- 
  Genusses -- lassen glänzend daheim -- hoch Erwartung -- tragen Wüsst Beschwerde Mühseligkeite Krieg -- fremd gedrückt Volk kämpfen -- 
  vergegenwärtige -- fühlen -- Ahnenstolz -- entspringen -- 
  -- stolz -- edl adelig Mensch -- 
  ursprünglich Wort eins -- 
  Wehe -- Folge Zeichen Sache trennen müssen -- 
  Frieden kehrt Vater Frankreich -- 
  finden alt Herzog -- Oheim -- tief beugen -- Verlust Liebling -- -- nunmehrig Erbe -- Zeichen Wertschätzung empfangen -- Hofe vorstellen -- bewundern Schmeichelt überhäufen -- 
  Frau finden unbeschreiblich schön -- Mann Gebot Ehrfurcht -- jüngern -- begünstigt -- schließen Begeisternng -- 
  Oheim zweckmäßig Schritt -- erhalten nah Aussicht ansehnlich Hofbedienung -- 
  Vater lieben Hof -- gefällig -- zart Benehme -- Abdruck menschenfreundlich Herzen -- Abneigung ahnden -- 
  Oheim höchst unangenehm überraschen -- Vater Festigkeit erklären -- niemals Hof fesseln -- 
  bestehen Oheim -- Regiment kaufen -- 
  Vater unterdrückt Äußerung Gedanke unrechtmäßig Verfahren -- weigern gleichfalls -- scheinbar Grund -- Soldatenstand lieben -- 
  finden Abneigung höchst ungereimt jung Held -- frisch Lorbeer heimkehren -- 
  Vater erwidern -- anderer Freiheit Menschenrecht Kampf ziehen -- Parade glänzen -- -- Söldling -- völlig fremd Zweck dienen -- 
  verstehen fast -- 
  Neff wünschen -- Studie kehren -- geliebt Grieche Römer leben -- Oheim nennen Pedanterie Verkehrtheit -- wodurch hoch Welt glänzend Entwurf verdorben -- feiner Leben entfremden -- 
  Spannung steigen -- Vater Mühe -- kindlich Zuvorkommenheit -- Unzufriedenheit bekämpfen -- 
  erhalten Vater Einwilligung -- -- Provence besuchen -- Mutter erben -- Kindheit sehen -- 
  verlassen Frühlingstag geräuschvoll Paris -- Vogel Käfig -- 
  Freund finden -- Luft -- gemeinschaftlich umfangen halten -- Schwül -- frei Aufatmen erschweren -- 
  sog jung Brust voll frisch Lebenslust froh Mut -- 
  Chaumerive sehen -- nördlich Ufer Durance -- schön Schauplatz froh Jugend -- 
  gewiß Gedenkst blumig Tales -- -- Rebenhügel umkränzen -- Läng ufern ziehen -- 
  dunkel Fluß -- Wohnung strömen -- zahllos Fischerbarke bedeckt -- gewiß kühn Wallfahrt Gedächtnis -- Nachmittag -- grün Uferwall unternahmen -- Ausfluß Rhone sehen -- 
  langten -- beginnen Sonne sinken -- -- gefesseln Schauspiel -- Rückkehr denken -- Dunkelheit Ermüdung Tran auspreßen -- 
  hierher begeben Vater -- 
  freilich weiten reizend -- finden -- 
  lang zwölf Besitzer vernachlässigen -- Gebäude verfallen -- Garten verwildern -- Feld Weinberg augenblicklich Nutzen bestellen -- 
  Mangel Schmutz blicken einzeln Hütte hervor -- blaßgelb Gestalt -- Lump hüllen -- verrichtet träge nötig Fronarbeit -- 
  Natur üppig -- 
  wild Durance tanzen trotzig -- 
  dunkel Olive schattieren anmutig frisch Zitrone -- Thymian Lawendel duftet öd Trift -- 
  bedürfen fest Wille -- Einsicht Geschmack -- gering Aufopferung Paradie schaffen -- späterhin jeder Auge entzücken -- 
  Vater Augenblick Ankunft Entschluß fassen -- 
  entlassen reich geworden Pächter -- angemessen Vergütung -- verteilt groß Acker Bauer -- jährlich gering -- bestimmt Pacht -- heben Zeichen Dienstbarkeit -- 
  stellen erstaunt Mensch -- Freund Ratgeber dar -- gewinnen Herzen -- 
  greifen mutig Arbeit -- entworfen Verbesserung rücken Riesenschritt -- 
  Weinbau Hügel beschränken -- Sorgfältiger betreiben -- 
  Kelter gleichzeitig reifend Gewächs verwandt Eigenschaft pflanzen -- 
  Ölbaum sparsam Reb dulden -- bekränzen meist Rücken Höhen nördlich Seite -- 
  Ebenen Weizen besäet -- sorgfältig schattend Baum wuchernden Gesträuch reinigen -- 
  sumpfig Wiese Trift -- Läng Fluß -- zweckmäßig Gräben trocken legen -- Ausrottunge Acker fast unbekannt Kartoffelbau gewinnen -- 
  magerst Land Maulbeer-Pflanzung anlegen -- Pomeranze -- Zitron übrig Obstart Garten Sorgfalt ziehen -- 
  klug Sonderung mannigfaltigen -- geworfen Anbaues Grundfläch -- zehnfach Ertrag abgewonnen -- 
  Üppig wallen golden Weizen -- Maulbeerbaum Gesträuch ersticken -- frei Weinstock liefern köstlichst Wein -- 
  entwässert Trift nähren zahlreich kräftig Herde -- mager Kuh Pächter weideten -- 
  Landmann -- Vorschüsse Vater unterstützen -- -- Wohlstand kehrt reinlich Hütte -- Gesundheit Kraft sprechen regsam Gestalt -- liebenswürdig Fröhlichkeit -- gut Provenzale eigentümlich -- 
  O -- Vater treu Untertan lieben -- 
  aussprüch Orakel -- Feld Berg bearbeiten -- Bau unglaublich schnell ausführen -- Auszahlung entstehen Streit -- geben -- Arbeiter nehmen -- 
  hoch Zins tragen -- anfangs gemacht Aufopferung -- 
  Leutseligkeit Folge Wucher vergolen -- 
  rührend -- edl Mann Kreis Untertan erblicken -- 
  lieben Benennung -- nennen Freund -- 
  -- arm -- -- pflegen sagen -- bedürfen Hilfe -- Meinig -- abgehärtet -- Bedürfnis anerzogen -- Entbehrung gewahr -- -- 
  fein gebildet Mann -- geistreich Unterhaltung Höfling bewundern -- Kind Natur einfach -- 
  stimmt Begriff ihrigen herab -- lenken -- legen gesellig Hand Arbeit -- mischen Spiel -- erfreute herzlich fröhlich Scherze -- 
  traurig -- rührend -- Anlaß füllen augenblicklich blau Auge Träne -- sorgfältig verbergen suchen -- 
  helfen -- -- trösten -- Hilfe -- 
  treten Halbgott gedrückt -- vernachlässigt Mensch neu brechen freundlich Tal -- 
  Vater scheinen schöner Lebensmorg aufgehen -- 
  lieblichst Wechsel fliegen -- fliegen Sommer Herbst -- 
  Muse besucht winterlich Kamin -- Gesimse frisch Blume gebrach -- 
  ahmt Anakreon Lied schäumend Becher voll süßen -- feurig Most -- öfter heimisch Gesang alt Troubadours -- 
  Einsamkeit Dichtkunst Liebe vorbereiten -- finden entzückend Frühling -- 
  Paris vergebens Rückkunft warten -- Herzog vergebens schriftlich dringen -- -- glücklich fühlend Vater -- weichen wissen -- Gegenwart notwendig Vollendung begonnen Bau darstellen -- 
  schildern Pomphaft -- Herzog -- Ehrgeiz ergreifen -- unaufgefordert Summe überschicken -- Provence Languedoc Pracht Haus reden möchten -- 
  -- Vater ausführt -- stolz Ansicht entfernt -- 
  höchst geschmackvoll Schöpfung -- einfach -- Wohnung -- mäßiger Größe -- häuslich glücklich Familie berechnen -- Garten Schönheit Nützlichkeit paaren -- 
  erspart Summe kommen Statten -- ländlich Freund helfen -- Wirtschaftsystem Schwung geben -- 
  karnavals Pariser Freund bestimmen Gegenwart rechnen -- vielfältig Erfindung letzter Maskenbälle mitteilen -- woran teilnehmen -- 
  lehnen Einladung -- veranlaßt Einfall -- Fastnachtabend aix reisen -- dortig Maskerade beizuwohnen -- 
  innig vergnügen betreten Stadt -- Geist Nahrung erhalten -- Jugendgespiel leben -- 
  -- Klasse wetteifern -- reißen Rednerbühne Parlament feurig Beredsamkeit -- 
  -- nenn Vorname Victor --- Sohn Kaufmann -- Parlaments-Advokat -- feurig -- unternehmend Kopf -- Herz schlagen -- -- Aufopferung -- kämpfen -- Freude -- Leo sehen -- laden -- Nacht -- Haus Vater -- 
  zuvor Freund Orbitello treffen -- Maskengetümmel freuen -- 
  Lust Leben empfangen Vater entzückend Korso -- Boulevard Paris messen -- 
  Baum blühn -- Fontän springen -- Schritt umringen hüpfend Mädchen -- reichen duftend Strauß bat Zuckerwerk Schwalbe -- 
  fröhlich alt griechisch Lust -- füllen leeren unaufhörlich Tasche lieblich Geschöpf -- 
  gelangt mittlerer Fontan -- Entfernung Freund erkennen -- arm hing Mädchen Tracht Bäuerinn Arle -- fast griechisch Kleidung -- schön stehen -- 
  kurz Unterkleid Blasroter Seide -- Drolet Oberkleid dunkelgrün Samt -- dunkel Locke wand Tuch gleich Farbe Gold durchwirken -- 
  schuhschnall Armspang schönsn Edelsteine besetzen -- blendend weiß Hals hing blaßrot Koralle -- 
  erscheinen Nymphengestalt Mal entzückt Auge Vater -- 
  Mutter -- 
  verzeihst gewiß -- Veranlassung umständlich erzählen -- nötig -- 
  Moment entscheiden Leben zwei unendlich teuer Person -- -- 
  Vater Troubadour kleiden -- Victor stellen Schwester -- 
  Eindruck -- machen -- überraschend -- Morgenfrüh trennt -- Gefühl durchdrungen -- Leben Tod -- 
  Liebe -- Blütenzeit Leben -- Silberblick Stromes Welle nirgend mächtig -- schön provenzalisch Himmel -- vaterland Lied -- 
  vereinigen Feuer Zartheit gleich Maß -- einzig Angelegenheit Leben -- 
  Eltern fühlen -- Augenblick -- -- 
  Leo atmen Klara -- Klara denken -- 
  Victor erfreuen Bündnis zwei teuer Wesen -- siegend Beredsamkeit reißen Vater fort -- anfangs Standesunterschied bemerken -- 
  Zeitgeist entfalten Schwing -- finden Freund begeistert Herold -- 
  ideal Welt alten leben -- Abkömmling altgriechisch Kolonie geträumen -- 
  Leo Amerika Standesunterschied -- sanft Herz niemals zusagen -- unbedeutend ansehen lernen -- Victor stolz Selbstgefühl beleidigen -- 
  stehen Verlobung Liebenden Hindernis Weg -- Leo eilt Flügel Liebe Chaumerive -- nötig Anstalt Empfang jung Gattin treffen -- 
  schreiben Oheim kindlich Zärtlichkeit sohn Entzück glücklich Bräutigam -- bitten Segen -- 
  sehen -- schlimm Fall -- Unzufriedenheit -- Mißbilligung stolz Herzog entgegen -- halten Hindernis Glück -- Volljährigkeit erreichen -- Chaumerive unbestritten Eigentum -- 
  Herzog Erbschaft Namen Gut entziehen -- niemals Ziel Wunsch -- 
  befremden -- Kurier Antwort Herzog überbrachen -- ungemessenst Zorn Niederträchtige nennen -- Ehre Haus beschimpfe -- Befahl -- sogleich entehrend Verbindung geben -- Paris verfügen -- 
  Vater empört Befehl -- 
  fühlt Mann -- Knabe scholten -- 
  -- beschließen zeigen -- 
  reisen ungesäumt Aix -- beschleunigen Anstalten Vermählung -- 
  fühlen zart -- Clara Familie -- Mitteilung erhalten Schreiben -- trübe Stunde verursachen -- 
  Gedacht klar künftig Spannung bruch Oheim -- annehmen -- -- Entfernung Paris -- Paradiese berühren -- 
  sehen Oheim Sache -- geschehen -- -- denken -- -- hintertreiben hoffen -- überlassen glücklich Leo -- Sorge -- Seligkeit Stand -- 
  Vermählung -- führen geliebt Clara Heimat -- 
  Bewohner Chaumerive empfing schön Frau -- nennen -- Königin -- freundlich Clara besitzen Herzen -- unumschränken -- Leo -- 
  -- gelieben Freundin -- sehen -- edle Paar lieben -- 
  erhöht Glück -- entdeckt liebenswürdig Eigenschaft -- 
  schön -- selig -- endet -- Reinheit wiederkehren -- 
  mond -- glücklich Augenblick schwunden -- rauh Novembernacht stark Geräusch Vater arm Gattin aufschrecken -- 
  Fackel erleuchtet Hof -- sehen Schein verschlossen Wagen halten -- Augenblick treten Polizeibeamter -- 
  zeigen Lettre de Cachet -- bemächtigen Person -- 
  vergönnt überrascht Unglücklichen Lippe Mal Mund ohnmächtig Gattin drücken -- 
  reißen Räubereil hinunter -- 
  Wagen erwacht Leute sammeln -- 
  geliebt Herr letzter Blutstropf verteidigen -- donneren Name Königs -- Wagen verschließen -- rollen unaufhaltsam furchtbar Bastille -- 
  Vater -- arm betäubt Vater -- Augenblick Aussicht Rettung -- 
  männlich Seele -- verzweifelt -- 
  Mann wagen mißlichst Kampf Schicksal -- Hoffnung Siege letzter Lebensfunk -- 
  vermöcht Verzweiflung unglücklich Klara schildern -- tief Ohnmacht erwachen -- 
  spät geraten -- fürchterlich Nacht sprechen -- 
  umklammeren unwillkürlich Vater Krampfhafter Stärke -- fürcht -- auf verlieren -- Träne Kuß überströmt Gesicht -- 
  fehlt Unglücklichen sogar Wohltat Träne -- 
  Stumm -- Marmorbilde -- sitzen -- 
  Kammerfrau handeln Stadt -- sandte treu Boten Pferd aix -- 
  Victor schäumt Wut -- übersehen Blick Zusammenhäng -- fühlen Busen Kraft helfen -- Machthaber Schranke treten -- 
  versehen Geld Wechseln -- Kurierpferde -- fliegen angebetet Schwester -- 
  erscheinen -- rettend Engel -- 
  hoch Kraft richtet Trostlose mühsam -- 
  haucht Hoffnung -- begeben ungesäumt Paris -- 
  zurückgelegt Station belebn Mut unglücklich Frau -- geliebter nah -- Ringmauer Stadt leben -- scheinen Glück schrecklich Entfernung -- 
  Victor hoffen zuversichtlich -- 
  Notabl versammeln -- Deputiert Provinz befreunden -- kräftig Unterstützung rechnen -- 
  Angelegenheit scheinen Sache Menschheit -- Gerechtigkeit versagen -- 
  Stimmung Geschwisterpaar Paris -- 
  Klara verlangen Gasthofe -- Bastille nahe -- wohnen -- scheinen unbezweifelt gewiß -- Gemahl befinden -- 
  Victor finden freilich -- -- entfernt -- fest Schlos bringen -- widersprechen Trauernd -- gewährt schwach Trost -- 
  fing Nachforschung rastlosem Eifer -- 
  sprechen Freund -- Versaill -- Grafen Mirabeau -- alt Freund Haus -- suchen -- 
  überall finden herzlichster Teilnahme Wille helfen -- Sache -- wähnen -- 
  -- erfahren -- wohin gefangener bringen -- hierüber gelangt Gewißheit -- 
  Chaumerive Weg Paris nehmen -- Nachtbarschaft erfahren -- späterhin Straße verlassen -- verbürgen -- 
  Herzog -- Auskunft geben vermögen -- fast unzugänglich -- 
  weigert Victor sehen -- lassen jederzeit abweisen -- Versuch -- sprechen -- erneuern -- 
  glücklich Bemühung der -- Rang Zirkel führen -- 
  alt Hofmann stellen völlig unwissend -- 
  mißlungen Schritt bringen Mirabeau -- Victor geheim Audienz König erhalten -- 
  Monarch scheinen gerührt lebhaft Schilderung jung Mann -- meinen -- müssen Ansicht herzoglich Haus berücksichtigen -- Haupt ältesn treust Diener -- 
  -- zuletzt erhalten -- Befehl Gouverneur Bastille -- -- gefangener Namens Gewahrsam befinden -- -- gehörig Vorsicht -- Zusammenkunft Gattin Schwager gestatten -- 
  teuer Papier eilt Hoffnungsvoll finsteren Mauer -- 
  Klaren Herz schlagen laut ungestüm Freude -- 
  o Schrecken -- Gouverneur Name gänzlich unbekannt -- 
  schlagen Weigerung Register Monat November -- vergebens -- 
  Victor entdecken -- rasch Wendung -- jung Mann einbringen -- Name Wohnort treffen -- 
  Klara verlangen -- voll ahndend Gefühl -- unbekannte sehen -- Gouverneur schlagen Festigkeit -- 
  Befehl lauten bestimmt Person -- übrig Pflicht -- 
  Hart Natur -- Gewohnheit -- weigern minde Auskunft unbekannte geben -- 
  verlassen Ort Schrecken völlig unverrichtet Sache -- 
  Klara fest Überzeugung -- unbekannte Gemahl -- Victor zweifelhaft -- 
  Versuch -- Hindernis -- 
  König schwierig beizukommen -- 
  halten unmöglich -- fremd Name gefangen säße -- verweigert Erlaubnis -- fremd sehen -- Staatsgeheimniß gefährden können -- 
  ähnlich Befehl St. Vicenz -- Geschwister reisen -- obwohl Klara Erfolg hoffen -- 
  Nachforschung vergeblich -- 
  Winter -- groß Frühling vorüber -- 
  arm Mutter rücken Entbindung nah -- Versank tief Gram -- 
  einzig Erholung -- Platz Bastille nieder -- düstern Mauer blicken -- umschlossen -- 
  Bruder Spaziergange bereden -- 
  kennen -- nennen schön Trauernde -- betrachtet Teilnahme -- 
  Bruder treffen lebhaft beschäftigter bewegt Gemüt -- Spannung Notabl Hof steigen auf hoch -- Gehrung allgemein -- Einzeln -- 
  Victor -- Schicksal Freund Auge verlieren -- werfen Feuer öffentlich Angelegenheit -- 
  klar -- Umwälzung Ding unvermeidlich notwendig -- 
  Hoffnung Leo knüpfen allgemein -- rastloser arbeiten -- Organisation -- 
  Julius heran -- beschrieben -- Weltgeschichte ewig merkwürdig Monat -- 
  Mutter all treiben -- gewahr -- tief Kummer unempfänglich Außenwelt -- 
  hören -- bedauern -- Vorübergehende laut Opfer Tyrannei nennen -- 
  tief kehren 14t Julius Mittags gewöhnlich Spaziergange nieder -- dauern -- ehe Herbeiström zahllosen Volksmeng aufmerksam -- 
  umringen -- Weiber Mädchen umwinden dreifarbig Bänder -- sollst rächen -- -- rufen -- 
  Getümmel nehmen -- 
  Seite Geschrei -- -- Nieder Bastille -- nieder -- -- 
  Kano aufgepflanzen -- Turm Zeughause Garten eingestoßen -- Loch Mauer brechen -- 
  Mutter fangen begreifen -- vorgehen -- zittern Schreck Freude -- sinken Knie strecken Arm fürchterlich Gefängnis -- Sinn vergehen -- mitleidig Umstehenden Stande gewaltsam Andrang Menge Augenblick schützen -- 
  arbeiten Victor dichte Gedräng -- fassen ohnmächtig Schwester arme -- drängen Riesenkraft rückwärts -- tragen Wohnung -- 
  schlagen Auge -- Moment stellen heftig unbekannt Schmerz -- verkündigen beschleunigt Entbindung -- 
  Victor rufen Hilfe -- übergeben Sorgfalt Frau -- sprechen Mut selig Hoffnung -- eilen -- wohin Begeisterung Pflicht rufen -- 
  legen Stärke Rasenden Hand -- Breche -- 
  Wütend packen Invalide -- Eingang Gefängnis zeigen -- übrig Ereignis -- einzig Streben -- Tür höllisch Behälter öffnen -- 
  Werkzeug schnell finden -- hilfreich arm Menge -- 
  befreien ziemlich Anzahl unglücklich Schlachtopfer tyrannisch Willkür -- finden Leo -- 
  weichen stark befestigt Tür -- Vater stürzen freudeschwindelnd Victor Arm -- 
  Freiheit Wort -- beide Brust hervordrängen -- Klara -- 
  Leben -- rufen Vater -- 
  -- 
  schreien Oheim -- -- fest umschlung -- unaufhaltsam Bahn teilnehmend Menge -- 
  erreichen fast atemlos Klara Wohnung -- 
  Mutter liegen Blaß erschöpfen Bette -- ruht Brust -- 
  Minute Licht Welt erblicken -- 
  Vater stürzen kniend Bette nieder -- 
  sprachlos Freude hing Lippe geliebter -- überströmen Hand Träne Küsse -- 
  Arm -- drücken -- gewaltsam schluchzend -- Herz -- 
  plötzlich heben Höhe -- rufen laut Feierlich -- Virginia -- Virginia -- 
  teuer Pfand Freiheit -- 
  Rom Virginia sprengen Tod Rom Bande -- verbürgst Augenblick Geburt Freiheit dein Vaterland -- knüpfest tausend Bande -- 
  legen Bett -- segnend Stirn -- 
  Victor knien tief erschüttern -- legen ebenfalls Hand -- Schwor -- Haupt -- 
  -- Freiheit Vaterland -- 
  Freiheit Gleichheit -- -- sprechen hoch Ernste -- 
  -- Vaterland -- Freiheit Gleichheit -- -- sprechen Vater -- 
  schlagen Mann kräftig Hand -- umarmt -- 
  lächelnd selig Mutter erhaben Schauspiel herab -- 
  Sieh -- Adel -- gebären -- 
  jemals ertragen -- 14t Julius Schmähung belegen -- dein Fest jemals gut Herz feiern -- 
  -- Virginia -- erstgeboren Tochter Freiheit -- frei Land sterben -- 
  Zeitpunkt Eltern vereinigen glücklich -- 
  Begebenheite -- Thron erschütteren -- Glück gründen -- 
  dankbar Erinnerung -- jemals verlassen -- jemals vergessen -- Despotie frischesten Blüte Glücke abgestreifen -- 
  -- Vater teilen nunmehr Freude Häuslichkeit ernst Bemühung öffentlichen -- 
  erneuert früh Verbindung -- knüpfen -- 
  Einfluß Beratschlagung Entwürf segensreich Nutzen -- 
  Familie wenden zärtlichster Sorge -- 
  edl Herz böse Gutem vergelten -- überlegen Verstand flößt Verkehrtheit Mensch Mitleid Zorn -- 
  versuchen alt Herzog sehen -- hoffen Krisis nützlich -- 
  erbittert Mann wich Bemühung -- -- Sache Vaterlande heilig Boden verlassen -- 
  nächstdem Vater Weg Mutter -- 
  -- einzig Schwester -- -- lieben brüderlich Herzen -- 
  -- Amerika -- zart Kind -- befinden Kloster St. Cyr Erziehung -- 
  Zurückkunft mehrere Mahl besuchen -- aufblühend Schönheit sanft Wesen freuen -- 
  Sprachgitter bleiben Scheidewand liebend Geschwister -- -- Liebe mindern -- Vertraulichkeit hemmen -- 
  Vater Chaumerive -- erfahren -- Herzog Mutter Hof bringen -- Beifall ernen -- 
  Verheiratung hören -- Herzog P. vermählen -- 
  schreiben -- antworten zärtlich -- Schüchtern -- deutet Zorn Oheim -- Beschränkung -- worein nahe bevorstehend Verbindung versetzen drohen -- 
  Pries glücklich -- Mann Schicksal Maß bestimmen -- wünschen herzlich Glück -- warnen mädchenhaft Furchtsamkeit -- 
  geliebt Schwester fliegen Vater -- 
  empfangen lebhaftest Freude -- Herz beklemmen ängstlich Sorge -- 
  Gemahl Stunde zuvor ankündigen -- Prinzeu entschlossen sein -- Grenze -- Hoffnung -- groß Adel folgen -- Anmaßung Stand vernichtend begegnen können -- 
  befohlen -- reisefertig halten -- folgen -- 
  befinden Monat Schwangerschaft -- lieben Umgebung -- fürchten unbekannt rauh Norden -- 
  sinken weinend Arm bekümmert Bruder -- 
  Herzog Vater treten Zimmer -- 
  Begrüßung Schwäger kalt förmlich -- 
  Vater lenken sogleich Gespräch Interesse -- Deinig wich stolz Höflichkeit -- sprechen wegwerfend Anmaßung -- 
  beschwören -- Rücksicht kränkelnd Gattin nehmen -- finden Gehör -- 
  redlich Anerbietung sichernd Maßregel -- Betreff Güter -- schlimmsen Fall -- Mißtrauen -- fast Hohn -- weisen -- 
  Erfolg edl Wille Oheim -- Herzog -- verspottet Äußerung Besorgnis weisen -- angeboten Dienstleistung -- beleidigendst Ausdrücken -- -- 
  dennoch Vater Undankbaro Folge -- wider Wille -- groß Dienst leisten -- Gut -- Mitwirkung bewährtesten Freund -- Scheinkauf groß Teil retten -- Einkünfte -- persönlich Gefahr -- übersenden -- 
  geliebt Schwester -- Vergünstigung auswirken -- England -- wohin Paß verschaffen -- 
  Victor besorgen -- Handelsverhältnisse väterlich Haus -- schnell bequem Überfahrt -- Anweisung bedeutend Summe Londoner Haus -- 
  Mutter -- wider Wille grausam Eile -- Umstand fordern -- vaterland arme wiedergefunden Bruder gerissen -- -- 
  englisch Boden betreten -- Niederkunft heran nahen -- dein Bruder Louis gebar -- 
  Revolution rasch Gang -- 
  Vater Freund schwamm Seligkeit -- Traum früh Jünglingstage -- Wirklichkeit heraus treten sehen -- 
  Beschluß fassen -- Grundsatz aufstellen -- Bewunderung Welt erregn -- 
  Europa herrlich morgenröte aufglühen -- groß Bewohner jauchzen entgegen -- 
  arm Sterbliche -- 
  hätten Bedenken -- Erfahrung Landmann lehren -- hochflammend rote Osten -- schwülen Gewittertag deuten -- 
  Heer menschlich Leidenschaft mischt Spiel -- verfälschen rein Begeisterung -- Werk beginnen -- 
  Edlen Volksführer -- befinden Lage Sisyphus -- Stein rolln bergab -- Höhe wälzen glauben -- gewaltsam Sturz zerschmettern -- 
  Vater reden handeln mutig Überzeugung -- Schmerz begonneu Werk sanft edl Sinn beendigen -- 
  Seele Menschheit hoch Grad reife zutrauen -- finden -- 
  Mirabeau sterben -- Jakobiner organisiert -- Partei fangen bekämpfen -- 
  Hof Ausland treiben finsteres Spiel -- verwirrt geheim Fäd Gewebe künstlich -- meister unglaublich Begebniss -- Gewißheit sagen -- Seite wirksamsten Schlag kommen -- 
  sicher ungeachtet Vater Kampf scheuen -- Mutter zittert teuer Mal verloren Gatte -- 
  beschwören täglich -- unsicher Schauplatz verlassen -- führen glücklich Heimat -- 
  Länge -- Träne widerstehen -- ziehen Sorge verlassen Anlage Bauer Chaumerive -- Victor bleiben Paris -- 
  Feuergeist finden Rand Vulkan Element -- 
  Chaumerive legen Vater Auszeichnung Stand völlig -- 
  Wappe überall abnehmen -- Livree abschaffen -- 
  richten bequem -- einfach -- -- 
  Vater versammelter sämtlichen Bewohner -- nennen gut Freund Nachbar -- erklären Gleichen bitten -- gnädig Herr -- schlichtweg Bürger nennen -- 
  gut Leute erstaunt -- hoch Grad Leutseligkeit Gleichheitssinn Vater gewöhnen -- lieben stark -- 
  legen Rechenschaft Haushalt -- Abwesenheit -- 
  Äcker -- ihrigen -- bestellen -- Ertrag gewissenhaft bewahren -- 
  Vater bezeigen lebhaft Dankbarkeit -- gut Mensch glauben verpflichten -- 
  knüpft schön Bande gegenseitig Liebe Vertrauen fest -- trotzt nachfolgend Stürme -- 
  unruhvoll blutig folgend Frankreich -- friedlich Tal -- Wiege Kindheit -- -- Sinnesart gut Vater -- ruhig glücklich bleiben -- liegen Insel still Ozean -- 
  benachbart Adel nennen anfangs Tollhäusler -- wich -- späterhin halten Schlaukopf -- suchen Vermittlung -- 
  Erkannt -- halten Klugheit -- Vernunft Gefühl -- 
  schön Umgebung -- Hand Liebe -- Schritt -- Geist bewußt -- 
  Eltern machen Erziehung künstlich Anstalt -- überlassen Natur -- gut Beispiel -- 
  Liebe -- zärtlichste aufopferndst Liebe umgeben -- erzeugen tief -- reg Gefühl -- 
  Geist bedürfen kein Sporn -- entwickeln überaus frühzeitig -- schaffen Nahrung -- 
  lernen fast lesen -- Alter -- Kind Wort Zusammenhang aussprechen -- 
  Mutter schaffen Puppe anderer Spielgerät -- wissen anfangen -- werfen Seite -- traurig fragend -- Virginia -- -- 
  Mutter begreifen Eigenheit -- verlieren Geduld -- 
  Vater erhalten -- Zufall -- alt Werk -- kindisch Aufmerksamkeit ziehen -- 
  Weltgeschichte -- durchweg Kupfer bildlich darstellen -- Text veraltet -- kräftig Stil -- 
  besehen eifrig schön Kupfer -- verlangt Erklärung -- Mutter verstehen -- fertigen Auslegung -- Alter passend glauben -- genügen -- 
  wendet Vater -- erklären Bild einfach -- -- 
  hing Lippe -- nimmer lassen -- Vater müssen abwesend -- bleiben lieben Buch -- 
  lesen -- tröstet Vater -- Geschichte erklären -- 
  Blitzstrahl Seele werfen -- 
  üben unermüden -- kurz Las fertig lieb Geschichte -- 
  Beschäftigung finden -- fühlt Leere -- 
  freien herumsprang Eltern plauderen -- sitzen Buch -- 
  Las lesen -- Begriff reihen Begriff -- verstehen -- fühlen lesen -- 
  eigentlichst Sinn sagen -- Heroen Vorwelt herangewachsen -- 
  Vorbild -- dienen Maßstab Ereignis Gegenwart -- 
  frühest Erinnerung Szene lebhaft gegenmärtig bleiben -- Heroenbilder erregn -- 
  alt -- geliebt -- geliebt Emil -- -- Frankreich fremd Armee hart bedrängen -- 
  Victor Grenze eilen -- Vaterland verteidigen -- Vater auffordern -- Gleich -- 
  Brief ankommen -- Inhalt Vater wichtig Eindruck scheinen -- 
  unruhig -- teilen Befehl -- treffen mancherlei Anstalt -- scheinen Vorhaben beschäftigen -- 
  Haus ängstlich Bewegung -- bekümmern -- 
  flüchten -- ähnlich Fall -- Buch -- 
  zufällig Kupfer aufgeblätteren Leonidas Paß Termopylä verteidigen -- Vater Saal treten -- stehen bleiben -- 
  -- starb Vaterland -- -- Pause -- legen Hand Kopf -- -- dreihundern Held wehrn Persermacht Eintritt heilig Land Freiheit -- -- 
  umgewenden -- schaute -- 
  schwer Träne hing Auge -- 
  -- tun Pflicht -- -- -- fahren Hand Träne -- lächelen -- wiederholen -- -- tun müssen -- -- 
  Mutter herein -- Emil Arm -- 
  bleich -- weinen -- 
  schweigend ziehen Gatten Sofa -- setzen Kind Schoß -- -- 
  Umschlang -- weinen heftig -- rufen Ton Verzweiflung -- -- hülflosen Könntest verlassen -- -- -- 
  sinken Schulter -- 
  Vater umfaßt Zärtlichkeit -- reden -- sprechen Pflicht Notwendigkeit -- 
  Knabe lächelen unbefangen drein -- spielen Vater Locken -- 
  Gruppe -- Bild Hektor Abschied erinnern -- schlagen -- ernsthaft -- Hektor -- Vater -- 
  richten Mutter -- blicken -- 
  Virginia -- rufen -- umarm Knie dein Vater -- flehen -- verlassen -- 
  -- Frau -- -- antwortet kindisch Sinn -- zeigen Bild -- -- Frau weinen -- Vater Pflicht -- 
  halten -- Virginia halten -- -- 
  Römermädche -- rufen Vater -- reißen Arm -- 
  verzweiflungsvoll Blick Mutter fallen -- Augenblick sinken leblos Boden -- 
  stürzen Geschrei Träne -- 
  Vater heben Arm -- Bett bringen -- heftig Fieber kündigen bedenklichst Zeichen -- 
  Krankheit dauern -- Leben erhalten -- Vater feierlich Versprechen ablegen -- niemals verlassen -- 
  Vater müssen schwer -- Pflichtgefühl -- Kampf Liebe -- schweigen bringen -- 
  spät unfreiwillig Äußerung deuten -- 
  -- Mutter mindeste merken lassen -- 
  Gefühl Art Folge einzig vertraute -- 
  Herz Mutter scheinen -- Vorfall -- leis Abneigung fest setzen -- 
  entsinnen -- Woche Krankheit sorgfältig abhielt -- sehen -- weinen -- 
  Genesung anfangs gütig -- -- lenken Zärtlichkeit Bruder -- 
  bemerken -- Neid -- lieben holden Emil -- 
  -- freundlich herzig Knabe -- 
  heit -- voll Scherz Fröhlichkeit -- bied Treu -- 
  lieben -- 
  überdies Knabe -- scheinen jeder Vorzug wert -- hoch Wirksamkeit Tatkraft Mannes erscheinen -- 
  weinen zuweilen stille -- Mädchen -- eins unbedeutend Wesen -- Geschichte -- Tat Mann jeder Blatt füllen -- 
  Opfer nennen -- 
  Jphigenia -- Virginia -- Opfer Zweck -- 
  glauben -- leidend Geduld notwendig Eigenschaft Weibe -- leidenschaftlich Gemüt stehen Stimmung ewig Widerspruch -- stören Harmonie Charakter -- 
  Vater aufmerksam -- fing -- Ernst Bildung bekümmern -- 
  lernen früh englisch -- späterhin deutsch -- 
  lesen vorzüglichst Dichter Ausländer -- Sprache -- 
  Gemüt früh poetisch stimmen -- wozu provenzalisch Himmel viele beitragen -- 
  leicht Liebeslied Landsleute -- woran Geschmack finden -- stellen erhaben Seite dar -- 
  Ode Krieg -- -- geheim gehalten Arbeit -- erinneren -- freilich fehlerhaft -- Vorbild -- 
  meist ernst kehren -- worüber Mädchen -- Gespiel -- neckten -- 
  schwärmen umh -- Herz leiben -- Kind -- 
  Freude Blume pflücken Kranz winden -- sitzen Vater Abends unser Kastanienbäume -- blickt zahllos Sternenheer dunkelblau Himmel -- 
  unerschöpflich Frage -- Vater antworten -- 
  nennen Sternbild -- aufmerksam Unzählbarkeit Sonnensystem -- Unendlichkeit Raumes -- knüpft Begriff überschwänglich Größe Erhabenheit Schöpfer -- 
  überrascht Mitternacht Gespräch -- Mutter längst eingeschlafen -- 
  lieben Unterhaltung -- fortschreitend Ausbildung allzugern -- 
  Kindheit -- Sitt -- Kloster verleben -- 
  weiblich Arbeit -- lesen schreiben -- häufig Religionsübunge erlangend Kenntnis -- 
  ausgereicht -- Vater Glück Leben finden -- bilden -- -- -- überflüssig -- Übel -- 
  Vater lassen Erörterungen Punkt -- 
  lieben ganz Herzen -- verdienen hoch Grade -- 
  schön voll Grazie -- gut Herz Welt -- lieben -- unermüden -- Bedürfnis besorgt -- Mutter -- Hausfrau -- Wohltäterin Dürftigen -- 
  Herz Mann fordern -- 
  fühlen Herz Vater völlig befriedigen -- 
  philosophisch Geist empfinden Bedürfnis Wesen -- Idee eingehen -- Gegenstand unterhalten -- wichtig -- 
  versuchen -- ausbilden -- Erfolg -- 
  Drang bildsam Stoff -- -- schöpferisch Liebe legen Hand -- Menge Bedenklichkeit Rücksicht nehmen -- allenfalls abmahnen -- 
  Emil -- jüng -- treu Spielgefährter -- Herz Seele -- 
  Vater scheinen Zärtlichkeit gleichmäßig teilen -- belehrend Sorgfalt -- 
  -- stark Sprung behalten -- Knabe Sinnenwelt -- Ideenwelt Haus -- 
  Augenblick -- deßhalt glücklich Preis -- 
  -- Richtung Seele liegen -- geschehen -- ehe bewußt -- fast angeboren -- 
  treiben fleißig umliegend Gegend umher -- spielen verwegen Spiel -- -- romantisch Sinn ritterlich Vorzeit -- -- wild Knabenart -- 
  schaukelt Fischernache wild Durance -- arbeiten Stang Läng Uferkrümmung -- Emil -- Kraft messen -- Gewalt Stromes -- Entennest suchen -- Schilfe -- -- Gedanke Kolumbus begleiten -- Welt entdecken -- unbekannt Bucht landen -- 
  Vater kauft Länderei Benagbarten Klosters -- längst aufheben -- feil bieten -- 
  Großvater Aix sterben -- Vermögen Mutter vorteilhaft nutzen -- 
  fühlen anfangs Gewissensskrupel -- wissen Weltgeistliche unser Kirchsprengel -- konstitutionell Priester -- rechtschaffen -- aufgeklärt Mann -- beruhigen heben -- 
  überdies bilden Mutter Sinn Erwerbe Besitz -- 
  äußerst emsig Wirtin -- gering Kleinigkeit -- 
  Vater lassen gewähren -- Glück ruhen -- 
  -- persönlich gewinnen -- allgemein Wohlstand -- Anlage -- verbreiten -- 
  hoch Zweck rastlos tätig -- vergrößert Wirkungskreis lassen Unterricht übrig -- -- wiewohl ungern -- entschließen -- lieben Emil trennen -- 
  bringen aix alt Schulfreunde -- Professor Lyzeum -- 
  Mutter Trennung übel zufrieden -- beruhigen -- Liebling Hände rechtschaffensen -- edelst Mann befinden -- Familie einheimisch -- unser Haus fühlen -- 
  kosten Abschied unzählig Träne -- richten Gedanke -- Bruder -- beneiden -- 
  Griechisch Lateinisch lernen -- einst Werk alt Ursprach lesen -- hoch Wunsch -- 
  Emil Aussicht reizend -- 
  Wortgedächtnis -- Erlern fremd Sprache schwer -- rechnet Leichtigkeit -- Fortschritt Mathematik -- 
  geliebt Bruder scheinen Genius Freude unser Haus gewichen -- 
  Wein Mutter vergrub -- schmerze entfliehen -- tief Geschäft -- 
  fing mißfällig bemerken -- -- gleich -- Sinn häuslich treiben fehlen -- 
  Verweis antreiben -- mangelen Geduld -- -- rasch Tätigkeit -- behindern -- allmählich Gewöhnung tüchtig -- 
  fehlt gut Wille -- wissen stellen -- hart Vorwurf -- Unbeholfenheit -- scheucht lang Geschäft -- 
  flüchten einsam Winkel -- Buch -- 
  Schalt heftig Lesen -- verbieten -- Vater Schutz -- unwillig Äußerung ruhig Freundlichkeit entgegen setzen -- 
  -- Klärch -- lieb Klärch -- -- pflegen sagen -- -- Wolltest -- Baum Deines Garten einerlei Art sein -- 
  Apfelbaum nützlich -- Granate Blüte -- Zierde Garten -- 
  Laß Virginie gewähren -- gewaltsam Eigentümlichkeit eingreifen -- zerstörst innerer Harmonie -- -- 
  versuchen -- Seit -- Tätigkeit setzen -- besserem Erfolg -- 
  Maulbeerpflanzung anlegen -- richten Klostergebäude Seidenbau -- 
  Kind Landleute Besitzung -- aufgebot Wartung Pflege Seidenraupen -- 
  Arbeit -- Kleinsten Blatt sammeln Würmer vorlegen -- 
  kraftlos greis Mütterche -- Feldbau schwer -- helfen -- 
  ansehnlich Ertrag -- gleichmäßig verteilen -- erhöhen Wohlstand Gegend -- 
  führen -- Anleitung Vater -- Oberaufsicht -- Zufriedenheit -- 
  Morgensonne -- aufmerksam Gang Geschäft -- behende geschickt Handgriffen -- 
  Abhaspel Seide fertigsen sorgsam Arbeiterin -- 
  gleich Erfolg stellen Weinlese -- sorgen -- Beeren -- behutsam -- Traube kämmen -- unser Wein -- Vorzug -- Weinen Provinz -- 
  Geschäft -- Tage- Wochenlang dauern -- Gemeinschaft betreiben -- unermüden tätig -- hoch Grade vergnügen fröhlich -- 
  singen Romanz Rundgesang -- erzählt märch Novelle -- bringen -- Jung Alt lieben herzlich -- 
  treten -- alltäglich Gang häuslich Leben -- fühlt Tätigkeit plötzlich lähmen -- 
  -- wiederkommend Sorge Haushalt vermochn -- Seele füllen -- Geist kehren heißhungrig Ideenwelt -- 
  Geschichte Zeit -- beschäftigen -- Begebenheite lebhaftesen Anteil -- 
  frühest Kindheit -- gewöhnen -- Muster alte beurteilen -- müssen Ansicht verschied Ansicht der -- Standpunkt Ding sehen -- 
  Vater scheinen Fall -- 
  gutmütig Ludwig Haupt Guillotine fallen -- tief betrüben -- 
  -- traurig -- -- -- -- müssen -- 
  O edeln König anfangs losmach anerzogen Begriff -- Aufrichtigkeit Sache Volk anschließen -- viele -- 
  fast Lage unmöglich -- Einfluß Umgebung mächtig -- ränk Ausgewandert -- verbündeter eingreifend -- fast enden -- 
  fallen Opfer Freiheit -- rein schuldlos Opfer -- 
  möge unterirdisch Gott versöhnen -- 
  nachwelt nennen heiligen -- 
  Schreckenszeit erfüllen Vater Grausen -- 
  hoch Erbitterung verbündet Mächt -- fast unvermeidlich herbei führen -- 
  Integrität jung Republik scheinen fast retten -- -- müssen -- Aufopferung Teil -- gegenwärtig Generation -- 
  Umstand treffen schrecklich -- Menschlichkeit müssen Vaterlandsliebe weichen -- 
  Erhaltung einzeln Erhaltung Nation Streit -- fast niemals Blut schlichten -- 
  Vater sanft -- menschlich Herz leiden schmerzlich -- danken Himmel Entschluß -- früh ländlich Stille flüchten -- tadelt hart Natur -- versuchen -- mast- steuerlos Schiff Vaterlande schäumend Brandung führen -- 
  gedacht Brutus -- Sohn hinrichten lassen -- Verbindung verbannt Tarquinius schuldig -- Dolch Busen Freundes -- Vater -- stoßen -- Republik vernichten streben -- 
  Schicksal Girondist erregt Teilnahme hoch Grade -- 
  meist Freund -- edel Mann -- voll redlich Eifer gute Vaterland -- voll Einsicht -- fehlt Festigkeit Gegner -- müssen unterliegen -- Zeitpunkt -- Frankreich Kraftfülle vorzüglich bedürfen -- 
  vaterland -- klug zurückziehen Friedensschluß erhalten -- beglücken -- 
  ergriff Schicksal Bürgerin Roland -- 
  späteren weinen -- ewig unvergeßlichen -- Römerin würdigen Brief lesen -- Gefängnis schreiben -- 
  Charlotte Corday gefeiert Heldin -- übertreffen Weib Karakterstärk -- 
  Robespiere stürzen -- atmen Frankreich frei -- 
  -- Menschheit Tod freuen -- -- Vater -- -- fluchen -- Tyrann -- glauben -- -- 
  Heuchler -- tugendhaft Schwärmer -- Tugend hart rauh -- -- 
  -- Katastrophe 9ten Thermidor -- Element weiten beruhigen -- fürchterlichsen ausbrüch Vulkan nachlassen -- -- vertraut -- achtet nachfolgend -- schwächeren Erschütterung -- 
  jeder Auge fast wendet Kriegesschauplatze -- Ruhm französisch Fahne schweben -- 
  alt kriegerisch Geist Volk erwachen neu Stärke -- Gallien Ritterzeit kehren -- 
  unser friedlich Tale meister Teil Krieg reden -- 
  Knabe werfen Ball Kreisel Seite -- spielen Kriegesspiel -- Mädchen singen Marseiller Hymnus -- 
  Vater lesen öfter -- -- Zeitung Gesellschaft Freund -- unser trefflich Pfarrer -- begeistert Gespräch dauern spät Nacht hinein -- müde -- zuzuhören -- 
  fleißig Zeitungsleserin -- stehen Sonne -- Postbot nächster Flecken entgegen -- Blatt schnell durchlaufen -- Vater Erwach froh Siegesnachricht zurufen -- 
  früh Begebenheite Übergang Pochette stärksn Eindruck -- 
  Hannibal -- Verwunderung Römer -- unwegsam Straße betreten -- Heerführer wagen -- 
  Buonapart zweit kühn sterblich -- Bahn brechen -- 
  einzig -- angestaunt Unternehmen -- stellen Schlag jugendlich Held Riesengröße Phantasie -- 
  Heroen Vorwelt -- Tat jung Herz pochen -- treten -- einzig Bild verschmelzen -- Leben -- Wirklichkeit heraus -- 
  Einbildungskraft schmückt herrlich Bild Reize männlich Schönheit -- stellen Idol Altar Herzens -- 
  lachen -- Adel -- bedenk Provence gebären -- Heißer empfinden -- kalt England -- bedenk Gesänge Troubadours Wiegenlieder -- Ideenwelt -- Heroenbilder aufwuchs -- 
  Vergötterung Held schallen Mund entgegen -- Vater Pfarrer Bewunderung durchdrungen -- steigert Neigung Schwärmerei -- 
  wissen -- Adel -- leicht Sinnesart -- spottest abenteuerlich Liebe -- erröten -- 
  ergötz Augenblick verblichen Farbe Gefühl Wirklichkeit jetzig Leben Traum Kindheit geben -- 
  schämen -- kindisch Opfer erzählen -- Grund -- Neigung -- tief verhehlen -- 
  Held Ägypten -- erbeben -- -- Flott schlagen -- Rückweg abschneiden scheinen -- 
  schlich Aben entlegen Waldkapelle -- kniet Altar heilig Jungfrau nieder -- 
  dämmeren schaurig -- efeuumranken -- buntgemalt Fensterscheibe -- lassen spärlich -- Licht untergehend Sonne -- 
  mitten Gebet schneiden lang -- schön Lokk -- legen Altar -- sprechen laut Gelübde -- Haar eher wachsen lassen -- eher Blume schmücken -- zurückkehren -- Schutz Gebenedeit heilige empfehlen -- 
  aufrichteen -- brechen Strahl scheidend Sonne Fenster -- rötet Angesicht Jungfrau -- lächeln scheinen -- 
  Voll freudig Hoffnung Haus -- erstaunen empfingen -- 
  hocherrötend gestehen -- Haar Altar Jungfrau opfern -- stockend Grund -- Mal lesen -- griechisch Mädchen -- Austritt Kindheit Locke Grazie opfern pflegen -- 
  Mutter schelten heftig zufrieden geben -- 
  Vater scheinen Sinn Opfer ahnden -- 
  legen lächeln Hand Scheitel -- 
  -- Schwärmerin -- -- -- dachtest Weiber -- Haar Bogensehn hergaben -- Opfer Vaterland -- -- 
  Erglühend küssen Hand -- 
  -- Beruhiger -- -- fahren fort -- -- Gelübde Unschuld gewiß Gottheit angenehm -- -- 
  Reihefolge Neigung bleiben -- erzählen -- begeben -- 
  zwölft antreten -- Emil Woche scheiden -- -- -- aix Erzog -- 
  vuonapart Ägypten zurückkehren -- Factione zerrissen Vaterland retten -- Flamm gräulich Bürgerkrieg löschen -- kräftig Hand steuerrud Staat fassen -- 
  gründet Partei Hoffnung -- 
  Gemäßigt hoffen fest Ordnung Gesetzlichkeit -- täuschen -- Republikaner Freiheit -- lassen Form Wesen -- Größe Reich -- Grad moralisch Bildung vertragen -- Ausgewandert Wiederherstellung alt -- Bourbon -- müssen betragen -- Aristokrat -- Ehrgeizig Glanz -- durchsetzen -- -- 
  Konsul Frankreich vergöttern -- 
  kühnen Held Simplon -- unwegsam Pfad -- treu -- begeistert Heer -- tragen Geschütz Schulter hinüber -- 
  Sieg Marengo erfochten -- Volk Jtalien frei -- 
  jeder Gemüt klassisch Boden angezogen fühlen -- leidenschaftlich bewegen -- hoffen Nachkomme Grieche Römer lang Schlaf erwachen -- 
  früh Weinlese beginnen -- Sieger Marengo -- Zug kehren -- 
  -- Laune -- Landstrich nah kennen lernen -- Straße verlassen -- gedacht Avignon Rhone Languedoc Paris -- 
  Zufall führen Chaumerive -- 
  Vater beeilen Konsul Glückwunsch bringen -- 
  -- Jüngling -- Monden Revolution kennen lernen -- Gelegenheit -- Dienst erweisen -- 
  Buonaparte erinnern sogleich -- Vater erblicken -- zeigen äußerst verbindlich liebenswürdig -- 
  unterrichtet Lage näh Verhältnis -- Pries glücklich unbekannt -- ruhig Leben -- 
  -- -- -- 
  -- setzen tiefer Atemzug hinzu -- -- -- Jxions Rad binden -- -- 
  Weinberg -- 
  schönsn Traube Pfirsich -- Mutter lieben -- Körbch sammeln -- mitbringen -- 
  vorbeigehen Lorbergebüsch -- schönsen Zweig pflücken -- spielend voll Kranz wunden -- Frucht legen -- 
  -- Virginia -- -- -- rufen Vater entgegen -- -- Lieblingswunsch erhören -- 
  siehst groß Held Jahrhundert -- -- 
  Blitz rühren bleiben stehen -- 
  -- -- Gedanke einsamen Stunde -- Traum Nacht -- 
  ähnlich Bild -- unähnlich -- 
  Gemälde David sehen -- gleichen -- freundlich Mund -- lächeln bezaubernd -- 
  liebenswürdig Phantasie malen -- größ Verhältnis -- 
  geben vermocht -- Hoheit Auges -- Herrscherblick -- -- tief klein stellen -- Auge erheben wagen -- 
  -- geboren Republikanerin -- stolz Freiheit -- Gleichheit Menschenwert -- knien nieder -- wissen -- legen Körbchen Kranze Fuß -- 
  heben Verlegenheit -- küßen Stirn -- Korb -- danken abgerissen Wort fein Überraschung -- 
  -- Virginia stellen Augenblick dankbar Vaterland dar -- Vater -- -- 
  vaterlande groß Dankbarkeit schuldig -- erwidern Held -- freundlich Neigung -- Wort Doppelsinn -- 
  Himmel -- setzen hinzu -- Traube -- Lorbeer -- süß Früchte begleiten möchten -- reist -- Gabe eigenhändig Wagen tragen -- mehrere Mahl -- Hand Blick grüßen -- 
  bleiben verändert Stimmung -- 
  Phantasie schweigen -- fühlt Ergebenheit durchdrungen -- frei Erziehung -- Vater empfinden -- 
  Szene zufrieden -- 
  -- Überreichung Lorbeere Frucht hübsch -- -- -- stehend dargebracht -- -- 
  -- erwidern -- hoch werfen nieder -- Beherrscher Erdkreises -- 
  Nachklang Gefühl immerfort Seele leise tönen -- Vorfall Kreis längst vergessen -- Gedachte -- 
  vorherrschend Eigenschaft Gemüt -- Mal empfangen Eindruck fast starr Treue bewahren -- 
  wechseln Neigung Abneigung -- -- Neigung frei Selbstsucht entstehen -- 
  Welt lieben hassen eigen Vorteil -- vergöttern -- frommen scheinen -- verdammen -- schädlich drohen -- scheinen Mal Idee handeln -- gewiß liegen Idee -- Wohllebe -- Glanz Putz -- Grundursachen tief verstecken -- 
  Ruhe -- Wohlstand Ordnung Frankreich herstellen sichern -- 
  Volk fühlen ehren glücklich -- wünschen Schutzgott Glück erhalten -- Wünschen Napoleon entgegen -- Kaisertitel annehmen -- Glanze Thrones umgeben -- wodurch sichereren -- Ehrfurcht gebietend Standpunkt Ausland Ränk geben glauben -- 
  gewiß rastlos Einwirkung groß Anteil Katastrophe -- 
  Ausgewandert verbündeter sehen Erwartung täuschen -- schnaubt Rache -- 
  England fürchtet Alleinherrschaft Meere -- Frankreich -- Regierung kräftig Geist -- Hilfsquell benutzen lernen -- Natur verleihen -- folglich wendet Einfluß fest Land -- gefährlich Nebenbuhler nieder drücken -- 
  Kontinent willig -- Absicht eingehen -- wahrscheinlich halb Jahrhundert einleuchten -- Fehlgriff tun -- 
  Vater Ereignis betreffen verstimmen -- 
  Idee Konsul Washington Muster nehmen -- 
  Pfarrer redet vielfach Weise -- aufmerksam Verschiedenheit Lage Reiche -- 
  -- bildet Staat -- -- sprechen -- -- zerstören -- 
  Amerika menschenarm -- Geisteskultur ausbreiten -- Sitte einfach -- 
  welch Unterschied Frankreich -- Übervölkerung -- Überbildung Luxus hoch Reibung hervor bringen müssen -- 
  Amerika Meere sichern -- Frankreich rings Schälsüchtige -- schlagfertig Nachbar umgeben -- bedürfen Heldenarme -- Aufrechthaltung -- 
  Führer Wechsel unterwerfen bleiben -- innerer Ruhe gefährden -- müssen Glanz umgeben -- Eitelkeit -- schoßsünd Volk -- -- 
  Pfarrer -- 
  ehren vorzüglich Napoleon -- Religion schützen aufrecht halten -- Mutter lebhaft Partei -- 
  Vater ehren Religion -- hoch Wesen groß Innigkeit -- behaupten -- bedürfen kein besonderer Schutz -- herrschend Kultus Kleid -- Wesen Religion -- 
  schweigen Verhandlung -- Überzeugung Seite Pfarrer -- 
  Geschichte Cäsar Zeitalter fleißiger studieren -- 
  Brutus Achtung versagen -- leuchten -- neidisch Kassius Mitverschworen Irre leiten -- grübelnd Philosophie Studium Volk -- versäumen -- 
  Cäsars bedürfen Rom -- morden -- fallen Hand listigen Octavius -- 
  streiten -- Napoleon Krone annehmen -- hören Zweifel -- Rechtmäßigkeit Besitzes -- 
  Thron gesamtwill Volk -- fast erledigen -- jetzig Inhaber -- Reich Untergange retten -- Zustimmung Mehrzahl bestiegen -- 
  Dynastien Ursprung gut Quelle herleien -- 
  Thron Prätendenten -- Volke Hindernis scheinen -- Anspruch anerkannen -- Ausland Heuchelei Grund -- Ursache Abneigung -- angeben -- Geschichte erhalten frisch Andenken -- Moralität Europa beleidigen finden hart Zurückweisung Zurücksetzung englisch Prätendent -- 
  Napoleon fürstlich Familie stammen -- Mehrzahl Volk Ärgernis -- 
  Freiheitsgeist unterwerfen Genie Geburt -- Neid Ehrgeiz fragen geheim -- -- 
  Fürstenhof freilich -- Standpunkt -- Ansicht -- 
  Diener Anhänger Moses Schöpfungsgeschicht bloß Fabel -- -- Erzählung -- Menschenpaar schaffen -- 
  möchten Mythos Schöpfung ausbilden -- Gott Fürst -- Adel -- Priester -- Bürger Bauer -- jeder Geschlecht -- schaffen -- Wolf -- Fuchs -- Hasen Schaf -- 
  geschien -- Ansicht Unglück Welt -- 
  Wirkung Rückwirkungen unaufhaltsam folgen begegnen -- Mitwelt schwerlich -- Parteilichkeit -- Endurteil sprechen -- 
  Vater scheinen Bemerkung drängen -- 
  Frieden Amien benutzen -- persönlich Konsul euer Rückkehr wirken -- Beweis -- mächtig Mann ehren -- bitten -- 
  wurden Liste Ausgewandert streichen -- 
  Mutter benutzen erteilt Erlaubnis -- geschwächt Gesundheit Wille -- geliebt Bruder sehen -- vieler Freude -- Vater Einwilligung -- wahrscheinlich ökonomisch politisch Rücksichte -- kamsen -- geliebt Adel -- Mutter -- 
  Welch Fest unser Haus -- 
  neu Leben -- 
  vierzehn -- alt -- innig schließen -- 
  Begriff Blutsverwandtschaft -- ketten -- längst stille Schwester wünschen -- finden -- 
  Eigentümlichkeit tragen viele unser zärtlich Verhältnis -- 
  Eigenheit -- Gesellschaft Mädchen Alter selten zusagen -- hört Gespräch ernsthaft Mann -- spielen klein Mädchen -- Vorzug schmeicheln fühlen -- anbetend Liebe hingen -- 
  Kind unser Dorf versammelt liebkosend -- blicken lassen -- froh Getümmel niemals müde -- müde -- kindisch Frage beantworten -- 
  liebend Sorgfalt -- belehren -- schmücken -- wissen hunderterlei Freude bereiten -- 
  -- nächsen Ideenwelt ziehen Kinderwelt -- meisten -- 
  Erschienst -- schön Kind -- jemals sehen -- 
  blau Auge -- golden Locke -- zart weiß Gesichtsfarbe unterscheiden unser provenzalisch Mädchen -- 
  kalt -- englisch Ernst französisch Lebhaftigkeit sanftest -- einnehmendst Heiterkeit mäßigen -- kamsen -- Engel Gemälde -- Seit fandest hoch Freude unser südlich Leben -- Kind -- wickeln -- Mal Bande lösen -- scheinen -- Mutter ausdrucken -- Flügel wachsen -- 
  Hättest bleiben -- 
  kurz -- vereinen bleiben -- unzertrennlich -- 
  Mutter Paris knüpfen -- Wille Deines Vater -- alt Bekanntschaft -- bliebst unterdessen unser Haus -- Tochter behandeln lieben wurdest -- 
  kennen lernen glücklich Haus -- brauchen wiederholen -- Liebe Zufriedenheit herrschten -- 
  Kennst Vater freundlich Ernst -- belehrend Gespräch -- launig Scherz -- geschäftig Mutter Gutmütigkeit necken -- 
  weißen -- sorgsam treu Mutter -- Lieb gewinnen -- Vernachlässigung nachsehen -- Deinetwillen begehen -- 
  herrlich Emil sehen -- Ferien besuchen -- 
  weißen -- grenzenlosen Freude empfangen -- Mondlang vorher -- fast Stunde Ankunft bestimmen -- 
  weißen -- Jubel Dienstleute -- Einwohner Kind Dorf herbei eilen -- Allgeliebt begrüßen -- 
  unaufhörlich bemühen -- Vergnügen bereiten -- Spiele Tänze beleben -- Gesänge rührend Flötenspiel begleiten -- 
  Seele unser jugendlich Kreis -- 
  wurdest Ideal jung Herzens -- Bild letzter Schritt begleiten -- 
  O -- herrlich schöne schnell vergänglich -- Gemein schlecht Sturm überdauern -- 
  Treffliche Mensch zart Blume -- glühend Strahle Mittag -- eisig hauch Norden widerstehen -- 
  Unkraut wuchern fort -- 
  Welch Unkraut Virginia -- Verlust all Liebe überleben -- 
  stehen einsam Distel Schottlands öd Heide -- verlassen Sänger Vorzeit rührend Nacht Schwermut besingen -- 
  Zeitraum hinweg eilen -- gemeinschaftlich erleben -- Bezug -- Merkwürdige -- 
  fließen gleichförmig fröhlich -- Herz schlagen ruhig -- ungeachtet anfingst jungfräulicher Alter hinüber -- antreten -- 
  Vater -- Sorgfalt unser Geist erhaben Vorwurf geben wissen -- unser Vergnügungen Kindlichkeit erhalten verstehen -- 
  Mutter kehren -- weder Neigung Geschick -- Plan dein Vater wirken -- 
  Paris gut empfangen -- gedachen allgemein Auswanderung -- Kaiser -- wohlwollend Rücksicht Vater scheinen -- 
  ehemalig Herzogin Rochefoucauld Jugendfreundinne -- stellen Kaiserin -- gütig Josephine all Liebenswürdigkeit -- schön Gemüte liegen -- 
  herzen tief gerührt erfahren zart Behandlung -- äußern Erzählung mannigfaltig -- 
  dein Vater Brief wagen -- 
  suchen Art besänftigen -- Vorstellungsart eingehen -- wissend -- aufbringen -- Zweck meist verfehlen -- 
  Antwort -- spät -- ausgebrochen Krieg -- Umweg -- gelangen -- atmen Zorn Mißmut -- 
  befehlen Mutter -- unverzüglich kehren -- 
  gehorsam Gattin Folge leisten -- Verbindung England -- strengsen gehemmt -- Brief befördern Schwierigkeit verknüpfen -- 
  verzögeren -- Freude -- gefürchtet angesetzt vereitelt Abreise 1806 -- wagen -- Rückweg Deutschland -- Hamburg antreten -- 
  schmerzhaft Trennung Seite -- 
  zerfloss Träne -- 
  lebhaft Mutter schelten mitten Träne -- Krieg -- schmäht König England -- Ausgewandert -- Revolution -- Kaiser -- 
  werfen durcheinander -- suchen leiden -- nächster Ursache -- heftig Gefühl entladen -- 
  Vater Mutter halten sprachlos umarmt -- Fühlt -- letzter Umarmung Leben -- 
  ungeachtet Ahnung Art -- Lage -- -- glauben -- unwahrscheinlich Weise Erfüllung -- 
  euer Abreise lassen unausfüllbar Lücke unser häuslich -- 
  vorzüglich leiden stark Fassung gewaltig Stoß -- 
  Brief -- Hamburg schicktest -- freudig Ereignis -- Herz entgegen schlagen -- Brief -- traurig -- tausend Träne entlocken -- 
  fühltest Trennung -- hattest fröhlich Frankreich gänzlich einbürgern -- England früh Verbindung fremd -- sogar gewiß Abneigung Inselland festgesetzen -- unser Haus täglich unredlich -- engherzig Kaufmannsgeist reden gehören -- 
  Schildertest dunkelst Farbe trauernd Gemüt -- Szene Elend -- Reise -- Folge Kriege -- bemerkbar -- litt Seele -- 
  Wehe Volke Flur blutig Erys hinschweben -- 
  Soldat Halme schon -- rastloser Fuß hineilen -- 
  Selbsterhaltung -- Gesetz organisch Natur -- zwingen Naturzustand -- Gut gemein -- Stärke Besitz ergreifen -- 
  Moralität Rede -- 
  Ursache Krieg Moralist beurteilen -- gewöhnlich verwickeln -- bündig Urteil sprechen -- 
  vorzüglich Frankreich Krieg -- Ausbruch Revolution -- Fall -- 
  Frankreich feindselig Nachbar Sinn -- brechen Joch -- Last -- lang -- desto unerträglich -- 
  Willkür Einzelner drücken -- mithin -- Druck aufhören -- Willkür Einzeln vernichten müssen -- 
  schri einzeln Feuer -- Nachbar ergriffen Gelegenheit Begierde -- verschlossen Haus eindringen -- Vorwande -- löschen -- 
  -- 
  Bewohner verbrannn -- Krankheit verpestet Kleidungstück Gerät -- Herr Feuer -- unberufen Helfer Tür sprengen -- -- Zugluft -- Flamm wütenden Ausbruch anfachen -- 
  draußen Sicherung Gebäude -- Lösch-Anstalt Belieben Tätigkeit setzen -- verargen -- 
  Verletzung Hausrecht empört Bewohner -- werfen Eindringende Straße hinaus -- verfolgt Haus -- Wiedervergeltung üben -- 
  Dämon Krieges losgelassen -- menschlich Vermocht fesseln -- 
  kehren Gehorsam -- zahmen Falke -- Ruf Träger abläßt Beize -- still Nebelkappe bedecken lassen -- 
  Fürst zittern -- Krieges-Manifest unterschretben -- 
  -- Rachgier Angreifer wachsen Verlust -- Friedensschlüs -- Erschöpfung herbeigeführen -- Unterzeichnung geheim Waffenstillstand betrachten -- 
  England wissen Empfindlichkeit alt Dynastien Atem erhalten -- sparen weder Geld -- Vorspiegelung -- Anstrengung reizen -- ziehen Nutzen Verblendung -- 
  spät Festland beklagen -- -- Handels-Despot -- versehen -- 
  vergebens Republik -- vergebens späterhin Kaiser Hand Frieden bieten -- verweigern -- schließen falsch Herz -- 
  Frankreich müssen Selbsterhaltung -- Freiheit fechten -- Gesetz annehmen -- müssen Lage setzen -- Gesetz geben -- Eroberunge Notwehr Ehrgeiz -- 
  Fürst Streit beginnen -- Fürst setzen fort -- Volk empfanden Härtest blutig Geißel -- 
  Maß gleichen Kind -- Tisch schlagen -- woran stoßen -- leicht Spiel -- Frankreich Ursache Übel verschreien -- führen -- 
  Abschnitt Leben -- gewöhnt -- fast schreiben -- lesen -- 
  gewohnen -- betreffend Ereignis erzählen -- sogar -- Veranlassung denken empfinden -- 
  lieb Gewohnheit setzen schriftlich fort -- Packetboth Korrespondenz einrichten -- 
  überall Kein -- müssen -- Hoffnung geschrieben Brief Flamme opfern -- 
  jeder Mal traurig -- niemals unwillig -- 
  Kontinentalsystem leuchten -- -- entspringenden -- Unannehmlichkeit unterzog -- empfindlich Herz -- 
  Vater nennen Maßregel weisen wohltätig spät Folge -- sowohl Frankreich -- übrig fest Land -- allgemein gut Wille ergreife -- 
  wirtschaftlich Mutter -- Preis Kolonialwar Höhe -- Triumvirate überstimmen -- Vater -- gut Pfarrer bestehen -- 
  Entsagung bereit -- unerschöpflich Erfindung Surrogat -- 
  fing -- dienlich scheinend Blume aromatisch Blatt -- zart Hervortreibe -- sorgsam trocken -- gelingen -- vieler Versuch Zusammensetz -- Mischung treffen -- chinesisch Tee nahe -- 
  Vater pflanzen Farbkräuter -- legen Fabrik Zucker Runkelrübe -- Freude -- Anlage -- Aufsicht -- wirken -- 
  Pfarrer legen fleißig Bienenzucht -- erfinden Vorrichtung -- Gespinste Flachses groß Vollkommenheit geben -- 
  sehen ruhig Isolierung Kontinent -- Verlust ehemalig Kolonie -- 
  bekämpft Erbfeind unblutig Waffe -- 
  Lehre pflanzen fort -- Nationalindustrie überall beleben -- bringen Nationalwohlstand hervor -- Sieg entscheiden -- allgemein Feind Volk verblendet Helfer finden -- 
  Krieg vorteilhaft Einfluß Frankreich -- wecken Tätigkeit -- 
  unterbrechen körperlich beschäftigen -- rastlos aufmerksam -- gut geschehen -- haushälterisch wirtschaften -- Fehlender ergänzen -- Vorhandene vervollkommnen -- 
  wendet Lehre -- Nation erhalten -- Einzelwesen -- unabhängig erhalten -- Bedürfnis befriedigen lernen -- 
  mechanisch Fertigkeit -- jüngst einig erstaunen nehmen -- Richtung Ansicht Ursprung danken -- 
  Gelegenheit absehen lassen -- ordentlich Briefwechsel fangen -- beleben schriftlich Unterhaltung Bruder -- -- groß Teil -- Gegenstand -- 
  bewahrt Bild treuem Herz -- nährt angenehm Hoffnung Weise sehen -- 
  nächst reichhaltig Stoff -- unterhalten -- fleißig Freund -- alt -- 
  Mucius Sohn väterlich Lehrer -- 
  Eintritt Haus fühlen ziehen -- Unterschied -- fortgeschritten wissenschaftlich Bildung Freund bemerkbar -- Emil schön Gemüt schnell reifend Vernunft glich Abstand völlig -- 
  Freund Bruder unaufhörlich erzählen -- Gewohnheit -- Schlus Brief Gruß Pilade aufzutragen -- 
  Mucius erwidern Aufmerksamkeit -- artig Vers -- Brief Bruder schreiben -- 
  antworten Gegengedicht -- ebenfalls Brief Emil -- entspann mittelbar Briefwechsel -- -- romantisch Natur -- unendlich reizen -- 
  Artigkeit Gefühl -- dunkl sehnen bemächtigen Herzen -- 
  -- warst -- freutest Gewohnheit Vater -- Anfang jeder Frühling Reise -- Abreise Ausflug wiederholt erweitern -- 
  Marseille Hieres -- Genf schön Umgebung besuchen -- 
  Gesundheit Mutter Anteil Reise -- Vergnügen -- 
  Winter Jahr 1808 Nervenzufälle gelitt -- weshalb gewöhnlich Weg machen -- Rate Arzt -- Montpellier -- 
  nehmen unser Weg Beaucaire durchschnitt Bergkette Bellegarde -- Vater Geschäft abzutun -- 
  Februar -- Nordseite Berg Schnee bedeckt -- Täler sproßen üppigster Grün -- Veilchen wild Hyazinthe blüht sonnig Abhäng -- majestätisch dunkel Tanne treiben goldgrün Sprosse -- Finken Grasemücken jubeln neubelaubt Gebüsch -- 
  nah Ziel unser nächster Ruhepunkt -- hoch Stelle Wege -- Turmspitze Bellegarde erblicken -- Hinabfahr Hohlweg -- Wagen umwarf -- 
  kommen fast Beschädigung -- Wagen desto stark erhalten -- schlechterdings unmöglich -- ferner bedienen -- 
  müssen entschließen -- nächster Dorfe Fuße -- wobei Vater -- Schreck halbtot Mutter führen -- 
  wirtshause Aufenthalt -- Förster -- Fleckens wohnen -- herzlich Gastfreiheit -- 
  bieten sogleich Menge Bauer -- Sache Weg holen -- unser Wagen Schmied schleppen -- 
  -- Fortsetzung Reise Fuhrwerk anbieten -- -- Neffe entgegen senden -- besuchen -- 
  Nachtlager gefallen lassen -- -- 
  Vater Hinsicht Mutter dankbar -- 
  entschließen -- Postpferd besteigen -- -- Postillon -- Bellegarde reien -- -- Wagen -- abzuholen versprechen -- 
  Mutter Oberzimmer führen -- 
  fühlen angreifen -- sogleich Bette legen müssen -- Neigung Schlaf gewahr -- -- wünschen scheinen -- hinunter Wohnzimmer -- 
  Dämmerung -- hereingebroch -- Geschwätz alt Tochter Förster -- sonderlich bemerken -- 
  aufmerksam -- setzen hinzu -- Vater lieben traulich Feierstündche -- sehen -- früh Licht anzünden -- 
  Wagengeräusch Hofe aufmerksam -- 
  Vetter -- rufen Mädchen -- hüpft Tür -- 
  kehren Förster Fremden -- Gestalt schwach Dämmerung unterscheiden -- 
  Förster Anwesenheit Zimmer -- erzählt Geschichte unser Mißgeschick -- worüber Fremde bedauern herzlich Wort schön Stimme bezeugen -- 
  Gespräch fallen allgemeiner Gegenstand -- 
  wissen -- Oheim -- plötzlich Fremd -- letzter Mahl sehen -- 
  -- fragen -- 
  gehen Woche -- -- Armee -- wünschen -- Lebewohl sagen -- 
  Soldat -- rufen Oheim -- nimmer denken -- 
  Fatal treffen -- Mal vorüber gehen -- 
  Entscheidung abwarten -- Fremd -- freiwillig bestimmen -- 
  freiwillig -- rufen Förster Erstaunen -- 
  unmöglich -- Lebensweise -- Neigung Soldatenstande fühlen -- 
  -- -- Neigung -- Vaterland verteidigen -- 
  --- mochtesen niemals Füchse Krieg erklären -- -- Treibjag -- aufmerksam Posten glauben -- finden Virgil Hand nachlässig Baume lagern -- Büchse -- 
  -- Tirtäus Kriegslieder -- Oheim -- 
  -- ewig schlafen -- Schlaf Feigen -- wecken nimmer Nachbar Hahn -- nimm Schwächeren Mut -- -- -- 
  woher Mal Änderung -- 
  Spanien -- auflauernd Buschklepper morden -- Weiber vergiften -- -- 
  Oheim -- 
  ahne Volkswille -- unklagen -- 
  Kriegsflamm drohen -- Seite Österreich -- England blasen voll Back glimmend Zunder -- glauben Mal Hinterhalt fallen lassen -- 
  Napoleon Spanien -- Rücken Frankreich angreifen -- flammend Schwerte -- Engel Eingang Paradiese -- bewachen -- gefürchtet Antlitz Rächer sehen -- 
  unterdessen Frankreich Heldenjugend erheben -- Führer schlagfertig Heer finden -- -- 
  Fremde sprechen Wort Nachdruck -- freudig Schauer Nerv beben -- 
  Mädchen Hand zittert Meinig -- 
  -- rufen Schluchzender Stimme -- böse Mann reden Krieg -- Vogelschießen -- denken Ruhm -- Träne denken -- 
  nützen arme Kaiser Ruhm -- mal leiben -- friedfertig -- eroberungssüchtig -- 
  Liebe Marie -- fremd Heftigkeit -- redest Weib -- verstehst -- 
  Napoleon Ruhm -- Frankreich groß Stärke -- Vaterland Sicherheit -- 
  frei Land Fessel verflossen Jahrhundert schmieden -- Hörensag kennen -- fast Geburt zerbrochen -- 
  -- redet Förster -- wehren -- alt Kopf feindlich Reihe stellen -- 
  jünglinge -- fahren Fremde fort -- elende sein -- Herzblut hingeben Vaterland Verfassung -- Schatten erwuchs -- Kaiser -- Wunde Revolution heilen -- Bürgerkrieg enden -- Ruhm Nation hoch Gipfel erheben -- 
  Bürger fühlen Teilnehmer Ruhm -- weiblich Herz -- 
  Apostrophe Geschlecht -- reizt Mitgespräch -- drücken Freiheitssinn glühend Vaterlandsliebe lebhaft Wort -- 
  Fremde scheinen Bewunderung hören -- Begriff -- fremd Mund vernehmen -- 
  -- glauben hören -- 
  setzen häufig -- Feuer Gespräch -- angefangen Periode fort -- genau Wort -- laut lassen -- 
  übernatürlich Übereinstimmung -- 
  Schwiege voll erstaunen still -- reden -- vergaß -- Wesen -- 
  sehen -- Geist -- erkannten -- -- scheinen -- geknüpft Freundschaft fortsetzten -- 
  fühlt unbegreiflich -- völlig unbekannt -- weis fremd ziehen -- 
  Fall -- beweisen zunehmend rührend Weichheit Stimme -- 
  aufstehen -- -- unbewußt -- Tisch nähern -- -- gewirkt Decke behangen -- Mitte Zimmer stehen -- Fremd -- Seite -- tun -- 
  Stunde stehen -- -- 
  Tisch Dunkelheit trennen -- fühlen vereinen -- -- verschlungen Seele durchflogen -- gemeinschaftlich -- endlos Raum Schöpfung -- Ansicht Punkt -- Licht betrachtend -- 
  Finster -- stockfinster -- sonnenhell -- 
  treten Försterin Licht herein -- stellen Tisch -- 
  Starrt sprachlos Secundelang -- heben Augenblick Arm -- -- Mucius -- 
  Virginia -- Tönt beide Lippe -- 
  -- Nie_gesehen -- -- ungekannte -- 
  Försterfamilie staunen -- müssen Rätsel lösen -- erzählen -- 
  Wundern Aufhör -- 
  wunderbar Weg Herr -- Försterin -- Gott Schickung lispeln leise Seufzer Marie -- alt Förster schütteln treuherzig Hand -- 
  ordentlich rühren -- eur Gespräch -- Kinderchen -- -- war_es Kirche -- 
  Mutter tragen -- Haus vermögen -- wissen Mucius Leibessen bereiten -- Koller schonen -- 
  denken vielfach Fest feiern -- Willkomme Abschieds -- Freude Trauerfest -- wissen Fest -- -- -- Herr lenke Wille -- unser -- 
  lüftet ledern Käppche -- zünden Wachsstock -- Kellerschlüssel eilen hinaus -- 
  Mutter Tochter beschicken emsig Tisch -- 
  Mucius setzen -- fallen Wort seltsam Zusammentreffe -- alt bekannter -- 
  sprechen Emil -- teuer Gegenstand treffen Seele innigsten -- 
  wiederholt hundert Mal -- lieben -- hörten Entzück -- gält Versicherung -- 
  Tisch erhalten Platz Oheim Neffen -- Mucius sitzen Marie -- 
  arm Marie einzig -- heit scheinen -- Ankunft -- -- Vater öfter glücklich Feldzug anstoßen -- nachtbar Mucius Bescheid -- 
  glücklich Reise getrunken -- 
  Reise Montpellier fortsetzen -- Frage -- plötzlich Mucius -- Herr Vater entscheiden -- 
  sehen verwundern -- bat Erklärung -- 
  -- ablehnend -- lassen Zukunft still bedecken -- heutig Abends rein genießen -- 
  stimmt fröhlich Rundgesang -- Abend spät Nacht verlängern heit beschließen -- 
  begeben geistig Rausch -- woran Wein Anteil -- Bette -- schlummeren Morgendämmerung selig Träum -- 
  -- Vater früh ankommen -- finden Bette Mutter Kämmerchen verlassen -- ernst -- Mutter Unruhe -- 
  umarmen -- eilt Hinunter -- Gespräch stören -- -- leugnen -- Mucius gut wünschen -- 
  treffen Wohnzimmer -- Auge strahlen entgegen -- 
  Vater ernst -- freundlich Rede -- sehen -- 
  -- erwidern -- Nachricht ernst stimmen -- 
  Nachricht -- rufen -- 
  erschrecken -- -- liebkosend Hand -- Emil begleiten Feld -- 
  O -- Mutter -- rufen voll Schrecken -- 
  gezitteren -- -- Unvermeidlich finden -- 
  Emil sechzehn -- kurz treffen -- Opfer freiwillig bringen -- unabänderlich bringen -- Hand Freundschaft -- wissen späterhin -- unwiderruflich entschließen -- Begriff -- Abreise -- Chaumerive -- Entschluß kund -- 
  -- rufen hastig -- 
  -- -- Herr Vater bereiten Mutter -- 
  arm -- arm Mutter -- klagen -- überleben -- 
  bleiben -- Mucius -- trocknen sanft Auge -- 
  Liebling -- fahren fort -- verdienen -- 
  verdienen -- 
  -- rufen Mucius -- Hand Heftigkeit Lippe drücken -- 
  Glücklicher Emil -- setzen hinzu -- Tran glänzen dunkelbraun Auge -- glücklich Emil -- Engel weinen -- 
  Unglücklicher Schwester -- 
  ihrig -- -- Träne fließen stark -- 
  Virginia -- rufen Ausruf Entzücken -- schlingen Arm -- sinken Übermaß Gefühl Brust -- 
  Lippe begegnen unwillkürlich -- halten sprachlos Seligkeit umarmt -- 
  O -- Leben schön -- rufen Mucius -- 
  halten all Zauber -- auf Spiel setzen -- entfalten schön Blüte -- 
  Feig hold Auge lächeln -- -- kämpfen schön Preis -- 
  Virginia Sieger lieben -- fragt Schmeicheltön -- 
  Ewig -- entgegnen -- 
  -- 
  rufen Mund -- Umarmung besiegeln Bund Ewigkeit -- 
  O -- selig Gefühl -- Seele -- Schöpfer Lichtfunke bilden -- finden verbinden ewig -- 
  Gegenwart Verhältnis verschwinden trunken Auge -- sehen aufwärts Quell Lichts -- 
  Träne plötzlich versiegen -- Herz jauchzen geheim mitten Äußerung Besorgnis -- 
  Träne Mutter tun wehe -- Vorwurf glücklich -- ändern -- glücklich -- 
  beschließen -- sogleich Rückreise Chaumerive antreten -- geliebten Emil Herz schließen -- Mucius sogleich entschließen -- begleiten -- 
  Oheim schüttelt Abschied kräftig Hand -- 
  brav Junge -- -- tun Pflicht -- Gott -- Mucius -- 
  Schild -- Oheim -- Schild -- entgegnen langsam -- Nachdruck -- 
  Mucius Scävola -- rufen Vater schließen feucht Auge Brust -- 
  Marie weinen heftig Abschied küßen -- umarmen -- Augenblick nachdenkend -- halb lächeln schweben leidend Gesicht -- schütteln leis Kopf -- sagen -- -- 
  trocknen mutig Träne -- schmiegen Sanft resignieren Vater -- 
  Rückreise erfreulich -- 
  Mutter meistens leidend kehren -- Mühe Mann geben beruhigen -- leuchtend Auge scheinen wund Gefühl oftmals verletzen -- 
  Seite hoch Freude -- bemerken -- Vater Minute Gefallen geliebter finden -- 
  erzählt amerikanisch Feldzug -- verjüngen mitten Bild Jugend -- 
  -- Bruder fallen -- -- seufzt Mutter -- 
  Überzeugung -- Sache -- Kamerad beweinen -- rufen Vater -- lang Leben schön Tod aufwiegen -- 
  Leben voll Liebe -- fragt Mutter -- drücken zärtlich Hand -- 
  Leben schön -- erwidern -- umarmen -- Heldentod Jünglings minder -- 
  beneid -- Mucius -- schön Auge weinen -- leben köstlich Träne selig Leben -- 
  dunkel Wolke fliegen Wort Seele -- mutig scheucht Hinweg -- 
  Glücklich Geschlecht -- -- handelnd eingreifen Weltbegebenheite -- 
  Preis glücklich -- antwortet Vater -- klein Kreis bezeichnen -- schmerzlich Wahl -- schwank Pflicht Haus -- Land -- 
  erkennen Vater -- -- Hand küssend -- 
  verstehen -- Geist vorüber -- 
  treffen Chaumerive fast teuer Emil -- 
  Mutter schließen leidenschaftlich Arm -- scheinen Hoffnung hegen -- halten -- überzeugt ruhig Haltung -- Vater bestimmt Erklärung -- -- Unvermeidliche ergeben müssen -- 
  Fassung Welt -- augenscheinlich Absicht -- Herz Liebling schwer -- 
  O Allmacht mütterlich Liebe -- Wunder bringst hervor -- 
  arm Mutter -- heftig Äußerung Schmerz -- gewinnen -- Sohn heiter Gesicht zeigen -- Herz tausend Wunde bluten -- 
  rastlos Bedürfnissen beschäftigen -- sprechen sogar scherzend baldig siegreich Rückkehr -- 
  Stille Morgen -- hört Schluchze -- anstoßend Kabinett -- bemerken -- Wohnzimmer treten -- blasseren Wange -- Spur frisch vergossen Träne -- sorgfältig tilgen suchen -- Frühstücksstunde heran nahten -- 
  zärtlich Achtsamkeit forscht Sohn lieben Gesicht -- bitten schmeichelnde Stimme -- -- traurig lieb Mutter -- -- 
  lächelen jeder Mal -- leugnen -- 
  fließen vierzehn schmerzlich-süße -- 
  Emil bemerken zärtlich Verhältnis Freund -- verhehl Strebt -- 
  ziehen Arm -- 
  halt Leben groß Schatz Brust -- -- 
  -- fragt Schalkhaft -- 
  Lebend -- Bild -- erwidern -- 
  fühlen -- -- -- Bild drücken -- -- Busen entfallen -- Seite hing -- 
  Übermaß Liebe teuer Bruder -- Gefühl Glück -- Kette Bilde Halse -- Schlang seinigen -- 
  Ägide -- -- schützen lieb Herz -- 
  Entzück Dankbarkeit -- 
  mutig Herz schlagen -- -- klopfen aufhören -- 
  O Stillstehen Herzen -- 
  bitten -- Gedanke erschüttern -- 
  -- -- lächelnd -- flüstern leis Ahnung -- gehen mutig Feind entgegen -- 
  Sage einst Adel -- setzen Ernst hinzu -- lieben -- letzter Hauch lieben -- 
  Stimme versagt Augenblick -- plötzlich richten ruhig freundlich Gesicht Umarmung -- 
  scheinen -- aufsehen -- Mahl beträchtlich groß -- 
  Voll aufgeregter Ängstlichkeit werfen Mucius Arm -- flüstern Ahndungsstimm -- fragen zitternd -- 
  Freudige verkündigen -- -- Umschlang -- 
  ruhig -- Virginia -- Glück Mutig hold -- 
  -- freudig -- wiedersehen -- 
  Ausspruch geliebter Stimme Dodona -- Brust rufen Hoffnung -- 
  brechen Abschiedsmorg heran -- 
  letzter Mahl begrüßen Sonne Aufgang -- zärtlich vereint -- glücklich Familie -- 
  Vater weich freundlich -- Mutter blass -- anscheinend ruhig fassen -- 
  Emil betreiben lebhaft Zurüstung Abreise -- lächelen -- Bewegung verbergen -- 
  Mucius -- Liebe beschäftigen -- wenden aufmerksamst Sorgfalt -- Mut aufrecht halten -- 
  bedurft Beistand -- 
  Gefahr -- geliebtest Gegenstand Zärtlichkeit verlieren -- verlassen sonstig Heldensinn liebend Mädchen kämpfen fruchtlos Träne -- 
  Vater Kampf Seele -- gütig -- -- stützend Trost geben -- 
  Zärtlich ergriff Emil Mucius Hand -- rufen Bewegter Stimme -- 
  Sohn -- 
  O reich Vater -- 
  Weihe Sohn vaterlande -- 
  Schutzengel -- bleiben treu hülfreich Liebe -- bleiben treu Leben Tod -- 
  Band Freundschaft knüpfen längst eure Herz -- füg feierlich Stunde -- -- schönerer -- hinzu -- brüderlichen -- 
  sobald zurückkehren -- Mucius Virginia Gatte -- 
  überraschen Wort -- äußern Bewegung verschieden Weise -- 
  Mucius werfen stürmisch Freude Vater arme -- sinken schluchzend Fuß -- Emil umfaßt Freund -- Mutter staunend Sofa Gruppe -- strecken Hand -- 
  -- einzig Reise Sohnes beschäftigen -- Verhältnis achten -- ziemlich fremd bleiben -- Mucius liebgewonnen -- Wille -- Emil Freund -- 
  niederkniet Segen bat -- segnen freudigst Rührung -- 
  Emil küssen -- kindlich schmeichelnd -- 
  Hand -- legen Freund -- teuer Tochter -- Hand vertrauen geliebt Sohn -- schützen Bruder -- 
  Blut -- rufen Mucius -- preßen Emil Arm -- 
  Sorge -- verehrt Mutter -- bringen gesund -- Hand -- niemals Kehr Heim -- 
  unerwartet Szene heroisch Schwung geben -- leicht gefürchtet Abschiedsstund hinweg tragen -- 
  Pferd stehen bereit -- Postillon mehrere Mal Horn stoßen -- ergreifen Mucius rasch Hand Freund -- 
  scheiden -- mutig -- leben Vater Mutter -- leben Virginia -- kehren -- 
  küssen Reihe -- Eile -- lassen Emile -- gleich -- 
  arm Emil -- 
  Bläs überziehen Gesicht -- schweben gewohnt lächeln -- drücken -- Lebewohl -- 
  fest Schritt folgen Freund -- rasch fortriß -- 
  weniger Minute unser Blick entschwinden -- hoch Jünglingsgestalt -- 
  -- -- 
  Mutter unverwandt -- Wagen unser Blick sichtbar -- sinken ohnmächtig nieder -- 
  Sorge -- Pflege -- ziehen Vater unser Empfindung -- 
  tun zerstreu Heiteren -- gering Erfolg -- 
  Vater bestehen eifrig -- unterbrochen Reise antreten -- Mutter bewegen -- 
  Emil wiederkehren -- genesen -- -- -- -- -- brechen -- Pause setzen hinzu -- 
  Ort Brief erhalten -- 
  -- Brief einzig Nahrung -- schwach Flamme Leben erhalten -- Liebkosung freundlich -- erwidern -- Träne floss arme geliebt Gatte -- 
  Schlacht Eßlingen -- steigen Angst Mutter hoch -- 
  Nacht Sohn -- verwunden Tod -- Träum -- 
  Umsonst wendeten Vater Vernunftgründe -- Herz heftig leiden -- Tröstung Verstand -- beleidigen -- 
  Römerin -- Heftigkeit -- 
  Vaterland -- fragt Vater -- 
  möge zertrümmern -- rufen -- teuer Sohn behalten -- 
  Klara -- lieb Klara -- Vater -- sanft verweisend -- Schmerz toben -- finden -- 
  Pflicht -- 
  Erde trösten -- verletzen -- 
  -- Teil -- suchen tröst -- weinen -- 
  arm Herz schwanken Hoffnung Furcht -- Trostes bedurfen -- Schauspiel unbegrenzt mütterlich Schmerz fest Haltung -- 
  gelobt -- stille -- etwaig Schläg Schicksal Fassung begegnen -- 
  -- vergeblich Bemühung Nachricht -- langt Brief geliebter -- Mutter Leben -- Vater sinken schwer Stein Herzen -- Mut erhalten folgenden -- 
  Freund heißeu heftig Feuer -- Kamerad rechts links fallen -- unversehrt bleiben -- 
  scheinen besonderer Schutz Himmel -- sehen paar Geweiht -- Kugel nahen dürfen -- 
  Mutter mutig -- hoffen schnell Frieden -- beten inbrünstig Gott -- 
  Schlacht Wagram erfahren Brief Mucius -- 
  schnellfüßigen Gerücht zuvor wissen -- 
  Begeisterung loben Mut schnell Geistesgegenwart Emil -- sogar Gelegenheit -- Kaiser bemerken -- loben -- 
  -- heißen Schluß Bericht -- gelieben Bruder Ausgang Schlacht -- Fuß verwunden -- Gefahr -- gedenken unser Liebe einzutreffen -- 
  Emil fügen Zeile hinzu -- worin bitten -- Sorge -- 
  bedauert geliebter -- allzu besorgt -- 
  leicht Fußwund -- meinen Vater -- Gefahr -- Mutter danken Gott -- tief aufatmend Brust -- gnädig fügen -- 
  Fall Liebling bergen -- 
  -- Wahrscheinlichkeit -- Mal schlagen -- Sicherheit -- 
  fing -- sichtlich erhol -- Geschäft tätigst Anteil -- erheitert munter Einfall froh Laune -- 
  Laute berühren -- ergriff meinig -- singen schön Stimme artigst Lied -- 
  Vater fühlt Liebe versetzen -- selig lebendig -- -- 
  Pfarrer -- weniger Hausfreund freuen -- 
  Schwamm Meer Wonne -- Brief eintreffen -- Rückmarsch schreiben -- 
  Mucius melden -- zufällig Unterredung Kaiser -- verwundet Freund -- Kürze -- Auskunft geben -- 
  Kaiser Vater erinnern -- eigenhändig Emil Kreuz Ehrenlegion Abschied Kapitän zustellen -- 
  jung Mann betreffen -- hinzufügen -- wohin Herz rufen -- gewiß -- Vaterland bedürfen -- kehren Mahl freiwillig Fahne -- 
  golden Wort -- fröhlich Rausch verbreitet Haus -- 
  Emil schreiben -- Wunde heil -- achten -- liebend Herz Sehnsucht Freund -- treiben Heimat -- 
  schön Herz sprechen liebevoll Zeile -- freuen kindlich empfangen Ehrenzeiche -- Eltern -- seinetwill -- Deinetwille -- fügen triumphierend hinzu -- Ägide -- Virginia -- Herz treulich beschützen -- 
  -- herrlich Bruder -- 
  brav -- liebend -- treu -- Engel gleichen -- 
  Engel -- Gesellschafter -- tröstend Gefährt -- 
  Mutter geschäftig Martha -- fröhlich Tochter Jiftach -- Rückkehr -- 
  schmückt ordnet Haus froh Empfang -- 
  beschäftigt Ausstattung -- scherzen freundlich Brautstand nahe Verbindung -- 
  berührt Erde -- schweben Gefilde Selig -- irdisch Geschäft pünktlich Sorgsamer verrichten -- 
  Fähigkeit Seele Organ -- Körper -- Liebe Freude erhöhetn -- verdoppeln -- 
  Weinreif rücken heran -- 
  Berg -- ordnet verschieden Vorbereitung Lese -- 
  Sonne entfernter Bergspitze nieder -- kraus rötlich Wölkche geben Geleit -- 
  grün Abhange lagern -- blicken fröhlich magisch Beleuchtung -- einzeln Sonnenstrahl rechts links schön Landschaft werfen -- 
  Grashalmenkranz geknüpfen Mucius Wiederkehr nächster -- erwünscht bejahend ausfallen -- 
  Fröhlichkeit Herzen pflückt Blume erreichen -- reihen -- halb leis Petrarcas zärtlich stanz singend -- Kranz -- Träne Wonne tropfend nieder fallen -- 
  gewahren -- Auge Landschaft erheben -- Entfernung -- Landmann -- -- Botenstab Hand -- eilig Weg Berg schritt -- 
  Anblick ergreifen plötzlich ahndend Gefühl -- Herz klopfen voll bangen Schrecken -- näh -- graus Schicksal schreiten -- 
  -- grausend -- entsetzlich -- nahen -- 
  Bote reichen Brief -- Mucius Hand -- Mucius Hand -- dennoch wagen -- öffnen -- ungewöhnlich Weg -- wagen fragen -- selber unbegreiflich -- 
  fassen -- gewaltsam Anstrengung -- Mut -- Siegel zitternd Hand lösen -- 
  zeilen Unglückbrief -- schmettert Boden -- 
  Augenblick -- -- versagen Feder fast Dienst -- entschließen -- fürchterlich Wort wiederholen -- -- Blitzstrahl heiter Luft vernichten -- 
  Emil Tod -- -- 
  tief Ohnmacht werfen Blume nieder -- 
  laut Ruf erschrocken Boten -- Vater herbeigezogen -- Nähe befinden -- 
  entfallen Brief aufheben -- erfahren -- unvorbereiten -- schrecklich Nachricht -- 
  Unglücklicher Vater mußt fürchterlich Botschaft empfinden -- 
  einzig Sohn -- Stolz -- 
  Blüte zerschmettern Hoffnung dein Alter -- 
  Natur mitleidig erbarmen -- totenähnlich Schlummer -- leiden Minute Stillstand bieten -- 
  einzig Ohnmacht Leben -- 
  dauern -- fing dämmern -- arme Vater erwachen -- 
  Blaß -- Besonnenheit beschäftigen -- 
  Emil -- rufen -- Bewußtsein klar zurückkehren -- Emil -- Emil -- Strom Träne stürzen starr Auge -- 
  Vater verbergen Angesicht -- fühlen Zittern Armes -- bewegen innerlich müssen -- 
  Minute -- Fassung nieder -- 
  Virginia -- liebkosend Stimme -- Virginia -- stark Mädchen -- erhole -- 
  Träne Gebühr lieben -- edl Sohn Bruder -- beweinen -- rufen nahe Sorge Tatkraft -- 
  O -- Mutter -- rufen schmerzlich -- 
  fürcht meister -- -- 
  fassen -- Kind -- 
  Mucius sehen -- 
  Mucius -- fragen -- -- 
  Brief lesen -- erwidern -- 
  schrecklich Wort -- 
  mach Inhalt -- kommen langsam -- gehen voran -- bereiten -- 
  Gott stärken -- 
  Wort langsam Hügel hinunt -- überlassen Kraft -- 
  laut brach Träne -- Klage -- kehrt Besonnenheit -- 
  plötzlich fallen -- Eingebung -- Stelle Nathan weise Sinn -- 
  mehrer Lessingischen Meisterwerk -- Übung deutsch Sprache -- übersetzen -- Stelle halblaut unwillkürlich -- 
  Gott -- 
  Gott Ratschluss -- 
  Wohlan -- 
  Komme -- übe -- längst begreifen -- sicherlich üben schwer -- begreifen -- -- 
  Schluchzend -- Begeisterung -- strecken arm Himmel -- rufen -- -- -- -- wollen -- -- still gen Himmel blickend -- setzen Gedanke Augenblick fort -- fühlen wunderbar stärken erheben -- 
  Odem Ewigen scheinen umwehen -- 
  steigen Mond voll Pracht Taugewölk empor -- verbreitet sanft Tageshelle -- 
  Blick fallen Brief -- entfalten Seite liegen -- Blatt Abendwind flüstern -- 
  -- lesen leidlich Fassung -- Verzweiflung schreiben -- 
  --- früh angetreten Reise heißen Jahreszeit -- Emil anscheinend leicht Wunde verschlimmern -- 
  bleiben Frankfurt Wundsieber erkranken -- 
  gesellt bösartig Nervenfieber hinzu -- 
  vergebens wenden Mucius treue Sorgfalt -- vergebens rufen tätig Hilfe herbei -- Arzt geben Hoffnung -- erklären -- vollendet stark Wachstum kranke -- -- verbinden Mühselkeite Feldzug -- Natur erschöpfen -- versag Unterstützung -- 
  schlummeren hold Jüngling sanft bewußtlos -- schön Leben -- hinüber -- beklagen lieben -- -- Krankheit kannen -- 
  Tochter Wirt weinen schön tote -- lobten -- Rose still Hügel pflanzen -- 
  Mucius -- Erlaubnis Feldherr benutzend -- Dienst verlassen -- Freund geleien -- Myrt Liebe winken -- 
  fallen Gedanke zentnerschwer Herz -- Geliebte -- Pflege Schutzbefohlen -- verzweifelnd Mutter erscheinen -- 
  scheinen unmöglich unser vereint Jammer tragen -- 
  Angst Verzweiflung treiben -- Regimente Dienst nehmen -- Frankfurt Spanien marschieren -- 
  Tod suchen -- 
  schreiben Entfernung weniger Meile -- fühlen stark mal sehen -- erlauben Dienstverhältnis -- 
  ewig Lebewohl -- fügen ungefähr hinzu -- Marsch gehen Bellegarde -- hoffen Oheim Mal umarmen -- 
  verstehen Vater meinen -- 
  -- rufen springen -- -- 
  fliegen -- Wind Eile Wohnung -- 
  Hof Reisewag bereiten -- 
  stürzen hastig Zimmer -- 
  -- -- 
  freilich -- Vater -- Zeichen -- Finger Lippe drücken -- 
  schweigen -- suchen sammeln -- 
  Mutter stehen abgewenden Kleidungstücke legend -- wenden -- Gegenwart bemerken -- bleich -- Glied zitteren -- 
  Weißt Unglück -- fragen -- 
  schweigen bedeckt Gesicht Hand -- 
  -- fahren fort -- Rettung -- 
  merken inner beben -- schrecklichste wissen -- 
  treiben -- Wäsche packen -- gehorcht Schein -- 
  halb Stunde sitzen Wagen -- fahren furchtbar Entwicklung entgegen -- 
  Mutter sprechen unaufhörlich traurig Lage Sohn -- gefährlich krank -- fern -- zart weiblich Pflege -- voll Sehnsucht -- 
  schluchzen Schwieg -- 
  Gedanke -- anfangs Wunde täuschen -- gefährlich -- gräßlich verstümmeln -- 
  Einbildungskraft erhitzen -- schaffen schrecklich Bild Zustand -- 
  Vater wiedersprechen -- weisen sanft Wille Ewig -- Haar unser Haupt fallen -- 
  Wirkung religösen Sinn -- hadern Gott Mensch -- 
  Krüppel Lebenszeit -- rufen heftig -- unnütz Welt -- selber Last -- 
  freilich Vater -- Zustande schilderst -- Tod ziehen -- Wahl Mensch stellen -- 
  malen Bild Möglichkeit -- 
  -- Tod -- schri Mutter -- Tod -- 
  Herr Himmel hören -- glücklich sehen -- nimm -- 
  Misse -- Leide -- 
  Klara -- teuer geliebt Klara -- bitten Vater -- gedenken Ausspruch -- gedenken dein Gelübd -- 
  Schicksal mächtig ergreifen -- 
  bückt Knie nieder -- überströmen Träne -- 
  versank tief schweigen -- Schwieg -- 
  fahren übrig Nacht hindurch -- Morgenröte hervorbrach -- 
  strahlen Licht regen Mutter einig klar Bewußtsein -- 
  betrachtet Gegenstand Weg Aufmerksamkeit -- forschen unser Gesicht -- 
  Herz zerspringen -- Vater müssen fast seitwärts wenden -- schrecklich Kampf innere verbergen -- 
  plötzlich fahren Kopf Schlage hinaus rückwärts -- 
  Sonne sandt Purpurstrahle herauf -- 
  fahren erschrocken -- 
  fahren Sonne entgegen -- fast vernichten -- Abend Frankfnrt liegen -- 
  wohin führen -- fragen stark -- fassen krampfhaft Hand Vater -- 
  Stimme versagen Dienst -- 
  wohin führen -- 
  Virginia -- Seligkeit -- wohin -- 
  Monthameau stammeln leise -- 
  werfen irr Blick wechselnd -- 
  -- stoßen hervor -- Tod -- 
  sagen -- bringen mühsam Vater hervor -- erschöpfen sinken -- Gesicht Tuche verhülln -- 
  laß Hülle schrecklich Szene werfen -- 
  hoch Schmerz vermögen Feder beschreiben -- Pinsel malen wagen -- 
  O Adel -- tragen Leiden -- zerreißend Mitgefühl Schmerze geliebt Person -- Jammer frischblutend Herzen Stunde empfinden -- 
  Anfang Mutter Besinnung -- umkehren -- Mucius sehen -- 
  treu Pfleger dein Sohn Herz schließen -- fragt Vater sanft verweisend -- treu Jüngling hören -- letzter grüß Bruder bringen -- hören -- sterben -- 
  Vorstellung wirken -- kommen Abend Monthameau -- 
  bleich Schrecken malen Gesicht erblicken -- 
  Mucius glüht Augenblick Freude -- -- Eintritt Zimmer -- erblicken -- 
  Augenblick -- 
  Bläs Tode scheucht rötlich Schimmer hinweg -- stürzt Füßen Mutter -- rufen Tönen Verzweiflung -- 
  bringen -- 
  halb bewußtlos sinken Mutter Schulter hinab -- 
  schluchzen -- verging Geraume -- ehe Wort Grabesstille unterbrechen -- 
  lösen freilich -- starre Schmerz laut Klage -- 
  fragen erzählen -- Mitternacht rücken heran traurig Gespräch -- 
  Natur fordern -- Schlaf sinken müde geweint Auge herab -- 
  Morgensonne wecken neu Jammer -- 
  insbesondere stehen herb Schmerz Trennung Mucius bevor -- 
  lieben -- Adel -- Vorstellung Schmerz -- Geliebten ewig Lebewohl sagen -- 
  -- 
  fühlen klar lebendig -- letzter Mal Welt Herz schlagen -- Ohr süßen Ton geliebt Lippe vernehmen -- 
  Schicksal -- unerbittlich -- Erbarme unser Jammer -- 
  müssen scheiden -- 
  Muctus müssen Regimente nacheilen -- Ehre Liebe weichen -- werfen halb sinnlos Pferd -- Augenblick verschwinden -- leuchtend Stern Lebensbahn erloschen -- 
  Marie schließen laut weinend Arm -- 
  Unglückliche Marie -- unglücklichere Virginia -- rufen tief Jammer -- 
  verlieren -- drückt Brust -- 
  Vater ergreifen zärtlich Hand -- 
  Virginia fürchen -- Vertrauen -- männlich Geist unvermeidlich tragen lernen -- 
  einfach Wort verehren Mund -- erheben sinkend Kraft -- verschließen Gram tief Busen -- vermögen -- hülfreich teilnehmend unglücklich Umgebung beschäftigen -- 
  lernen Mensch leiden -- eigentlich Seelenbad -- 
  Kraft Mensch -- Wille rufen -- 
  Schlägen Schicksals erliegen Mut -- Schwäche lähmen -- 
  Rückreise jammervoll -- Beruhigung weinend Familie gut Förster nachgewünscht -- 
  trostlos Ankunft Chaumerive -- herzlich Träne jeder Einwohner spiegeln auf -- unersetzlich Verlust -- 
  Mutter kleiden Haus Trauer -- lassen Seelenmesse teuer tote lesen -- 
  -- Ruhe Seele stellen Messe -- 
  Vater lassen gewähren -- anerzogen Begriff bestreiten -- 
  Grundsatz -- übersinnlich Ding müssen Einsicht abmachen -- 
  Überzeugung frei Menschensatzung erhalten -- 
  wünschen -- leis Kopfschütteln -- Glaube Kirche vorgeschrieben Zeremoniell können lieb gebrochen Herz heilen -- 
  treffen Anstalten Gram -- emsig Geschäft -- suchen -- -- Wohlstand geistig Ausbildung Gemeinde befördern -- allmählich kehrt sanft Heiterkeit Gemüt -- 
  Auge Mutter treffen -- trüben Blick -- 
  suchen Beispiel folgen -- zwingen Lage Umstand -- tief still Gram zügeln -- 
  Mutter schwach -- irdisch Geschäft -- leben Andachtsübung -- 
  vergebens suchen Weise erheitern -- Leben gewinnen -- 
  liegen Geschäft Haushalt -- unbeschränkt Kreis -- lernen darein finden -- 
  Schwand Winter trübe -- allzulangsam vorüber -- 
  Mucius mehrmals schreiben -- Lage zufrieden -- 
  achtet Kraft Spanier haßt Triebfedern -- wodurch gespannt -- 
  bringen Streit -- 
  sehnlich wünschen englischen entgegen führen -- -- ungeteilt Sinn -- feindlich begegnen -- 
  erheben jugendlich Herz allmählich Hoffnung -- 
  wünschen -- rechnen sehen -- 
  Frühling hoffnungs- segensreich Frankreich einziehen -- 
  hoch Nationalfreude beleben -- Hütte herab begrüßen froh Jubel -- 
  Frankreich jauchzt jung schön Kaiserbraut entgegen -- sanft Friedensengel -- künftig Mutter stark Geschlecht -- 
  unser Kreis fast -- froh Begebenheit sprechen -- 
  Vater all Anteil -- Land -- Ruhm unser gekrönt Held nehmen pflegen -- 
  Mutter scheinen Fröhlichkeit schmerzen -- 
  spät -- seufzen -- müssen teur Opfer bringen -- Friede einzögen -- 
  O -- Mutter -- rufen Aufloder alt Begeisterung -- Emil sterben -- zählen -- 
  -- Gottheit Menschenopfer annähmen Frankreich Frieden -- Freiheit Glück -- -- tausend Freude -- Blut tropfenweise vergießen -- 
  Vater drücken schweigend Hand -- Mutter starr Blick -- schütteln langsam Kopf -- fassen Rosenkranz -- versank still Gram -- 
  Freude -- Trauer -- 
  mitten Vermählungsfeierlichkeit sterben arm Mutter arme -- 
  Vater kämpfen männlich herben Schmerz -- 
  küssen kalt Mund geliebter zärtlich Wehmut -- 
  Ruhe sanft hold Klara -- -- erdenleid drücken arm Herz -- still Friede ruhen rein Stirn -- klagen -- glücklich -- dein Frieden freuen -- 
  empfinden -- -- weint Verlust -- freut Ruhe -- schmückt Sarg buntest Kind Frühling -- 
  -- -- Hügel Rose umkränzen -- glücklich preisen -- Tod früh Stürme dunkle Wohnung retten -- 
  Seele fehlen ideal Richtung mutig Wille -- womit ungeheur Schicksal bestehen vermögen -- 
  Einsamer still leben fort -- ruhig heit -- 
  freut Wohl strebt Kraft fördern -- 
  Mucius Brief bleiben Herbste Jahr 1810 plötzlich -- genauest Erkundigung Nachricht verschaffen -- 
  Verlust vorbereiten -- schmerzen tief -- 
  Seele wehren -- glauben -- mehrere zurückkommend Soldat Regiment versichern -- -- Einnahme Victoria Brücke vordringen -- Adler Hand -- Freiwilligen Korps aufmunternd hinüber führen sehen -- 
  Mitte niedrig Geländ herabgedrängen unfehlbar reißend Strome verschlungen -- sehen -- 
  entscheiden -- bleiben hoffen -- fürchten übrig -- glauben -- richten traurig Trost gewaltsam -- 
  Tochter -- rufen -- werfen Vater Hals -- 
  bleiben -- -- drücken zärtlich Brust -- trauern schmerzlich Verlust wackeren Jüngling -- Sohn lieben -- 
  reden lieb verlorene -- labten Erinnerung irdisch Dasein -- 
  schön Erde -- Vater -- schnell verblühen -- -- 
  verlebt Wintertage -- 
  spielt Harfe fleißieg -- singen Lied -- Lage passen Vater erfreute -- 
  suchen Studie hervor -- setzen Unterricht neu Sprache eifrig fort -- übersetzen trefflichst Stelle Klassiker -- 
  Studium Geschichte -- alt -- füllen regelmäßig abendstunden -- wobei Vergleichungen fehlen -- neuerlich aufgestellt Meinung günstig -- 
  beschäftigen auf emsig künstlich Stickerei Weberei -- wobei Vater lächelnd Penelope vergleichen -- 
  Hirtenflöten Täler tönen -- hüpfte kindlich froh blumig Matte -- 
  leicht Blut Heimat verleugnen jugendlich Herz -- werfen schwarz -- trübe Mischung hinaus -- hüpfen fröhlich Ader -- -- 
  Sternenhimmel aufsehen -- weinend Mucius denken -- entzückt Flöt Nachtigalle -- tausendstimmigen Chor Abendvögel umher -- 
  Balsamdüfte Blütengebüsche ziehen lindernd Brust -- schmeichelnd Abendwind trocknen feucht Auge -- 
  Blume pflücken -- Grab Mutter Emil teuer Bildnis kränzen -- erfreute Farbenschmelz -- Wand -- spielend -- Haar -- Anblick Vater erfreun -- arbeitstische lassen nimmer fehlen -- Mahlzeit schmücken sorgsam Tafel -- 
  Tänze Dürferinn entziehen -- Besuch nachbarlich Gespielinn erwidern willig -- stimmen heit jugendlich Fröhlichkeit -- 
  Vater freut Heiterkeit -- 
  Mut -- womit Gram bekämpfen -- feindselig Leben freundlich Seite Abgewann -- liegen Seele -- 
  Wunder -- Zögling -- 
  -- aufrecht halten -- stark Stütze gelehnen -- 
  ahndeen -- Schicksal Kraft verweisen -- 
  fest Gesundheit -- jugendlich Kraft Vater geben kindlich Sicherheit -- Ruhe -- Zufriedenheit Wohlsein herrscht bekannt Lebenskreise -- 
  denken -- letzter froh Frühling -- letzter -- Frankreich lieb Flur -- blühend Täler schön Provence -- denken -- Seele scheinen dunkl Vorgefühl hegen -- 
  liebend -- -- hing wert Gegenstand -- Nacht entreißen -- 
  durstig Zügen trinken Naturschönheit -- Frühlingslust -- heit sterbend begierig Duft Blüte Strahl Lichts empfangen -- 
  bleiben Lebensfroh -- Vater bisweilen besorgt Kopf schütteln -- 
  hört Kriegeszug Norden -- verlieren -- 
  Krieger aufwachsen -- Frankreich Jugend -- Wort Krieg Grade erschrecken -- Volk erschrecken -- Ruhe Frieden nossen -- 
  Frankreich Inneren glücklich -- blicken -- vertrauend sicher -- kühn Held -- 
  Heer lieben Kampf -- jung Konskribiert ergänzt -- Gefühl National-Ehre -- meistens gut Wille -- 
  Fand mitunter Ausnahme -- nennen meister Teil öffentlich Meinung Name höchst mißbilligend -- 
  Frankreich Sicherheit -- 
  fast Losungswort -- 
  Nachwelt richten -- Irrtum obgewalten -- scheid -- Umstand -- Willkür herbeigeführen -- Ehrgeiz -- Notwehr -- 
  fern Jahrhundert Unterdrückt appellieren -- Gegenwart Glas stark färben -- 
  -- scheinen Augenblick Unternehmen gigantisch fabelhafen -- neu Alexanderzug Indien -- 
  Weg -- Schaudert malen -- tief hinein Norden -- Rußland Schneegefilde -- menschenleer ewig wüsst Steppe -- 
  danken Gott -- Mueius -- Emil abenteuerlich Zug begleiten -- gefahrvoll schrecklich denken -- 
  desto fruchtbar Einbildungskraft Mal Wirklichkeit übertreffen -- selten Fall -- 
  trösten -- Deutschland Bund -- 
  Nachbar eisig Norden -- Beschwerlichkeiter vertraut -- wissen begegnen -- unser Krieger hülfreich -- 
  Sommer Herbst Jahres 1812 verstreichen abwechselnd Beschäftigung Vergnügen -- 
  Trank lieblich Wein vorig Lese Gesundheit Heerführer einzeln Krieger -- hoffen zuversichtlich -- siegreich sehen -- Vater scheinen leis Zweifel hegen -- 
  Brief Victor -- hoch Rang bekleiden -- Besorgniß aussprechen -- 
  Ba -- antworten -- Lehrwerk -- -- 
  Sehne dehnen -- Vater -- Stützpunkt fern -- reißen -- 
  denken Römerzug entfernt Albion -- tröstet Abendgenosse -- freundlich Pfarrer -- 
  rechnen Polen -- voll Freiheitshoffnung Rachgefühl erheben -- -- Stützpunkt ansehen -- 
  schwach -- Vater -- 
  O -- Vater -- rufen -- Volke gebieten -- einzeln Held -- 
  arm Polen -- erobern -- mitten Frieden Federstrich mächtig Nachtbarn -- zerteilen -- zerrissen -- sträubend Volk Rebellenhaufen behandeln -- 
  gleichwohl berufen Moralität Gerechtigkeit -- Eisen mächtig -- 
  Winter treten unfreundlich -- gewöhnlich -- 
  jeder rauh Lüftche preßen leise Seufzer -- 
  kalt Norden -- denken -- 
  O -- unselig Winter -- 
  Träne Frankreich Mütter Bräut kosten -- 
  vernichtet schön Heer Europa -- 
  Nachricht treffen Donnerschlag Reich -- 
  erstarren Schrecken Graus -- 
  selig tote -- rufen aufgehoben arme -- sehen -- 
  selig preisen -- Vater -- Träne benetzten männlich Auge -- 
  Frankreich Heldenblüte fallen -- kriegerisch Ruhm befleckt -- o Jammer -- 
  nützen weibisch Träne -- -- fahren fort -- Auge trocknend -- handeln -- aufricht tief Fall -- 
  Gefahr fest Führer schließen -- vereint -- mutig Wille aufopfernd Sinn retten -- Klügel Absonder Verderbe führen -- 
  männlich Sinn -- allgemein -- Anschein -- 
  unglücklich Kaiser finden treu Volk -- Schmerz vergessen -- verehren Herrscher trösten -- 
  verlieren -- 
  neu Heer ziehen nahend Feind entgegen -- gespannt Erwartung -- wendet Blick gen Osten -- 
  Deutschland fallen Bund -- Vormauer andringend Koloß Norden -- 
  tief schmerzt Abfall Volk -- 
  schmäht tapfer deutsche -- teilen Ansicht -- 
  deutsche -- sobald bloß Druck Augenblick Betracht ziehen -- -- 
  Last Kriege Jahrelang Einzeln drücken -- Ursprung vergessen Menge unbeachtet -- Sinn Freiheit Menschenrecht allgemein lebhaft -- 
  fühlen fesseln -- klagen Frankreich -- erheben Kraft -- einst Joch Römer -- siegten -- 
  Geben Gott -- blutig Saat golden Frucht tragen -- volkswill Ehrenwert entsprungen Großtat deutsche -- tief Wunde -- Frankreich schlagen -- 
  möge Gefühl Kraft entschlummern -- gelingen einst -- Frankreich vergebens -- 
  Vater nah heranwälzend ungewitter Krieg ernst Blick entgegen -- 
  treffen Vorkehrung begreifen -- beschränkt Ausgabe -- suchen Einnahme Weise erhöhen -- Verkauf -- völlig Wert Ding erreichen -- 
  böse -- -- baren Hilfsquell zuviel -- 
  pünktlichst Zahler öffentlich Abgabe -- freigebig -- freiwillig Beitrage -- 
  Vergünstigung -- längst Einwohner unser Besitzung zugestehen -- suchen gerichtlich Kind Kindeskind hinaus sicher stellen -- beweisen Ängstlichkeit -- Verwunderung setzen -- 
  Ueberhanpt handeln redet Sinn sterbend Rechnung Welt Himmel abschließen -- obschon blühend Lebensfülle stehen -- 
  ängstlich umarmen fragend Auge -- blicken heit -- 
  Virginia -- -- begreifen Not tun -- Not tun -- tragen Pflicht Ehre gebieten -- 
  O -- Vater rufen -- Verlust -- verlieren -- 
  verliere -- verlieren -- ernst -- 
  ewig hallen Wort Seele -- 
  rauh Novembertag -- Sturm heuln Säulengang Gebäudes -- jagt Blatt hoch Ulme unser Fenster vorüber -- freundlich leuchtend Kamin flüchten -- Pfarrer eilig -- gewöhnlich -- Zimmer treten -- wissen -- fragen ängstlich -- 
  -- fragn -- 
  Gerücht böse -- stockend -- Feind Rheinübergang wagen -- Widerstand finden -- 
  Schwiege starr Bestürzung -- 
  erfüllen -- brechen Vater -- dunkel Ahnung -- formloses Nachtgespenst zuschreien -- weder klar -- teilen wagen -- 
  entscheiden -- Franzose einsehen -- Eins übrig bleiben -- Faust bewaffnen -- Thron schützen Herd -- 
  schweigen blicken erwartungsvoll -- 
  stockt Sprache -- 
  -- Virginia -- fragt Pause -- äußerst -- 
  -- Vater -- fragen zitternd -- 
  Vaterland Sohn -- -- 
  edelst -- rufen -- Mut kehren -- 
  -- Vater -- sehen mußt -- weibisch Tran hindern -- 
  Sorge Tochter -- sterben wissen -- 
  leben -- hoffen -- -- ziehen Brust -- 
  unglücke Tod entlaufen -- feige Flucht -- entehren -- Schande überleben -- 
  versprich -- mutig fort wirken -- Kraft halten -- letzter Stütze brechen -- selber treu bleiben Zeit Verrat -- 
  schwören -- Vater -- rufen schluchzend -- 
  schwören Wert bleiben Zeit -- -- 
  fromm Sinn stärken -- Fräulein -- wackeren Pfarrer -- 
  Virginia tragen Göttliche Busen Form erhaben -- erwidern Vater -- 
  Gerührt begeistert heben Hand gen Himmel -- rufen -- -- -- -- wollen -- -- 
  treiben Vater eifrig Bewaffnung -- 
  Dienerschaft Einwohner folgen -- 
  hoffen anfangs allgemein Landwehr einrichten sehen -- -- unser südlich Provinz -- Stande -- 
  Heer verstärken -- Vater -- Abreise bereit -- 
  Laß Vater -- flehen -- 
  weiber gehören Kampf -- -- Teilnahme kriegerischen Auftritt Unnatur -- entschuldigen lassen -- unfreiwillig zwingen -- 
  erbeben Innere Blut Mord -- erwidern -- laß nahe -- hören -- Welt -- 
  -- entgegnen -- Reise -- zuvörderst Paris -- 
  Punkt wohin Feind streben -- Herz Staat -- Verteidigung ausgehen -- 
  alt ehrlich Antoin treu Mannon begleiten -- -- 
  treffen Anstalten -- Vater versehen reichlich Gelde Abwesenheit -- 
  Abend Abreise befehlen -- Leute zeitig Ruhe schicken -- schlief Zimmer -- gehorchen -- 
  eintreten -- Kästchen Tisch stehen -- 
  sehen Virginia -- -- längst Zeit Not sparen -- einfach Lebensweise -- 
  fünftausend Napoleondor -- gleich Summe amerikanisch Staatspapier -- 
  Kampfe Unabhängigkeit erleben -- Vaterland Geldverlegenheit befinden -- hilfn -- -- gib Kaiser -- Kaiser -- hergestellt geschützt Ordnung erwerben -- 
  -- nimmer denken -- Trümmer -- retten -- 
  schließen Kästchen -- laden -- schwer tragend -- Schulter -- reichen Blendlatern Werkzeug -- gehen schweigend Weg Kapelle -- 
  nehmen Marienbild herunter -- öffnen unbemerkbar Höhlung Gemäuer -- schieben Kästchen hinein -- schließen unbemerkbar -- hing Bild Stelle -- 
  heilig Stätte sehen -- fragt leis Herz -- 
  sinken kniend Stufe Altar -- beten -- Ewiger gib Kraft -- 
  flehen -- Unerforschlicher -- rufen Vater -- knien -- 
  Anblick erschüttern tief -- bewegen sehen -- 
  O -- fahren betend Betrachtung fort -- Weg dunkel -- Frage -- drängen Lippe -- beantworten Einsicht -- frommen -- 
  wissen -- Einsicht menschlich -- irren allgemein Sterbliche -- bleiben gut wissen -- reinst Wille einzig sichr Richtschnur -- Folge -- Ausgang stehen -- 
  Segne Vaterland -- 
  untergeh künftig Geschlecht -- Menschheit -- gib Entsagung Kraft -- laß Edel fallen -- 
  erheben mutig -- ziehen Arm empor -- 
  gehen stärken vertrauen Wohnung -- Ruhe kräftig schmerzlich Abschied -- 
  Weinend umringt Bewohner umliegend Gegend -- 
  einzig Familie Vater Abschied -- 
  segenswünsche erfüllten Luft -- jung Mannschaft freiwillig Dienst nehmen -- stehen ebenfalls bereit -- beritten begleiten -- Vater Anführung fechten -- 
  Greis geben Jüngling kräftig Ermahnung -- Mutter zittert Leben Sohn -- empfahl Sorgfalt Erhaltung gut Herr -- 
  Beschützet unser Vater -- beschirmen Gefahr -- Aufopferung -- eur Leben -- rufen -- 
  Vater tief rühren -- Träne fließen reichlich -- 
  --- Weg Paris Truppe bedeckt -- Richtung Armee eilen -- 
  Vater unschlüssig -- anschließen -- indessen setzen unser Weg fort -- Hauptstadt -- sicherst Aufenthalt -- geleiten -- 
  langter heiteren -- 
  Anblick vieler Pracht wogend Getümmel Entzück erfüllen -- Seele schreckend Gegenwart bang Ahnung teilen -- 
  gewinnen Paris -- geschichtlich Hinsicht -- Interesse -- Gegenwart abziehen -- 
  Erzählung Kindheit vergegenwärtigten -- 
  Schauplatz Trauerspiel ehemals Gräuelscene -- Großtat -- wechselnd Schauder Freudenträne erfüllen -- 
  hierher wünschen -- 
  -- Märchenhaft scheinen rauh Wirklichkeit -- 
  furchtbar Bastille gestehen -- schrecklich Guillotine permanent tätig -- 
  altertümlich Dom Tempel Vernunft weihen -- erheben rein Stil majestätisch Pantheon -- 
  Gegenstand Geist beschäftigen -- 
  wunderen -- Pariser Denkmal leichtsinnig umh laufen -- haschend Tand leer Zerstreuung -- Genuß Augenblick -- 
  erstaunen wachsen -- -- ernst Bedrängnis -- scherzen witzeln hören -- 
  wehe -- Herz bluten -- 
  persönlich Bekanntschaft veranlaßen Vater -- untergebene Korps Marschalls Marmont schließen -- Sage -- Marschall beauftragen -- Paris decken -- 
  rechtschaffe- Familie bringen -- Mutter wohnen -- gebar -- 
  Wirtin verwitwet -- leben Töchter -- Alter -- still einziehen -- 
  erkennen Vater Erläuterung -- freuen -- Mädchen sehen -- Geburt Schoße wiegen -- 
  Merkwürdig gebären lieb Kind -- -- hören Donner Geschützes -- Vivatrufen Augenblick Geburt -- 
  Wahrlich -- Prinzessin begrüßen -- 
  weiber schrecken lärmen -- Vater Zimmer stürzen -- frei -- -- Gott -- weinen Kind -- 
  lieben schön Blasse -- unglücklich Frau ganz Herz -- 
  -- -- Mutter -- 
  treten Träne Auge zuversichtlichen Frage -- 
  folgend Erzählung dämpft Frende ehrlich Frau -- vernarbt Wunde brannen -- 
  Vater empfehlen würdig Matrone mütterlich Aufsicht -- 
  Sorge -- -- Tochter -- Augapfel -- 
  verlassen -- wehren tapf Feind -- 
  arm Kaiser -- Gott segnen -- fast all Gegner erwehren -- 
  -- Kunst -- Hund Löwe Tod -- Sprüchwort -- 
  schwatzen Fort -- Zimmer führen -- Mutter gebar -- 
  unnennbaren Empfindung werfen Bett -- ehemals arm Mutter Träne weinen -- 
  -- rufen -- Erdenschmerz entnehmen -- 
  Herz erleiden -- Hättest erleben -- 
  Wirtin freundlich Tochter tun möglich -- Abreise Vater erheitern -- 
  Mannon schließen gewohnt Liebe -- ehrlich Antoin täglich Feldpost -- Brief erkundigen -- erhalten -- 
  Vater mehrere glücklich Gefecht beigewohnen -- sprechen Mut -- 
  Nachricht Armee lauteen günstig -- Kaiser stark -- Rhein vorzurücken -- hofft Feind folgen müssen -- -- Kriegstheat Grenze hinaus verlegen -- 
  Eitle menschlich Hoffnung -- trüglich Berechnung endlich Verstand -- Buche Schicksal stehen schreiben -- Operationsplan erfahren Kriegsrat -- 
  Feind rücken -- unbekümmert gefährdet Rückzug -- Paris -- Marschall Marmont müssen Verteidigung denken -- besetzt fest Stellung Montmartre -- 
  Vater Gelegenheit Mal Stadt -- Gegenwart erfreuen -- 
  Gesellschaft befinden jung Pole -- Lanzier -- Adjoint Marschalls -- jung schön Mann voll Feuer Mut -- Kaiser Herz ergeben -- 
  natürlich Leutseligkeit Zuvorkommenheit Vater -- vorzüglich Fremd anziehend -- Seit besonderer Aufmerksamkeit widmen -- Zug Charakter schätzbar -- 
  lieben gewiß Vaterland Mitbürger glühend Seele -- wovon Leben Tod unwidersprechlich Beweis geben -- 
  stolz -- Franzose -- eitel -- erkennen Wert jeder fremd Volk -- vornehm Absonderung leiden -- Vaterlandslieb ausgeben -- 
  Kind Vater -- pflegen sagen -- zeigen gütig Vater -- gleichverteilt Segen -- -- -- wohlgefällig -- 
  schlagen unartig Kind Spielgerät -- hoffen -- einst vernünftig -- Bruderlieb umfassen -- 
  freilich -- Flegeljahr dauern -- Partei desjenigen nehmen -- gemeinschaftlich Mutter -- -- schwächeren -- -- meister scheinen -- vergessen -- Gegner gemeinschaftlich Vater -- Fehde vorüber -- eifre jeglicher gute -- legen Maule -- kindisch prahlen -- Grund Streit -- 
  einzig Stückchen Brot geben -- hungernde fremde -- -- reichen -- einheimisch Bruder fände eher Hilfsquelle -- -- Haus Gelegenheit unbekannt -- 
  denken fühlt edl Vater -- gleichen -- 
  O -- schön Bild mal Stunde Abschied -- stehen fest ruhig Heldenblick -- 
  Freundlich trocknet Auge -- streichen Locke Stirn -- 
  arm Virginia -- -- schlimm -- -- handeln -- mußt Schicksal leidend erwarten -- 
  meister Mut vonnöten -- 
  schau Gefahr standhaft besonnen entgegen -- -- 
  lassen Lage -- jeder Weib zittern -- zittre -- treu Herr dein Schicksal bleiben -- 
  -- Freund -- -- Polen wendend -- Mädchenseel liegen Römersinn männlich Stärke -- Waffengefährt -- 
  Fremde verbeugen -- ehrfurchtsvoll höflich -- erröten verbergen -- empfehlen Vater -- 
  stolz Fräulein -- Jüngling -- drücken Hand heiß Lippe -- Kaiser Ehre heißen begeistern -- Virginia Feldgeschrei -- vergönn Ritter -- Farbe tragen -- 
  erstaunen Ernst -- womit Wort aussprechen -- 
  Lächelnd streift blau Band Haaren -- reichen -- küßte Begeisterung -- schlingen Hals -- 
  romantisch Spiel heit Lichtstrahle düstre Abschiedsscene werfen -- wehren Vorgefühl -- Herz zersprengen -- 
  trennt -- fast Stimmung -- -- Lied Troubadours -- ehemals Dame Ritter Schlacht ziehen sehen -- 
  besonnen Vater unterhalten freundlich Scherz -- letzter Mal umarmen -- fühlen leises Zittern arme -- plötzlich ungeheur -- stechend Schmerz durchbeben -- 
  sogleich fassen -- setzen wohltätig Scherz fort -- lächelnd -- leben Fräulein gedenken eur Gebet -- 
  schwingen auf Pferd -- verschwinden schnell Blick -- 
  jung Pole küßte Zipfel blau Band -- neigen -- folgen Blitzesschnelle -- 
  -- lieben freundlich Mensch -- -- 
  Peinlicher -- 
  Kindheit Vater bleiben -- Gedanke austauschen -- verstehen -- billigen befriedigend berichtigen -- 
  -- 
  Kreis umgeben -- vermögen untergeordnet Ansicht fassen -- berechnet Lebensmittel teuer -- hinaus -- sehnt -- leichtsinnig rennen Fahren -- Drängen Theatern Schauspiel -- beleidigt Augenblick tief Seele -- 
  empörend -- vornehm reich Welt -- scharenweise eilt -- Sache Land Feig verlieren gebend -- denken -- Schatz Sicherheit bringen -- 
  Zeichen böse -- dachen Kummer -- 
  häufigsen -- liebsn Spaziergäng Boulewarts aux Italien -- Montmartre nah -- wagen weilen -- Antoin gesellschafterinne begleiten -- Barriere -- 
  weniger vernahm Kanonendonner -- fern nah -- erfüllten kriegerisch Szene Vorstadt Montmartre eigentlich Stadt ziemlich ruhig -- 
  Kontrast auffallend -- gehen kommen -- 
  geputzt Welt Tullierien -- Champs-ellisees lustwandelen -- Truppen-Abteilung Art -- Proviantwag -- Geschütz -- bewaffnet Bürger -- kommend gehend -- Marketender Fuß Pferd -- eilend -- lärmend -- all Geräusch Artilleriesalve -- Gewalt Erde beben scheinen -- 
  Szene neu -- sonderbar ergriffen fast persönlich Lage vergessen -- 
  Tochter Wirtin beschwören -- heilige -- Haus -- voll Furcht Schrecken -- -- gefesseln Schauplatz -- hinaus verlegen -- 
  -- nachgeben -- Forderung erschöpft Natur befriedigen -- finden sicher Wohnung Ruhe -- ziehen unwiderstehlich Gegend -- 
  dacht Augenblick -- unerklärlich -- 
  Krieg Schlacht geschichtlich Reiz -- niemals ausführlich Erzählung Augenzeuge -- innerer leiden -- anhören -- Beschreibung Wunde verursacht heftigst Schmerz unverletzt Gliede -- niemals entschließen -- Taube Huhn schlachten sehen -- 
  -- Blutvergießen nahe -- blutend verwundeter begegnend -- leben -- 
  erklären -- führen verhieln -- 
  Besorgnis Vater regen lebhaft Herz -- Eindruck -- Größe Augenblick lassen überwiegend -- 
  -- gespannt Erwartung -- teilen einzeln verwundeter Tücher Geld -- hegt Hoffnung siegreich Ausgang -- Gerücht verbreiten -- Kosak dicht Barriere streifen sehen -- 
  Verweil -- 
  reißen Gewalt fort Wohnung -- 
  -- daheim -- eingeschossen Zimmer -- ergriff quälend Unruhe -- 
  plötzlich Stille folgen Donner Geschütz -- Straße minder geräuschvoll -- öd -- fragt bang Neugier Nachbar Nachricht -- widersprechend -- unsicher -- 
  lassen plötzlich Pferdegalopp Straße hinauf vernehmen -- ahnungsvoll stürzt Fenster -- 
  jung Pole -- -- Staub bedeckt -- Pferd springen -- 
  furchtbar Vorgefühl werfen regungslos Sessel -- Anblick schrecklichsen -- ehe Lippe öffnen -- 
  Verzweiflung Rang Zügen -- Bläß Stelle Jugendröte treten -- 
  sinken Fuß -- 
  verloren -- hauchte mühsam hervor -- 
  Vater -- rufen fast erstickend -- 
  ziehen Portefeuille Bildnis Mutter Busen -- 
  letzter Andenken Edle -- Lebewohl -- vernehmbar -- 
  vernichten -- Träne -- 
  -- fahren fort -- Vater sterben beneidenswert -- Schlacht -- entscheiden -- Hoffnung Seite -- 
  leben hoffen Ruhm Freiheit Vaterlande erkämpfen -- 
  vorbei -- 
  drücken heftig blutbefleckt Andenken Mund -- sinken Schmerz -- 
  Frau eilen Hilfe -- 
  Frage erfahren -- früh -- ferner Begebenheit -- 
  schimpflich kapitulieren -- 
  Frankreich Ehre Kaiserkrone wankten -- vernehmen -- 
  Fräulein rufen jung Pole drücken kalt Hand Brust -- kühn -- hegt Hoffnung -- 
  tranm schön -- 
  herabgestürzen himmeln -- 
  Verlasse gefunden -- rufen Pflicht -- bleiben Herr -- wählen Stern -- Tod trennen Schicksal -- 
  ermannt Augenblick -- Feuer Jüngling regen Lebenskraft -- 
  -- -- -- wohin Pflicht Ehre rufen -- Achtung begleiten -- 
  neigen nieder -- drücken leidenschaftlich Brust -- 
  gehen wert bleiben -- rufen -- leb Welt -- -- -- -- 
  Matt -- dumpf Fühllosigkeit -- fallen arme weinend Mannon -- 
  übergehen zerreißend Empfindung nächster Stunde -- schrecklich -- 
  lindernd Tran brennend Schmerz kühlen -- Gehirn bringen verworren gräßlich Bild hervor -- 
  erbarmt Natur -- gütig -- -- retten Sinn betäubend Krankheit -- 
  Fieberhitze liegen -- Anschein -- Raub Tod -- allmählich schwach ordnet Bewußtsein -- 
  Zustande Kindes -- Größe Verlustes begreifen -- lernt Meinig fassen ertragen -- 
  -- Leben Sonne -- -- graut finster Nacht -- gelassen -- 
  Kind plaudern -- fürchten -- redet leise -- gegenwärtig scheinen -- 
  hören red Vorfälle Tages -- Anteil verstärkt langsam -- Beobachtung genau -- Ansicht unverändert -- 
  äußern überall Behutsamkeit -- Schreckenszeit gewöhnen -- merkt seicht Trostgründe -- womit unabänderlicher vorteilhaft Licht stellen suchen -- Trostes bedürfen -- 
  vermied Äußerung -- -- nächst persönlich Verlust -- schmerzlich bewegen -- teils körperlich Schwäche -- teils zwecklos halten -- ohnmächtig Weiberstimme erheben -- Million Männerstimme schweigen müssen -- Geist Vater setzen Gedanke Gespräch fort -- 
  Sache volke verlieren -- -- Sache Fürst siegen -- zwanzigjährig Blutvergießen -- 
  Mann Jahrhundert verlästern -- liegen Größe -- 
  Flecken Mähler erscheinen Riesenfigur groß -- Pigmee finden Guliwer abscheulich -- 
  groß Verbrechen scheinen -- -- Volke gebären -- Weg Throne bahnen -- Volk bestätigen -- 
  geboren Fürst -- Geschichte Held Vorzeit erheben -- Eroberunge Verbrechen anrechnen -- 
  Regierung Besitzergreifung beflecken -- beweisen neue Zeit Eroberunge Rußland Süden Osten -- Handlungsweise Engländer Ostindien Teilung Polen -- 
  besiegter tragen Schicksal Größe verbürgt Stärke Geist -- eitl Ehrgeizig erliegen -- -- stolz Selbstgefühl -- Fessel erhaben dünken frei -- 
  mehrere Woche -- bleiben -- Zustand Schwäche -- Bette festhalten -- einzeln Stunde Wohnzimmer -- Sofa -- Familienkreise unser Haus beiwohnen -- 
  -- Krankheit -- Veränderung zugetragen -- 
  jung deutsch Freiwilliger Jäger einquartieren -- kurz einheimisch -- 
  Bekanntschaft wehe -- Stand -- Jugend liebenswürdig Sanftheit Bescheidenheit erinnern lebhaft lieben Emil -- 
  -- denken -- tausend schmerzlich Betrachtung drängen leidend Gemüte -- 
  Träne füllt Auge -- schön Jüngling ansehen -- edl Haltung -- 
  besuchend Kamerad -- -- kindisch eitel -- Unbillig -- anmaßend -- großprahlerisch -- zeichnet Geistesbildung -- Bescheidenheit Billigkeit Urteil -- 
  tapf -- geben rot Streif Stirn -- steif Fuß Zeugnis -- Lützen tapfer kämpfen -- Wunde tragen -- 
  merken -- schön Freiwilligen Henriett -- Tochter Hausee -- innig Neigung entsponnen -- 
  Altest -- Nancy -- -- Civil-Dienst angestellt Landsmanne versprechen -- wachsend Zuneigung Schwester mißbilligend Auge -- 
  -- Gegenwart -- Familien-Streitigkeit -- 
  Gott Ketzer -- seufzter fromm Mutter -- 
  edl Mensch -- lieb Mütterche -- besänftigend -- brav menschlich Rede handeln -- sprechen Eltern Geschwister zartesn Ehrfurcht Liebe -- Gott -- zufällig Äußerung -- vertrauen Dankbarkeit -- 
  schön Kind -- schön -- erwidern alt -- -- Mensch -- unbemitteln -- hören -- Glaube -- 
  Gott entscheiden -- antworten -- Form Menschenwerk -- 
  kosten Mühe -- Gewissen fromm Frau beruhigen -- leicht Stande -- leidenschaftlich Vorurteil heftig Nancy besiegen -- 
  Fremder -- rufen Erbitterung -- Feind -- 
  fremd -- 
  feindselig Nancy -- fragen -- 
  Himmel reden -- heftig -- 
  wissen Gewehr Brust dein Vater gezielt -- 
  Zufall fügen -- erwidern -- Anstrengung -- schätzen -- 
  Schicksal stellen -- tat Pflicht -- verfocht Meinung Sache Fürst -- persönlich Streit -- setzen Gebräuch Zweikampf fest -- Beendigung Sieger besiegter umarmen -- eher beendigt Völkerfehd geschehen -- 
  deutsche -- fühlen fesseln -- sprengt Kette -- erheben Kraft -- bewaffnet -- besiegen bewaffneen -- 
  verargen -- 
  tun -- -- Freiheitsdrang ängstlich Besorgnis Aufrechthaltung -- Ding tun -- 
  -- deutsche bewunder lieben -- 
  sagen -- männlich Jugend Deutschland Heldenjugend -- ständen -- 
  zumal edel Jüngling -- Gastfreund -- -- unkriegerisch Weiber -- 
  verfochen täglich Eifer Sache Liebende -- 
  Fremd -- Henriett -- erfahren -- bezeugen zarte Teilnahme lieb krank Fräulein -- nennen -- 
  Freude hören -- Henriett Heimat begleiten -- gewährt Trost -- glauben -- Autheil erwünscht Ausgang Schicksal -- 
  Aufenthalt Paris unerträglich -- 
  Geräusch betäuben -- Karakterlosigkeit Einwohner ärgern -- 
  sehnt Stille Chaumerive -- täuschend Trostgefühl -- alt Welt wiederfinden -- Schwäche verhindern -- Anstalt treffen -- 
  Mannon sehnt stille harmlos Tänze unser Dörfchen -- 
  Antoin -- ehrlich Antoin -- Dienst unser Haus -- arme tragen -- betrüben herzlich Verlust gut Herr -- Schmerz -- 
  -- plötzlich Schicksal unvorhergesehen Wendung -- 
  abgereisen -- vergessen bleiben -- Lage -- beraten -- Plan befolgen -- Umstand aufgedrungen -- 
  weißen -- lieb Adel -- ehrlich alt -- Tuilerie herumschlendernd -- Mutter erblicken -- Schwester teuer Herr -- 
  Freude -- 
  erfuhren Anwesenheit -- Minute halten euer Wagen Tür -- 
  euren arme -- Entzück verwaist Herz -- 
  überlassen anfangs Trunkenheit -- Wehmut gemeinschaftlich bemächtigen -- 
  weinen klagen -- kündigen Mutter -- folgend abhol -- Hotel wohnen -- 
  versprechen bereit -- dunkel Abneigung spüren -- 
  gut Hausgenoss hört Betrübnis Veränderung -- 
  Glanz eurer Erscheinung -- Titel Gräfin -- Mutter sprechen -- arm Leute schüchtern -- 
  kosten Mühe überzeugen alt Virginia -- bleiben wollen -- 
  weinen herzlich -- Mutter fahren -- 
  Hotel angelangen -- führen Mutter Kabinett -- zärtlich umarmt -- mütterlich Liebe zusichern -- -- Gemahl -- Herzoge -- vorstellen -- meinetwegen sprechen -- Vorteil stimmen -- 
  unmöglich beschreiben -- widrigen Eindruck fremd -- vornehm Wendung -- 
  -- fortfuhr -- 
  Herzog wissen bloß -- Vater Tod -- bitten -- verhehlen -- -- Waffe Hand -- Sache unser König bekämpfend -- sterben -- 
  nachteilig Gunst Hofes -- Herzog äußerst mißfallen -- 
  erstarren -- O Vater -- brechen schluchzend -- Tochter verlangen -- Vaterlandsliebe heldenmütig Aufopferung verleugnen -- 
  vernünftig -- Virginia -- Mutter -- Ding verändern -- darein finden lernen -- eingesogen Vorurteil ablegen -- 
  Bruder -- Umstand -- schlecht Sache verflochten -- Friede Seele -- 
  still Verlust weinen -- Untersage -- mütterlich ansehen -- öffentlich Verlegenheit setzen -- 
  schweigen -- ausdrücklich fragen -- entrüsten -- Rührung begonnen Unterredung enden ziemlich lau -- 
  sobald melden -- Herzog sichtbar -- -- Mutter begleiten -- Saal führen -- 
  empfangen artig -- stellen Haupt Familie -- Testament Großoheims -- versichern väterlich Schutz -- 
  umging früh Beziehung -- viele schmeichelhaft Vergnügen -- Welt einführen -- gewiß Erfolg auftreten -- 
  -- fügen -- Mutter wendend -- Bedeutung -- hinzu -- Sorge tragen -- Nicht all Glanze auftreten -- Annehmlichkeit unser Range gebühren -- 
  lieb traurig Farbe -- fahren -- Blick -- fort -- raub schön Wang Feuer -- -- 
  entlassen -- höflich Wendung -- 
  betäuben befremdend Szene Zimmer -- Arm flogst -- 
  warst alt -- herzig Adel -- 
  Liebkosung -- heiteren Scherz beruhigt empört Gemüt -- 
  Bruder Louis lassen melden -- Bekanntschaft schön Cousine schnell -- 
  warst Zeug -- Benehme Manier auffielen -- Lachtest mehrmals laut -- verlegen Befremdung -- 
  -- werfen Ausland unser Landsleute Frivolität Leichtsinn -- Unrecht -- Aufenthalt Paris Unwillen wahrnehmen -- überbot Ausländer Muster Art sehen -- 
  froh -- Vergnügung rissen -- Neigung -- tausend Mal schwor -- 
  fing atmen -- fremd Welt finden -- 
  tausend Stimme innere rufen -- nimm -- nimmer meinige können -- entschließen -- näh Auge fassen -- reiflich erwägen -- vonnöten -- 
  verleben angenehm -- -- Musik Lese aufheiterten -- 
  Mutter meistens gütig liebreich -- schön Provence -- 
  Herz neigen kindlich -- schaulustig Art -- vorschlugst -- nah Spaziergang besuchen -- Theater fahren -- weigern -- Trauer -- anfangs dankbar zart Schonung halten -- Verlegenheit -- Vorschlag -- wissen kleiden wollen -- Tracht Aufsehen errege Ablegung Gefallen erzeig -- enthalten groß Leidenschaft Hamlet ausrufen -- 
  O Himmel -- vernunftlos Tier lang trauern -- 
  Mutter schweigen beschämt -- 
  vertrauen vernichten -- obschon Auge liegen -- -- Gefühl -- Vorschrift dein Vater -- handeln -- 
  Herzog -- vergibn Adel -- dein Vater nennen -- fremd -- kündigen -- eurer Familie -- fast nennen -- Herzog mehrere auswärts speisen -- erscheinen nämlich Mittagstafel -- 
  bemerken -- öfters finster mißfällig Blick werfen -- 
  aufgehoben Tafel nähern -- nötigt Fenster treten -- 
  Farbe -- anfangs mißbilligend erklären -- fragt -- gebietend Stimme -- 
  Trauer vorüber -- stotteren -- 
  Trauer passen -- herrisch -- tote gestern begraben -- Trauerzeichen zweideutig -- -- Haus -- sehen -- 
  zudem Montage Prinzessin -- vorstellen -- bereiten gehörig -- 
  erwidern -- lassen Wort -- 
  -- Gräsinn Nicht -- fahren mild fort -- fügen wissen -- 
  entfernt Zimmer -- 
  wankt Meinig -- Mutter folgen -- umarmen -- Rührung -- 
  ersparen -- -- wolltest Winke verstehen -- 
  brechen Träne -- 
  Beruhiger -- lieb Virginia -- -- Weiber Mal gehorch gebären -- gib Eigensinn -- 
  Eigensinn -- o Himmel Erde -- -- 
  kamsen liebkostest gutmütig Art -- redetesen freundlich -- eure Friedensvorschlag annehmen -- -- außerhalb Zimmer erschien -- bunt kleid -- öffentlich Gesellschaft heiter Gesicht zeigen -- 
  O -- welcher Opfer bringen bittend Freundschaft -- Sehnsucht eilt Einsamkeit -- schwarz Gewänder anlegen -- Seele betrüben -- 
  Welch Wechsel -- -- Schein Zwanges fühlen -- frei aufwachsen -- Reh Wald -- umgarnt tausend Netz Ausgang gewahrend -- 
  Augenblick Notwendigkeit -- lassen einführen fremd Welt -- 
  voll Besorgnis auftreten -- eifrig bemühen -- Mut sprechen -- 
  müssen innerlich lächeln -- fehlen -- 
  fühlt Widerstrebe -- Ängstlichkeit -- 
  imponierte lassen Gleichgewicht -- 
  scheinen allgemein überrascht ruhig Besonnenheit -- 
  spiegelglaten säl Hof -- hoffähig Leute -- sicher Gang -- fremd Erscheinung -- 
  fast Fremde Glück -- ungünstig aufnehmen -- gestehen -- gewiß Berühmtheit gelangen -- unterhalten Bruder unaufhörlich glänzend Eindruck -- -- Glück unerträglich -- 
  unmöglich Maske Unterwürfigkeit nehmen -- Schmähung verflossen Zeit einstimmen -- 
  ewig witzelnd -- schal Unterhaltung -- -- Viertelstund -- Ball Politik -- neu Mode neu Mordtat überspringen -- tief Seele zuwider -- 
  wahrhaftig Charakter -- Eindruck verberg Gesellschaft empfangen -- 
  tischgenossen -- -- Kälte -- rächen -- machen boshaft Vergnügen -- Verlegenheit setzen -- Meinung neu Begebenheit hören wünschen -- 
  suchen geschickt heraus wickeln -- weder Meinung verleugnen -- Fremde wehe -- Mäßigung Angreifer kühn -- 
  Bruder gesellen selten -- 
  Herzog werfen -- Vorfall -- wütend Blick -- Mutter halten geheim Strafrede -- wehe tun -- überzeugen -- 
  deutlich Plan heraus -- ahnden -- Louis vermählen -- 
  gehörsen Familie -- -- mußt Gesinnung unsrigen ändern suchen -- 
  fühlen empört anmaßend Zumutung -- Erwiderungen Unterwürfigkeit ausdrücken -- 
  fing -- häufig schmäh kränken -- Bruder zuversichtlich -- herrisch Betragen -- 
  nennen schön Zukünftig -- behandeln Protestationen Scherz -- 
  halten -- altklug Miene -- Vorlesung Pflicht unser Geschlecht Gattinne -- Begriff übereinstimmen -- 
  lachtest geradezu -- brachtest Fassung -- lächeln -- lächerlich -- 
  Stunde Einsamkeit fing ernstlich -- denken -- drückend Lage entziehen -- 
  Chaumerive kehren -- -- glücklich -- ruhig leben -- finden einfach -- 
  waffnen Mut -- Entschluß Herzoge -- Mutter -- kindisch Einfall -- aufnehmen -- geraten -- denken -- 
  lassen förmlich Herzoge melden -- 
  Ruhig tragen Wunsch -- nächster Heimat abzureisen -- 
  schweigen Augenblick betreffen -- antworten haltend -- -- denken -- Gräfin -- anderer -- Haus -- -- 
  dankbarst Empfindung verlassen -- erwidern -- Aufenthalt Kindheit fordern unwiderstehlich -- 
  -- romantisch Hang ablegen -- -- antworten -- Sorge tragen Interesse auf gut wahrnehmen -- sicher Geschäftsmann senden regulieren -- wünschen -- Güte bestimmen -- -- 
  Pause Auge -- bescheiden -- nachdrücklich -- Chaumerive nachbarlich Besitzung Vater rechtmäßig Eigentum -- mündig -- 
  -- Töchter Familie niemals -- -- erwidern -- -- bitte vergessen -- Ehre -- Haupt unsrigen -- -- 
  Achtung bezeugen -- Herr Herzog -- legen Entschluß -- vieler Ruhe -- 
  -- Zustimmung ausführen glauben -- -- 
  -- rufen zornig -- -- sagen -- Wagen -- trotzig Republikanerin -- 
  Arm reichen -- König liegen -- Glanz getreue -- reich Erbinne -- Erhöhet -- Einleitung treffen -- 
  Hand Sohne bestimmen -- Bündnis stellen Partei zufrieden -- Meinung Gewicht -- Tochter hoch Abkunft Gesetz Konvenienz vermählen -- -- O Gott -- 
  hoch Abkunft -- rufen -- 
  -- Schleier Vergangenheit werfen -- -- erwidern -- -- Hof Enkelin Herzog Montorin ansehen -- suchen Gnade würdig -- scheuen Zorn -- -- 
  entlassen -- 
  verstören Zimmer -- heftig Tränenstrom gepreßt Brust erleichteren -- 
  Mutter erscheinen -- 
  Unglückliche -- -- mußtesen unangenehm Szene zuziehen -- kindisch Grille Wille -- 
  Hättest Augenblick nachdenken -- Würdest selber eingesehen -- unschicklich -- Chaumerive reisen -- 
  Vermählung Louis gewiß Gefälligkeit -- Woche führen -- 
  setzen Fall lieb Tante -- -- Seele fremd -- 
  Fremd -- rufen -- -- bitten -- 
  Louis lieben -- wußtest längst -- worauf Abneigung gründen -- jung liebenswürdig -- sichern hoch Rang Gesellschaft -- überdies Heirat Familie Mal beschließen -- hoffen -- Erziehung -- wissen -- Familie Gehorsam schuldig -- 
  Eltern fordern -- vermissen -- antworten fassen -- gewiß teuer Eltern niemals Hand verfügen -- Herz Rate ziehen -- 
  -- -- -- Bruder denken freilich bürgerlich -- unser stand Rede -- 
  hoffen -- Herz einnehmen -- Emporkömmling ehemals -- 
  rat -- Stille verbannen -- schlimm Spiel -- 
  schweigen -- versteckt Drohung fürchten -- Mucius Name -- Liebe heilig -- aussprechen -- 
  Mutter glauben fortdauernd Stillschweigen ruhig werdend Miene günstig Zeichen sehen -- glaubt nachgeben stimmen -- verlassen vieler Zufriedenheit -- wiederholt umarmt -- Tochter vernünftig Virginia nennen -- irren -- 
  Seele arbeiten Vorsatz empor -- Fessel -- Preis -- brechen -- mutig Gedanke Festigkeit Ruhe -- 
  Sobald -- fing -- nachdenken -- Ziel gelangen -- befinden ziemlich Labyrinth -- 
  Rechtmäßigkeit Forderung -- Anspruch Unabhängigkeit überzeugen -- wissen -- Gewalt Willkür -- 
  Kindheit machtsprüchen -- Gewaltstreichen Art gehören lesen -- Möglichkeit aufdringen -- -- eifrig streben scheinen -- alte stellen -- Bedenken -- Zuflucht nehmen -- 
  Schutz hoffen -- Gegner siegenden -- Freund unterdrückt Partei -- 
  gefahrvoll Amt Verteidigung belasten -- 
  Versperrt -- offenbaren Auflehna -- unglücklich Fall -- Weg Rettung -- 
  begreifen -- einzig Heil liegen Flucht -- Mute dürfen vertrauen -- 
  sobald hierüber einig -- fühlen beruhigen -- erscheinen -- gewohnt Heiterkeit -- wodurch Vorhaben täuschen -- 
  still Fuhr beobachten fort -- klar -- fast gefangener hüten -- 
  Kammerfrau geben -- Mannon ziemlich überflüssig suchen -- 
  antoin Pension -- entlassen Heimat kehren -- Abschied Hand küssen -- Mutter zugegen -- 
  vorbereiten -- drücken -- Goldstücke Andenken schenken -- unvermerken Zettel Hand -- worin Befahl -- Nachricht -- nächster Dorfe verweilen -- 
  Behutsamkeit finden Gelegenheit -- Mannon Vorhaben entdecken -- 
  Schlauheit Mädchen glich Treue -- schnell orientieren -- spielt Rolle vortrefflich -- sehnt Blumenufer Durance -- Freiheit -- 
  Reichlich Geld Sohn -- fing Spiel -- schau- tanzlustig stellen -- Bedienten Nachbarschaft öffentlich Ort besuchen -- worüber Mal Mißbilligung ernstlich Verweis Mutter zuziehen -- 
  Licht stellen -- nützen angenommen Meinnng Gang -- Antoin aufsuchen -- verabred -- 
  spät Haus -- wobei jung Mensch begleiten lassen -- aufschließend Schweizer schmeicheln -- spät Ausbleibe verschweigen sollen -- 
  Beschwichtig -- bringen mehrere Abend Fläschchen Madeira -- -- -- Liebhaber verehren -- Aufsicht Herr Weinkeller fahren -- Wein hitzig meinen -- Schweizer finden Geschmack -- 
  sicher -- mischen Abends leicht Schlaftrunk Wein -- Wirkung schnell kurz Dauer -- erquickt Nachhausekommen wartenden -- 
  Winke Benachrichtiget liegen wachend Bette -- 
  schnell stehen -- werfen Unterkleidung -- hüllen Tuch -- schlichen behutsam Treppe hinab -- 
  Schweizer liegen glücklich tief Schlaf -- Mannon Schlüssel -- öffnet -- erreichen glücklich Gaß -- 
  nächster Ecke erwartet antoin Wagen -- 
  Mannon Kleid -- Antoin Paß -- Tochter lautend -- sorgen -- 
  kommen Hindernis Barriere -- atmen tief -- Steinmasse liegen -- Gefängnis -- 
  Vergib -- teuer Adel -- wehe -- verlassen -- Gefühl Freiheit überwog Empfindung -- 
  Verlust Unglück Vaterlande fühlt Augenblick schwach -- 
  eilen schnell vorwärts -- gönnt notwendigste Rast -- 
  glauben -- Vorüberflug -- bemerken -- Stirn überall tief furchen -- Paris -- 
  Maße -- lang Hauptstadt leben -- glaub Volk hassen lernen -- 
  entwöhnen -- äußerer -- beobachtet Reise -- 
  hören Postmeister Pserdewechseln -- Veranlassung sagen -- 
  Fréjus -- Reich retten -- ahndet -- Mal Pferd geben -- gerettet Reiche Verbannung -- 
  tiefbewegt Stimme Mannes erschüttern -- 
  stehen Schwelle Greisenalter -- weinend schweigend reicht Hand -- 
  O -- Fräulein -- -- seinigen drücken -- Kampfe Vaterland Söhne verlieren -- wack Junge -- trösten -- Frankreich glücklich -- 
  all Blut -- Freiheit opfern -- vergebens fließen -- 
  verbergen schluchzend Gesicht -- zeigen Hand gen Himmel -- 
  -- Fräulein -- -- Gott Weg Weg -- Sterblichen geziemt Entsagung -- 
  schlagen Herz Ventoux Ferne erblicken -- hoch -- weiß Gemäuer Chaumerive sichtbar -- 
  Wagen fahren langsam -- verlassen -- fliegen Windeseile Fußpfade -- 
  müssen all lieb Verloren finden -- 
  -- finden -- 
  treu völkchen finden -- ausschweifend Freude umarmen -- fragt hören -- teilnehmend weint Vater Vaterland -- 
  Erquickend Träne -- verarmter Herz Menschheit banden -- 
  O bleiben -- getrennt übrig Welt -- vergessen -- 
  hoffen -- Pfarrer -- Rat einholen -- fürchten Sicherheit Aufenthalts -- Unruhe Verdruß voraus -- 
  müssen schwer Herz losreißen Wiege Kindheit -- 
  Weinend besucht Mal jeder Plätzchen Erinnerung -- kränzt letzter Mahl Grab Mutter -- Sommerblumen -- verschließen Zimmer -- Mut Einsamkeit stärken -- 
  alt Bilderbuch fallen Ahn -- mechanisch heraus -- schlagen -- 
  treffen Szene -- Athen Rom Held ruhig Verbannung gehen -- Volk Messenier -- stolz Sparta besiegen -- geliebt Heimat verlassen -- Sizilien Küste -- glücklich Himmel Provonce -- Freiheit Sitte retten -- 
  Klein unbedeutend erscheinen Schicksal Beispiel -- alt -- besonnen ruhig -- 
  packen -- nehmen gedingen -- lassen Abends Pfarrer bitten -- helfen -- Angelegenheit ordnen -- 
  sobald finst -- -- Antoines Begleitung -- Kapelle -- Vater -- ahnungsvoll Gefühl Zukunft Vermächtnis nieder legen -- 
  ziehen Kästche sicher Verborgenheit -- ehrlich Antoin tragen Zimmer -- 
  kniet Stufe Altar nieder -- schmerzlich Erinnerung dringen -- Standhaftigkeit verlassen -- ehrwürdig Pfarrer stärken -- Hinweisung ewig Vorsicht -- erteilen Segen -- 
  führen Zimmer -- -- antoin Pferd besorgt -- Wagen packen -- beauftragen Andenken -- Getreuen lassen -- trennen weinend -- 
  Kindheit treu Freund Haus -- -- Vater verlören -- 
  halten Pflicht Amt -- treiben Pflicht Selbsterhaltung hinweg -- Erhaltung besseren -- 
  -- finster Nacht reisen -- schwer -- weinend Menge trennen -- unerträglich fast -- geliebt Gegende allmählich entschwinden sehen -- 
  reist Antoin -- Marseille geleiten -- 
  folgen -- Kind trennen -- Mannon unmöglich Eltern entziehen -- Vorhaben verschweigen -- 
  lassen Aussteuer -- Anhänglichkeit -- trösten -- 
  Ankunft Marseille erkundigen sogleich Hafen -- finden segelfertig amerikanisch Schiff -- günstig Wind warten -- Anker lichten -- 
  Kapitän -- Philadelphia -- einnehmend Phisiognomien -- sogleich vertrauen erwecken -- 
  tragen Wunsch -- sogleich bereitwillig -- bequemen Platz Kajüte einräumen -- lebhaft besorgt -- Drang -- Schiff sofort besteigen -- Nachfrage vereiteln -- 
  lassen Sache Bord bringen -- trennt treu Antoin -- sorgenfreier Alter zusichern -- schmerzlich Rührung -- Bitte weit Umweg Heimat kehren -- 
  -- Mahl -- fremd Umgebung -- 
  Gegenstand -- Gesicht erinnern bekannt Vergangenheit -- 
  Eindruck neu -- erfüllen innig Wehmut -- 
  -- verlassen -- entreißen -- verlieren Augenblick -- 
  bedurft Wesen -- treu Brust Klage ausströmen -- 
  warst geliebt treu Seele -- 
  Gewiß Blatt -- gelangen -- regest Mitgefühl lesen -- 
  enthalt Rechtfertigung bedürfen -- 
  Mutter entschuldigen -- hoffen Wage -- 
  Ungern nehmen Zorn Welt hinüber -- ewig geliebt Schwester teuer Vater bleiben -- 
  Bring zärtlichst Lebewohl sagen -- Virginia unglücklich -- undankbar -- 
  --- Herzog betreffen -- Tod -- Erbschaft Besitzung -- hoffentlich früh trösten -- 
  Louis gewiß längst vergessen -- 
  Neigung Kind Konvenienz -- erreichen Wunsch -- lästig Zugabe -- fühlbar -- -- glänzend Verbindung -- Glanz viele erhöhen -- 
  gehören Chaumerive -- 
  -- Adel -- Schutzgeist verlassen Freund -- 
  glücklich -- gut Mutter empfehlen gleichfalls -- Kind -- Freund wahrhaft edl Bruder -- Nahme enkeln -- Liebe nennen -- 
  O -- Adel -- schön Sommermonde lieblich Täler wandelst -- gedenken -- 
  Sprich getreue -- bringen Gruß -- 
  Geißblattlaube ruhest tanzend Durance betrachtest -- lispeln leis Lüftchen Blüte -- denken -- Stimme Virginia -- 
  Geist umschweben -- Gefilde Selig -- lieb Gegende kehren -- 
  lang Brief schreiben -- Leben mal vorüber lassen Bedürfnis -- 
  Hauptmoment darstellen -- Grundzug angeben -- 
  vermeiden -- Gegenstand Ereignis Berührer -- fremd Person Beziehung stehen -- 
  -- unsrige -- behutsam -- Verfolgung aussetzen -- 
  abschließen alt Leben -- neu beginnen -- sterbend -- all irdisch Tand lassen -- lassen Europa verworren Angelegenheit -- 
  hoffen künftig schauen -- abgeschieden Geist Welthandel -- berühren -- 
  Reise mitteilen -- 
  -- Schauspiel -- Meer gewähren -- brauchen sagen -- Hamburg Begriff -- obschon Weltmeer ergreifend -- Nordsee -- 
  Fahrt angenehm -- Seefahrer versichern -- Welle brechen -- Schwank Fahrzeuge beschwerlich -- 
  Umstand zuschreiben -- -- Seekrankheit empfinden -- fürchterlich schildern -- 
  treten stark Wille entgegen -- bringen -- -- Verdeck -- zweckmäßig Nahrungsmittel -- vermeiden -- Übel ergriffen Passagier sehen -- 
  bleiben gesund -- erhalten Mut bedürfen -- 
  -- befreundet Equipage -- fing -- verlassen Mädchen interessieren -- 
  Kapitän -- beweisen herzlichst Freundschaft -- nah Zärtlichkeit grenzen -- 
  Ellison -- Vater -- Kaufmann Namens -- Chef ansehnlich Handlungshaus -- Philadelphia -- 
  Ellison Versprechen abgewonnen -- Eltern wohnen -- dorthin -- bekannt Haus -- Brief schicken -- machen -- schreiben -- 
  Ellison schön bauen -- blau Auge blitzen Feuer -- Muttersprache englisch -- sprechen fertig französisch -- Sprache drucken -- kräftig -- unterhaltend -- belehrend -- gesprächig -- 
  Gesellschaft helfen vorzüglich Länge Seereise verkürzen Kammer verlassen -- zierlich einrichten -- täglich Stunde schreiben zubring -- Aufmerksamkeit -- fest bereiten -- 
  schmackhaft Mal -- Spiel -- Fischfang -- Matrosentanz dergleichen wechseln -- 
  Konzert geben -- wobei Freundin Harfenspiel Stimme -- unverdient Ehre einernten -- 
  Reisegesellschaft bestehen Kaufleut New- York -- jung Maler Schweiz -- Florentinerinn -- Mutter Tochter -- Manne Vater nachreisen -- Havanna etablieren -- freisinnig -- toleranen Mensch -- 
  Reise -- einzig politisch Streitigkeit -- unsr fließen schnell angenehm -- 
  St. Helena nehmen Erfrischung -- 
  originell Fels mitten Wasserwüste -- 
  ergehen üppig Täler -- träumt Möglichkeit -- auserwählt Gesellschaft Freund -- abgeschied Welt -- glücklich leben -- 
  tunlich -- schwierig Landung -- unmöglich -- 
  Unweit Insel erhaben Schauspiel Seesturms -- höchst wichtig erwünschen -- 
  sehen Kopf schütteln -- zart -- furchtsam Adel -- Mal Freude wild Naturbegebenheit -- angeboren -- 
  Kind freut Durance Ufern brechen -- Gewitter Vater hinaus -- Mutter ängstlich verbergen -- 
  aufmerksam Schönheit -- Segen Erscheinung -- zeigen Zufälligkeit selten Gefahr Blitz -- -- lächerlich ansehen lehren -- Gefahr Leben bedenken vermeiden -- 
  sitzen Kind -- ruhig Platanus -- Donner krachen -- 
  stehen hundert Baum rings -- denken -- Strahl treffen -- 
  tun -- bestimmen -- Bette töten -- -- 
  Freut türmend Wasserberge -- heulend Orkan -- Behendigkeit Matrose -- verdoppelt leben -- legen Abend -- ruhig Hangmatte nieder Bett -- 
  Hand Gott -- überall -- 
  zitterst Adel -- sicher fest Land -- 
  O . 
  stehen Glutschwanger Vulkan -- trauen Stille -- Augenblick öffnen -- Flammenmeer hinunt schlingen -- 
  Schiffbruch fürchterlich -- 
  Verschlänge Ozean -- gezählt letzter ablaufen -- 
  Würfe freundlich Welle Ufer -- Gut höchst -- Leben -- frisch Mut retten -- glauben -- versunken Schatz trauern -- 
  Inhalt Kästchen Basis Sicherheit -- Inhalt -- 
  Sprache -- Musik Frucht sorgfältig Bildung -- sicher bequem fortkommen vornehm Welt -- bürgerlichen -- Geschicklichkeit -- Europa neu dürfen -- italienisch Strohflechterei -- Perlweberei -- u. S. W. ländlich Verhältnis letzter Kenntnis -- Fertigkeit erwerben -- überall -- belehrend -- nützlich -- 
  -- sichern Ansicht Leben Verhältnis -- 
  Standesunterschied -- Platze zufrieden leben -- Inneren selber bleiben -- 
  nah Ziel Reise gelangen -- 
  Küste Welt -- liegen blau Ferne -- 
  dünn Nebelschleier gebreiten -- Schleier Zukunft -- 
  hochklopfend Herzen blicken -- bergen -- 
  fürchten -- stehen -- 
  verlieren -- gewinnen ewig Wechselspiele Leben -- 
  gewinnen -- wünschen wissen -- 
  Ellison stehen Verdeck -- betrachten glühend Blick -- Auge wechseln ruhig -- Anblick blau Berg -- rasch Strömung Delawar -- Mündung Anker werfen -- 
  Reisegesellschaft verlassen -- Steuer Läng Küst -- Bay gelangen -- hinauf Philadelphia führen -- 
  schreiben -- 
  leben -- 
  -- Unterbrechung Störung -- Eindruck aufnehmen -- umring erwarten -- 
  Psych landen Acheron -- Lethe finden -- 
  gewiß -- 
  hineintauch dunkel Welle -- Bild Liebe -- Bild -- traut Adel -- 
  Bewahr meinig -- versuch -- schreiben -- Leb -- 
  Lebe glücklich -- 
  Leben -- 
  Frankreich glücklich -- 
  tausend -- tausend Lebewohl Virginia -- 
  Teil -- 