Wilhelm Meister Lehrjahre -- 
  Roman -- 
  Herausgegebe Goethe -- 
  Band -- 
  Frankfurt Leipzig -- 1795 -- 
  Wilhelm Meister Lehrjahre -- 
  Buch -- 
  Kapitel -- 
  Kennst Land -- Zitrone blühn -- dunkel Laub Gold-Orangen glühn -- sanft Wind blau Himmel wehen -- 
  Myrte still Lorbeer stehen -- 
  Kennst -- 
  -- 
  -- 
  -- o Geliebter -- ziehen -- 
  Kennst Haus -- Säule ruhen Dach -- glänzen Saal -- schimmeren Gemach -- Marmorbilder stehen sehen -- 
  -- arm Kind -- tun -- 
  Kennst -- 
  -- 
  -- 
  -- o Beschützer -- ziehen -- 
  Kennst Berg Wolkensteg -- 
  Maultier suchen Nebel Weg -- Höhle wohnen Drache alt Brut -- stürzen Fels Flut -- 
  Kennst -- 
  -- 
  -- 
  Weg -- o Vater -- laß ziehen -- 
  Wilhelm Morgens Mignon Haus umsehen -- finden -- hören -- früh Melina ausgehen -- -- Garderobe übrig Theater-Gerätschaft übernehmen -- Zeit aufmachen -- 
  Verlauf Stunde hören Wilhelm Musik Türe -- 
  glauben anfänglich -- Harfenspieler zugegen -- unterschied Ton Zither Stimme -- singen Anfing -- Mignon Stimme -- 
  Wilhelm öffnet Türe -- Kind treten Herein singen Lied -- aufgezeichnen -- 
  Melodie Ausdruck gefiel unser Freund -- Wort verstehen -- 
  lassen Stroph wiederholen erklären -- schreiben übersetzt deutsche -- 
  Originalität Wendung ferne nachahmen -- 
  kindlich Unschuld Ausdruck verschwinden -- gebrochen Sprache übereinstimmend -- Unzusammenhängende verbinden -- 
  Reiz Melodie vergleichen -- 
  fing Ver feierlich prächtig -- sonderbares aufmerksam -- wichtig vortragen -- 
  zeil Gesang Dumpfer düster -- -- Kennst -- drücken geheimnisvoll bedächtig -- -- -- -- liegen unwiderstehlich Sehnsucht -- -- Laß ziehen -- wissen -- Wiederholung -- dergestalt modifizieren -- bittend dringend -- treibend vielversprechend -- 
  Lied zweitenmal geendigen -- halten Augenblick inne -- Wilhelm scharf fragen -- kennst Land -- -- 
  Italien meinen -- versetzen Wilhelm -- woher Liedche -- -- 
  Italien -- Mignon bedeutend -- gehst Italien -- nimm -- frieren -- -- 
  -- lieben -- fragt Wilhelm -- 
  -- Kind still bringen -- 
  Melina -- hereinkommen -- besehen Zither freuen -- hübsch zurecht -- 
  Instrument Inventarienstück alt Garderobe -- Mignon ausgeben -- Harfenspieler beziehen sogleich -- Kind entwickelt Gelegenheit Talent -- kennen -- 
  Melina Garderobe Zugehör übernehmen -- Glied Stadtrat versprach Erlaubnis -- Ort spielen -- 
  froh Herz erheitert Gesicht nunmehr -- 
  scheinen anderer Mensch -- 
  Sanft -- höflich -- zuvorkommend einnehmend -- 
  wünscht Glück -- nunmehr Freund -- verlegen müßig -- beschäftigen Zeitlang engagieren -- wobei bedauern -- freilich Anfang Stande -- vortrefflich Subjekt -- Glück zuführen -- Fähigkeit Talent belohnen -- Schuld großmütig Freund -- Wilhelm zeigen -- Ding abtragen müssen -- 
  ausdrücken -- Melina -- Freundschaft erzeig -- Direktion Theater verhelfen -- 
  antreffen -- befinden wunderlich Lage -- 
  erinnern -- lebhaft Bekanntschaft Abneigung Theater sehen lassen -- müssen -- sobald verheiraten -- lieb Frau -- Freude Beifall versprechen -- Engagement umsehen -- 
  finden keins -- beständig -- -- glücklicherweise -- Geschäftsmänner -- außerordentlich Fall brauchen -- Feder umgehen wissen -- Französisch verstehen -- Rechn unerfahren -- 
  Zeitlang -- leidlich bezahlen -- schaffen -- Verhältnis machen Schande -- 
  außerordentlichen Auftrag Gönner gehen -- dauerhaft Versorgung denken -- Frau verlangen desto eifrig Theater -- -- Umstand vorteilhaftest -- Publikum Ehre darstellen -- 
  -- hoffen -- Anstalt -- Hilfe einrichten -- Meinig Anfang -- verdanke künftig Glück -- wollen -- 
  Wilhelm hören Äußerung Zufriedenheit -- sämtlichen Schauspieler gleichfalls Erklärung Direktor ziemlich zufrieden -- freuen heimlich -- schnell Engagement zeigen -- neigen -- Anfang -- gering Gage vorlieb nehmen -- meister dasjenig -- unvermutet anbieten -- Zuschuß ansah -- kurz Rechnung -- 
  Melina Begriff Disposition benutzen -- suchen geschickt Weise sprechen -- -- Weise bereden wissen -- Kontrakt geschwind abschließen neigen -- Verhältnis nachdachn -- sichern glauben -- sechswöchentlich Aufkündigung loskommen -- 
  Bedingung gehörig Form bringen -- Melina dachen Stück -- Publikum anlocken -- Kurier Stallmeister Ankunft Herrschaft verkündigen -- untergelegt Pferd vorführen befehlen -- 
  fahren hochbepackt Wagen -- Bock bedienter heruntersprangen -- Gasthause -- Philine Art Hand stellen Türe -- 
  -- fragt Gräfin Hereintreten -- 
  Schauspielerin -- Exzellenz dienen -- Antwort -- Schalk fromm Gesicht demütigen Gebärde neigen Dame Rock küßen -- 
  Graf -- Person umh stehen -- gleichfalls Schauspieler ausgaben -- erkundigen Stärke Gesellschaft -- letzter Ort Aufenthalt Direktor -- 
  Franzose sein -- Gemahlin -- können Prinz unerwartet Freude -- Lieblingsunterhaltung verschaffen -- 
  kommen -- versetzen Gräfin -- Leute -- unglücklicherweise deutsch -- Schloß -- Fürst bleiben -- spielen lassen -- 
  Geschicklichkeit -- 
  Sozietät lassen Theater unterhalten -- Baron zustutzen -- 
  Wort gehen Treppe hinauf -- Melina präsentieren Direktor -- 
  Ruf Leute -- Graf -- stellen -- sehen -- -- 
  Liste Stück sehen -- allenfalls aufführen können -- 
  Melina eilt tief Bücklinge Zimmer -- Schauspieler -- 
  drücken -- präsentiert -- Begierde fallen -- -- leichtsinnig darstellen -- 
  Philine bezeigt Gräfin -- außerordentlich gnädig freundlich -- Ehrfurcht -- Graf musteren indes übrig -- 
  fragt Fache -- äußern Melina -- streng Fach halten müssen -- Ausspruch groß Devotion aufnehmen -- 
  Graf bemerken -- worauf studieren -- Figur Stellung besseren -- zeigen einleuchtend -- woran deutsche fehlen -- lassen außerordentlich Kenntnis sehen -- groß Demut erleuchtet Kenner erlaucht Beschützer stehen -- Atem holen getrauten -- 
  Mensch Ecke -- fragt Graf -- Subjekt -- vorstellen -- hagr Figur naht abgetragenen -- Ellbogen Fleckchen besetzten -- Rocke -- kümmerlich Perücke bedeckt Haupt demütigen Klient -- 
  Mensch -- vorig Buch Philines Liebling kennen -- pflegen gewöhnlich Pedante -- Magister Poet spielen -- meistens Rolle übernehmen -- Schlag kriegen begießen -- 
  gewiß kriechend -- lächerlich -- furchtsam Bückling angewöhnen -- stockend Sprache -- Rolle passen -- Zuschauer lachen -- brauchbar Glied Gesellschaft ansehen -- dienstfertig gefällig -- 
  naht Weise Grafe -- neigen -- beantwortet Frage Art -- Rolle Theater gebärden pflegen -- 
  Graf gefällig Aufmerksamkeit Überlegung Zeitlang -- alsdann rufen -- Gräfin wenden -- 
  Kind -- betrachten Mann genau -- hafen -- Schauspieler -- -- 
  Mensch ganz Herz albern Bückling -- Graf laut lachen müssen -- ausraufen -- 
  Sache exzellent -- weten -- Mensch spielen -- Schade -- besserem brauchen -- 
  außerordentlich Vorzug übrig kränkend -- Melina empfinden -- vielmehr Grafe vollkommen -- versetzen ehrfurchtsvoll Min -- -- mehrere Kenner Aufmunterung fehlen -- gegenwärtig ew -- Exzellenz finden -- 
  sämtlich Gesellschaft -- Graf -- 
  Glied abwesend -- versetzen klug Melina -- können -- Unterstützung finden -- Nachbarschaft vollzählig -- 
  indessen Philine Gräfin -- 
  hübsch jung Mann -- gewiß Liebhaber qualifizieren -- 
  lassen sehen -- versetzt Gräfin -- 
  holen -- rufen Philin -- eilt Türe hinaus -- 
  finden Wilhelm Mignon beschäftigen -- bereden Hinunter -- 
  folgen einig Unwille -- treiben Neugier -- vornehm Person hören -- voll verlangen -- nah kennen lernen -- 
  treten Zimmer -- Auge begegneen sogleich Auge Gräfin -- richten Philine ziehen Dame -- indes Graf übrig beschäftigen -- 
  Wilhelm neigen -- verschieden Frage -- reizend Dame -- Verwirrung Antwort -- 
  Schönheit -- Jugend -- Anmut -- Zierlichkeit fein Betrag machen angenehmst Eindruck -- -- Rede Gebärde gewiß Schamhaftigkeit -- dürfen sagen -- Verlegenheit -- begleiten -- 
  Grafe vorstellen -- -- Gemahlin an Fenster treten -- fragen scheinen -- 
  bemerken -- Meinung lebhaftester seinigen übereinstimmen -- eifrig bitt Gesinnung bestärken scheinen -- 
  kehrt Gesellschaft -- -- 
  gegenwärtig aufhalten -- Freund schicken -- billig Bedingung -- Mühe geben -- abneigen -- Schloß spielen lassen -- 
  bezeign Freude -- küßen Philin groß Lebhaftigkeit Gräfin Hand -- 
  sieht -- Dame -- leichtfertig Mädchen backen klopfen -- sehen -- Kind -- 
  -- Versprechen halten -- anziehen -- 
  Philine entschuldigt -- Garderobe verwenden -- sogleich befehlen Gräfin Kammerfrauen -- englisch Hut seiden Halstuch -- Auszupacke -- herauf geben -- 
  putzen Gräfin Philine -- fortfuhr scheinheilig -- unschuldig Miene artig gebärden betragen -- 
  Graf bieten Gemahlin Hand führen Hinunter -- 
  grüßt Gesellschaft vorbeigehen freundlich -- kehren nochmals Wilhelm -- huldreichst Miene -- 
  sehen -- 
  glücklich Aussicht belebt Gesellschaft -- lassen nunmehr Hoffnung -- Wunsch Einbildung frei Lauf -- sprechen Rolle -- spielen -- Beifall -- erhalten -- 
  Melina überlegen -- geschwind -- Vorstellung -- Einwohner Städtchen Geld abnehmen Gesellschaft Atem setzen können -- indes Küche gehen -- besseer Mittagsesse bestellen -- einnehmen gewohnen -- 
  Kapitel -- 
  Baron -- Melina empfangen Furcht -- 
  Graf Kenner ankündigen -- besorg -- schwach Seite Haufen entdecken -- einseh -- formiert Truppe -- Stück gehörig besetzen -- sowohl Direktor sämtlichen Glied Sorge -- Baron Mann finden -- groß Enthusiasmus vaterländisch Theater betrachten -- Schauspieler Gesellschaft willkommen erfreulich -- 
  begrüßen Feierlichkeit -- Pries glücklich deutsch Bühne unvermutet antreffen -- Verbindung -- vaterländisch Muse Schloß verwandte einführen -- 
  bringen Heft Tasche -- Melina Punkt Kontrakts erblicken hoffen -- anderer -- 
  Baron bitten -- Drama -- verfertigen -- spielen sehen wünschen -- Aufmerksamkeit anhören -- 
  willig schließen Kreis -- erfreut -- gering Kosten Gunst notwendig Mann befestigen -- obgleich dick Heft übermäßig befürchten -- 
  -- Stück Akte schreiben -- Art -- nehmen -- 
  Held vornehm -- Tugendhafter -- großmütig verkannt verfolgt Mann -- zuletzt Sieg Feind tragen -- sodann strengste poetisch Gerechtigkeit ausüben -- Stelle verzeihen -- 
  Stück vortragen -- Zuhörer Raum denken -- sacht Demut -- kurz neigen fühlen -- glücklich Selbstgefälligkeit empor steigen -- anmutigst Aussicht Zukunft überschauen -- 
  -- angemessen Rolle Stück finden -- erklären -- halten Baron unglücklich Autor -- Stelle -- beklatschen hofft -- groß Lobe möglichst Zufriedenheit Verfasser verfolgen -- 
  Ökonomischen geschwind fertig -- 
  Melina wissen Vorteil Baron Kontrakt abschließen -- übrig Schauspieler geheim halten -- 
  Wilhelm sprechen Melina Baron vorbeigehen -- versichern -- Theaterdichter qualifiziern -- Schauspieler übel Anlage -- 
  Baron sogleich Kollege Bekanntschaft Wilhelm produzieren Stück -- nebst weniger Reliquie -- groß Arbeit Feuer aufgehen lassen -- Zufall retten -- 
  Baron loben sowohl Stück Vortrag -- -- hinüber Schloß -- versprechen -- Abschied -- gut Aufnahme -- bequem Wohnung -- Essen -- Beifall Geschenk -- Melina setzt Versicherung bestimmt Taschengeld hinzu -- 
  denken -- Stimmung Besuch Gesellschaft setzen -- ängstlich niedrig Zustand Ehre Behag -- 
  machen voraus Rechnung lustig -- jeder halten unschicklich -- Groschen Geld Tasche behalten -- 
  Wilhelm indessen Rate -- Gesellschaft Schloß begleiten sollen -- 
  finden Sinn rätlich -- 
  Melina hoffen vorteilhaft Engagement schuld abtragen -- Freund -- Menschenkenntnis ausgehen -- Gelegenheit versäumen -- Welt nah kennen lernen -- aufschlüsser Leben -- Kunst erlangen hoffen -- 
  gestehen -- wünsch -- schön Gräfin nah -- 
  suchen vielmehr überzeugen -- Vorteil näh Kenntnis vornehmen reich Welt bringen -- 
  Betrachtung Grafe -- Gräfin -- Baron -- Sicherheit -- Bequemlichkeit Anmut Betragen -- rufen -- -- Entzück -- 
  dreimal glücklich preisen -- Geburt sogleich unterer Stufe Menschheit hinaus heben -- Verhältnis -- Mensch Leben abängstigen -- durchzugeh -- Gast verweilen brauchen -- 
  allgemein Blick hoch Standpunkt -- Schritt Leben -- 
  Geburt gleichsam Schiff setzen -- Überfahren -- -- günstig Wind bedienen -- Widrig abwarten -- anstatt Person schwimmend abarbeit -- günstig Wind Vorteil genießen -- Sturme erschöpft Kraft untergehen -- 
  Bequemlichkeit -- Leichtigkeit angeboren Vermögen -- sicher blühet Handel -- Kapital gründen -- mißlungen Versuch sogleich Untätigkeit versetzen -- 
  Wert Unwert irdisch Ding kennen -- genießen Jugend Fall -- Geist notwendige -- nützliche -- Wahr leiten -- Irrtum Alter überzeugen -- Kraft gebrechen -- neu Leben anfangen -- 
  rufen Freund derjenige Glück -- hoch Region befinden -- -- Kreis nähern -- Quelle schöpfen -- pries Genius -- Anstalt -- Stufe hinan führen -- 
  indessen müssen Melina -- Kopf zerbrochen -- verlangen Grafe Überzeugung Gesellschaft Fach einteilen bestimmt Mitwirkung übertragen -- zuletzt -- Ausführung -- zufrieden -- gering Personal Schauspieler willig finden -- Möglichkeit Rolle schicken -- 
  übernehmen gewöhnlich Laert Liebhaber -- Philin Kammermädch -- jung Frauenzimmer teilen naiv zärtlich Liebhaberinne -- alt Polterer spielen -- Melina glauben Chevalier auftreten -- Madam Melina müssen -- groß Verdruß -- Fach jung Frau -- sogar zärtlich Mutter übergehen -- neu Stück Pedant Poet -- vorkommen -- lächerlich -- müssen bekannt Günstling Grafe nunmehr Präsident Minister spielen -- gewöhnlich Bösewichter vorstellen Akt übel behandeln -- 
  stecken Melina Vergnügen -- Kammerjunk Kammerherr -- Grobheit -- biederen deutsch Mann hergebracht Maß mehrere beliebt Stück aufgedrungen -- Gelegenheit artig herausputzen -- Hofmanne -- vollkommen besitzen glauben -- anzunehm Erlaubnis -- 
  dauern -- kommen verschieden Gegenden mehrere Schauspieler herbeigeflossen -- sonderlich Prüfung annehmen -- sonderlich Bedingung festhalten -- 
  Wilhelm -- Melina vergebens einigemal Liebhaberrolle bereden suchen -- Sache gut Wille -- neu Direktor Bemühung mindest anerkannt -- vielmehr glauben nötig Einsicht überkommen -- Streich angenehmst Beschäftigung -- wodurch jeder Stück gehörig Zeitmaß herunter setzen wissen -- Rücksicht nehmen -- 
  Zuspruch -- Publikum zufrieden -- geschmackvollst Einwohner Städtchen behaupten -- Theater Residenz keineswegs bestellen -- 
  Kapitel -- 
  herbei -- Überfahrt schicken -- Kutsch Wagen erwarten -- Truppe Schloß Grafe hinüber führen bestellen -- 
  voraus fallen Streitigkeit -- fahren -- sitzen -- 
  Ordnung Einteilung Mühe ausmachen festsetzen -- Wirkung -- 
  bestimmt Stunde kommen Wagen erwarten -- müssen einrichten -- 
  Baron -- Pferd hinterdrein folgen -- Ursache -- Schloß Bewegung -- Fürst eintreffen -- glauben -- unerwartet Besuch gegenwärtig angelangen -- Platz gehen -- logieren -- vorher bestimmen -- außerordentlich leid tun -- 
  teilen Wagen -- -- leidlich Wetter Schloß Stunde entfernt -- machen Lustigst Fuße Weg -- Rückkehr Kutschen abwarten -- 
  Karawane ziehen Freudengeschrei -- erstenmal Sorge -- Wirt bezahlen -- 
  Schloß Grafe stehen Feengebäude Seele -- glücklichst fröhlichst Mensch Welt -- knüpfte unterwegs -- Art denken -- Reihe Glück -- Ehre Wohlstand -- 
  stark Regen -- unerwartet einfiel -- angenehm Empfindung reißen -- anhaltend stark -- spüren ziemlich Unbequemlichkeit -- 
  Nacht herbei -- erwünscht erscheinen -- Stockwerk erleuchtet Palast Grafe -- Hügel entgegen glänzt -- Fenster zählen -- 
  nah heran kommen -- finden Fenster Seitengebäude erhellet -- 
  denken -- Zimmer -- meister begnügt bescheiden Stube Mansarde Flügel -- 
  fahren Dorf Wirtshause vorbei -- 
  Wilhelm lassen halten -- absteigen -- Wirt versichern -- geringsten Raum anweisen können -- 
  Herr Graf -- unvermutet Gast ankommen -- sogleich Wirtshaus besprechen -- Zimmer stehen gestern Kreid deutlich anschreiben -- wohnen sollen -- 
  wider Wille müssen Freund übrig Gesellschaft Schloßhofe hineinfahren -- 
  Küchenfeuer Seitengebäude sehen geschäftig Köch bewegen -- Anblick erquicken -- eilig kommen Bedient Lichtern Treppe Hauptgebäud gesprung -- Herz gut Wanderer quoll Aussicht -- 
  verwunderten -- Empfang entsetzlich Fluchen auflösen -- 
  bedienter schimpfen Fuhrleut -- herein fahren -- umwenden -- rufen -- hinaus alt Schlos -- Raum Gast -- 
  unfreundlich unerwartet Bescheid fügen allerlei Spötterei hinzu -- lachen -- Irrtum Regen sprengen -- 
  goß -- Stern stehen Himmel -- Gesellschaft holprig Weg Mauer alt hint Schloß ziehen -- unbewohnt stehen -- Vater Grafe vorderen bauen -- 
  Teil Hof -- teils lang gewölbt Torwege halten Wagen still -- Fuhrleut -- Anspanner Dorfe -- spannen ritt Weg -- 
  Empfange Gesellschaft zeigen -- steigen -- rufen -- suchen -- vergebens -- 
  bleiben finst Still -- 
  Wind blies hoch Tor -- graulich alt Turm Hof -- wovon Gestalt Finsternis unterscheiden -- 
  froren Schauert -- Frau fürchten -- Kind fangen wein -- Ungeduld vermehrt Augenblick -- schnell Glückswechsel -- vorbereiten -- bringen Fassung -- 
  Augenblick erwarten -- aufschließen -- Regen Sturm täuschen -- Tritt erwünscht Schloßvogts hören glauben -- bleiben unmutig untätig -- fallen -- Schloß -- mitleidig Seele Hilfe anrufen -- 
  begreifen -- Freund -- Baron -- bleiben -- höchstbeschwerlich Lage -- 
  kommen Mensch -- erkennen Stimme Fußgänger -- Weg Fahrende bleiben -- 
  erzählten -- Baron Pferd stürzen -- Fuß stark beschädigen -- -- Schloß nachgefragen -- Ungestüm hierher weisen -- 
  Gesellschaft groß Verlegenheit -- ratschlagen -- -- Entschluß fassen -- 
  weitem Laterne -- holt frisch Atem -- Hoffnung baldigen Erlösung verschwinden -- Erscheinung nah deutlich -- 
  Reitknecht leuchten bekannt Stallmeister Grafe -- erkundigen -- näh -- eifrig mademoisell Philin -- 
  übrig Haufen hervortreten -- dringend anbieten -- Schloß führen -- Plätzch Kammerjungfer Gräfin bereiten -- 
  Besann Anerbiet dankbar ergreifen -- fassen Arm -- Koffer empfehlen -- forteilen -- treten Weg -- fragen -- bitten -- beschwören Stallmeister -- -- schöne -- versprechen -- versichern -- kurz sollen Schloß eröffnen gute einquartieren -- 
  sehen Schein Laterne verschwinden -- hoffen vergebens Licht -- Wort -- Schelt Schmähe erscheinen -- einig Trost Hoffnung belebn -- 
  alt Hausknecht eröffnet Türe alt Gebäude -- Gewalt eindringen -- 
  sorgt Sache -- abpacken -- hereinzuschaffen -- 
  meister -- Person -- tüchtig durchweichen -- 
  Licht langsam -- 
  Gebäude stoßen -- stolperen -- fallen -- 
  bitten Licht -- bitten Feuerung -- 
  einsilbig Hausknecht lassen genau Not Laterne -- -- -- 
  fing Haus durchsuchen -- Tür Zimmer -- Öfen -- gewirkt Tapete -- eingelegt Fußböde vorig Pracht übrig -- Hausgerät finden -- Tisch -- Stuhl -- Spiegel -- ungeheur leer Bettstelle -- Schmuck Notwendig berauben -- 
  naß Koffer Mantelsäcke Sitz wählen -- müde Wanderer bequemt Fußboden -- Wilhelm Stufe setzen -- Mignon liegen Knien -- Kind unruhig -- Frage fehlen -- antworten -- hungern -- 
  finden -- verlangen Kind still -- übrig Gesellschaft aufgezehrt -- müssen arm Kreatur Erquickung lassen -- 
  bleiben Vorfalle untätig -- still kehren -- 
  verdrießlich grimmig -- Sinn bestehen Wirtshause abgestiegen -- oberer Boden Lager nehmen -- 
  übrig gebärdet Art -- 
  haufen alt Gehölz ungeheur Kamin Saal schaffen zünden -- groß jauchzen -- Scheiterhauf -- 
  Unglücklicherweise Hoffnung trocken wärm schrecklichste täuschen -- Kamin stehen Zierde -- herein vermauern -- Dampf treten schnell erfüllt Zimmer -- dürre Holz schlagen rasselnd Flamme -- Flamm herausgetrieben -- Zug -- zerbrochen Fensterscheibe drang -- unstät Richtung -- fürchtet Schloß anzuzünden -- müssen Feuer auseinander ziehen -- austret -- dämpfen -- Rauch vermehrn -- Zustand unerträglich -- Verzweiflung nahe -- 
  Wilhelm Rauch entferntes Zimmer gewichen -- wohin Mignon folgen wohlgekleidet Bedienten -- hoch hellbrennend -- doppelt erleuchtet Laterne tragen -- hereinführen -- wenden Wilhelm -- schön porzellanen Teller Konfekt Frucht überreichen -- -- schickt jung Frauenzimmer drüben -- Bitte -- Gesellschaft -- lassen sagen -- setzen Bedient leichtfertigen Min hinzu -- gehen -- wünsch Zufriedenheit Freund teilen -- 
  Wilhelm erwartet Antrag -- Philin -- Abenteuer -- steinern Bank -- entschieden Verachtung begegnen -- fest entschließen -- Gemeinschaft -- Begriff stehen -- süß Gabe schicken -- bittend Blick Mignon vermögen -- annehmen -- Name Kind danken -- Einladung schlagen -- 
  bitten Bedienten -- Sorge angekommen Gesellschaft -- erkundigen Baron -- 
  liegen Bette -- -- soviel Bedient sagen wissen -- Auftrag geben -- elend Beherbergt sorgen -- 
  Bedient hinterlassen Wilhelm eins Lichter -- Ermangelung Leuchter Fenstergesims kleben müssen -- Betrachtung Wand Zimmer erhellen -- 
  währen -- ehe Anstalt regen -- Gast Ruhe bringen -- 
  kommen Licht -- Lichtputz -- Stuhl -- Stunde Deckbett -- Kissen -- durchnetzen -- Mitternacht -- Strohsäck Matratz herbeigeschaffen -- -- -- höchstwillkommen -- 
  Zwischenzeit essen trinken angelangen -- Kritik nossen -- unordentlich Abhub ähnlich -- Achtung -- Gast -- sonderlich Zeugnis ablegen -- 
  Kapitel -- 
  Unart Übermut leichtfertig Geselle -- vermehrt Unruhe übel Nacht -- neckt -- aufwecken wechselsweise allerlei Streich spielen -- 
  brechen -- lauten Klage Freund -- Baron -- getäuscht anderer Bild Ordnung Bequemlichkeit -- -- -- 
  Verwunderung Trost erscheinen Frühe Graf Bedienten -- erkundigen Umstand -- 
  entrüsten -- hören -- übel ergehen -- Baron -- -- führen -- herbei hinkt -- verklagt Haushofmeister -- befehlswidrig Gelegenheit zeigen -- glauben Bad anrichten -- 
  Graf befehlen sogleich -- Gegenwart möglichst Bequemlichkeit Gast ordnen sollen -- 
  kommen Offizier -- Aktrice sogleich Kundschaft nehmen -- Graf lassen Gesellschaft vorstellen -- redet Name -- mischen Scherz Unterredung -- gnädig Herr entzücken -- 
  müssen Wilhelm Reihe -- Mignon anhehen -- 
  Wilhelm entschuldigt Freiheit -- Graf hingegen scheinen Gegenwart annehmen -- 
  Herr -- Grafe stehen -- Offizier halten -- Uniform anhaten -- sprechen unser Freund -- zeichnen -- 
  hellblau Auge leuchteen hoch Stirn hervor -- nachlässig blond Haar aufschlagen -- mittlerer Statur zeigen Wackeres -- fest bestimmt Wesen -- 
  Frage lebhaft -- scheinen verstehen -- wonach fragen -- 
  Wilhelm erkundigen Manne Baron -- sagen wissen -- 
  Charakter Major -- eigentlich Günstling Prinz -- verseh geheim Geschäft Arm halten -- Ursache glauben -- natürlich Sohn -- 
  Frankreich -- England -- Italien Gesandtschaft -- überall distinguieren -- machen einbildisch -- wähnen -- deutsch Literatur Grund kennen -- erlauben allerlei schal Spöttereie -- 
  -- Baron -- vermeid Unterredung -- Wilhelm -- entfernt halten -- geben -- 
  nenn Jarno -- wissen -- Name sollen -- 
  Wilhelm sagen -- empfinden fremde -- Kalt Abstoßend -- gewiß Neigung -- 
  Gesellschaft Schlos eingeteilen -- Melina befehlen streng -- nunmehr ordentlich halten -- Frau wohnen -- Rolle -- Kunst Augenmerk Neigung richten -- 
  schlagen Vorschrift Gesetz -- Punkt bestehen -- Tür -- 
  Summe Strafgelder bestimmen -- Übertreter gemein Büchse entrichten -- 
  Verordnung achten -- 
  jung Offizier gehen -- spaßen fein Aktrice -- Akteur -- vernichtet Polizeiordnung -- ehe Wurzel fassen -- 
  jagt Zimmer -- verkleiden -- verstecken -- 
  Melina -- Anfangs Ernst zeigen -- allerlei Mutwille äußerste bringen -- Graf holen lassen -- Platz sehen -- Theater aufrichten -- Übel ärger -- 
  jung Herr ersannen allerlei platt Späß -- Hilfe Akteur plumper -- scheinen -- alt Schloß wüetnden Heer besessen -- endigen Unfug eher -- Tafel -- 
  Graf Melina Saal führen -- alt Schlos gehören -- Galerie verbinden -- worin Theater aufstellen -- 
  zeigen einsichtsvoll Hausherr -- wollen einrichten -- 
  Arbeit Eile vornehmen -- Theatergerüste aufschlagen ausziern -- Dekoration Gepäck brauchen -- anwenden -- übrig Hilfe geschickt Leute Grafe verfertiget -- 
  Wilhelm greifen -- helfen Perspektive bestimmen -- Umrisse abschnüren -- höchst beschäftigen -- unschicklich -- 
  Graf -- öfters -- zufrieden -- zeigen -- tun -- eigentlich -- lassen ungemein Kenntnis Kunst sehen -- 
  fing Probier ernstlich -- wozu Raum Muße -- anwesend Fremden stören sein -- 
  kommen täglich Gast -- Gesellschaft Augenschein nehmen -- 
  Kapitel -- 
  Baron Wilhelm Hoffnung hinhalten -- Gräfin vorstellen -- 
  -- -- -- vortrefflich Dame geistreichen empfindungsvoll Stück erzählen -- erwarten -- sprechen vorlesen lassen -- 
  halten fassen Wink hinüber -- nächster Ruhig gewiß rufen -- 
  bezeichnen Nachspiel -- vorlesen -- wodurch empfehlen -- 
  Dame bedauern -- unruhigen eintreffen -- übrig Gesellschaft alt Schlos behelfen müssen -- -- 
  Sorgfalt Wilhelm Stück -- womit Eintritt Welt -- 
  -- -- stille arbeiten -- einzeln Freund Beifall erhalten -- Talent verzweifelt -- mußt Sorge -- Weg -- Talent Neigung Theater -- 
  Ohr geübt Kenner -- Kabinett -- Illusion finden -- Versuch gefährlich anderwärt -- gerne bleiben -- Genuß vorig Freude knüpfen -- Hoffnung Zukunft erweitern -- 
  Stück -- La groß Aufmerksamkeit -- korrigieren -- rezitieren laut -- Sprache Ausdruck wenden -- stecken dasjenig -- meister üben -- womit groß Ehre einlegen glauben -- Tasche -- hinüber Gräfin fordern -- 
  Baron versichern -- gut Freundin -- 
  Zimmer treten -- Baronesse C vieler Freundlichkeit entgegen -- freut Bekanntschaft -- präsentieren Gräfin -- frisieren lassen -- freundlich Wort Blick empfangen -- Stuhl Philine knien allerlei Torheit -- -- 
  schön Kind -- Baronesse -- verschieden vorgesungen -- 
  Endige angefangen Liedche -- verlieren -- 
  -- Wilhelm hören Stückche Geduld -- Entfernung Friseurs wünschen -- ehe Vorlesung anfangen -- 
  bieten Tasse Schokolade -- wozu Baronesse Zwieback reichen -- 
  Demungeachtet schmeckt Frühstück -- wünschen lebhaft schön Gräfin vorzutragen -- interessieren -- wodurch fallen -- 
  Philine Weg -- Zuhörerin unbequem -- 
  Schmerz Friseur Hand -- hoffen Augenblick Vollendung Baues -- 
  indessen Graf hereingetreen -- erzählt erwartend Gast -- Einteilung Tag -- Häusliches vorkommen -- 
  hinaus -- lassen Offizier Gräfin Erlaubnis -- -- Tafel wegreiten müssen -- aufwarten -- 
  Kammerdiener indessen fertig -- lassen Herr hereinkommen -- 
  Baronesse inzwischen Mühe unser Freund unterhalten -- Achtung bezeigen -- Ehrfurcht -- obgleich zerstreuen -- aufnehmen -- 
  fühlen manchmal Manuskript Tasche -- hoffen Augenblick -- fast Geduld reißen -- Galanteriehändler hereingelassen -- Pappe -- Kasten -- Schachtel unbarmherzig eröffnen -- Sorte Geschlecht Zudringlichkeit vorweisen -- 
  Gesellschaft vermehrn -- 
  Baronesse Wilhelm -- sprechen leise Gräfin -- bemerkt Absicht verstehen -- Haus klar -- ängstlich vergebens durchharrt Stunde wegbegab -- 
  finden schön englisch Portefeuille Tasche -- 
  Baronesse heimlich beyzustecken wissen -- folgen Gräfin Mohr -- artig gestickt Weste überbrachen -- deutlich sagen -- woher kommen -- 
  Kapitel -- 
  Gemisch Empfindung Verdruß Dankbarkeit verderben Rest Tag -- Abend Beschäftigung finden -- Melina eröffnen -- Graf vorspieler sprechen -- Prinz Ehre -- Ankunft -- aufführen -- 
  wollen Eigenschaft Held Menschenfreunde Personifizieret -- 
  Tugende auftreten -- Lob verkündigen zuletzt Büste Blume Lorbeerkränze umwinden -- wobei verzogen Name Fürstenhute durchscheinend glänzen -- 
  Graf aufgeben -- Versifikation übrig Einrichtung Stückes sorgen -- hoffen -- Wilhelm -- leichtes -- hierin gerne beistehen -- 
  -- rufen verdrießlich -- Porträt -- verzogen Name allegorisch Figur -- Fürst ehren -- Meinung anderer Lob verdienen -- 
  vernünftig Manne schmeicheln -- Effigie aufstellen Name Geöhltem Papier schimmern sehen -- 
  fürcht -- Allegorie -- Garderobe -- Zweideutigkeit Späß Anlaß geben -- 
  Stück lassen -- dawider -- bitte -- verschonen bleiben -- 
  Melina entschuldigen -- ungefähr Angabe Herr Grafe -- überlas -- Stück arrangieren -- 
  herzlich gerne -- versetzen Wilhelm -- trag Vergnügen vortrefflich Herrschaft -- Muse angenehm Geschäft -- Lob Fürst -- Verehrung verdienen -- stammelnd hören lassen -- 
  Sache nachdenken -- gelingen -- Truppe stellen -- Effekt -- 
  Augenblick sann Wilhelm eifrig Auftrage -- 
  Ehe einschlaufen -- ziemlich geordnet -- -- -- Plan fertig -- Szene entwerfen -- vornehmst Stelle Gesänge Vers Papier bringen -- 
  Wilhelm eilen morgens Baron gewiss Umstand sprechen -- legen Plan -- 
  gefiel -- bezeigt Verwunderung -- 
  Grafe gestern Abend Stück sprechen hören -- Angabe Vers bringen -- 
  wahrscheinlich -- versetzen Wilhelm -- Absicht Herr Grafe -- Stück -- Meline angeben -- fertigen lassen -- Irre -- bloß Fingerzeig Weg weisen -- 
  Liebhaber Kenner zeigen Künstler -- wünschen -- überlassen alsdann Sorge Werk hervorzubringen -- 
  mitnichten -- versetzen Baron -- Herr Graf verlassen -- Stück -- angeben -- aufführen -- 
  Ihrige freilich entfernt Ähnlichkeit Idee -- durchsetzen Gedanke abbringen -- Dame bewirken -- 
  vorzüglich wissen Baronesse dergleichen Operation meisterlich anlegen -- Frage -- Plan fällen -- Sache annehmen -- gewiß -- 
  brauchen ohnedies Hilfe Dame -- Wilhelm -- personal Garderobe Ausführung hinreichen -- 
  hübsch Kind rechnen -- Haus laufen -- Kammerdiener Haushofmeister gehören -- 
  ersuchen Baron -- Dame Plan -- 
  bringen Nachricht -- sprechen -- 
  Abend -- Herr Spiel setzen -- ohnedies Ankunft gewiß General ernsthaft -- gewöhnlich -- vorwand Unpäßlichkeit Zimmer ziehen -- geheim Treppe einführen -- können alsdann Sache gut vortragen -- 
  Art Geheimnis geben Angelegenheit nunmehr doppelt Reiz -- Baronesse freu Kind Rendezvous -- -- heimlich schicken Wille Grafe unternehmen -- 
  Abend -- bestimmen -- Wilhelm abgeholen Vorsicht hinauf führen -- 
  Art -- Baronesse Kabinett entgegen -- erinnern Augenblick vorig glücklich Zeit -- 
  bringen Zimmer Gräfin -- Frage -- Untersuchen -- 
  legen Plan möglichst Wärme Lebhaftigkeit -- Dame einnehmen -- Leser erlauben -- Kürze -- 
  ländlich Szene Kind Stück Tanze eröffnen -- Spiel vorstellen -- einer herum Platz abgewinnen -- 
  Scherze abwechselnn zuletzt wiederkehrend Reihentanze fröhlich Lied singen -- 
  Harfner Mignon herbeikommen -- Neugierd erregen mehrere Landleute herbeilocken -- alt verschieden Lied Lobe Frieden -- Ruhe -- Freude singen -- Mignon Eiertanz tanzen -- 
  unschuldig Freude kriegerisch Musik stören -- Gesellschaft Trupp Soldat überfallen -- 
  Mannspersone setzen Wehr überwinden -- Mädchen fliehen einholen -- 
  scheinen Getümmel Grund -- Person -- Bestimmung Dichter ungewiß -- herbei Nachricht -- Heerführer -- Ruhe herstellen -- 
  Charakter Held schönsn Zug schildern -- mitten Waffe Sicherheit versprechen -- Übermut Gewalttätigkeit Schranke setzen -- 
  allgemein Fest Ehre großmütig Heerführer begehen -- 
  Dame Plan zufrieden -- behaupten -- müssen notwendig allegorisch Stück -- Herr Grafe angenehm -- 
  Baron Vorschlag -- Anführer Soldat Genius Zwietracht Gewalttätigkeit bezeichnen -- zuletzt müssen Minerva herbei -- Fessel anlegen -- Nachricht Ankunft Held geben Lob preisen -- 
  Baronesse übernehmen Geschäft -- Grafe überzeugen -- angegeben Plan -- Veränderung -- ausführen -- verlangen ausdrücklich -- Stück notwendig Büste -- verzogen Name Fürstenhut erscheinen müssen -- Unterhandlung vergeblich -- 
  Wilhelm -- Geist vorstellen -- fein Held Mund Minerva preisen -- lang Widerstand Punkt -- fühlen angenehm Weise zwingen -- 
  schön Auge Gräfin -- liebenswürdig Betragen bewogen -- schön angenehmst Erfindung -- erwünscht Einheit Komposition schicklich Detail Verzicht -- poetisch Gewissen handeln -- 
  stehen bürgerlich Gewissen hart Kampf bevor -- -- bestimmter Austeilung Rolle -- Dame ausdrücklich bestehen -- mitspielen müssen -- 
  Laert gewalttätig Kriegsgott erhalten -- Wilhelm Anführer Landleute vorstellen -- artig gefühlvoll Vers sagen -- 
  Zeitlang sträuben -- müssen ergeben -- finden Entschuldigung -- Baronesse vorstellen -- Schaubühne Schlos ohned Gesellschaftstheater ansehen -- -- schicklich Einleitung -- mitzuspielen wünschen -- 
  entließ Dame unser Freund vieler Freundlichkeit -- 
  Baronesse versichern -- unvergleichlich Mensch -- begleiten Treppe -- Händedruck Nacht -- 
  Kapitel -- 
  Befeuert aufrichtig Anteil -- Frauenzimmer Sache nehmen -- Plan -- Erzählung gegenwärtig -- lebendig -- 
  bringen groß Nacht sorgfältigst Versifikation Dialog Lied -- 
  ziemlich fertig -- Schloß rufen -- hören -- Herrschaft -- frühstücken -- sprechen -- 
  treten Saal -- Baronesse entgegen -- Vorwande -- gut bieten -- lispelen heimlich -- sagen Stück -- fragen -- 
  hören -- rufen Graf -- fleißig arbeit Vorspiel -- Ehre Prinz geben -- 
  billigen -- Minerva anbringen -- denken Zeit -- Göttin kleiden -- Kostüm verstoßen -- 
  lassen Bibliothek Buch herbeibringen -- worin Bild befinden -- 
  Augenblick treten Bedient Körbe voll Buch allerlei Format Saal -- 
  Montfaucon -- Sammlung antik Statue -- gemmer Münze -- Art mythologisch Schrift aufgeschlag Figur vergleichen -- 
  -- 
  Grafe vortrefflich Gedächtnis stellen Minerva -- Titelkupfer -- vignetten -- vorkommen -- 
  müssen Buch Bibliothek herbeigeschaffen -- Graf zuletzt Haufen Buch sitzen -- 
  -- Minerva einfiel -- rufen lachen -- 
  wetten -- Minerva Bibliothek -- erstemal vorkommen -- Büchersammlung Bild Schutzgöttin entbehren -- 
  Gesellschaft freut Einfall -- Jarno -- Graf Buch herbeizuschaffen reizen -- lachen unmäßig -- 
  nunmehr -- Graf -- Wilhelm wenden -- Hauptsache -- Göttin -- 
  Minerva Pallas -- Göttin Krieges Kunst -- -- schicklichsen -- euer Exzellenz -- versetzen Wilhelm -- hierüber bestimmt ausdrücken -- -- Mythologie doppelt Person spielen -- doppelt Qualität erscheinen lassen -- 
  melden Krieger -- Volk beruhigen -- preisen Held -- Menschlichkeit erheben -- überwinden Gewalttätigkeit stellen Freude Ruhe Volke -- 
  Baronesse -- bange -- Wilhelm verraten -- schieben geschwind Leibschneid Gräfin -- Meinung abgeben müssen -- antik Rock gut fertigen -- 
  Mann -- Maskenarbeit erfahren -- wissen Sache -- Madam Melina -- ungeachtet hoch Schwangerschaft -- Rolle himmlisch Jungfrau übernehmen -- angewiesen -- Maß nehmen -- Gräfin bezeichnen -- wiewohl einig Unwille Kammerjungfern -- Kleid Garderobe -- verschnitten -- 
  geschickt Weise wissen Baronesse Wilhelm Seite schaffen -- lassen wissen -- übrig Sache besorgt -- 
  schicken Musikum -- Grafen Hauskapelle dirigieren -- teils notwendig Stück komponieren -- teils schicklich Melodie Musikvorrat aussuchen -- 
  nunmehr Wunsch -- Graf fragt Stück -- hauptsächlich transparent Dekoration beschäftigen -- Stücke Zuschauer überraschen -- 
  Erfindung Geschicklichkeit Konditors bringen angenehm Erleuchtung zuwege -- 
  Reise groß Feierlichkeit Art sehen -- Kupfer Zeichnung mitbringen -- wissen -- gehören -- Geschmack angeben -- 
  unterdessen endigen Wilhelm Stück -- Rolle -- übernehmen seinig -- Musikus -- Tanz verstehen -- richten Ballett -- -- 
  unerwartet Hindernis legen Weg -- böse Lücke drohen -- 
  groß Effekt Mignon Eiertanze versprechen -- erstaunt -- Kind -- gewöhnlich Trockenheit -- abschlagen tanzen -- versichern -- nunmehr Theater -- 
  suchen allerlei zureder bewegen -- lassen eher -- bitterlich wein Anfing -- Füßen fallen rufen -- Vater -- bleiben Brett -- 
  merken Wink -- Sann -- Wendung Szene interessant -- 
  Philin -- eins Landmädche -- Reihentanz einzeln Stimme singen Vers Chore zubringen -- Freute auslassen -- 
  vollkommen Wunsch -- besonderer Zimmer -- Gräfin -- Affenposse unterhieln -- täglich schenken bekommen -- 
  Kleid Stück zurechen -- leicht nachahmend Natur -- Umgang Dame merken -- schicken -- kurz voll Lebensart gut Betragen -- 
  Sorgfalt Stallmeister -- Offizier stark eindringen -- reichlich Element befinden -- fallen -- Spröde spielen -- geschickt Weise gewiß vornehm ansehen üben -- 
  Kalt fein -- kannt Schwäche Haus -- -- absichtlich Verfahren -- Glück -- 
  bedient Vorteils -- belustigen -- gut Impertinent -- merken -- Gefahr geschehen -- 
  Rolle lernen -- Hauptprobe Stück befohlen -- Graf -- Gemahlin fing sorgen -- aufnehmen -- 
  Baronesse berufen Wilhelm heimlich -- zeigen -- näh Stunde herbei rücken -- Verlegenheit -- 
  Idee Grafe übrig bleiben -- 
  Jarno -- herein treten -- Geheimnis ziehen -- 
  Freute herzlich -- neigen -- Dienst Dame anbieten -- 
  schlimm -- -- gnädig Frau -- Sache heraus helfen -- fäll Hinterhalte liegen bleiben -- 
  Baronesse erzählen hierauf -- Grafen Stück -- stellenweise Ordnung erzählen -- jeder Einzeln vorbereiten -- stehen freilich Gedanke -- Idee zusammentreffen -- 
  -- -- Abend Probe setzen -- zerstreuen suchen -- 
  Konditor vorgehaben -- Dekoration schön -- gering fehlen lassen -- 
  wissen Hof -- versetzen Jarno -- tätig klug Freund brauchen -- -- 
  Abend Künsten fort -- winken -- Grafe heraus holen -- eher hinein lassen -- Minerva auftreten -- Illumination Sukkurs hoffen -- 
  eröffnen -- Vetter betreffen -- Ursache aufschieben -- 
  Distraktion geben -- angenehmsen -- 
  Geschäft hindert Grafe -- Anfang Probe -- unterhalten Baronesse -- 
  Jarno Hilfe nötig -- 
  Graf zurecht weisen -- verbessern anordnen -- vergessen -- Frau Melina zuletzt Sinn sprechen -- Illumination ausfallen -- bezeigen vollkommen zufrieden -- 
  vorbei -- Spiel -- scheinen Unterschied auffallen -- fing nachdenken -- Stück Erfindung -- 
  Wink fallen Jarno Hinterhalte hervor -- Abend verging -- Nachricht -- Prinz kommen -- bestätigen -- riten einigemal -- Avantgarde Nachbarschaft kampieren sehen -- Haus voll Lärmen Unruhe -- Schauspieler -- unwillig Bedienten versorgen -- müssen -- sonderlich erinnert -- alt Schlos Erwartung Übung zubringen -- 
  Kapitel -- 
  Prinz ankommen -- Generalität -- stabsoffizier übrig Gefolge -- gleich eintreffen -- Mensch -- teils Besuch -- teils geschäftsweg einsprach -- machen Schloß Bienenstocke ähnlich -- schwärmen -- 
  drängen herbei -- vortrefflich Fürst sehen -- bewundert Leutseligkeit Herablassung -- erstaunt Held Heerführer gefälligst Hofmann erblicken -- 
  hausgenossen müssen Order Grafe Ankunft Fürst Posten -- Schauspieler blicken lassen -- Prinz vorbereitet Feierlichkeit überraschen -- scheinen Abends -- wohlerleuchteen gewirkt Tapet vorig Jahrhundert verziert Saal führen -- Schauspiel -- viel_wenig Vorspiel Lobe -- vorbereiten -- 
  laufen gut -- Truppe müssen vollendet Vorstellung herbei Prinz zeigen -- freundlich Weise fragen -- gefälligste Art sagen wissen -- 
  Wilhelm Autor müssen vortret -- gleichfalls Beifall zugespenden -- 
  Vorspiele fragen sonderlich -- -- dergleichen aufführen -- Jarno Wilhelm gelegentlich sprechen -- verständig loben -- setzen hinzu -- schade -- hohl Nüsse hohl Nüs spielen -- 
  -- mehrere liegen Wilhelm Ausdruck Sinn -- wissen -- ausleg -- nehmen -- 
  unterdessen spielt Gesellschaft Abend -- Kraft vermochte -- möglich -- Aufmerksamkeit Zuschauer ziehen -- 
  unverdient Beifall muntert -- alt Schlos glauben -- eigentlich ihretwillen dräng Versammlung herbei -- Vorstellung ziehen Menge fremd -- Mittelpunkt -- deswillen drehen bewegen -- 
  Wilhelm bemerken Verdrusse Gegenteil -- 
  obgleich Prinz Vorstellung Anfange Sessel sitzend -- groß Gewissenhaftigkeit abwarten -- scheinen Weise dispensieren -- 
  -- Wilhelm Gespräch Verständigst finden -- Jarno Spitze -- bringen flüchtig Augenblick Theatersaale -- sitzen Vorzimmer -- spielen -- schien Geschäft unterhalten -- 
  Wilhelm verdroß -- anhaltend Bemühung erwünschtest Beifall entbehren -- 
  Auswahl Stück -- Abschrift Rolle -- häufig Probe -- vorkommen -- Meline eifrig Hand -- -- Unzulänglichkeit stillen fühlend -- zuletzt gewähren lassen -- 
  Rolle memorieren Wilhelm Fleiß -- tragen Wärme Lebhaftigkeit -- Anstand -- Bildung erlauben -- geben -- 
  fortgesetzt Teilnahme Baron benehmen indes übrig Gesellschaft Zweifel -- versichern -- groß Effekt hervorbring -- einer Stück aufführen -- bedauern -- Prinz ausschließend Neigung französisch Theater -- Leute hingegen -- worunter Jarno auszeichnen -- Ungeheure englisch Bühne leidenschaftlich Vorzug geben -- 
  Weise Kunst Schauspieler gut bemerken bewundern -- Person Zuschauer Zuschauerin völlig gleichgültig -- 
  anzeigen -- Schauspielerinn Anfang Aufmerksamkeit jung Offizier erregn -- Folge glücklich -- machen wichtig Eroberunge -- 
  schweigen bemerken -- Wilhelm Gräfin interessant vorkommen -- still Neigung aufzukeimen anfehen -- 
  -- Theater -- Auge abwenden -- scheinen gerichtet spielen rezitieren -- 
  wechselseitig ansehen -- unaussprechlich vergnügen -- harmlos Seele überließen -- lebhaft Wunsch nähren -- Folge besorgt -- 
  Fluß hinüber -- scheiden -- feindlich Vorpost ruhig lustig besprech -- Krieg denken -- beiderseitig Partei begreifen -- 
  wechseln Gräfin Wilhelm bedeutend Blick ungeheuer Kluft Geburt Stande hinüber -- jeder glaubt Seite -- sicher Empfindung nachhängen -- 
  Baronesse indessen Laert aussuchen -- wacker -- munter Jüngling wohlgefiel -- -- Weiberfeind -- vorbeigehend Abenteuer verschmähen -- diesmal wider Wille Leutseligkeit einnehmend Wesen Baronesse fesseln -- Baron zufällig gut -- -- -- schlimm Dienst erzeigen -- Gesinnung Dame nah -- 
  Laert einst laut rühmen -- Geschlecht vorziehen -- versetzen Baron scherzend -- 
  merk Sache stehen -- lieb Freundin Stall gewinnen -- 
  unglücklich Gleichnis -- klar gefährlich Liebkosung Circe deuten -- verdroß Laert Maßen -- Baron Ärgernis zuhören -- Barmherzigkeit fortfuhr -- 
  Fremd glauben -- -- angenehm Betragen gelten -- irren gewaltig -- Weg herum führen -- Mann -- Jüngling Knabe -- -- Zeitlang ergeben -- Anhäng -- Sehnsucht bemühen -- 
  Glückliche -- -- Garten Zauberin hinein tretend -- Seligkeite künstlich Frühling empfangen -- unangenehm überraschen -- -- Ohr Gesang Nachtigall lauschen -- verwandelt Vorfahr unvermutet entgegen grunzt -- 
  Laert schämt Entdeckung Herzen -- Eitelkeit nochmals verleiten -- Frau mindest denken -- 
  vernachlässigen nunmehr völlig -- halten Stallmeister -- fleißig fochen Jagd -- Probe Vorstellung betragen -- bloß Nebensach -- 
  Graf Gräfin lassen manchmal morgens Gesellschaft rufen -- Philin unverdient Glück beneid Ursache finden -- 
  Graf Liebling -- Pedante -- Stundenlang Toilette -- 
  Mensch bekleiden -- Dose equipiern ausstatten -- 
  Gesellschaft manchmal samt Tafel hoch Herrschaft fordern -- 
  schätzen groß Ehre -- bemerkn -- Jäger Bedient Anzahl Hund hereinbringen -- Pferd Schloßhofe vorführen lassen -- 
  Wilhelm -- gelegentlich Prinz Liebling -- Racine -- loben -- Meinung erwecken sollen -- 
  finden Nachmittag Gelegenheit -- vorgefordern -- Prinz fragen -- fleißig französisch Theaterschriftsteller lesen -- Wilhelm lebhafen antworten -- 
  bemerken -- Fürst -- Antwort abwarten -- Begriff weg wenden -- fassen vielmehr sogleich treten beinahe Weg -- fortfuhr -- 
  Schätz französisch Theater les Werk Meister Entzück -- wahrer Freude gehören -- Fürst Talenten Racine völlig Gerechtigkeit widerfahren lassen -- 
  vorstellen -- fahren fort -- vornehmen erhaben Person Dichter schätzen -- Zustand hoch Verhältnis vortrefflich schildern -- 
  Corneille -- sagen -- Mensch darstellen -- Racine vornehm Person -- 
  -- Stück les -- Dichter denken -- glänzend Hof leben -- König Auge -- umgehen -- Geheimnis Menschheit dringen -- kostbar gewirkt Tapet verbergen -- 
  Brittanikus -- Berenice studieren -- -- Hof -- Wohnung irdisch Gott einweihen -- sehen -- Auge feinfühlend Franzose -- König -- Nation anbeten -- Hofleut -- tausend beneidet -- natürlich Gestalt Fehlern Schmerz -- 
  Anekdot -- Racine Tod gegrämt -- Ludwig vierzehnen ansehen -- Unzufriedenheit fühlen lassen -- Schlüssel Werk -- unmöglich -- Dichter Talenten -- Leben Tod Auge Königes hängen -- Stück schreiben sollen -- Beifall König Fürsten wert -- 
  Jarno herbei treten hören unser Freund Verwunderung -- Fürst -- antworten gefällig Blick Beifall zeigen -- wenden seitwärts -- obgleich Wilhelm -- unbekannt -- anständig -- Umstand Diskurs fortsetzen Materie erschöpfen -- gerne sprechen Fürst zeigen -- Nutzen Gefühl Lieblingsdichter lesen -- 
  niemals -- Jarno -- beiseite -- Stück Shakespeare sehen -- 
  -- versetzen Wilhelm -- 
  -- Deutschland bekannt -- Theater unbekannt -- wissen -- freuen -- zufällig alt jugendlich Liebhaberei Beschäftigung gegenwärtig erneuern -- 
  indessen -- Stück gehören -- neugierig -- seltsam Ungeheuer nah kennen lernen -- Wahrscheinlichkeit -- Wohlstand hinauszuschreien scheinen -- 
  raten -- versetzen -- Versuch -- schaden -- seltsam Auge sehen -- 
  Paar Teil borgen -- anwend -- losmach -- Einsamkeit alt Wohnung Zauberlatern unbekannt Welt sehen -- 
  sündlich -- Stunde verderben -- Aff menschlich auszuputzen -- Hund tanzen lehren -- 
  einer halten -- Form stoßen -- übrig richtig Gefühl überlassen -- 
  Pferd stehen Türe -- Jarno setzen Kavaliere -- Jagd erlustigen -- 
  Wilhelm traurig -- 
  gerne Manne viele sprechen -- -- wiewohl unfreundlich Art -- Idee -- Idee bedürfen -- 
  Mensch manchmal -- Entwicklung Kraft -- Fähigkeit Begriff nähern -- Verlegenheit -- Freund helfen -- 
  gleichen Wanderer -- Herberge Wasser fallen -- griffe sogleich -- risse an Land -- naß tun -- anstatt -- jenseitig Ufer -- heraus helfen -- beschwerlich weit Umweg bestimmt Ziel -- 
  Wilhelm fing wittern -- Welt zugehen -- denken -- wichtig bedeutungsvoll Leben Vornehmen Nähe -- verwundert -- leicht Anstand geben wissen -- 
  Heer Marsche -- fürstlich Held Spitze -- mitwirkend Krieger -- zudringend Verehrer erhöht Einbildungskraft -- 
  Stimmung erhalten versprochen Buch -- kurz -- vermuten -- ergriff Strom Genius -- führen unübersehlich Meer -- worin völlig vergaß verlieren -- 
  Kapitel -- 
  Verhältnis Baron schauspielern aufenthalt Schloß verschieden Veränderung erleiden -- 
  Anfang gereichen beiderseitig Zufriedenheit -- 
  Baron erstemal Leben Stück -- Gesellschaftstheater beleben -- Hand wirklich Schauspieler Weg anständig Vorstellung -- Humor -- beweisen freigebig -- kaufen Galanteriehändler -- einstellten -- Geschenk Schauspielerinn -- wissen Schauspieler Bouteille Champagner extra verschaffen -- geben Stück Mühe -- Wilhelm sparn Fleiß -- herrlich Rede vortrefflich Held -- Rolle gefallen -- Genaust memorieren -- 
  indessen Mißhelligkeit eingeschlichen -- 
  Vorliebe Baron gewiß Schauspieler merklich -- notwendig müssen übrig verdrießen -- 
  erheben Günstlinge ausschließlich -- bringen Eifersucht Uneinigkeit Gesellschaft -- 
  Melina -- streitigen Fall ohnedem helfen wissen -- befinden unangenehm Zustande -- 
  gepriesenen nehmen Lob -- sonderlich dankbar -- zurückgesetzten lassen allerlei Weise Verdruß spüren -- wissen hochverehrt Gönner Aufenthalt Weise unangenehm -- Schadenfreude gering Nahrung -- gewiß Gedicht -- Verfasser kennen -- Schloß Bewegung verursachen -- 
  -- ziemlich fein Weise -- Umgang Baron Komödiant aufhalten -- allerlei Geschichte bringen -- gewiß Vorfall ausgeputzt -- lustig interessant Gestalt geben -- 
  zuletzt fing erzählen -- entstehen Art Handwerksneid Schauspieler -- einbildet -- Schriftsteller -- Sage gründen Gedicht -- sprechen -- lauten folgen -- 
  arm Teufel -- Herr Baron -- Beneide Stand -- Platz nah Thron -- manch schön Stück Acker Land -- Vater fest Schloß -- Wildbahn Geschoß -- 
  arm Teufel -- Herr Baron -- beneider -- scheinen -- Natur Knabe mütterlich meinen -- 
  -- leicht Mut Kopf -- arm -- arm Tropf -- 
  dächen -- Herr Baron -- ließen_es -- bleiben Herr Vater Sohn -- bleiben Mutter Kind -- 
  leben Neid Haß -- begehren Titel -- Platz Parnaß -- Kapitel -- 
  Stimme Gedicht -- fast unleserlich Abschrift verschieden Hand befinden -- teilen -- Verfasser wissen mutmaßen -- Schadenfreude ergötzen Anfing -- erklären Wilhelm -- 
  deutsche -- rufen -- verdient -- Muse Verachtung bleiben -- schmachten -- Mann Stande schätzen wissen -- Literatur Weise abgeben -- 
  Geburt -- Stand Vermögen stehen Widerspruch Genie Geschmack -- fremd Nation lehren -- Kopf Anzahl Edelleute zählen -- 
  Deutschland Wunder -- Mann Geburt Wissenschaften widmen -- berühmt Name Neigung Kunst Wissenschaft berühmt -- steigen Dunkelheit hervor -- treten unbekannt Stern Horizont -- -- Irre -- Klasse Nation Weg -- Vorteil Erringung schönsn Kranz Muse Zukunft bedienen -- 
  unangenehm -- Bürger Edelmann -- Muse schätzen wissen -- spotten -- Person Stande unüberlegt Laune niemals billigend Schadenfreude gleich Weg abschrecken sehen -- Ehre Zufriedenheit erwarten -- 
  scheinen letzter Äußerung Grafe richten -- Wilhelm gehören -- Gedicht finden -- 
  freilich Herr -- Art Baron scherzen pflegen -- Anlaß erwünschen -- verwandter Weise plagen -- 
  Mutmaßung -- Verfasser Gedicht -- Graf -- Scharfsinn übertroffen -- fallen Gedanke -- sogleich beschwören bereit -- Gedicht können Pedante herschreiben -- fein Bursch -- poetisch Genie merken -- 
  Vergnügen -- lassen Schauspieler rufen -- Gegenwart Gräfin -- Baronesse Jarnos Gedicht Art vorlesen müssen -- Lob -- Beifall Geschenk einernten -- Frage Grafe -- Gedicht früh Zeit besitzen -- Klugheit ablehnen wissen -- 
  Pedant Rufe Dichter -- Witzling -- Auge der -- Baron günstig -- Pasquillant schlecht Mensch -- 
  applaudiert Graf -- Rolle spielen -- arm Mensch zuletzt aufgeblasen -- beinahe verrückt -- Sann -- Philin Zimmer Schlos beziehen -- 
  Plan sogleich vollführen -- Unfall vermeiden -- 
  abends spät alt Schlos -- dunkel eng Weg herum tappen -- anfallen -- Person festhalten -- indessen Wacker losschlugen -- Finster zerdroschen -- beinahe liegen bleiben -- Mühe Kamerad hinauf kroch -- -- entrüsten stellen -- Unfall heimlich Freude fühlen -- Lachen erwehren -- durchwalkt braun Rock wissen -- Müllern Händel -- bestäuben befleckt sehen -- 
  Graf -- sogleich hiervon Nachricht erhalten -- brechen unbeschreiblichen Zorn -- 
  behandeln groß Verbrechen -- qualifizieren beleidigt Burgfriede -- lassen Gerichtshalter strengster Inquisition vornehmen -- 
  weißbestäuben Rock Hauptanzeige geben -- 
  Puder Mehl Schlos schaffen -- Untersuchung ziehen -- vergebens -- 
  Baron versichern Ehre feierlich -- Art scherzen freilich mißfallen -- Betrag Herr Graf freundschaftlichsen -- hinauszusetz wissen -- Unfall -- Poet Pasquillant -- nennen wollen -- begegnen -- mindest Anteil -- 
  übrig Bewegung fremd Unruhe Haus bringen Sache Vergessenheit -- unglücklich Günstling müssen Vergnügen -- fremd Feder kurz tragen -- teuer bezahlen -- 
  Truppe -- regelmäßig Abend fortspielen -- halten -- fing -- -- desto groß Anforderung -- 
  kurz Essen -- Trinke -- Aufwartung -- Wohnung gering -- liegen Beschützer -- Baron -- -- sorgen -- Genusse Bequemlichkeit -- versprechen -- verhelfen sollen -- 
  Klage laut -- Bemühung Freund -- -- Fruchtloser -- 
  Wilhelm indessen -- Probe Spielstunde -- Vorschein -- 
  hintersten Zimmer verschließen -- wozu Mignon Harfner Zutritt gerne verstatten -- leben weben shakespearisch Welt -- kennen Empfand -- 
  erzählen Zauberer -- magisch Formel ungeheuer Menge allerlei geistig Gestalt Stube herbeiziehen -- 
  Beschwörung kräftig -- Raum Zimmer ausfüllen -- Geist gezogen Kreis hinan drängen -- Haupt Meister ewig drehend Verwandlung bewegend vermehren -- 
  Winkel vollpfropfen -- jeder Gesims besetzen -- Ei dehn Riesengestalte ziehen Pilze -- 
  Unglücklicher Weise Schwarzkünstler Wort vergessen -- womit Geisterflut Ebbe bringen -- 
  -- sitzen Wilhelm -- unbekannt Bewegung tausend Empfindung Fähigkeit regen -- Begriff Ahnung -- 
  Zustande reißen -- unzufrieden -- Gelegenheit -- -- auswärts vorging -- unterhalten -- 
  merken -- Nachricht bringen -- Schloßhof Exekution vorgehen Knabe gestäupt -- nächtlichen Einbruch verdächtig -- Rock Perückenmacher tragen -- wahrscheinlich Meuchelmörder -- 
  Knabe leugne hartnäckigst -- können förmlich bestrafen -- wollen Vagabund Denkzettel geben schicken -- Gegend herumgeschwärmt -- nachts Mühl aufhalten -- Leiter Gartenmauer anlehnen -- Herüber steigen -- 
  Wilhelm finden Handel sonderlich merkwürdig -- Mignon hastig herein versichern -- gefangener Friedrich -- Händel Stallmeister Gesellschaft unser Auge verlieren -- 
  Wilhelm -- Knabe interessieren -- eilends -- finden Schloßhofe Zurüstung -- 
  Graf lieben Feierlichkeit dergleich Fall -- 
  Knabe herbeigebrachen -- 
  Wilhelm treten bitten -- inne halten -- Knabe kennen -- vorher verschieden Seinetwege anzubringen -- 
  Mühe Vorstellung durchzudringen -- erhalten Erlaubnis -- Delinquent sprechen -- 
  versichern -- Überfall -- Akteur mißhandeln -- wissen -- 
  Schloß herum streifen -- nachts herein geschlichen -- Philin aufsuchen -- Schlafzimmer ausgekundschaften -- gewiß treffen -- unterwegs auffangen -- 
  Wilhelm -- -- Ehre Gesellschaft -- Verhältnis gerne entdecken -- eilt Stallmeister bitten -- Kenntnis Person Haus -- Angelegenheit vermitteln -- Knabe befreien -- 
  launig Mann erdachen -- Wilhelm Beistand -- Geschichte -- Knabe Truppe gehören -- entlaufen -- wünschen -- einzufind aufnehmen -- 
  Absicht -- Nachtzeit Gönner aufsuchen -- empfehlen -- 
  bezeugen -- aufführen -- Dame mischen darein -- entlassen -- 
  Wilhelm -- nunmehr Person wunderbar Familie -- Wilhelm ansehen -- 
  alt Mignon nehmen Wiederkehrend freundlich -- verbanden nunmehr -- Freund Beschützer aufmerksam dienen -- angenehm erzeigen -- 
  Kapitel -- 
  Philine wissen täglich Dame einzuschmeicheln -- 
  -- leiten meistenteils Gespräch Mann -- kommen gehen -- Wilhelm letzen -- beschäftigen -- 
  klug Mädchen bleiben verbergen -- tief Eindruck Herz Gräfin -- erzähln wissen wissen -- hütete vorbringen -- Nachteil deuten -- rühmt Edelmut -- Freigebigkeit Sittsamkeit Betrag weiblich Geschlecht -- 
  übrig Frage -- geschah -- beantwortet Klugheit -- Baronesse zunehmend Neigung schön Freundin bemerken -- Entdeckung willkommen -- 
  Verhältnis mehrere Mann -- letzter Jarno -- bleiben Gräfin verbergen -- rein Seele Leichtsinn Mißbilligung sanft Tadel bemerken -- 
  Weise Baroneß sowohl Philine -- besonderer Interesse -- unser Freund Gräfin nah bringen -- Philine hoffen überdies Gelegenheit -- arbeiten -- verloren Gunst jung Mann erwerben -- 
  tags -- Graf übrig Gesellschaft Jagd geriten -- Herr erwarten -- ersann Baronesse Scherz -- völlig Art -- lieben Verkleidung -- Gesellschaft überraschen -- Bauermädch -- Page -- Jägerbursche Vorschein -- 
  ansehen Fee -- überall -- -- wenigster vermuten -- gegenwärtig -- 
  glich Freude -- unerkannt Zeitlang Gesellschaft bedienen -- wandeln -- zuletzt scherzhaft Weise entdecken wissen -- 
  Abend lassen Wilhelm Zimmer fordern -- -- Philin vorbereiten -- 
  finden Verwunderung -- gnädigen Frau -- leichtfertig Mädchen Zimmer -- 
  begegnet gewiß anständig Freimütigkeit -- üben -- nötigen gleichfalls Höflichkeit -- 
  scherzt Glück -- verfolgen -- -- Merk -- gegenwärtig hierher bringen -- Sodann werfen angenehm Art Betrag -- womit quälen -- Schalt beschuldigen -- gestehen -- Begegnung verdienen -- aufrichtig Beschreibung Zustand -- vorig nennen -- setzen hinzu -- verachten müssen -- fähig ändern -- Freundschaft wert -- 
  Wilhelm Rede betreffen -- 
  Kenntnis Welt -- wissen -- leichtsinnig Besserung unfähig Mensch lebhaftesen anklagen -- Fehler Freimütigkeit bekennen bereuen -- minde Kraft -- Weg treten -- übermächtig Natur hinreißen -- 
  unfreundlich zierlich Sünderin bleiben -- lassen Gespräch -- vernehmen Vorschlag sonderbaren Verkleidung -- womit schön Gräfin überraschen gedachen -- 
  finden Bedenken -- Philin verhehlen -- Baroneß -- Augenblick herein treten -- lassen Zweifel übrig -- ziehen vielmehr fort -- versichern -- Stunde -- 
  dunkel -- führen Garderobe Grafe -- lassen Rock ausziehen -- seiden Schlafrock Grafe hinein schlupfen -- setzen Mütze rot Bande -- führen Kabinett heißen -- Sessel setzen Buch nehmen -- zünden argantisch Lampe -- stehen -- unterrichten -- -- Rolle spielen -- 
  -- -- Gräfin unvermutet Ankunft Gemahl -- übel Laune ankündigen -- -- einigemal Zimmer abgehen -- alsdann Lehne Sessel setzen -- Arm Schulter legen -- Wort sprechen -- 
  sollen Ehemannsrolle spielen -- entdecken müssen -- sollen hübsch artig galant -- 
  Wilhelm sitzen unruhig wunderlich Maske -- Vorschlag überraschen -- Ausführung eilt Überlegung zuvor -- 
  Baroneß Zimmer hinaus -- bemerken -- gefährlich Posten -- einnehmen -- 
  leugnet -- Schönheit -- Jugend -- Anmut Gräfin Eindruck -- Natur leer Galanterie entfernen -- Grundsatz Gedanke ernsthafter Unternehmung erlauben -- Augenblick gering Verlegenheit -- 
  Furcht -- Gräfin mißfallen -- billig fallen -- -- 
  weiblich Reiz -- jemals wirken -- zeigen Einbildungskraft -- 
  Mariane erscheinen weiß Morgenkleid -- fleht Andenken -- 
  Philines Liebenswürdigkeit -- schön Haar -- einschmeichelnd Betragen neu Gegenwart wirksam -- treten Flor Entfernung -- edlen -- blühend Gräfin denken -- Arm Minute Hals fühlen -- unschuldig Liebkosung erwidern auffordern -- 
  sonderbar Art -- Verlegenheit ziehen -- ahnden freilich -- 
  erstaunen -- Schrecken -- Türe Auftat -- verstohlen Blick -- Spiegel werfen -- Grafe deutlich erblicken -- Licht Hand herein treten -- 
  Zweifel -- -- sitzen bleiben aufstehen -- flieh -- bekennen -- leugnen Vergebung bitten sollen -- dauern Augenblick -- 
  Graf -- unbeweglich Türe stehen bleiben -- treten Sachte -- 
  Moment springen Baronesse Seitentüre herein -- löscht Lampe -- reißen Wilhelm Stuhle -- ziehen Kabinett -- 
  Geschwind werfen Schlafrock -- sogleich gewöhnlich Platz erhalten -- 
  Baronesse Wilhelm Rock Arm -- eilt Stube -- Gang Verschlag Zimmer -- Wilhelm -- erholen -- vernehmen -- Gräfin kommen -- erdichten Nachricht Ankunft Grafe bringen -- 
  wissen -- Gräfin -- begegnen -- 
  Seitentor herein reiten sehen -- 
  erschrocken Baronesse sogleich Graf Zimmer laufen -- abzuholen -- 
  Unglücklicherweise spät kommen -- rufen Wilhelm -- 
  Graf vorhin Zimmer -- sitzen sehen -- 
  erkennen -- 
  wissen -- 
  Spiegel -- -- ehe wissen -- Gespenst -- treten -- drücken Türe -- 
  Verlegenheit Baronesse vermehrn -- Bedienter rufen -- anzeigen -- Graf befinden Gemahlin -- 
  schwer Herzen -- finden Grafe still kehren -- Äußerung mild freundlich gewöhnlich -- 
  wissen -- denken -- 
  sprechen Vorfälle Jagd Ursache früh Zurückkunft -- 
  Gespräch -- 
  Graf stillen -- müssen Baronesse auffallen -- Wilhelm fragen -- Wunsch äußern -- 
  rufen lassen -- vorlese -- 
  Wilhelm -- Zimmer Baroneß angekleiden einigermaßen erholen -- Sorge Befehl herbei -- 
  Graf Buch -- abenteuerlich Novelle Beklemmung vorlas -- 
  Ton Unsicheres -- Zitternde -- glücklicherweise Inhalt Geschichte schicken -- 
  Graf einigemal freundlich Zeichen Beifall -- loben besonderer Ausdruck Vorlesung -- zuletzt unser Freund entlassen -- 
  Elftes Kapitel -- 
  Wilhelm Stück Shakespear lesen -- Wirkung stark -- fortzufahren Stande -- 
  Seele geraten Bewegung -- 
  suchen Gelegenheit -- Jarno sprechen -- verschaffen Freude danken -- 
  voraussehen -- -- Trefflichkeit außerordentlichst wunderbarst Schriftsteller unempfindlich bleiben -- 
  -- rufen Wilhelm -- erinneren -- Buch -- Mensch Begebenheit Leben Wirkung hervorbringen -- köstlichen Stück -- Gütigkeit kennen lernen -- 
  scheinen Werk himmlisch Genius -- Mensch nähern -- gelindest Weise -- 
  Gedicht -- glauben aufgeschlagenen -- ungeheur Buch Schicksal stehen -- Sturmwind bewegtest Leben sausen -- Gewalt rasch blättern -- 
  Stärke Zartheit -- Gewalt Ruhe erstaunt -- Fassung bringen -- Sehnsucht warten -- Zustande befinden -- lesen -- 
  bravor -- Jarno -- unser Freund Hand reichen drücken -- -- Folge -- hoffen -- gewiß ausbleiben -- 
  -- wünschen -- versetzen Wilhelm -- -- gegenwärtig vorgehen -- entdecken -- 
  Vorgefühl -- jemals Menschheit Schicksal -- Jugend -- unbemerken -- begleiten -- finden Shakespear Stück erfüllen entwickeln -- 
  scheinen -- Rätsel offenbaren -- sagen -- 
  Wort Auflösung -- 
  Mensch scheinen natürlich Mensch -- -- 
  geheimnisvollst zusammengesetztest Geschöpf Natur handeln Stück -- Uhr sein -- Zifferblatt Gehäuse Kristall bilden -- zeigen Bestimmung Lauf Stunde -- Räder Federwerk erkennen -- treiben -- 
  weniger Blick -- Shakespear Welt tun -- reizen -- wirklich Welt schnell Fortschritt vorwärts -- Flut Schicksal mischen -- verhängen -- dereinst -- glücken -- Meer wahr Natur Becher schöpfen -- Schaubühne lechzend Publikum Vaterlande auszuspenden -- 
  freuen Gemütsverfassung -- sehen -- versetzt Jarno -- legen bewegt Jüngling Hand Schulter -- 
  Lassen Vorsatz fahren -- tätig Leben überzugehen -- eilen gut -- gönnen -- Wacker nutzen -- 
  behilflich -- geschehen ganz Herz -- 
  fragen -- Gesellschaft kommen -- weder gebären Erzog -- 
  Hoffe sehen -- heraus sehnen -- 
  wissen Herkunft -- häuslich Umstand -- überlegen -- vertrauen -- 
  sagen -- Zeit Krieg -- leben -- schnell Wechsel Glückes hervorbringen -- Kraft Talent unser Dienst widmen -- Mühe -- Not tun -- Gefahr scheuen -- Gelegenheit -- Platz stellen -- Zeitlang bekleiden -- Folge gereuen -- 
  Wilhelm ausdrücken -- willig -- Freund Beschützer Geschichte Leben erzählen -- 
  Gespräch Park verlieren -- Landstraße -- durchging -- kommen -- 
  Jarno stehen Augenblick still -- -- bedenk Vorschlag -- entschließen -- geben Antwort -- schenken vertrauen -- 
  versichr -- unbegreiflich -- Volk gemein -- 
  Ekel Verdruß sehen -- -- einigermaßen leben -- Herz herumziehend Bänkelsänger albern zwitterhaft Geschöpf hängen müssen -- 
  ausgeredet -- Offizier Pferd eilends herankommen -- Reitknecht Handpferd folgen -- 
  Jarno rufen lebhaft Gruß -- 
  Offizier springen Pferd -- umarmt unterhieln -- Wilhelm -- bestürzt letzter Wort kriegerisch Freund -- kehren Seite stehen -- 
  Jarno durchblättert Papier -- Ankommende überreichen -- Wilhelm -- reichen Hand -- rufen Emphase -- treff würdig Gesellschaft -- folgen Rate Freund -- erfüll Wunsch Unbekannt -- herzlichen nehmen -- 
  sprechen -- umarmen Wilhelm -- drücken Lebhaftigkeit Brust -- 
  gleich treten Jarno herbei -- fremde -- 
  -- reiten hinein -- nötig Ordr erhalten -- reit Nacht fort -- 
  schwang Pferd -- überließen unser verwundert Freund Betrachtung -- 
  letzter Wort Jarno klangen Ohr -- 
  unerträglich -- Paar menschlich Wesen -- unschuldigerweis Neigung abgewonnen -- Mann -- verehren -- tief heruntergesetzt sehen -- 
  sonderbar Umarmung Offizier -- kennen -- Eindruck -- beschäftigt Neugierde Einbildungskraft Augenblick -- Jarnos Reden Herz treffen -- tief verwunden -- brechen Rückwege Vorwurf -- Augenblick hartherzig Kälte Jarnos -- Auge heraussehen -- Gebärde sprech -- Verkenn vergessen -- 
  -- -- rufen -- bildest -- abgestorben Weltmann -- Freund könnest -- 
  -- anbieten -- Empfindung wert -- Unglücklichen binden -- 
  welch Glück -- Zeit entdecken -- erwarten -- -- 
  schließen Mignon -- entgegen -- Arm -- rufen -- -- trennen -- Geschöpf -- 
  scheinbar Klugheit Welt vermögen -- verlassen -- vergessen -- schuldig -- 
  Kind -- heftig Liebkosung ablehnen pflegen -- erfreute unerwartet Ausdrucke Zärtlichkeit -- hing fest -- Mühe zuletzt -- 
  Jarnos Handlung -- lobenswürdig scheinen -- -- Mißfiel -- 
  stark Verdacht -- Gedicht Baron -- arm Pedant teuer bezahlen -- Jarno Arbeit -- 
  Wilhelm Gegenwart Vorfall scherzen -- glauben Freund hierin Zeichen höchst verdorben Herzen erkennen -- Boshafter -- Unschuldige -- leiden verursachen -- verspoten -- weder Genugtuung Entschädigung denken -- 
  Wilhelm veranlassen -- sonderbaren Zufall Täter nächtlich Mißhandlung Spur kommen -- 
  verbergen wissen -- jung Offizier -- unterer Saal alt Schloß -- Teil Schauspieler Schauspielerinne Nacht lustig Weise zubrachten -- 
  morgens -- Gewohnheit früh aufgestehen -- ungefähr Zimmer -- finden jung Herr -- höchst sonderbar Toilette Begriff Stunde -- 
  Napf Wasser Kreide eingerieben -- tragen Teig Bürste Westen Beinkleider -- auszuziehen -- stellen Reinlichkeit Garderobe schnellsen -- 
  Unserem Freund -- Handgriff wunderen -- fallen weiß bestäubt befleckt Rock Pedante -- Verdacht stark -- erfahren -- verwandte Baron Gesellschaft befänden -- 
  Verdacht nah Spur -- suchen jung Herr Frühstück beschäftigen -- 
  lebhaft -- erzählten lustig Geschichte -- 
  -- Zeitlang Werbung stehen -- wissen List Tätigkeit Hauptmann rühmen -- Art Mensch ziehen -- Art überlisen verstehen -- 
  umständlich erzählt -- jung Leute gut Haus sorgfältig Erziehung -- allerlei Vorspiegelung anständig Versorgung betrügen -- lachen herzlich Gimpel -- Anfange tun -- angesehen -- tapfer -- klug freigebig Offizier schätzen hervorgezogen sehen -- 
  segnen Wilhelm Genius -- unvermuten Abgrund zeigen -- Rand unschuldigerweise nähern -- 
  Jarno Werber -- Umarmung fremd Offizier erklärlich -- 
  verabscheut Gesinnung Mann -- vermeiden Augenblick -- Uniform tragen -- -- Nachricht -- Armee vorwärts rücken -- Sinn angenehm -- fürchten -- Nähe schön Freundin -- -- verbannen -- 
  Zwölftes Kapitel -- 
  inzwischen Baronesse mehrere -- Sorge unbefriedigt Neugierd peinigen -- zubrachen -- Betrag Grafe Abenteuer völlig Rätsel -- 
  Manier herausgegang -- gewöhnlich Scherze hören -- 
  Forderung Gesellschaft bedienter nachlassen -- 
  Pedanterie gebieterisch Wesen merken -- vielmehr still kehren -- scheinen heit -- anderer Mensch -- 
  Vorlesung -- zuweilen Anlaß -- wählen ernsthaft -- religiös Buch -- Baronesse leben beständig Furcht -- anscheinend Ruhe geheim Groll verbergen -- still Vorsatz -- Frevel -- zufällig entdecken -- rächen -- 
  entschließen -- Jarno vertraute -- -- Verhältnis stehen -- verbergen pflegen -- 
  Jarno kurz entschieden Freund -- klug -- Neigung Freude lärmend Welt -- umgeben -- verbergen -- 
  Auge Gräfin Roman entgehen -- höchst wahrscheinlich suchen Baronesse Freundin gleichfalls beschäftigen -- still Vorwurf entgehen -- manchmal edl Seele erdulden -- 
  Baronesse Freund Geschichte erzählen -- lachend ausrufen -- 
  glauben alt gewiß sehen -- fürchten -- Erscheinung Unglück -- Tod bedeuten -- zehmen halbmensch -- Auflösung denken -- entgehen -- entgehen -- 
  stillen -- hoffen -- leben -- Gelegenheit formieren -- Frau Hausgenossen Last -- 
  fangen -- schicklich -- Gegenwart Grafe -- Ahnung -- Erscheinung dergleichen sprechen -- 
  Jarno spielen Zweifler -- Freundin gleichfalls -- treiben -- Graf Jarno Seite -- Freigeisterei verweisen -- -- -- Möglichkeit Wirklichkeit Geschichte überzeugen suchen -- 
  Jarno spielen betroffener -- Zweifelnd Überzeugt -- still Nacht Freundin desto lustig schwach Weltmann -- Unart Popanz bekehren -- loben -- vieler Fassung bevorstehend Unglück -- Tod erwarten -- 
  natürlich Folge -- Erscheinung -- fassen -- rufen Baronesse gewöhnlich Munterkeit -- -- Sorge Herz nehmen -- übergehen -- 
  Jarno reichlich belohnen -- schmieden Anschlag -- Graf kirr -- Neigung Gräfin Wilhelm reizen bestärken -- 
  Absicht erzählt Gräfin Geschichte -- anfangs unwillig zeigen -- nachdenklich -- ruhig Augenblick Szene -- zubereiten -- Bedenken -- verfolg auszumalen scheinen -- 
  Anstalt -- nunmehr Seite treffen -- lassen Zweifel übrig -- Armee vorwärts rücken -- Prinz Hauptquartier verändern -- heißen -- Graf verlassen Stadt zurückkehren -- 
  schauspiel Nativität stellen -- einzig Melina Maßregel -- suchen Augenblick Vergnüglichste erhaschen -- 
  Wilhelm indessen Weise beschäftigen -- 
  Gräfin Abschrift Stück verlangen -- Wunsch liebenswürdig Frau schön Belohnung -- 
  jung Autor -- gedruckt sehen -- wenden Fall groß Aufmerksamkeit reinlich zierlich Abschrift Werk -- 
  gleichsam golden Zeitalter Autorschaft -- sehen Jahrhundert versetzen -- Presse Welt unnütz Schrift überschwemmen -- würdig Geistesprodukt abschreiben -- edelst Mensch verwahren -- begehen Alsdann Fehlschluß -- sorgfältig abgezirkelt Manuskript würdig Geistesprodukt -- wert Kenner Beschützer besessen aufstellen -- 
  Ehre Prinz -- kurz abgehen -- Gastmahl anstellen -- 
  Dame Nachbarschaft laden -- Gräfin Zeit anziehen -- 
  reicheres Kleid anlegen -- wohnen -- 
  Frisur Aufsatz gesucht -- Juwele schmücken -- 
  Baronesse Möglich tun -- Pracht Geschmack anzukleid -- 
  Philin -- merken -- Dame -- Erwartung Gast -- -- schlagen -- Wilhelm lassen -- fertig Manuskript überreich Kleinigkeit vorzulesen wünschen -- 
  erstaunen Hereintreten Gestalt -- Anmut Gräfin -- Putz sichtbar -- 
  elsan Befehl Dame -- zerstreuen -- Zuhörerinn nachsichtig sein -- entlassen -- 
  Gräfin anblicken -- scheinen -- elektrisch Funke Auge zeigen -- wissen zuletzt -- Atem Rezitation hernehmen sollen -- 
  schön Dame fallen -- scheinen -- vollkommeneres sehen -- tausenderlei Gedanke -- Seele kreuzt -- ungefähr folgend Inhalt -- 
  töricht lehnen Dichter sogenannter gefühlvoll Mensch Putz Pracht -- verlangen einfach -- Natur angemessen Kleid Frau Stand sehen -- 
  schelt Putz -- Bedenken -- arm Putz -- mißfallen -- häßlich minder schön Person reich sonderbar kleiden erblicken -- Kenner Welt versammeln fragen -- wünschten Falte -- Bänder Spitze -- Puffen -- Locke leuchtend Stein wegzunehmen -- 
  fürchten -- angenehm Eindruck stören -- willig entgegen -- 
  -- sagen -- 
  Minerva rüsten Haupt Jupiter entspringen -- scheinen Göttin voll Putze Blume leicht Fuß hervortreten -- 
  Lesen -- Eindruck ewig einprägen -- lesen einigemal falsch -- Verwirrung geraten -- Verwechselung Wort Buchstaben leidig Schandfleck Vorlesung verzweifeln -- 
  falsch Lärm -- Gast anfahren kommen -- Vorlesung -- 
  Baronesse weg -- Gräfin -- Begriff Schreibtisch zuzumachen -- stehen -- ergriff Ringkästchen stecken Ring Finger -- 
  trennen -- -- Auge Kästchen heften -- nehmen Andenken gut Freundin -- lebhaft wünschen -- wohlgehen mögen -- 
  Ring heraus -- Kristall schön Haar geflochten Schild zeigen -- Stein besetzen -- 
  überreichen Wilhelm -- -- annehmen -- sagen wissen -- eingewurzeln Boden stehen -- 
  Gräfin schließen Schreibtisch -- setzen Sofa -- 
  leer ausgehen -- Philin -- Hand Gräfin niederknien -- sehen Mensch -- Unzeit Worte Mund führen -- armselig Danksagung herstammeln -- 
  Frisch -- Herr -- pantomimisch Schuldigkeit -- erfinden wissen -- ahmen -- 
  Philine ergriff Hand Gräfin -- küßen Lebhaftigkeit -- 
  Wilhelm stürzen Knie -- fassen linker -- drücken Lippe -- 
  Gräfin scheinen verlegen -- Widerwille -- 
  -- rufen Philin -- Schmuck sehen -- Dame -- würdig tragen -- 
  Armbänder -- 
  Hand -- 
  Halsschmuck -- Brust -- 
  Stille -- Schmeichlerin -- rufen Gräfin -- 
  stellen Herr Graf -- Philin -- reich Medaillon deuten -- Gräfin kostbar Kette linker Seite tragen -- 
  Bräutigam malen -- versetzt Gräfin -- 
  jung -- fragt Philin -- 
  -- wissen -- verheiraten -- 
  Jugend Rechnung Maler -- versetzen Gräfin -- 
  schön Mann -- Philin -- 
  niemals -- fahren fort -- Hand Herz Gräfin legen -- verborgen Kapsel and Bild eingeschlichen -- 
  verwegen -- Philin -- rufen -- 
  verziehen -- 
  Laß zweitenmal hören -- 
  zürnen -- unglücklich -- rufen Philine -- springen eilt Türe hinaus -- 
  Wilhelm halten schön Hand Hand -- 
  unverwandt Armschloß -- -- groß Verwunderung -- Anfangsbuchstaben Name brillanten Zügen sehen lassen -- 
  Besitz -- fragen bescheiden -- kostbaren Ring -- Haar -- 
  -- versetzen halb Stimme -- -- -- Hand drücken -- stehen -- leben -- 
  stehen Nahme -- rufen -- sonderbarst Zufall -- 
  zeigen Armschloß -- 
  -- rufen Gräfin -- 
  Chiffre Freundin -- 
  Anfangsbuchstaben Namen -- 
  vergessen -- 
  Bild stehen unauslöschlich Herz -- 
  Leben -- lassen fliehen -- 
  küssen Hand -- aufstehen -- Traum Seltsamst Seltsamst entwickelnd überraschen -- halten -- wissen geschehen -- Gräfin arme -- Lippe ruhen seinigen -- wechselseitig lebhaft Küs gewährt Seligkeit -- aufbrausend Schaum frisch eingeschenkt Becher Liebe schlürfen -- 
  haupt ruht Schulter -- zerdrückt Locke Bänd denken -- 
  Arm geschlungen -- umfaßt Lebhaftigkeit -- drücken wiederholend Brust -- 
  O Augenblick Ewigkeit währen -- wehe neidisch Geschick -- unser Freund kurz Augenblick unterbrechen -- 
  erschrak Wilhelm -- betäuben fahren glücklich Traume -- Gräfin Schrei losriß -- Hand Herz fahren -- 
  stehen betäuben -- halten Hand Auge -- rufen Pause -- entfernen -- eilen -- 
  stehen -- 
  verlassen -- rufen -- Hand Auge -- unbeschreiblich Blick ansehen -- setzen lieblichst Stimme hinzu -- flieh -- lieben -- 
  Wilhelm Zimmer -- Stube -- ehe wissen -- befinden -- 
  Unglücklichen -- sonderbar Warnung Zufall Schickung reißen -- 
  Wilhelm Meister Lehrjahre -- 
  Buch -- 
  Kapitel -- 
  Laert stehen nachdenklich Fenster blicken -- Arm stützen -- Feld hinaus -- 
  Philin schlich Saal herbei -- lehnen Freund -- verspotten ernsthaft ansehen -- 
  lache -- versetzen -- abscheulich -- vergehen -- verändern nehmen -- 
  Sieh -- stehen kurz schön Lager -- lustig sehen Zelt -- 
  lebhaft -- 
  sorgfältig bewacht Bezirk -- verschwinden -- 
  kurz zertreten Stroh eingegraben Kochlöcher Spur zeigen -- umgepflügt -- Gegenwart vieler tausend rüstig Mensch Gegend Kopf alt Leute spuken -- 
  Philin fing singen -- ziehen Freund Tanze Saal -- 
  Laß -- rufen -- nachlaufen -- vorüb -- schön Göttin -- vorbeiziehen -- fröhlich zierlich verehren -- 
  Wendung -- Madam Melina Saal -- 
  Philine boshaft -- gleichfalls Tanze einladen -- Mißgestalt erinnern -- Schwangerschaft versetzen -- 
  -- Philin Rücken -- Frau Hoffnung sehen -- 
  hoffen -- Laert -- 
  kleiden häßlich -- 
  vord Wackelfalt verkürzt Rock sehen -- voraus spazieren -- bewegen -- 
  Art Geschick -- bissch Muster Zustand verbergen -- 
  Laß -- Laert -- Hilfe -- 
  hübsch -- rufen Philine -- Kind Bäumen schütteln -- 
  Baron treten herein -- freundlich Name grafer Gräfin -- früh abgereisen -- Geschenk -- 
  Wilhelm -- Nebenzimmer Mignon beschäftigen -- 
  Kind freundlich zutätig bezeigen -- Wilhelm Eltern -- Geschwister verwandte fragen -- Pflicht erinnern -- seinig Nachricht geben -- 
  Baron bringen nebst Abschiedsgruße Herrschaft -- Versicherung -- Graf -- Spiel -- poetisch Arbeit theatralisch Bemühung zufrieden -- 
  ziehen Beweis Gesinnung Beutel hervor -- schön Gewebe reizend Farbe neu Goldstück durchschimmeren -- Wilhelm treten -- weigern annehmen -- 
  sehen -- fahren Baron fort -- Gabe Ersatz -- Erkenntlichkeit Mühe -- Belohnung Talent -- 
  gut Name Neigung Mensch verschaffen -- billig -- Fleiß Anstrengung erwerben -- Bedürfnis befriedigen -- Geist -- 
  Wären Stadt -- finden -- Summe -- Ring verwandeln -- geben Zauberstab unmittelbar Hand -- schaff Kleinod -- liebsn dienlichsten -- verwahren unser Andenken -- 
  halten Beutel Ehre -- 
  Dame gestricken -- Absicht -- Gefäß Inhalt annehmlichst Form geben -- 
  Vergebe -- versetzen Wilhelm -- Verlegenheit Zweifel -- Geschenk annehmen -- 
  vernichten gleichsam tun -- hindern frei Spiel glücklich Erinnerung -- 
  Geld schön Sache -- abtun -- wünschen Andenken Haus abtun -- 
  Fall -- versetzen Baron -- zart empfinden -- verlangen -- Graf völlig Schuldner denken -- 
  Mann groß Ehrgeiz setzen -- aufmerksam gerecht -- 
  entgehen -- Mühe geben -- Absicht widmen -- wissen -- -- gewiß Anstalt beschleunigen -- Geld schonten -- 
  erscheinen -- versichern -- Erkenntlichkeit Vergnügen -- 
  denken -- Empfindung folgen dürfen -- versetzen Wilhelm -- -- unerachten Grund -- hartnäckig weigern -- Gabe -- schön ehrenvoll -- annehmen -- leugne -- Augenblick -- Verlegenheit setzen -- Verlegenheit reißen -- Meinig befinden -- still Kummer verursachen -- 
  sowohl Gelde -- Rechenschaft geben -- hausgehalten -- Edelmut Herr Grafe -- Meinig getrost Glücke Nachricht geben -- sonderbar Seitenweg führen -- 
  Opfre Delikatesse -- zart Gewissen Gelegenheit warnen -- hoch Pflicht -- Vater mutig Auge treten -- stehen beschämt Ihrig -- 
  sonderbar -- versetzen Baron -- welch wunderlich Bedenken -- Geld Freund Gönner annehmen -- Gabe Freude empfangen -- 
  menschlich Natur ähnlich Eigenheit -- Skrupel erzeugen sorgfältig nähren -- 
  nämlich Ehrenpunkt -- fragen Wilhelm -- 
  -- versetzen Baron -- Vorurteil -- 
  ausjät -- edl Pflanze auszuraufen -- 
  freuen -- einzeln Person fühlen -- hinaussetz -- denken Vergnügen Geschichte geistreichen Dichter -- Hoftheater Stück verfertigen -- Beifall Monarch erhalten -- 
  ansehnlich belohnen -- großmütig Fürst -- forsch -- Kleinod Vergnügen -- verschmähen Geld annehmen -- 
  scherzhaft Art antwortet Dichter abgeordneen Hofmann -- danken lebhaft gnädig Gesinnung -- Kaiser Geld nehmen -- sehen -- schämen -- Geld annehmen -- 
  Baron Zimmer verlassen -- Wilhelm eifrig Barschaft zählen -- unvermuten -- glauben -- unverdient Zugekommen -- 
  scheinen -- Wert Gold -- späteren fühlbar -- ahnungsweise erstenmal entgegen blickt -- schön blinkend Stück zierlich Beutel hervorrollten -- 
  Rechnung finden -- -- Melina Vorschuß sogleich bezahlen versprechen -- -- Kassa -- -- Philine Strauß abfordern lassen -- 
  heimlich Zufriedenheit blickt Talent -- stolz Glück -- leiten begleiten -- 
  Ergriff nunmehr Zuversicht Feder -- Brief schreiben -- Familie Verlegenheit bisherig Betragen gut Licht setzen -- 
  Vermied eigentlich Erzählung -- lassen bedeutend mystisch Ausdrück dasjenig -- begegnen -- erraten -- 
  Zustand Kasse -- Erwerb -- Talent schuldig -- Gunst -- Neigung Frau -- Bekanntschaft weit Kreis -- Ausbildung körperlichen geistig Anlage -- Hoffnung Zukunft bilden wunderlich Luftgemälde -- Fata Morgana seltsam durcheinander wirken -- 
  glücklich Exaltation fahren fort -- Brief schließen -- lang Selbstgespräch unterhalten -- Inhalt Schreiben rekapituliern -- tätig würdig Zukunft ausmalen -- 
  vieler edl Krieger angefeuern -- shakespearisch Dichtung Welt eröffnen -- Lippe schön Gräfin unaussprechlich Feuer gesogen -- 
  -- Wirkung auf Leben bleiben -- 
  Stallmeister fragen -- 
  Einpacke fertig -- 
  Melina denken -- 
  eilig aufbrechen -- 
  Graf versprechen -- Gesellschaft Tagereise transportieren lassen -- Pferd bereit -- entbehren -- 
  Wilhelm fragt Koffer -- Madam Melina Nutze -- verlangt Gelde -- Herr Melina unten Koffer Sorgfalt packen -- 
  Philin -- 
  meinig Platz -- Wilhelm Kleid -- befehlen Mignon übrige nachzubringen -- 
  Wilhelm müssen Widerwille geschehen lassen -- 
  aufpacken -- zubereiten -- Melina -- 
  verdrießlich -- Seiltänzer Marktschreier reisen -- wünschen -- Mignon Weiberkleid anzögen -- Harfenspieler geschwind Bart scheren lassen -- 
  Mignon halten fest Wilhelm -- Lebhaftigkeit -- 
  Knabe -- Mädchen -- 
  alte schweigen -- Philin Gelegenheit Eigenheit Grafe -- Beschützer -- lustig Anmerkung -- 
  Harfner Bart abschneiden -- -- sorgfältig Band nähen bewahren -- vornehmen -- sobald Herr Grafe irgendwo Welt begegnen -- Bart Gnade Herr verschaffen -- 
  drang Erklärung sonderbaren Äußerung verlangen -- lassen Folgendergestalt vernehmen -- Graf glauben -- Illusion beitragen -- Schauspieler gemein Leben Rolle fortspielen -- Charakter soutenieren -- Pedante günstig -- finden -- gescheit -- Harfner falsch Bart Abends Theater -- beständig tragen -- freut natürlich Aussehe Maskerade -- 
  Irrtum sonderbaren Meinung Grafe spotteen -- Harfner Wilhelm Seite -- Abschied -- bitten Träne -- sogleich entlassen -- 
  Wilhelm reden -- versichern -- schützen -- Haar krümm -- viel_wenig Wille abschneiden -- 
  alte bewegen -- Auge glüht sonderbares Feuer -- 
  Anlaß treiben hinweg -- rufen -- machen still Vorwurf -- bleiben -- 
  nirgends verweilen -- Unglück ereilen beschädigen -- gesellen -- 
  Fürcht -- entlassen -- fragen -- gehören -- bleiben -- 
  Gehörst -- 
  Gewalt ausüben -- 
  Herr -- lassen schaudervoll Geheimnis -- geben -- 
  Rache -- verfolgen -- irdisch Richter -- gehören unerbittlich Schicksal -- bleiben -- -- 
  Zustande -- sehen -- gewiß lassen -- 
  Hochverrat -- Wohltäter -- zaudre -- 
  sicher -- Gefahr -- 
  wissen -- Nähe hegen -- 
  schuldig -- unglücklich schuldig -- 
  Gegenwart verscheuchen Glück -- ohnmächtig -- treten -- 
  Flüchtig unstet sollen -- unglücklich Genius einholet -- langsam verfolgen -- merken lassen -- Haupt niederlegen ruhen -- 
  Dankbarer bezeigen -- verlassen -- 
  Sonderbarer Mensch -- 
  vertrauen nehmen -- Hoffnung -- glücklich sehen -- 
  Geheimnis dein Aberglauben eindringen -- Ahnung wunderbar Verknüpfung Vorbedeutung lebst -- sagen Trost Aufmunterung -- gesell Glück -- sehen -- Genius stark -- Schwarzer Weißer -- 
  Wilhelm ergreifen Gelegenheit -- mancherlei Tröstliche sagen -- wunderbar Begleiter Mensch sehen glauben -- Zufall Geschick schuld laden -- Erinnerung fortschleppen -- 
  weniger Wilhelm Gesang behorchen -- folgend Zeile merken -- 
  färben Morgensonne Licht rein Horizont Flamme -- schuldigen Haupt brechen schön Bild Welt -- 
  alte sagen -- Wilhelm stark Argument -- wissen kehren wenden -- wissen brav -- herzlich tröstlich sprechen -- alt aufzuleben Grill entsagen scheinen -- 
  Kapitel -- 
  Melina Hoffnung -- wohlhabend Stadt Gesellschaft unterzukommen -- 
  befinden Ort -- wohin Pferd Grafe bringen -- sehen Wagen Pferd -- hoffen -- 
  Melina Transport übernehmen -- zeigen -- Gewohnheit -- karg -- 
  Wilhelm schön Dukat Gräfin Tasche -- fröhlich Verwendung groß glauben -- vergessen -- stattlich Bilanz -- Seinig zuschicken -- ruhmredig aufführen -- 
  Freund Shakespeare -- Freude Pate anerkannen -- Wilhelm nennen lassen -- Prinz -- gering -- sogar schlecht Gesellschaft Zeitlang aufhalten -- -- ungeachtet edel Natur -- Roheit -- Unschicklichkeit Albernheit sinnlich Bursche ergötzen -- 
  Höchst willkommen Ideal -- womit gegenwärtig Zustand vergleichen -- Selbstbetrug -- wozu fast unüberwindlich Neigung spüren -- außerordentlich erleichtern -- 
  fing Kleidung nachdenken -- 
  finden -- Westchen -- Notfall kurz Mantel würfen -- Wanderer angemessen Tracht -- 
  gestrickt Beinkleid Paar Schnürstiefel scheinen wahr Tracht Fußgänger -- 
  verschaffen schön seiden Schärpe -- Vorwande -- Leib warm halten -- Umband -- befreit Hals Knechtschaft Binde -- lassen Streifen Nesseltuch an Hemde heften -- breit geraten -- völlig ansehen antik Kragen erhalten -- 
  schön seiden Halstuch -- gerettet Andenken Mariane -- liegen locker knüpfen nesseltuchen Krause -- 
  rund Hut bunt Bande Feder Maskerade vollkommen -- 
  Frau beteueren -- Tracht lassen vorzüglich -- 
  Philine stellen bezaubern -- bitten schön Haar -- -- natürlich Ideal desto nah -- unbarmherzig abschneiden -- 
  empfehlen übel -- Freund -- Freigebigkeit erwerben -- Prinz Harry's Manier übrig umgehen -- Geschmack -- toll Streich angeben befördern -- 
  fochen -- tanzen -- Erfand allerlei Spiel -- Fröhlichkeit Herzens genoß leidlich Wein -- antreffen -- stark Maß -- Philine lauert Unordnung Lebensart spröd Held -- Genius Sorge tragen mögen -- 
  vorzüglich Unterhaltung -- Gesellschaft ergötzen -- bestehen extemporiert Spiel -- bisherig Gönner Wohltäter nachahmen durchzogen -- 
  Eigenheit äußerer Anstand verschieden vornehm Person merken -- Nachbildung übrig Gesellschaft groß Beifall aufnehmen -- Philin geheim Archiv Erfahrung besonderer Liebeserklärung -- geschehen -- vorbrachen -- wissen lachen Schadenfreude lassen -- 
  Wilhelm schelten Undankbarkeit -- setzen entgegen -- -- erhalten -- genügsam Abverdient -- Betrag verdienstvoll Leute -- rühmen -- gut -- 
  beschweren -- Achtung begegnen -- setzen -- 
  Spott -- Necken Nachahm -- bitter ungerecht -- 
  wünschen -- Wilhelm -- eur Äußerung weder Neid Eigenliebe durchschien -- Person Verhältnis Gesichtspunkt betrachteten -- 
  Sache -- Geburt erhaben Platz menschlich Gesellschaft setzen -- 
  ererbt Reichtümer vollkommen Leichtigkeit Dasein verschaffen -- -- ausdrücken -- Beiwese Menschheit -- Jugend -- reichlich umgeben finden -- gewöhnen meist Gut Größte betrachten -- Wert Natur schön ausgestattet Menschheit deutlich -- 
  Betrag Vornehmen Geringere -- äußerer Vorzüg abmessen -- erlaub Titel -- Rang -- Kleid Equipage -- Verdienst geltend -- 
  Wort Gesellschaft unmäßig Beifall -- 
  finden abscheulich -- Mann Verdienst stehen müssen -- Welt Spur natürlich herzlich Umgang finden -- 
  kommen letzter Punkt Hundertst Tausendste -- 
  Scheltet -- rufen Wilhelm -- bedauern vielmehr -- 
  Glück -- hoch erkennen -- innerer Reichtum Natur fließen -- selten erhöht Empfindung -- 
  arme -- besitzen -- gönnen -- Glück Freundschaft reich Maß genießen -- 
  geliebter weder Gnade erheben -- Gunst befördern -- Geschenk beglücken -- 
  -- 
  hingeben -- -- Wert -- Freund ewig versichern -- 
  welch Genuß -- welcher Glück Geber Empfänger -- 
  selig Zustand versetzen Treue -- vorübergehend Menschenleben himmlisch Gewißheit -- Hauptkapital unser Reichtum -- 
  Mignon Wort nähern -- Schlang zart arme -- bleiben Köpfchen Brust lehnen stehen -- 
  legen Hand Kind Haupt -- fahren fort -- 
  -- Gemüt gewinnen -- eignen Herz -- 
  gefällig -- bequem -- einigermaßen menschlich Betragen tun Wunder -- -- erworben Geist fest halten -- selten -- schwer -- -- -- erwerben leisten -- groß Wert legen -- 
  rührend Beispiel treu Diener -- Herr aufopferten -- 
  schön Shakespeare schildern -- 
  Treue -- Fall -- Bestrebe edlen Seele -- Größer -- 
  fortdauernd Anhänglichkeit Liebe Diener Herr -- bezahlt Sklave ansehen berechtigen -- 
  -- Tugende gering Stand -- entbehren -- kleiden schön -- 
  loskaufen -- versuchen -- Erkenntlichkeit überheben -- 
  -- Sinn glauben behaupten -- Freund -- Freund können -- 
  Mignon drücken Fester -- 
  -- versetzt Gesellschaft -- 
  brauchen Freundschaft -- niemals verlangen -- 
  Kunst verstehen -- beschützen -- 
  spielen -- zuhören -- lauter Parteilichkeit -- 
  günstig -- gefiel -- günstig -- fallen verdienen -- 
  erlauben -- Alberne Abgeschmackt Aufmerksamkeit Beifall ziehen -- 
  abrechnen -- versetzen Wilhelm -- Schadenfreude Ironie -- denken -- Kunst Liebe -- 
  Weltmann zerstreut Leben Innigkeit erhalten -- Künstler bleiben -- Vollkommenes hervorzubringen denken -- derjenige fremd -- Anteil Werk nehmen -- Künstler wünschen hoffen -- 
  glauben -- Freund -- Talenten Tugend -- 
  Wille lieben -- aufgeben -- 
  erkennen belohnen -- -- gefährlich Geheimnis -- verborgener üben -- 
  unterdessen -- Kenner auffinden -- Hunger sterben -- rufen Ecke -- 
  sogleich -- versetzen Wilhelm -- 
  sehen -- leben rühren -- finden Nahrung -- reichlich -- 
  worüber beschweren -- 
  unvermuten -- schlimmsen aussehen -- aufnehmen bewirten -- 
  -- gebrechen -- fallen -- Übung -- einigermaßen streben -- 
  treiben fremd Ding -- entfernen -- Schulkindern ähnlich -- -- Lektion erinnern -- 
  Wahrhaftig -- Philin -- unverantwortlich -- lassen Stück wählen -- Stelle spielen -- 
  Möglichst -- groß Auditorium stehen -- 
  überlegen -- Stück bestimmen -- 
  -- Deutschland Beifall finden -- verschollen -- 
  pfiffen Symphonie -- besann schnell Rolle -- fing spielt groß Aufmerksamkeit Stück -- Erwartung -- 
  applaudieren wechselsweise -- selten halten -- 
  fertig -- empfinden ausnehmend Vergnügen -- teils wohlzugebracht -- teils zufrieden -- 
  Wilhelm lassen weitläufig Lobe heraus -- Unterhaltung heit fröhlich -- 
  sollten sehen -- rufen Freund -- müssen -- Übung Art fortsetzten -- bloß Auswendiglern -- Probier Spiel mechanisch pflicht handwerksmäßig Einschränkt -- 
  Lob verdienen Tonkünstler -- ergötzen -- genau -- gemeinschaftlich Übung vornehmen -- 
  bemühen -- Instrument übereinzustimmen -- genau halten Takt -- zart wissen Stärke Schwäche Tons ausdrücken -- 
  fallen -- Solo vorlaut Akkompagnieren Ehre -- 
  suchen Geist Sinn Komponist spielen -- -- auftragen -- -- ausdrücken -- 
  genau geistreich Werk -- Kunst treiben -- zart Art Musik -- gewöhnlichst seltenst Äußerung Menschheit geschmackvoll ergötzend darstellen berufen -- 
  abscheulich -- Probe sudeln -- Vorstellung Laune Glück verlassen -- 
  groß Glück Vergnügen setzen -- übereinzustimmen -- wechselsweise fallen -- fern Beifall Publikum schätzen -- gleichsam garantieren -- 
  Kapellmeister Orchester gewiß -- Direktor Schauspiel -- 
  Mißgriff -- äußerer Ohr beleidigen -- schämen -- selten Schauspieler verzeihlich unverzeihlich Mißgriff -- innerer Ohr schnöde beleidigt -- anerkenn Schäme sehen -- 
  wünschen -- Theater schmal -- Draht Seiltänzer -- Ungeschickter hinauf wagen -- anstatt Fähigkeit fühlen -- paradieren -- 
  Gesellschaft Apostrophe -- überzeugen -- Rede können -- kurz nebst übrig halten -- 
  vielmehr überein -- Sinn -- anfangen -- Reise künftig -- bleiben -- gesellig Bearbeitung wollen obwalten lassen -- 
  finden -- Sache gut Laune frei Wille -- müssen eigentlich Direktor darein mischen -- 
  ausgemacht -- gut Mensch republikanisch Form gut -- behaupten -- Amt Direktor müssen herum -- müssen wählen -- Art klein Senat jederzeit beisetzen bleiben -- 
  Gedanke einnehmen -- wünscht -- Werk richten -- 
  -- Melina -- Reise Versuch -- suspendi Direktorschaft -- Ort Stelle -- 
  hoffen -- sparen -- Ausgabe Republik Interimsdirektor aufzuwälzen -- 
  lebhaft Rat -- Form Staat auf gute einrichten wollen -- 
  wandernd Reich -- Laert -- Grenzstreitigkeit -- 
  Schritt sogleich Sache -- erwählen Wilhelm Direktor -- 
  Senat bestellen -- Frau erhalten Sitz Stimme -- schlagen Gesetz -- verwerfen -- genehmigen -- 
  Unvermerkt Spiel vorüber -- angenehm zubrachen -- glauben Nützliche tun Form Aussicht vaterländisch Bühne eröffnen -- 
  Kapitel -- 
  Wilhelm hoffen nunmehr -- Gesellschaft Disposition -- dichterisch Verdienst Stück unterhalten -- 
  -- -- Tage kommen -- Schauspieler Stück ansehen -- Eindruck beurteilen -- Prüfung Gefallen Mißfalle erkennen geben -- 
  Zuschauer erlauben -- rühren unterhalten -- eigentlich urteilen -- 
  Schauspieler Stück Ursache Lobe Tadel Rechenschaft geben -- -- Sinn Autor -- Absicht eindringen verstehen -- 
  Fehler -- Stück Rolle beurteilen -- Rolle Zusammenhang Stück betrachten -- lebhaft bemerken -- erzählen -- geneigt Gehör gönnen -- 
  kennen Shakespear unvergleichlich Hamlet Vorlesung -- Schlos groß Vergnügen -- 
  setzen -- Stück spielen -- -- wissen -- Rolle Prinz übernehmen -- glauben studieren -- Anfing stärksen Stelle -- Selbstgespräche Auftritt memorieren -- Kraft Seele -- Erhebung Geist Lebhaftigkeit frei Spielraum -- bewegt Gemüt gefühlvoll Ausdrucke zeigen -- 
  glauben Geist Rolle eindringen -- Last tief Schwermut gleichsam Nähme -- Druck Vorbilde seltsam Labyrinth Laun Sonderbarkeite folgen suchen -- 
  memorieren -- üben -- glauben -- Held Person -- 
  -- desto schwer Vorstellung -- scheinen zuletzt fast unmöglich -- Übersicht gelangen -- 
  Stück ununterbrochen Folge -- passen -- 
  scheinen Charakter -- Ausdruck widersprechen -- verzweifelen fast -- Ton finden -- Rolle Abweichung Schattierung vortragen -- 
  Irrgängen bemühen vergebens -- besonderer Weg Ziel nähern hoffen -- 
  suchen Spur -- Charakter Hamlet früh Tod Vater zeigen -- bemerken -- unabhängig traurig Begebenheit -- unabhängig nachfolgend schrecklich Ereignis -- interessant Jüngling -- -- 
  Zart Edel entsprossen wachsen königlich Blume -- unmittelbar Einflüssen Majestät -- hervor -- Begriff Recht fürstlichen -- Gefühl gut Anständig Bewußtsein Höhe Geburt -- entwickeln -- 
  Fürst -- geboren Fürst -- wünschen regieren -- ungehinderen -- 
  Angenehm Gestalt -- sitten Natur -- gefällig Herz -- Muster Jugend -- Freude Welt -- 
  hervorstechend Leidenschaft -- Liebe Ophelia still Vorgefühl süß Bedürfnis -- Eifer ritterlich Übung Original -- vielmehr müssen Lust -- Lob -- beilegen -- geschärft erhöhen -- rein fühlend kannt Redlichen -- wissen Ruhe schätzen -- aufrichtig Gemüt offen Busen Freund genießen -- 
  gewiß Grad Künsten Wissenschaft schön erkennen würdigen lernen -- Abgeschmackte zuwider -- zart Seele Haß aufkeimen -- nötig -- beweglich falsch Höflinge verachten -- spöttisch spielen -- 
  gelassen Wesen -- Betragen einfach -- weder Müßiggange behaglich -- allzubegierig Beschäftigung -- 
  akademisch Hinschlendern scheinen Hof fortsetzen -- 
  besitzen Fröhlichkeit Laune Herzens -- Gesellschafter -- nachgiebig -- bescheiden -- besorgt -- Beleidigung vergeben vergessen -- niemals vereinigen -- Grenze -- Gute -- Anständig überschreten -- 
  Stück lesen -- beurteilen -- Weg -- 
  hoff Meinung Stelle belegen -- 
  Schilderung lauten Beifall -- glauben voraus sehen -- Handelsweise Hamlet erklären lassen -- freut Art -- Geist Schriftsteller eindringen -- 
  -- Stück Art studieren Sinn Verfasser entwickeln -- 
  Kapitel -- 
  müssen Gesellschaft Ort liegen bleiben -- sogleich zeigen verschieden Glied unangenehm Abenteuer -- Laert Dame angereizen -- Nachbarschaft -- äußerst kalt -- unartig betragen -- Philine Spötterei erdulden müssen -- 
  ergriff Gelegenheit -- unser Freund unglücklich Liebesgeschicht erzählen -- arm Jüngling weiblich Geschlecht Feind -- 
  übel nehmen -- rufen -- Geschlecht hassen -- übel mitgespieln -- Übel -- Mann Weiber befürchten -- konzentriert Trank verschlucken -- 
  Stelle -- binnen Stunde Liebhaber -- Bräutigam -- Ehemann -- Hahnrei -- Patient Witwer -- 
  wissen -- Ärger -- 
  Laert laufen halb lachend -- halb verdrießlich Stube hinaus -- Philin fing allerliebsten Art Geschichte erzählen -- Laert jung Mensch achtzehn -- Theatergesellschaft eintreffen -- schön vierzehnjährig Mädchen finden -- Vater -- Direktor entzweiet -- abzureisen Wille -- 
  Stegreife sterblich verlieben -- Vater möglich Vorstellung tun bleiben -- versprechen -- Mädchen heiraen -- 
  angenehm Stunde Brautstand trauen -- glücklich Nacht Ehemann zubrachen -- Frau Morgen -- Probe -- Standesgebühr Hörnerschmuck beehren -- allzugroß Zärtlichkeit früh Haus eilen -- alt Liebhaber Stelle finden -- unsinnig Leidenschaft drein schlagen -- Liebhaber Vater herausfordern -- leidlich Wunde kommen -- 
  Vater Tochter Nacht abgereisen -- doppelt Weise verwunden bleiben -- 
  Unglück schlechtesen Feldsch Welt führen -- Arm schwarz Zähn triefend Auge Abenteuer scheiden -- 
  bedauern -- brav Junge -- Gott Erdbod trügen -- 
  -- -- tun leid -- arm Narr weiber hassen -- 
  Weiber hassen -- leben -- 
  Melina unterbrechen -- Nachricht -- Transport völlig bereit -- früh abfahren können -- 
  überreicht Disposition -- fahren -- 
  Freund Schoß nehmen -- Philin -- zufrieden -- eng erbärmlich sitzen -- einerlei -- 
  tun -- Laert -- herbei -- 
  verdrießlich -- Wilhelm -- eilt Weg -- 
  finden Geld bequem Wagen -- Melina verleugnen -- 
  Einteilung -- freut -- bequem abreis -- bedenklich Nachricht einlufen -- Weg -- nehmen -- Freikorps sehen lassen -- erwarten -- 
  Ort Zeitung aufmerksam -- schwankend zweideutig -- 
  Stellung Armee scheinen unmöglich -- feindlich Korps durchschleichen -- freundlich bleiben -- 
  eifrig -- Gesellschaft Gefahr -- warten -- gefährlich beschreiben -- Weg anzuran -- 
  meister Unruhe Furcht setzen -- republikanisch Form sämtlich Glied Staat rufen -- außerordentlich Fall beratschlagen -- fast einstimmig Meinung -- Übel vermeid Ort bleiben -- ausweich Weg erwählen müssen -- 
  Wilhelm -- Furcht einnehmen -- halten schimpflich -- Plan -- Überlegung eingehen -- nunmehr bloß Gerücht aufgeben -- 
  sprechen Mut -- Grund männlich überzeugend -- 
  -- -- Gerücht -- entstehen dergleichen Krieg -- 
  Verständige Leute sagen -- Fall höchst unwahrscheinlich -- beinahe unmöglich -- 
  wichtig Sache bloß ungewiss Gerede bestimmen lassen -- 
  Route -- Herr Graf angeben -- Paß lauten -- kürzeste -- finden selbig Weg -- 
  führen Stadt -- Bekanntschaft -- Freund sehen -- Aufnahme hoffen -- 
  umweg bringen -- schlimm Weg verwickeln -- führen -- 
  Hoffnung -- spät Jahrszeit heraus finden -- Geld indessen versplittern -- 
  -- tragen Sache mancherlei vorteilhaft Seite -- Furcht verringern -- Mut zunehmen -- 
  wissen Mannszucht regelmäßig Truppe vorzusagen -- Marodeur hergelaufen Gesindel nichtswürdig schildern -- Gefahr lieblich lustig darstellen -- Gemüt aufgeheiteren -- 
  Laert Moment Seite -- versichern -- wanken weichen wollen -- 
  alt Polterer finden übereinstimmend Ausdruck Manier -- Philin lachen -- Madam Melina -- -- hoch Schwangerschaft ungeachtet -- natürlich Herzhaftigkeit verlieren -- Vorschlag heroisch finden -- Melina -- freilich nächster Weg -- akkordieren -- sparen hoffen -- widersteh -- willigt Vorschlag ganz Herz -- 
  fing -- Fall Verteidigung einrichten -- 
  kaufen Hirschfänger -- hing wohlgestickten Rieme Schulter -- 
  Wilhelm stecken überdies Paar Terzerole Gürtel -- Laert ohned Flint -- hoch Freudigkeit Weg -- 
  schlagen Fuhrleut -- Gegend kundig -- -- waldigen Bergplatz Mittagsruh halten -- Dorf abgelegen -- gut Weg Nähme -- 
  Witterung schön stimmt Vorschlag -- 
  Wilhelm eilen Fuß Gebirge voraus -- sonderbar Gestalt müssen -- begegnen -- stutzig -- 
  eilt schnell zufrieden Schritt Wald hinauf -- Laert Pfiff drein -- Frau lassen Wagen fortschleppen -- 
  Mignon laufen gleichfalls nebenher -- stolz Hirschfänger -- -- Gesellschaft bewaffnen -- abschlagen -- 
  Hut Perlenschnur wunden -- Wilhelm Mariane Reliquie übrig behalten -- 
  Friedrich Blonde tragen Flinte Laert -- Harfner friedlichsen ansehen -- 
  lang Kleid Gürtel stecken -- frei -- 
  stützt knotig Stab -- Instrument Wagen bleiben -- 
  Beschwerlichkeit Höhe erstiegen -- Erkannt sogleich angezeigt Platz schön Buche -- umgaben bedeckn -- 
  sanft-abhängig Waldwiese laden Bleibe -- eingefaßter Quelle bieten lieblich Erquickung dar -- zeigen Seite Schlucht Waldrücken fernen -- schön hoffnungsvoll Aussicht -- 
  liegen Dorf Mühl Grund -- Städtchen Ebene -- Ferne eintretend Berg machen Aussicht hoffnungsvoll -- sanft Beschränkung hereintraten -- 
  Ankommende nehmen Besitz Gegend -- ruhen Schatten -- machen Feuer -- erwarten geschäftig -- singend übrig Gesellschaft -- herbei -- Platz -- schön Wetter -- unaussprechlich schön Gegend Mund begrüßen -- 
  Kapitel -- 
  Wänden fröhlich Stunde nossen -- -- aufgeweckt -- Freiheit Himmel Schönheit Gegend jeder Gemüt reinigen scheinen -- 
  fühlen nah -- wünschen angenehm Aufenthalt Leben hinbringen -- 
  beneiden Jäger -- Köhler Holzhauer -- Leute -- Beruf glücklich Wohnplätze fest halten -- Pries reizend Wirtschaft Zigeunerhaufen -- 
  beneidet wunderlich Geselle -- selig Müßiggange abenteuerlich Reiz Natur genießen berechtigen -- freut -- einigermaßen ähnlich -- 
  indessen Frau anfangen -- Erdäpfel sied -- mitgebracht Speise auszupacken bereiten -- 
  Topf stehen Feuer -- gruppenweise lagert Gesellschaft Bäume Büschen -- 
  seltsam Kleidunge mancherlei Waffe geben fremd ansehen -- 
  Pferd Seite füttern -- Kutsche verstecken -- Anblick Horde Illusion romantisch -- 
  Wilhelm Genoß gefühlt Vergnügen -- 
  wandernd Kolonie Anführer denken -- 
  Sinn unterhalten -- bilden Wahn Moment poetisch -- 
  Gefühl Gesellschaft erhöhen -- aß -- trank jubiliert -- bekennen wiederholen -- niemals schön Augenblick erleben -- 
  Vergnügen zunehmen -- jung Leute Tätigkeit erwachen -- 
  Wilhelm Laerte griff Rapier -- fangen diesmal theatralisch Absicht Übung -- 
  Zweikampf darstellen -- Hamlet Gegner tragisch nehmen -- 
  Freund überzeugen -- wichtig Szene -- Theater geschehen pflegen -- ungeschickt stoßen dürfen -- hofft Muster darstellen -- -- Aufführung -- Kenner Fechtkunst würdig Schauspiel geben -- 
  schließen Kreis -- focht Eifer Einsicht -- Interesse Zuschauer wachsen Gang -- 
  fallen nächster busch Schuß -- -- Gesellschaft fahren erschreckt auseinander -- 
  erblicken bewaffnet Leute -- Ort zudrangen -- Pferd bepackt Kutsch Futter einnahmen -- 
  allgemein Schrei Entfuhr weiblich Geschlecht -- Held werfen Rapier weg -- greifen Pistole -- eilen Räuber entgegen -- fordern -- lebhaft Drohung -- Rechenschaft Unternehmen -- 
  lakonisch Paar Musketenschüssen antworten -- drücken Wilhelm Pistole Krauskopf -- Wagen erstiegen -- Stricke Gepäckes auseinander schneiden -- 
  Wohlgetroffe stürzen sogleich herunter -- Laert fehl schießen -- Freund ziehen beherzt Seitengewehr -- räuberisch Bande -- Fluchen Gebrüll -- losbrach -- Schuß -- blinkenden Säbel Kühnheit entgegen setzen -- 
  jung Held halten tapfer -- rufen übrig Geselle -- muntert Verteidigung -- 
  verlieren Wilhelm Anblick Lichtes -- Bewußtsein -- vorging -- 
  Schuß -- Brust linker Arm verwunden -- Hieb -- Hut spalten -- fast Hirnschal durchdrang -- betäuben -- fallen nieder -- müssen unglücklich Überfalls Folge Erzählung vernehmen -- 
  Auge aufschlagen -- befinden wunderbarst Lage -- 
  -- Dämmerung -- Auge liegen -- entgegen blickte -- Gesicht Philin -- Herüber neigen -- 
  fühlen schwach -- -- empor richten -- Bewegung -- finden Philin Schoß -- sinken -- 
  sitzen Rasen -- Kopf ausgestreckt Jüngling leise drücken -- arme -- -- sanft Lager bereiten -- 
  Mignon kniet zerstreut blutig Haar Fuß -- umfaßt Träne -- 
  Wilhelm blutig Kleid ansehen -- fragen gebrochen Stimme -- befinden -- 
  begegnen -- 
  Philine bitten -- ruhig bleiben -- übrig -- -- Sicherheit -- Laert verwunden -- 
  erzählen -- bitten inständig -- ruhig halten -- Wunde Eile verbinden -- 
  reichen Mignon Hand -- erkundigt Ursache blutig Locke Kind -- verwunden halten -- 
  beruhigen -- erzählen Philine -- gutherzig Geschöpf -- Freund verwunden sehen -- Geschwindigkeit besonnen -- Blut still -- Haar Kopf fliegen -- nehmen -- Wunde stopfen -- vergeblich Unternehmen abstehen -- 
  Nachher verbinden Schwamm Moos -- Philine Halstuch hergeben -- 
  Wilhelm bemerken -- Philin Rücken Koffer sitzen -- verschließen unbeschädigt aussehen -- 
  fragen -- glücklich -- habseligkeiten retten -- 
  antworten Achselzuck Blick Wiese -- zerbrochen Kasten -- zerschlagen Koffer -- zerschnitten Mantelsäcke Menge Gerätschaft zerstreuen liegen -- 
  Mensch Platz sehen -- wunderlich Gruppe finden Einsamkeit -- 
  Wilhelm erfahren wissen -- übrig Mann -- allenfalls Widerstand -- Schrecken setzen überwältigen -- fliehen -- entsetzen Unfalle -- 
  Fuhrleut -- Pferd hartnäckigsten halten -- niedergeworfen binden -- kurz rein ausplündern weggeschleppen -- 
  beängstign reisend fangen -- sobald Sorge Leben vorüber -- Verlust bejammern -- eilen -- möglichst Geschwindigkeit -- benachbart Dorfe -- führen verwundet Laert -- bringen Trümmer Besitztümer -- 
  Harfner beschädigt Instrument Baum gelehnen -- Ort eilen -- Wundarzt aufsuchen -- tot gelassen Wohltäter Möglichkeit beizuspringen -- 
  Kapitel -- 
  verunglückt Abenteurer bleiben indes Zeitlang seltsam Lage -- eilt Hilfe -- 
  Abend herbei -- Nacht droht hereinzubrechen -- Philines Gleichgültigkeit fing Unruhe überzugehen -- Mignon laufen -- Ungeduld Kind Augenblick -- 
  Wunsch gewähren -- Mensch nähern -- überfiel neu Schrecken -- 
  hören deutlich Trupp Pferd Weg herauf -- legen -- fürchten -- abermals Gesellschaft ungebeten Gast Wahlplatz besuchen -- Nachles halten -- 
  angenehm überraschen -- Busch -- Schimmel reitend -- Frauenzimmer Gesicht -- ältlich Herr Kavaliere begleiten -- Reitknecht -- Bedienten Trupp Husaren folgen -- 
  Philin -- Erscheinung Auge -- Begriff rufen schön Amazone Hilfe anzuflehen -- erstaunt Auge wunderbar Gruppe wenden -- sogleich Pferd lenken -- herzureten Stille halten -- 
  erkundigen eifrig verwundeter -- Lage -- Schoß leichtfertig Samariterin -- höchst sonderbar vorzukommen scheinen -- 
  Mann -- fragt Philin -- 
  Freund -- versetzen Ton -- Wilhelm höchst zuwider -- 
  Auge sanft -- hoch -- still -- teilnehmend Gesichtszug Ankommende heften -- glauben edleres liebenswürdigerer sehen -- 
  Mannsüberrock verbergen Gestalt -- -- scheinen -- Einfluß kühl Abendluft Gesellschafter borgen -- 
  Ritter indes nah kommen -- steigen -- Dame gleich -- fragt -- menschenfreundlich Teilnehmung -- Umstand Unfall -- reisend betreffen -- Wunde hingestreckt Jüngling -- 
  wenden schnell -- alt Herr seitwärts Wagen -- langsam Berg herauf kommen -- Wahlplatze still halten -- 
  jung Dame kurz Schlage Kutsche gestehen -- Ankommende unterhalten -- steigen Mann untersetzt Gestalt heraus -- unser verwundet Held führen -- 
  Kästchen -- Hand -- ledern Tasche Instrument erkennen Wundarzt -- 
  Manier rauh einnehmend -- Hand -- Hilfe willkommen -- 
  untersuchen genau -- erklären -- Wunde gefährlich -- wollen Stelle verbinden -- alsdann können kranke nächster Dorf bringen -- 
  Besorgnis jung Dame scheinen vermehren -- 
  sehen -- -- einigemal hergegang -- alt Herr herbei führen -- sehen -- zugerichten -- 
  leiden unsertwillen -- 
  Wilhelm hört Wort -- verstehen -- 
  unruhig -- scheinen -- Anblick verwundeter losreißen -- fürchten Wohlstand verletzen -- stehen bleiben -- -- -- wiewohl Mühe -- entkleid Anfing -- 
  Chirurg schneiden -- linker Ärmel -- alt Herr hinzutrat -- ernsthaft Tone -- Notwendigkeit Reise fortsetzen vorstellen -- 
  Wilhelm Augen richten -- Blick einnehmen -- fühlen -- vorging -- 
  Philin indessen aufgestanden -- gnädigen Dame Hand küssen -- 
  stehen -- glauben Freund Abstand sehen -- 
  Philin ungünstig Licht erscheinen -- 
  -- vorkommen -- edl Natur nahen -- berühren -- 
  Dame fragt Philine verschieden -- leise -- 
  kehrt alt Herr -- trocken stehen -- -- Oheim -- Kosten freigebig -- 
  ziehen sogleich Überrock -- Absicht -- verwundeter Unbekleidet hinzugeben -- verkennen -- 
  Wilhelm -- heilsam Blick Auge fest halten -- -- Überrock fallen -- schön Gestalt überraschen -- 
  treten nah herzu -- legen Rock sanft -- 
  Augenblick -- Mund öffn Wort Danke stammeln -- wirken lebhafte Eindruck Gegenwart sonderbar angegriffen Sinn -- vorkommen -- Haupt Strahl umgeben -- Bild verbreit glänzend Licht -- 
  Chirurg berühren Unsanfter -- Kugel -- Wunde stecken -- herauszuzieh Anstalt -- 
  heilig verschwinden Auge Hinsinkende -- verlieren Bewußtsein -- -- Reiter Wagen -- schön samt Begleiter verschwinden -- 
  Kapitel -- 
  Freund verbinden angekleiden -- eilt Chirurg weg -- Harfenspieler Anzahl Bauer herauf -- 
  bereiten eilig abgehauen Äst eingeflochten Reisig Trage -- lud verwundeter drauf bringen Anführung reitend Jäger -- Herrschaft lassen -- sachen Berg hinunter -- 
  Harfner -- still kehren -- tragen beschädigt Instrument -- Leute schleppen Philin Koffer -- schlendert Bündel -- Mignon springen voraus -- Seite Busch Wald -- blickten sehnlich krank Beschützer hinüber -- 
  liegen -- warm Überrock hüllen -- ruhig Bahr -- 
  elektrisch Wärme scheinen fein Wolle Körper überzugehen -- fühlt behaglichst Empfindung versetzen -- 
  schön Besitzerin Kleid mächtig wirken -- 
  Rock Schulter fallen -- edelst Gestalt -- Strahl umgeben -- stehen -- Seele eilt Verschwundene Fels Wälder Fuß -- 
  sinkend Nacht Zug Dorfen Wirtshause -- übrig Gesellschaft befinden -- verzweiflungsvoll unersetzlich Verlust beklagen -- 
  einzig Stube Haus Mensch vollpfropfen -- liegen Streue -- Bank einnehmen -- ofen drucken -- Frau Melina erwartet -- benachbart Kammer -- ängstlich Niederkunft -- 
  Schrecken beschleunigen -- Beistande Wirtin -- jung -- unerfahren Frau -- erwarten -- 
  Ankömmling herein gelassen verlangen -- entstehen allgemein murren -- 
  behaupten -- Wilhelm Rat besonderer Anführung gefährlich Weg unternehmen -- Unfall aussetzen -- 
  werfen Schuld übl Ausgang -- widersetzen Türe Eintritt -- behaupten -- 
  müssen anderswo unterzukommen suchen -- 
  Philine begegnen Schnöder -- Harfenspieler Mignon müssen ihrig leiden -- 
  hören Jäger -- Vorsorge Verlaßen schön Herrschaft ernstlich anbefohl -- Streite Geduld -- fahren Fluchen Drohen Gesellschaft -- Gebot rücken -- Ankommende Platz -- 
  fing bequemen -- 
  bereiten Wilhelm Platz Tisch -- Ecke schieben -- Philine lassen Koffer stellen -- setzen drauf -- 
  drücken -- Jäger begeben weg -- sehen -- bequemer Quartier Ehepaar ausmachen können -- 
  fort -- Unwille laut Anfing -- Vorwurf drängen -- 
  erzählt erhöht Verlust -- schelten Verwegenheit -- viele einbüßen -- verhehlen sogar Schadenfreude -- Wunde unser Freund empfinden -- verhöhnte Philin -- Art Weise -- Koffer retten -- Verbrechen -- 
  allerlei Anzüglichkeit Stichelrede schließen -- Plünderung Niederlage Gunst Anführer Bande bemühen -- -- wissen Kunst Gefälligkeit -- vermocht -- Koffer frei geben -- 
  Weile vermissen -- 
  antworten klappert Schlössern Koffer -- Neider Gegenwart überzeugen -- Verzweiflung Haufen Glück vermehren -- 
  Kapitel -- 
  Wilhelm -- stark Verlust Blut schwach Erscheinung hülfreichen Engel mild sanft -- zuletzt verdrusse hart ungerecht Rede enthalten -- Stillschweigen unzufrieden Gesellschaft erneuern -- 
  fühlen stärken -- aufzuricht -- Unart vorstellen -- Freund Führer beunruhign -- 
  heben verbunden Haupt Höhe -- fing -- Mühe stützt Wand lehnen -- Folgendergestalt reden -- 
  vergeb Schmerze -- Verlust empfinden -- Augenblick beleidigen -- beklagen sollten -- widerstehen Stoßt -- erstemal Hilfe erwarten -- 
  Dienst -- erzeigen -- Gefälligkeit -- erweisen -- euren -- eu freundschaftlich Betragen genügsam belohnen finden -- verleiten -- zwingen Gemüt zurückzugehen überdenken -- tun -- Berechnung peinlich -- 
  Zufall führen -- Umstand heimlich Neigung halten -- 
  euren Arbeit -- euren Vergnügung -- weniger Kenntnis eur Dienst -- 
  geben bitter Weise Unfall Schuld -- betreffen -- erinnern -- Vorschlag Weg nehmen -- fremd Leute -- prüfen -- billigen -- 
  Reise glücklich vollbringen -- gut Einfall loben -- Weg angeraen -- vorgezog -- Überlegung ausgeübt Stimmrecht Freude erinnern -- verantwortlich -- zwingen Schuld -- willig übernehmen -- reinste Bewußtsein frei spräch -- berufen -- 
  sagen -- bringen ordentlich -- verteidigen wissen -- Gegründetes angeben -- schweigen -- qualten -- Ruhe äußerst bedürftig -- 
  Stadt Antwort fangen Mädchen abermals wein Verlust umständlich erzählen -- 
  Melina Fassung -- 
  freilich meister denken einbüßen -- 
  Rasend stolpert eng Raume -- stoßen Kopf wider Wand -- fluchte Schalt unziemlich -- gleich Kammer treten -- Nachricht -- Frau tot Kind niedergekommen -- erlauben heftig ausbrüch -- einstimmig heulen -- schrie -- brummen Lärmte durcheinander -- 
  Wilhelm -- mitleidiger Teilnehmung Zustande Verdruß niedrig Gesinnung Innerst bewegen -- fühlen unerachten Schwäche Körper Kraft Seele lebendig -- 
  fast -- rufen -- verachten -- beklagensweren -- 
  Unglück berechtigen -- Unschuldige Vorwurf beladen -- falsch Schritt -- büßen -- 
  liegen verwunden -- Gesellschaft verlieren -- verlieren meister -- 
  Garderobe rauben -- Dekoration Grund gehen -- -- -- Herr Melina -- bezahlen -- sprech Forderung hiermit völlig frei -- 
  schenken -- rufen Melina -- wiedersehen -- 
  Geld liegen Frau Koffer -- Schuld -- verlieren -- 
  o -- -- -- 
  fing auf stampfen -- Schimpf schreien -- 
  erinnert schön Kleid Garderobe Grafe -- Schnalle -- Uhr -- Dose -- Hüte -- Melina Kammerdiener glücklich handeln -- 
  fallen -- obgleich gering Schatz Gedächtnis -- blickt Verdruß Philines Koffer -- Wilhelm verstehen -- wahrlich übel tun -- schöne assoziieren -- Glück Habseligkeiten retten -- 
  glauben -- rufen -- -- darbt -- erstemal -- Not redlich teil -- 
  öffnen Koffer -- -- öffentlich Bedürfnis niederlegen -- 
  Koffer -- Philin -- eher aufmachen -- beliebt -- 
  Paar Fittiche -- aufheben -- betragen -- redlichst Jude verkaufen -- 
  denken -- Heilung kosten -- fremd Land begegnen -- 
  -- Philin -- versetzen Wilhelm -- vorenthalten -- -- Verlegenheit retten -- 
  Mensch besitzen -- womit Freund beistehen -- klingend Münze brauchen -- 
  -- Unglücklichen widmen -- gewiß -- -- gegenwärtig Betragen bereuen -- 
  -- fahren fort -- fühlen bedürfen -- vermögen -- leisten -- schenken eu vertrauen auf -- beruhigen Augenblick -- nehmen -- versprech -- 
  Zusage Name empfangen -- 
  recken Hand -- rufen -- 
  versprech -- eher weichen -- eher verlassen -- Verlust doppelt dreifach ersetzen sehen -- Zustand -- -- Schuld wollen -- befinden -- völlig vergessen -- glücklicher vertauschen -- 
  halten Hand ausstrecken -- fassen -- 
  versprech -- rufen -- Kissen sinken -- 
  bleiben still -- beschämt -- trösten -- Philin -- Koffer sitzend -- knackt Nüs -- Tasche finden -- 
  Kapitel -- 
  Jäger Leute -- Anstalt -- verwundeter wegzuschaffen -- 
  Pfarrer Orts bereden -- Ehepaar aufnehmen -- Philines Koffer fortgetragen -- folgen natürlich Anstand -- 
  Mignon laufen voraus -- kranke Pfarrhaus ankommen -- weit Ehebette -- Gast Ehren-Bette bereit stehen -- eingegeben -- 
  bemerken -- Wunde aufgehen stark bluten -- 
  müssen Verband sorgen -- 
  kranke verfiel Fieber -- Philine warten treulich -- Müdigkeit übermeisteren -- lösen Harfenspieler -- Mignon -- fest Vorsatz -- wachen -- Ecke eingeschlafen -- 
  morgens -- Wilhelm erholen -- erfahren Jäger -- Herrschaft -- gestern Hilfe kommen -- kurz Gut verlassen -- Kriegsbewegung auszuweichen -- Frieden ruhigeren Gegend aufhalten -- 
  nennen ältlich Herr Nicht -- zeigen Ort -- wohin begeben -- erklären Wilhelm -- Fräulein einbinden -- Verlaßen Sorge tragen -- 
  hereintretend Wundarzt unterbrach lebhaft Danksagunge -- Wilhelm Jäger ergießen -- umständlich Beschreibung Wunde -- versichern -- heil -- Patient ruhig halten abwartete -- 
  Jäger weggeriten -- erzählen Philine -- Beutel Louisd -- Ohr lassen -- geistlich Douceur Wohnung geben -- Kurkoste Chirurg niederlegen -- 
  gelten Wilhelm Frau -- introduzieren allemal Qualität -- zugeben -- Wartung umsehen -- 
  Philin -- Wilhelm -- Unfall -- begegnen -- schuldig -- wünschen -- Verbindlichkeit vermehrt sehen -- 
  unruhig -- -- wissen -- womit Mühe vergelten -- 
  geben Sache -- Koffer retten -- heraus -- schließen übrig Gesellschaft -- suchen and Quartier -- nehmen golden Erkenntlichkeit -- verlassen -- Gegenwart beunruhigt glauben -- 
  lacht Gesicht -- endigen -- 
  Tor -- -- klug -- 
  wissen -- bleiben -- Stelle rühren -- 
  Mann niemals rechnen -- deinen -- leiben -- -- 
  bleiben -- Pfarrer Familie eingeschmeicheln -- lustig -- schenken -- Sinn reden wissen -- -- -- 
  Wilhelm befinden übel -- Chirurg -- unwissend -- ungeschickt Mensch -- lassen Natur walten -- Patient Weg Besserung -- 
  sehnlich wünschen herstellen sehen -- Plan -- Wunsch eifrig verfolgen -- 
  Unaufhörlich rufen Begebenheit -- unauslöschlich Eindruck Gemüt -- 
  schön Amazone reitend Büsche hervorkommen -- nähern -- steigen -- -- bemühen seinetwillen -- 
  umhüllend Kleid Schulter fallen -- Gesicht -- Gestalt glänzend verschwinden -- 
  Jugendträume knüpft Bild -- 
  glauben nunmehr edl heldenmütig Chlorinde Auge sehen -- fallen krank Königssohn -- Lager schön teilnehmend Prinzessin still Bescheidenheit herantreten -- 
  -- manchmal stille -- Jugend Schlafe -- Bild zukünftig Schicksal umschweben -- unser unbefangen Auge ahnungsvoll sichtbar -- Keim -- begegnen -- Hand Schicksal ausgestreut -- Vorgenuß Frucht -- einst brechen hoffen -- -- 
  Krankenlager Szene tausendmal wiederholen -- 
  tausendmal rufen Klang süß Stimme -- beneiden Philine -- hülfreich Hand küßen -- 
  Geschichte Traum -- Märche halten -- Kleid bleiben -- Gewißheit Erscheinung versichern -- 
  groß Sorgfalt Gewand lebhaft verlangen verbinden -- bekleid -- 
  sobald Aufstand -- werfen -- sorgen -- Flecken -- Weise beschädigen -- 
  Kapitel -- 
  Laert besucht Freund -- 
  lebhaft Szene Wirtshause gegenwärtig -- liegen oberer Kammer -- 
  Verlust trösten -- helfen gewöhnlichen -- 
  tun -- 
  erzählt verschieden lächerlich Züge Gesellschaft -- Frau Melina Schuld -- bewein Verlust Tochter -- altdeutsch Vergnügen können -- Mechtilde taufen lassen -- 
  Mann betreffen -- offenbar sich_es -- Geld -- Vorschuß -- Wilhelm abgelocken -- keineswegs bedurfen -- 
  Melina wollen nunmehr nächster Postwag abgehen -- Wilhelm Empfehlungsschreiben Freund Direktor Serlo verlangen -- Gesellschaft -- Unternehmung scheitern -- unterzukommen hoffen -- 
  Mignon still -- Drang -- gestehen -- Arm verrenken -- 
  Verwegenheit danken -- Philin -- erzählen -- Kind Gefechte Hirschfänger ziehen -- Freund Gefahr sehen -- wack Freibeuter zugehauen -- 
  Arm ergriffen Seite schleudern -- 
  Schalt -- Übel eher entdecken -- merken -- Chirurg scheuen -- Knabe halten -- 
  suchen Übel heben -- müssen Arm Binde tragen -- 
  Hierüber auf empfindlich -- Pflege Wartung Freund Philine überlassen müssen -- angenehm Sünderin zeigen desto tätig Aufmerksamer -- 
  morgens Wilhelm erwachen -- finden sonderbaren Nähe -- 
  weit Lager Unruhe Schlafs hint Seite rutschen -- 
  Philine liegen quer vorderen hingestrecken -- scheinen Bett sitzend lesend eingeschlafen -- 
  Buch Hand fallen -- Kopf nah Brust sinken -- blond aufgelöst Haar Welle ausbreiten -- 
  Unordnung schlafs erhöht Kunst Vorsatz Reize -- kindisch lächelnd Ruhe schwebt Gesicht -- 
  Zeitlang -- scheinen Vergnügen tadeln -- womit ansehen -- wissen -- Zustand segnen tadelen -- Ruhe Mäßigung Pflicht -- 
  Zeitlang aufmerksam betrachten -- Regen Anfing -- 
  schließen Auge sachen -- unterlassen blinzen sehen -- zurecht putzen Wegging -- Frühstück fragen -- 
  sämtlichen Schauspieler Wilhelm melden -- Empfehlungsschreiben Reisegeld unartig ungestüm fordern widerwillen Philines erhalten -- 
  vergebens stellen Freund -- Jäger Leute ansehnlich Summe zurückgelassen -- -- 
  vielmehr kommen lebhaft Zwist -- Wilhelm behaupten nunmehr allemal -- gleichfalls übrig Gesellschaft anschließen Glück Serlo versuchen -- 
  Augenblick verlassen Gleichmut -- erholen schnell -- rufen -- Blonde -- kümmern -- 
  meinen Friedrich -- Wahlplatze verlieren zeigen -- 
  morgens bringen Mignon Nachricht an Bette -- Philine Nacht abgereisen -- Nebenzimmer -- gehören -- ordentlich legen -- 
  empfinden Abwesenheit -- treu Wärterin -- munter Gesellschafterin verlieren -- wohnen -- 
  Mignon füllen Lücke -- 
  leichtfertig schön freundlich Bemühung verwundeten umgeben -- ziehen -- Still bleiben -- freies Feld gewinnen -- treten Aufmerksamkeit Liebe hervor -- eifrig dienen -- munt unterhalten -- 
  Elftes Kapitel -- 
  lebhaft Schritt naht Besserung -- 
  hofft Reise antreten -- 
  planlos schlendernd Leben fortsetzen -- zweckmäßig Schritt künftig Bahn bezeichnen -- 
  hülfreich Herrschaft aufsuchen -- Dankbarkeit legen -- alsdann Freund Direktor eilen -- verunglückt Gesellschaft gut sorgen -- Handelsfreunde -- Adresse versehen -- besuch -- aufgetragen Geschäft verrichten -- 
  Hoffnung -- Glück vorher künftig beistehen -- Gelegenheit verschaffen -- glücklich Spekulation Verlust ersetzen -- Lücke Kasse ausfüllen -- 
  verlangen -- Retterin sehen -- wachsen -- 
  Reiseroute bestimmen -- geistlich Rate -- schön geographisch statistisch Kenntnis -- artig Bücher Karten-Sammlung besitzen -- 
  suchen Ort -- edl Familie Krieg Sitz erwählen -- suchen Nachricht -- Ort Geographie -- Karte finden -- genealogisch Handbücher sagen Familie -- 
  Wilhelm unruhig -- Bekümmerni laut lassen -- entdecken Harfenspieler -- 
  Ursache glauben -- Jäger -- Ursache wollen -- wahr Name verschweigen -- 
  Wilhelm -- Nähe Schöne glauben -- hofft Nachricht erhalten -- Harfenspieler abschicken -- Hoffnung täuschen -- 
  alte erkundigen -- Spur -- 
  verschieden lebhaft Bewegung unvorgesehen durchmärsch Gegende vorgefallen -- reisend Gesellschaft geben -- ausgesendet Bote -- jüdisch Spion ansehen -- Ölblatt Herr Freund erscheinen müssen -- 
  legen streng Rechenschaft -- Auftrag ausrichten suchen -- bemühen -- Verdacht Nachlässigkeit entfernen -- 
  suchen Weise Wilhelm Betrübnis lindern -- Besann -- Jäger erfahren -- bringen mancherlei Mutmaßung -- wobei Umstand vorkommen -- woraus Wilhelm rätselhaft Wort schön verschwundener deuten -- 
  räuberisch Bande nämlich wandernd Truppe -- Herrschaft aufgepassen -- viel Geld Kostbarkeit vermuten -- Zug genau Nachricht müssen -- 
  wissen -- Freikorps -- Marodeur Räuber zuschreiben -- 
  -- Glück vornehmen reichen Karawane Gering arme Platz kommen -- Schicksal erdulden -- zubereiten -- 
  bezog Wort jung Dame -- Wilhelm erinnern -- 
  vergnügen glücklich -- vorsichtig Genius Opfer bestimmen -- vollkommen sterblich retten -- nah Verzweiflung -- -- finden -- sehen -- Augenblick -- Hoffnung verschwinden -- 
  sonderbar Bewegung vermehrn -- Ähnlichkeit -- Gräfin schön unbekannte entdecken glauben -- 
  gleichen -- Schwester gleich -- jung alt nennen -- scheinen Zwillinge -- 
  Erinnerung liebenswürdig Gräfin unendlich süß -- 
  rufen Bild allzugern Gedächtnis -- 
  treten Gestalt edel Amazone -- Erscheinung verwandeln -- Stande -- fest halten -- 
  wunderbar müssen Ähnlichkeit Handschrift -- 
  verwahrt reizend Lied Hand Gräfin Schreibtafel -- Überrocke Zettelch finden -- worin zärtlich Sorgfalt Befinden Oheim erkundigen -- 
  Wilhelm überzeugen -- Retterin Billet schreiben -- Reise Wirtshause Zimmer schicken Oheim Tasche stecken -- 
  halten Handschrift -- zierlich gestellt Buchstabe Gräfin fallen -- finden ähnlich freier Züg Unbekannten unaussprechlich fließend Harmonie -- 
  Billet enthalten -- Zug scheinen -- ehemals Gegenwart schöne -- erheben -- 
  verfiel träumend Sehnsucht -- einstimmend Empfindung Lied -- Stunde Mignon Harfner unregelmäßig Duett herzlichsten Ausdrucke singen -- 
  Sehnsucht kennen -- weiße leiden -- 
  abtrennen Freude -- Sehe an Firmament Seite -- 
  -- 
  lieben kennen Weite -- 
  schwindeln -- brennen Eingeweid -- 
  Sehnsucht kennen -- weiße leiden -- 
  Zwölftes Kapitel -- 
  sanft Lockung lieb Schutzgeist -- anstatt unser Freund Weg führen -- nähren vermehrt Unruhe -- vorher empfinden -- 
  heimlich Glut schlich Ader -- bestimmt unbestimmt Gegenstand wechseln Seele -- erregn endlos verlangen -- 
  wünschen Roß -- Flügel -- unmöglich scheinen -- bleiben -- -- wohin eigentlich begehren -- 
  Faden Schicksal sonderbar verworren -- wünscht seltsam Knoten auflösen zerschneiden sehen -- 
  Pferd traben Wagen rollen hören -- schaut eilig Fenster hinaus -- Hoffnung -- -- aufsucht -- Zufall -- Nachricht -- Gewißheit Freude brächen -- 
  erzählt Geschichte -- Freund Werner Gegend überraschen -- Mariane erscheinen dürfen -- 
  Ton Posthorn setzen Bewegung -- 
  Melina schicksal Nachricht geben -- vorzüglich Jäger wiederkommen angebetet Schönheit einladen -- 
  geschehen -- müssen zuletzt bleiben -- durchnehmen -- Umstand -- betrachten beleuchten -- widrig Unerträglicher -- 
  verunglückt Heerführerschaft -- Verdruß denken -- 
  Abend böse Tag Gesellschaft ziemlich herausgereden -- schuld verleugnen -- 
  schreiben vielmehr hypochondrisch Augenblick Vorfall -- 
  eigenliebe lassen sowohl Tugende Fehler bedeutend -- -- erscheinen -- 
  vertrauen regen -- Wille übrig lenken -- Unerfahrenheit Kühnheit leiten -- Vorangegang -- ergriff Gefahr -- wachsen -- 
  Laute still Vorwurf verfolgt -- irregeführt Gesellschaft empfindlich Verlust zusagen -- verlassen -- verloren Wucher ersetzen -- Verwegenheit schelten -- womit allgemein ausgeteilt Übel Schulter nehmen vermaß -- 
  verweisen -- Aufspannung Drang Augenblick Versprechen tun -- fühlt -- gutmütig Hinreiche Hand -- annehmen würdigen -- leicht Förmlichkeit Gelübde -- Herz tun -- 
  Sann -- wohltätig nützlich -- finden Ursache -- Reise Serlo beschleunigen -- 
  packen nunmehr Sache -- eilt -- völlig Genesung abwarten -- Rat Pastor Wundarzt hören -- wunderbar Gesellschaft Mignon alte -- Untätigkeit entfliehen -- Schicksal abermals halten -- 
  Dreizehntes Kapitel -- 
  Serlo empfangen offen arme -- rufen entgegen -- 
  Sehen -- 
  Erkenn -- 
  ändern -- Liebe edelst Kunst stark lebendig -- 
  erfreu Ankunft -- mißtrauen fühlen -- letzter Brief erregen -- 
  Wilhelm bitten betroffen nah Erklärung -- 
  -- versetzen Serlo -- alt Freund betragen -- Herr behandeln -- gut Gewissen unbrauchbar Leute empfehlen -- 
  Schicksal hängen Meinung Publikum -- fürcht -- Herr Melina seinigen schwerlich aufnehmen dürfen -- 
  Wilhelm Gunst sprechen -- Serlo fing -- unbarmherzig Schilderung -- Freund zufrieden -- Frauenzimmer Zimmer treten -- Gespräch unterbrechen -- sogleich Schwester Aurelia Freund vorstellen -- 
  empfangen freundschaftlichst -- Unterhaltung angenehm -- entschieden Zug Kummer gewahr -- geistreich Gesicht besonderer Interesse -- 
  erstenmal lang finden Wilhelm Element -- 
  Gespräch notdürftig gefällig Zuhörer finden -- gegenwärtig Künstler Kenner sprechen Glück -- vollkommen verstehen -- Gespräch belehrend erwiderten -- 
  Geschwindigkeit neusten Stück -- Sicherheit beurteilen -- wissen Urteil Publikum prüfen schätzen -- Geschwindigkeit klären -- 
  müssen -- Wilhelm Vorliebe Shakespeare -- Gespräch notwendig Schriftsteller lenken -- 
  zeigen lebhafte Hoffnung Epoche -- vortrefflichen Stück Deutschland müssen -- bringen Hamlet -- beschäftigen -- 
  Serlo versichern -- Stück längst -- -- geben -- Rolle Polonius übernehmen wollen -- 
  setzt lächeln hinzu -- Ophelia finden -- Prinz -- 
  Wilhelm bemerken -- Aurelie Scherz Bruder mißfallen scheinen -- vielmehr Art weitläufig lehrreich -- Sinn Hamlet spielen wollen -- 
  legen Resultat umständlich dar -- beschäftigen sehen -- Mühe -- Meinung annehmlich -- Zweifel Serlo Hypothese erregen -- 
  -- zuletzt -- geben -- erklären -- 
  viele -- -- versetzen Wilhelm -- 
  denken Prinz -- schildern -- Vater unvermutet sterben -- 
  Ehrgeiz Herrschsucht Leidenschaft -- beleben -- sich_es gefallen lassen -- Sohn Königs -- nötigen Abstand aufmerksam -- König Untertan scheiden -- 
  Krone erblich -- läng Leben Vater Anspruch einzig Sohn befestigen -- Hoffnung Krone sichern -- 
  sehen Oheim -- ungeachtet scheinbar Versprechung -- ausschließen -- fühlen arm Gnade -- Gut -- fremd -- Jugend Eigentum betrachten -- 
  nehmen Gemüt traurig Richtung -- 
  fühlen -- -- Edelmann -- Diener -- höflich -- herablassend -- -- herabgesunken bedürftig -- 
  vorig Zustande blicken verschwunden Traume -- 
  vergebens -- Oheim aufmuntern -- Lage Gesichtspunkt zeigen -- Empfindung verlassen -- 
  Schlag -- treffen -- verletzen tief -- beugen -- 
  Heirat Mutter -- 
  -- treu zärtlich Sohne -- bleiben -- Vater sterben -- Mutter übrig -- hofft Gesellschaft hinterlaßenen edl Mutter Heldengestalt Abgeschiedene verehren -- Mutter verlieren -- schlimm Tod rauben -- 
  zuverlässig Bild -- wohlgeraten Kind Eltern -- verschwinden -- tote Hilfe -- Lebendig Halt -- 
  Weib -- Geschlechtsname -- Gebrechlichkeit -- begreifen -- 
  fühlen beugen -- verwaisen -- Glück Welt ersetzen -- verlieren -- 
  traurig -- nachdenklich Natur -- Trauer Nachdenken schwer Bürde -- 
  sehen auftreten -- 
  glauben -- Stück hineinlegen -- Zug übertreiben -- 
  Serlo Schwester -- -- falsch Bild unser Freund -- 
  fangen -- vorerzählen überreden -- 
  Wilhelm schworen teuer -- überreden -- überzeugen wollen -- bitten Augenblick Geduld -- 
  denken -- rufen -- Jüngling -- Fürstensohn lebhaft -- vergegenwärtig Lage -- beobachten -- erfahren -- Gestalt Vater erscheinen -- stehen schrecklich Nacht -- ehrwürdig Geist auftreten -- 
  ungeheuer entsetzen ergreifen -- reden Wundergestalt -- sehen winken -- folgen hören -- schrecklichste Anklage wider Oheim ertönen Ohr -- Aufforderung Rache dringend wiederholt Bitte -- erinnern -- 
  Geist verschwinden -- sehen stehen -- 
  jung Held -- Rache schnauben -- 
  geboren Fürst -- glücklich fühlen -- Usurpator Krone auffordern -- 
  -- 
  Staune Trübsinn überfällen Einsamen -- bitter lächelnd Bösewichter -- schwören Abgeschieden vergessen -- schließen bedeutend Seufzer -- Gelenke -- wehe -- gebären -- einrichten -- 
  Wort -- dünken -- liegen Schlüssel Hamlet Betrag -- deutlich -- Shakespeare schildern -- Seele legen -- wachsen -- 
  Sinn find Stück durchgängig arbeiten -- 
  Eichbaum köstlich Gefäß pflanzen -- lieblich Blume Schoß aufnehmen -- Wurzel dehnen -- Gefäß zernichten -- 
  schön -- rein -- Edles -- höchst moralisch Wesen -- sinnlich Stärke -- Held -- Last Grund -- weder tragen abwerfen -- Pflicht heilig -- schwer -- 
  unmögliche fordern -- Unmögliche -- unmöglich -- 
  winden -- drehen -- ängstigen -- treten -- erinnern -- erinnern -- zuletzt fast Zweck Sinn verlieren -- jemals froh -- 
  Vierzehntes Kapitel -- 
  verschieden Person treten herein -- Gespräch unterbrachen -- 
  Virtuose -- Serlo gewöhnlich Woche Konzert versammeln -- 
  liebt Musik -- behaupten -- Schauspieler Liebe niemals deutlich Begriff Gefühl Kunst gelangen können -- 
  leicht Anständiger Agier -- Gebärde Melodie begleiten leiten -- müssen Schauspieler prosaisch Rolle gleichsam Sinn komponieren -- eintönig individuell Art Weise hinsudel -- gehörig Abwechslung Takt Maß behandle -- 
  Aurelie scheinen -- vorging -- Anteil nehmen -- vielmehr führen zuletzt unser Freund Seitenzimmer -- an Fenster treten gestirnt Himmel anschauen -- -- Hamlet schuldig bleiben -- voreilig -- wünsch -- Bruder anhören mögen -- sagen -- lassen Gedanke Ophelia hören -- 
  lassen sagen -- versetzen Wilhelm -- Meisterzügen Charakter vollenden -- 
  Wesen schweben Reifer süß Sinnlichkeit -- 
  Neigung Prinz -- Hand Anspruch -- fließen Quelle -- Herz überlassen Verlangen -- Vater Bruder fürchten -- geradezu unbescheiden warnen -- 
  Wohlstand -- leicht Flor Busen -- Bewegung Herzen verbergen -- vielmehr Verräter leisen Bewegung -- 
  Einbildungskraft anstecken -- still Bescheidenheit atmen liebevoll Begierde -- bequem Göttin Gelegenheit Bäumchen schütteln -- Frucht sogleich herabfallen -- 
  -- Aurelie -- verlassen sehen -- verstoßen verschmähen -- Seele wahnsinnigen geliebter Höchste Tiefste umwenden -- süß Becher Liebe bitter Kelch leiden hinreichen - Herz brechen -- rufen Wilhelm -- Gerüste Dasein rücken Fuge -- Tod Vater stürmen Herein -- schön Gebäude stürzen völlig -- 
  Wilhelm bemerken -- Ausdruck Aurelie letzter Wort aussprechen -- 
  Kunstwerk -- Zusammenhäng Vollkommenheit richten -- ahndet -- Freundin Wirkung empfinden -- -- tief Schmerz dramatisch Schattenbilder lebhaft erregen -- 
  Aurelie Haupt arme unterstützen -- Auge -- Träne füllt -- gen Himmel wenden -- 
  halten lang verborgen Schmerz -- fassen Freund Hand -- rufen -- erstaunt stehen -- verzeih -- verzeih geängstigt Herz -- Gesellschaft schnüren preßen -- unbarmherzig Bruder verbergen suchen -- Gegenwart Bande auflösen -- 
  Freund -- fahren fort -- Augenblick -- Vertrauter -- 
  Wort aussprechen -- sinken Schulter -- 
  denken übel -- schluchzend -- schnell eröffnen -- schwach sehen -- 
  -- bleiben Freund -- verdienen -- 
  redet herzlichster -- umsonst -- Träne fließen erstickt Wort -- 
  Augenblick treten Serlo unwillkommen Herein -- unerwartet Philin -- Hand halten -- 
  Freund -- -- freuen -- begrüßen -- 
  -- rufen Wilhelm erstaunt -- sehen -- 
  bescheiden -- gesetzt Wesen -- heißen willkommen -- rühmen Serlo's Güte -- Verdienst -- bloß Hoffnung -- bilden -- trefflich Truppe aufnehmen -- 
  Wilhelm freundlich -- ehrerbietig Entfernung -- 
  Verstellung währen lang -- Zugeg -- 
  Aurelie Schmerz verbergen Wegging -- Serlo abgerufen -- Philine genau Tür -- gewiß fort -- hüpfte töricht Stube herum -- setzen Erde -- Kichern lachen ersticken -- 
  springen -- schmeichelen unser Freund -- Freut maßen -- klug -- vorauszugehen -- Terrain rekognoszieren einzunisen -- 
  bunt -- -- -- 
  Aurelie unglücklich Liebeshandel Edelmanne -- prächtig Mensch -- sehen -- 
  Andenken hinterlassen -- müssen irren -- 
  laufen Knabe herum -- ungefähr -- schön Sonne -- Papa allerliebst -- Kind leiden -- Junge freuen -- 
  nachgerechnen -- 
  Tod Mann -- Bekanntschaft -- alt Kind -- treffen -- 
  Freund Weg gehen -- sehen -- 
  untröstlich -- 
  Närrin -- 
  -- Bruder Truppe Tänzerin -- schön tun -- Aktrische -- vertraut -- Stadt Frau -- aufwartet -- stehen Liste -- 
  Narr -- -- 
  übrig Volke sollst hören -- 
  Wörtche Philine -- Kennst -- Erznärrin verlieben -- 
  schworen -- -- beteuern -- Spaß -- 
  bitten Wilhelm inständig -- Aurelie verlieben -- Hetze angehen -- 
  laufen Ungetreue -- -- Bruder -- 
  Lust halbes -- Episode sterben -- vierfach verschlungen Roman hinzuwirfen -- 
  bitten -- Handel verderben -- Achtung bezeigen -- öffentlich Betragen verdienen wollen -- 
  Fünfzehntes Kapitel -- 
  nächster Gedachte Wilhelm Madam Melina besuchen -- finden Haus -- fragt übrig Gliedern wandernd Gesellschaft -- erfahren -- 
  Philin Frühstück einladen -- 
  Neugier eilen -- treffen aufgeräumt trösten -- 
  klug Geschöpf versammeln -- Schokolade bewirten -- verstehen geben -- Aussicht versperren -- hoff Einfluß Direktor überzeugen -- Vorteilhaft -- geschickt Leute Gesellschaft aufnehmen -- 
  hören aufmerksam -- schlurft Tas hinunter -- finden Mädchen übel -- nehmen -- gute reden -- 
  Glaube -- Wilhelm -- Philine bleiben -- Serlo entschließen -- Gefährt behalten -- 
  nicht -- versetzen Philin -- liegen -- -- sein eher fort -- einzig Laert wünscht behalten -- übrig Seite bringen -- 
  Hierauf Freund verstehen -- gewiß überzeugen -- nunmehr Talent lang vergraben -- Direktion Serlo auf Theater -- 
  Ordnung -- Geschmack -- Geist -- herrschen -- rühmen -- sprechen schmeichelnd unser Freund -- schmeichelhaft Talent -- Herz Einbildungskraft Vorschlage nähern -- Verstand Vernunft entfernen -- 
  verbergen Neigung Philine -- bringen unruhigen -- entschließen -- Handelskorrespondent -- Brief -- liegen möchten -- abzuholen -- 
  Unruhe Seinig vorstellen -- scheut -- Sorge Vorwurf umständlich erfahren -- -- rein Genuß Abend Aufführung Stück versprechen -- 
  Serlo weigern -- Probe zulassen -- 
  -- -- Seite kennen lernen -- ehe zugeben -- Karte sehen -- 
  groß Zufriedenheit wohnt Freund Abend Vorstellung -- 
  erstemal -- Theater Vollkommenheit -- 
  Traut sämtlich Schauspieler fürtrefflich Gabe -- glücklich Anlage hoch klar Begriff Kunst -- -- halten tragen wechselsweise -- feueren -- Spiel bestimmen genau -- 
  fühlen -- Serlo Seele -- zeichnen Vorteil -- 
  heit Laune -- gemäßigt Lebhaftigkeit -- bestimmt Gefühl schicklich Gabe Nachahmung -- müssen -- auf Theater treten -- Mund öffnen -- bewundern -- 
  innerer Behaglichkeit Dasein scheinen Zuhörer ausbreiten -- geistreich Art -- fein Schattierung Rolle groß Leichtigkeit ausdrucken -- erwecken soviel Freude -- Kunst verbergen wissen -- anhaltend Übung -- 
  Schwester Aurelie bleiben -- erhalten groß Beifall -- Gemüt Mensch rühren -- erheitern erfreu Stande -- 
  -- angenehm Weise zubringen -- verlangt Aurelie unser Freund -- 
  eilen -- finden Kanapee liegen -- scheinen Kopfweh leiden -- Wesen fieberhaft Bewegung verbergen -- 
  Auge erheitern -- Hereintretende ansehen -- vergeben -- rufen entgegen -- zutrauen -- einflößt -- schwach -- 
  Schmerz stille unterhalten -- geben Stärke Trost -- -- wissen zugegangen -- Bande Verschwiegenheit lösen -- wider Wille Kampfe nehmen -- Streit -- 
  Wilhelm antworten freundlich verbindlich -- 
  versichern -- Bild Schmerz beständig Seele schweben -- vertrauen bitte -- Freund widme -- 
  sprechen -- Auge Knabe anziehen -- Erde sitzen -- allerlei Spielwerk durcheinander werfen -- 
  -- Philin angeben -- ungefähr alt -- Wilhelm verstehen -- leichtfertig -- Ausdrücken selten erhaben Mädchen Knabe Sonne vergleichen -- 
  offen braun Auge voll Gesicht kräuselen schönsn golden Locke -- blendend weiß Stirn zeigen zart dunkel sanftgebogen Augenbraun -- lebhafte Farbe Gesundheit glänzt Wang -- 
  setzen -- Aurelie -- sehen glücklich Kind Verwunderung -- gewiß -- Freude Arm nehmen -- bewahr Sorgfalt -- Grad Schmerz erkennen -- Wert Gabe selten empfinden -- 
  Erlaub -- fahren fort -- Schicksal reden -- liegen -- verkennen -- 
  glauben gelassen Augenblick -- lassen rufen -- -- Fade verlieren -- 
  verlaßen Geschöpf Welt -- sagen -- 
  Mann -- denken -- 
  bärden notwendig Übel -- gewiß Tod Weib schweben -- Untreue Mann -- Törin -- -- 
  O Freund -- Schicksal gemein -- gemein Übel ertragen -- außerordentlich -- ich_es Spiegel zeigen -- auftragen -- erzählen -- 
  O verführen -- überrascht verlassen -- Verzweiflung Trost -- schlimm -- hintergangen -- wider wissen betrügen -- ist_es -- niemals verzeihen -- 
  edl Gesinnung -- Ihrig -- versetzt Freund -- unglücklich -- 
  wissen -- Gesinnung schuldig -- fragt Aurelie -- allerschlechtester Erziehung -- jemals Mädchen verderben -- schlimmsen Beispiel -- Sinn Neigung verführen -- 
  frühzeitig Tod Mutter bringen schön Entwicklung Tante -- Gesetz -- Gesetz Ehrbarkeit verachten -- 
  Blindlings überlassen Neigung -- Gegenstand gebiet Sklave -- wild Genuß vergessen -- 
  müssen Kind rein deutlich Blick Unschuld Begriff männlich Geschlecht -- 
  dumpf -- dringend -- dreist -- ungeschickt -- herbeireizen -- -- übermütig -- leer abschmacken -- sobald wünsch Befriedigung finden -- 
  Frau Gebot schlechtesen Mensch erniedrigen sehen -- Begegnung müssen erduld -- Stirn wissen Schicksal finden -- Art schändlich Fessel tragen -- 
  lernt Geschlecht kennen -- Freund -- rein haßt ich_es -- bemerken scheinen -- leidlich Mann -- Verhältnis unsrig -- gut Gefühl entsagen scheinen -- Natur fähig -- 
  Gelegenheit traurig Erfahrung Geschlecht -- wahrhaftig -- Mädchen sechzehn klüg -- -- verstehen -- 
  klug -- jung -- klug -- Törichter -- 
  Knabe Lärm -- Aurelie ungeduldig klingeln -- 
  alt Weib herein -- wegzuholen -- 
  Zahnweh -- Aurelie alte -- Gesicht verbinden -- 
  fast unleidlich -- versetzen dumpf Stimme -- heben Knabe -- gerne mitzugehen scheinen -- bringen weg -- 
  Kind Seite -- Aurelie bitterlich wein Anfing -- 
  jammern klagen -- rufen -- schämen -- arm Wurm liegen -- 
  Besonnenheit weg -- erzählen -- 
  Stockt Schwieg -- 
  Freund -- Allgemeines sagen -- Besonderer sagen wissen -- drücken Hand -- Zeitlang -- 
  Verlegenheit Buch -- Tischchen liegen finden -- Shakespears Werk Hamlet aufschlagen -- 
  Serlo -- Tür herein -- Befinde Schwester fragen -- schaut Buch -- Freund Hand halten -- rufen -- find Hamlet -- 
  -- 
  Zweifel aufgestoßen -- kanonisch ansehen -- Stück gerne geben möchten -- vermindern scheinen -- 
  Engländer -- Hauptinteresse Akt schließen -- letzter Akt kümmerlich halten -- -- Stück weder rücken -- 
  -- Wilhelm -- Glied Nation -- Meisterstück aufweisen -- Vorurteil Beschränktheit falsch Urteil leiten -- hindern -- Auge sehen -- gerecht -- 
  entfernt -- Plan Stück tadeln -- glauben vielmehr -- groß ersonnen -- 
  -- ersonnen -- -- 
  Ausleg -- fragt Serlo -- 
  auslegen -- versetzen Wilhelm -- vorstellen -- denken -- 
  Aurelie heben Kissen -- stützen Hand -- unser Freund -- groß Versicherung -- -- reden fortfuhr -- 
  fällen -- schmeicheln -- Held sehen -- handeln -- lieben hassen -- Herz gebieten -- unternehmen ausführen -- Hindernis abwenden Zweck gelangen -- 
  Geschichtsschreiber Dichter möchten gerne überreden -- stolz Mensch fallen können -- 
  belehren -- Held Plan -- Stück planvoll -- 
  starr eigensinnig durchgeführt Idee Rache Bösewicht bestrafen -- geschehen ungeheuer -- wälzen Folge fort -- reißen Unschuldige -- Verbrecher scheinen Abgrunde -- bestimmen -- ausweichen -- stürzen hinein -- -- Weg glücklich auszulaufen gedenken -- 
  Eigenschaft Greueltat -- Böes unschuldigen -- gut Handlung -- Vorteil Unverdient ausbreiten -- Urheber weder bestrafen belohnen -- 
  unser Stück wunderbar -- 
  Fegefeuer senden Geist fordern Rache -- vergebens -- 
  Umstand -- treiben Rache -- vergebens -- 
  weder Irdische Unterirdische gelingen -- Schicksal vorbehalten -- 
  Gerichtsstunde -- 
  böse fallen guter -- 
  Geschlecht weggemähen -- Sproßt -- 
  Pause -- ansahen -- Serlo Wort -- Vorsehung sonderlich Kompliment -- Dichter erheben -- scheinen Ehre Dichter -- Ehre Vorsehung -- Endzweck Plane unterzuschieben -- denken -- 
  Sechzehntes Kapitel -- 
  Lassen -- Aurelie -- Frage -- 
  Ophelia Rolle ansehen -- zufrieden -- getrau gewiß Umstand spielen -- 
  sagen -- Dichter Wahnsinnigen Liedchen unterlegen -- 
  Fragment melancholisch Ballad wählen -- 
  Zweideutigkeit lüsterne Albernheit Mund edl Mädchen -- 
  gute Freundin -- versetzen Wilhelm -- Jota nachgeben -- 
  Sonderbarkeit -- anscheinend Unschicklichkeit liegen Sinn -- 
  wissen Anfang Stück -- womit Gemüt gut Kind beschäftigen -- 
  Stille leben -- verbirgen Sehnsucht -- Wunsch -- 
  heimlich klangen Ton Lüsternheit Seele -- versuchen -- unvorsichtig Wärterin Sinnlichkeit Ruhe singen Liedche -- wach halten müssen -- 
  zuletzt -- Gewalt entrissen -- Herz Zunge schweben -- Zunge Verräterin -- Unschuld Wahnsinn ergötzen König Königin Nachklange geliebten -- losen Lied -- Mädchen -- gewinnen -- Mädchen -- Knabe schleichen -- -- 
  ausgereden -- wunderbar Szene Auge entstehen -- Weise erklären -- 
  Serlo einigemal Stube gehen -- Absicht merken lassen -- 
  treten Aurelie Putztisch -- greifen schnell liegen -- eilt Beute Türe -- 
  Aurelie bemerken Handlung -- Auffuhr -- Weg werfen -- unglaublich Leidenschaft angriff -- geschickt -- geraubt Gegenstand fassen -- 
  Rang balgen hartnäckig -- drehten wanden lebhaft herum -- lachte -- ereiferen -- Wilhelm hinzu eilt -- auseinander bringen besänftigen -- Aurelie bloß Dolch Hand Seite springen -- Serlo Scheide -- zurückbleiben -- verdrießlich Boden werfen -- 
  Wilhelm treten erstaunt -- stumm Verwunderung scheinen Ursache fragen -- sonderbar Streit wunderbar Hausrat entstehen -- 
  -- sprechen Serlo -- Schiedsrichter -- 
  scharfen Stahle -- 
  Lasse zeigen -- 
  Dolch ziemen Schauspielerin -- spitz scharf Nadel Messer -- 
  Poß -- 
  heftig -- tun ungefähr leide_es -- 
  innerlich Haß Sonderbarkeit -- ernstlich Gedanke Art toll -- gefährlich Spielwerk abschmacken -- 
  -- rufen Aurelie -- blanken Klinge Höhe halten -- treu Freund verwahren -- 
  Verzeih -- rufen -- Stahl küßen -- vernachlässigen -- 
  Serlo scheinen Ernst böse -- 
  -- Nimm -- Bruder -- fahren fort -- wissen -- Form köstlich Talisman bescheren -- Hilfe Rat schlimmsen finden -- schädlich -- gefährlich aussehen -- 
  Dergleichen Rede -- Sinn -- toll -- Serlo -- verlassen heimlich Grimm Zimmer -- 
  Aurelie verwahrt Dolch sorgfältig Scheide -- stecken -- 
  Lassen Gespräch fortsetzen -- unglücklich Bruder stören -- fallen -- Wilhelm Frage sonderbaren Streit vorbrachen -- 
  Schilderung Ophelia gelten lassen -- fahren fort -- 
  Absicht Dichter verkennen -- bedauern -- empfinden -- 
  erlauben Betrachtung -- kurz Gelegenheit geben -- Bewunderung bemerk tief richtig Blick -- Dichtung dramatisch Dichtung beurteilen -- tief abgründ Erfindung verbergen -- fein Zug Ausführung bemerkbar -- 
  Gegenstand jemals Natur erblicken -- erkennen Wahrheit Bilde -- scheinen Vorempfindung Welt liegen -- harmonisch Berührung Dichtkunst erregen entwickeln -- 
  wahrhaftig -- fahren fort -- außen hinein -- sehen -- Mensch -- leben -- kennen -- Grund verkennen -- -- 
  Erlaub -- sagen -- Shakespeare erklären hören -- glauben -- kommen Rate Götter -- zugehören -- bereden -- Mensch bilden -- Leute umgehen -- sehen gleichsam -- geboren Kind Schöpfung -- sonderlich Verwunderung erbaulich Gutmütigkeit Löwe Aff -- Schaf Elefant anstaunen -- treuherzig gleich ansprechen -- bewegen -- 
  Ahnung schülerhaft wesen -- wert Freundin -- versetzen -- öfter lästig -- danken -- Welt mehrere Klarheit verhelfen -- 
  Jugend Auge Geist innen außen richten -- -- Mensch gewiß Grad kennen lernen -- Mensch mindester verstehen begreifen -- 
  gewiß -- Aurelie -- Anfangs Verdacht -- -- Leute -- Bruder zugeschicken -- sagen -- Brief Verdienst Mensch halten -- 
  Bemerkung Aurelie -- -- Freund Mangel gestehen -- führen Drückend -- sogar Beleidigend -- still -- -- teils Empfindlichkeit merken lassen -- teils Busen Wahrheit Vorwurf forschen -- 
  betreten -- fahren Aurelie fort -- Licht Verstand gelangen -- Fülle Herzen geben -- 
  Künstler bestimmen -- Dunkelheit Unschuld bewahren -- schön Hülle jung Knospe -- Unglücks -- früh herausgetrieben -- 
  gewiß -- kennen -- arbeiten -- 
  O -- 
  glücklich Zustande -- hoch Begriff Nation Bühne betreten -- 
  deutsch Einbildung -- -- 
  Nation sprechen -- Gerüst erheben -- Reihe Lampen trennen -- Glanz Dampf hindern -- Gegenstand genau unterscheiden -- 
  willkommen Klang Beifall -- Menge herauf tönen -- dankbar Geschenk -- einstimmig Hand dargebracht -- 
  wiegen -- wirken -- wirkt Menge -- Publikum vernehmen -- glauben vollkommen Harmonie fühlen -- jederzeit Edelst Nation sehen -- 
  Unglücklicherweise Schauspielerin -- Naturell Kunst Theaterfreunde interessieren -- machen Anspruch jung lebhaft Mädchen -- 
  geben undeutlich verstehen -- Pflicht -- Empfindung -- reg -- persönlich teilen -- 
  Sache -- wünschen Gemüt erheben -- -- Herz nennen -- mindest Anspruch -- Stände -- Alter Charakter -- Last -- verdrießlich -- anderer ehrlich Mädchen Zimmer verschließen -- Mühe ersparen -- 
  Mann zeigen meist -- Tant sehen wohnen -- diesmal Abscheu erregen -- Eigenheit Albernheit unterhalten -- 
  vermeiden -- Theater -- öffentlich Ort -- Haus sehen -- -- auszulauern -- Bruder helfen Wacker -- 
  denken -- beweglich Ladendiener eingebildet Kaufmannssohn -- gewandt abwiegend Weltmann -- kühn Soldat rasch Prinz -- -- -- vorbei gehen -- Art Roman anzuknüpfen gedachen -- verzeihen -- einbilden -- Nation ziemlich -- 
  phantastisch aufgestutzt Student -- demütig-stolz verlegen Gelehrt -- schwankfüßigen genügsam Domherr -- steif aufmerksam Geschäftsmann -- derben Landbaron -- freundlich glatt-platten Hofmann -- jung Bahn schreitend Geistliche -- gelassen -- Schnell tätig spekulierend Kaufmann -- Bewegung sehen -- Himmel -- finden -- gemein Interesse einzuflöß Stande sein -- vielmehr äußerst verdrießlich -- Beifall Tor einzeln -- Beschwerlichkeit lang Weile -- einzukassieren -- behagen -- gerne zueignen -- 
  Spiel vernünftig Kompliment erwarten -- hoffen -- Autor loben -- hochschätzen -- machen albern Anmerkung -- nannt abgeschmackt Stück -- wünschen spielen sehen -- 
  Gesellschaft herum horchen -- edl -- geistreich -- witzig Zug nachklängen -- Vorschein kommen -- selten Spur vernehmen -- 
  Fehler -- vorkommen -- Schauspieler versprechen Provinzialismus hören lassen -- wichtig Punkt -- fest halten -- -- 
  wissen zuletzt -- wohin wenden -- dünkn klug -- unterhalten lassen -- glauben wundersam unterhalten -- herum tätschelen -- 
  fing -- Herz verachten -- -- Nation vorsätzlich Abgesandte prostituieren -- 
  links -- übel Erzog -- unterrichten -- leer gefällig Wesen -- geschmacklos -- 
  rufen -- 
  deutsch Schuh zuschnallen -- fremd Nation lernen -- 
  sehen -- verblenden -- hypochondrisch ungerecht -- lang währen -- desto Krankheit -- 
  umbringen -- verfiel and Extrem -- 
  verheiraten -- vielmehr lassen verheiraten -- 
  Bruder -- Theater übernehmen -- wünschen Gehilfe -- 
  Wahl fallen jung Mann -- Zuwider -- mangeln -- Bruder besitzen -- Genie -- Leben -- Geist rasch Wesen -- finden -- abging -- 
  lieb Ordnung -- Fleiß -- köstlich Gabe hauszuhaln -- Gelde umgehen -- 
  Mann -- wissen -- leben -- wissen -- 
  -- Sache gehen -- 
  nehmen -- Tätigkeit Bruder Ursache -- kommen -- Verdienst Mann -- 
  denken Welt Nation -- 
  Welt teilen -- Begriff Nation verlieren -- 
  auftreten -- leben -- öffnet Mund -- schweigen -- heraus kommen -- reden -- 
  -- arg machen -- eigentlich Absicht Bruder ergeben -- Beifall Geld -- -- -- hören gerne loben brauchen -- 
  spielt Gefühl -- Überzeugung -- anwie -- Danke -- zufrieden -- 
  richten Schwäche Publikum -- Geld -- Willkür leben -- -- 
  indessen handwerksmäßig Schlendrian fallen -- 
  ziehen Freude Anteil -- Ehe kinderlos dauern kurz -- 
  Mann krank -- Kraft nehmen sichtbar -- Sorge unterbrach allgemein Gleichgültigkeit -- 
  Bekanntschaft -- neu Leben anfehen -- neu schneller -- -- 
  schweigen Zeitlang stille -- fahren fort -- stocken geschwätzig Laune -- getrau Mund aufzutun -- 
  Lasse ausruhen -- weggeh -- ausführlich all Unglück wissen -- 
  rufen indessen Mignon herein -- hören -- 
  Kind Aurelie Erzählung einigemal Zimmer -- 
  Eintritt leise sprechen -- weggeschlich -- sitzen Saale still -- warten -- 
  hereinkommen heißen -- bringen Buch -- Form Einband geographisch Atlas erkennen -- 
  Pfarrer unterwegs Verwunderung Landkarte sehen -- fragen -- -- -- unterrichten -- 
  verlangen lernen scheinen Kenntnis lebhaft -- 
  bitten Wilhelm inständig -- Buch kaufen -- 
  Bildermann silbern Schnalle einsetzen -- wollen -- Abend spät -- früh einlösen -- 
  bewilligen -- fing -- dasjenig -- wissen -- teils herzusag -- teils Art wunderlichst Frage -- 
  bemerken -- Anstrengung schwer mühsam begreifen -- 
  Handschrift -- Mühe -- 
  sprechen brechen deutsch -- Mund Singen Auftat -- Zither rühren -- scheinen einzig Organ bedienen -- wodurch Innerst aufschließen mitteilen -- 
  -- gegenwärtig sprechen -- Verlegenheit gedenken -- unser Freund Öfter versetzen -- 
  -- gut -- Nacht -- schließen fest Arm -- küssen Inbrunst -- Heftigkeit aufkeimend Natur Angst bange -- 
  zuckend Lebhaftigkeit scheinen Betragen täglich vermehren -- Wesen bewegen rastlos Stille -- 
  -- bindfad Hand drehen -- Tuch kneen -- Papier Hölzche kauen -- 
  jeder Spiel scheinen innerer heftig Erschütterung abzuleiten -- 
  einzig -- Heiterkeit geben scheinen -- Nähe Felix -- artig abgeben wissen -- 
  Aurelie -- Ruhe stimmen -- Freund Gegenstand -- Herz liegen -- erklären -- Beharrlichkeit diesmal ungeduldig -- verstehen -- wegbegeben -- müssen -- helfen -- ausdrücklich wider Wille fortschicken -- 
  niemals -- Aurelie -- Rest Geschichte erzählen -- 
  zärtlich geliebt -- ungerecht Freund Meile -- sagen -- setzen Pferd -- suchen Weise Bekanntschaft -- zurückkehren -- gewiß verzeihen -- bedauern Herz -- 
  Wort sagen -- liebenswürdig -- lieben -- 
  kritisch -- Mann besorgt müssen -- lernen kennen -- 
  Amerika kommen -- Gesellschaft Franzose vieler Distinktion Fahne vereinigt Staat dienen -- 
  begegnet gelaßen Anstande -- offen Gutmütigkeit -- sprechen -- Lage -- Spiel -- alt Bekannt -- teilnehmend deutlich -- erstenmal freuen -- Existenz Wesen klar erkennen -- 
  Urteil absprechend -- Treffend lieblos -- 
  zeigen Härte -- Mutwille gefällig -- 
  scheinen gut Glück Frau gewohnen -- aufmerksam -- keineswegs schmeichelnd andringend -- sorglos -- 
  Stadt weniger -- meist Pferd -- besuchen bekannte Gegend -- besorgt Geschäft Haus -- 
  -- steigen -- behandelt kränker Mann warm Sorge -- schaffen Leidende geschickt Arzt Linderung -- -- betreffen -- -- lassen Schicksal nehmen -- 
  erzählt Geschichte Kampagne -- unüberwindlich Neigung Soldatenstande -- Familienverhältnisse -- vertraut gegenwärtig Beschäftigung -- 
  -- geheim -- entwickelt Innerst -- lassen verborgenst Winkel Seele sehen -- lernt Fähigkeit -- Leidenschaft kennen -- 
  erstemal Leben -- herzlich -- geistreich Umgang Genoß -- 
  anziehen -- hingerissen -- ehe Betrachtung anstellen -- 
  inzwischen verlieren Mann ungefähr nehmen -- 
  Last theatralisch Geschäft fallen -- 
  Bruder -- unverbesserlich Theater -- Haushaltung niemals nützen -- besorgt -- studiert Rolle fleißig jemals -- 
  spielen Alter -- anderer Kraft neu Leben -- seinetwillen -- gelingen -- edl Freund Schauspiel wissen -- einigemal behorcht -- angenehm unvermutet Beifall überraschen -- denken -- 
  gewiß -- seltsam Geschöpf -- 
  Rolle -- spielen -- eigentlich Mut -- loben Ehre spräch -- Stimmung Herzens -- Wort -- -- 
  Wusste Zuhörer -- getraut -- Gewalt sprechen -- Liebe -- Lob geradezu Gesicht aufdringen -- abwesend -- frei Spiel -- Best gewiß Ruhe -- unbeschreiblich Zufriedenheit -- 
  Beifall freuen -- Publikum Vergnügen -- hinunt rufen -- 
  schuldig -- 
  -- Wunder Verhältnis Publikum -- Nation verändern -- 
  erscheinen vorteilhaftest Licht -- erstaunt bisherig Verblendung -- 
  unverständig -- -- -- ehemals Nation schaltest -- Nation -- 
  -- einzeln Mensch interessant -- 
  keineswegs -- 
  fragen -- Maß Menge Anlage -- Kraft Fähigkeit verteilen -- günstig Umstand entwickeln -- vorzüglich Mensch gemeinsam Endzwecke leiten -- 
  freut -- hervorstechend Originalität Landsleute finden -- freut -- Richtung außen annehmen verschmähten -- 
  Freut -- Anführer finden -- 
  Lothar -- lassen Freund geliebt Vorname nennen -- deutsch Seite Tapferkeit vorstellen -- zeigen -- braveren Nation Welt -- führen -- schämen -- Eigenschaft Volks niemals denken -- 
  Geschichte -- meister verdienstvoll Mann Zeitalter stehen Verhältnissen -- 
  jung -- Auge hervorkeimend hoffnungsvoll Jugend Vaterlande -- still Arbeit Fach beschäftigt tätig Mann -- 
  lassen Überblick Deutschland -- -- können -- schämen -- Nation verworren Menge beurteilen -- Theatergarderobe drängen -- 
  Pflicht -- Fache -- geistreich belebend -- 
  scheinen inspirieren -- Theater treten -- 
  Mittelmäßige Stelle Gold Munde -- Dichter zweckmäßig beigestanden -- wunderbar Wirkung hervorbringen -- 
  leben jung Witwe Monat fort -- 
  entbehren -- höchst unglücklich -- außen bleiben -- 
  zeigen Brief verwandte -- vortrefflich Schwester -- 
  klein Umstand Verhältnis -- innig -- vollkommen Einigkeit denken -- 
  Nahme Liebe nennen -- 
  -- -- -- Freund -- hoch -- -- 
  Siebzehntes Kapitel -- 
  Wilhelm lang Besuch Handelsfreunde aufschieben -- 
  Verlegenheit -- wissen -- Brief Seinig antreffen -- 
  fürchtet Vorwurf -- enthalten müssen -- wahrscheinlich Handelshause Nachricht Verlegenheit geben -- seinetwegen befinden -- 
  scheut -- ritterlich Abenteuer -- schülerhaft ansehen -- erscheinen -- -- trotzig -- Weise Verlegenheit verbergen -- 
  Verwunderung Zufriedenheit leidlich -- 
  lebhaft beschäftigter Comptoir -- Brief aufsuchen -- lang Außenbleiben Vorbeigehen denken -- 
  Brief Vater Freund Werner eröffnen -- finden sämtlich leidlich Inhalt -- 
  alt -- Hoffnung weitläufigen Journals -- Führung Sohne Abschied sorgfältig empfehlen -- wozu tabellarisch Schema mitgegeben -- scheinen Stillschweigen ziemlich beruhigen -- Rätselhafte einzig Schloß Grafe abgesandt Brief beschweren -- 
  Werner scherzt Art -- erzählen lustig Stadtgeschichten -- bitten Nachricht Freund bekannte -- Wilhelm nunmehr Handelsstadt häufig kennen lernen -- 
  Freund -- außerordentlich erfreut -- wohlfeil Preis loszukommen -- antworten sogleich munter Brief -- versprechen Vater ausführlich Reisejournal -- verlangen geographisch -- statistisch merkantilisch Bemerkung -- 
  viele Reise sehen -- hoffen leidlich Heft schreiben -- 
  merken -- beinahe Fall -- befinden -- Schauspiel -- weder schreiben -- memorieren -- aufführen -- Licht angezünden Zuschauer herbei rufen -- 
  anfing -- Komposition -- gewahr -- Empfindung Gedanke -- Erfahrung Herzen Geist sprechen erzählen -- äußerer Gegenstand -- -- merken -- minde Aufmerksamkeit schenken -- 
  Verlegenheit kommen Kenntnis Freund Laert -- 
  Gewohnheit jung Leute -- unähnlich -- verbinden -- Fehler -- Sonderbarkeit interessant Mensch -- 
  heiteren glücklich Sinnlichkeit begabt -- alt -- Zustand nachdenken -- 
  Unglück Krankheit rein Gefühl Jugend rauben -- Blick Vergänglichkeit -- Zerstückelte unser Dasein eröffnen -- 
  launig -- rhapsodisch Art Gegenstand denken -- vielmehr unmittelbar Eindruck äußeren -- entstehen -- 
  -- treiben Kaffeehäuser -- Wirtstisch herum -- Haus bleiben -- Reisebeschreibung liebsten -- einzig Lektüre -- 
  -- Leihbibliothek finden -- Wunsch befriedigen -- spukt halb Welt gut Gedächtnisse -- 
  Freund Mut einsprechen -- völlig Mangel Vorrat feierlich versprochen Relation entdecken -- 
  Kunststück -- -- gleichen -- 
  Deutschland durchreist -- durchkreuzt -- durchzog -- durchkreochen durchflogen -- deutsch reisend herrlich Vorteil -- Ausgabe Publikum erstatten lassen -- 
  Gib Reiseroute -- ehe kamsen -- wissen -- 
  Quelle Hilfsmittel Werk aufsuchen -- Quadratmeile -- messen -- Volksmeng -- zählen -- fehlen lassen -- 
  Einkünfte Land nehmen Taschenbücher Tabell -- -- -- zuverlässigst Dokument -- 
  gründen politisch Räsonnement -- seitenblicken Regierung soll_es fehlen -- 
  Paar Fürst beschreiben wahr Vater Vaterlande -- desto eher glauben -- anhängen -- geradezu Wohnort berühmt Leute durchreisen -- begegnen Wirtshause -- lassen Vertrauen albernst Zeug sagen -- vergessen Liebesgeschicht naiv Mädchen anmutigster einzuflecht -- Werk geben -- Vater Mutter Entzück erfüllen -- Buchhändler Vergnügen bezahlen -- 
  Schritt Werk -- Freund Lust Arbeit -- indes Wilhelm Abends Schauspiel Umgange Serlo Aurelie groß Zufriedenheit finden -- Idee -- eng Kreis herum drehen -- täglich ausbreiten -- 
  achtzehnt Kapitel -- 
  groß Interesse vernehmen Stückweise Lebenslauf Serlo's -- Art selten Mann -- vertraulich -- Zusammenhang sprechen -- 
  -- sagen -- Theater gebären säugen -- 
  stumme Kind müssen bloß Gegenwart Zuschauer rühren -- Verfasser natürlich unschuldig Hilfsmittel kannen -- -- 
  Vater Mutter -- bringen beliebt Stück groß Beifall zuwege -- ehe wissen -- Händeklatsche bedeuten -- 
  Amor -- zitternd -- -- Flugwerk herunter -- entwickelt Harlekin Ei -- Essenkehrer früh artigst Streich -- 
  müssen Beifall -- glänzend Abend erhalten -- Zwischenzeit teuer bezahlen -- 
  Vater -- überzeugen -- Schlag Aufmerksamkeit Kind erregen festhalten können -- prügelt einstudieren Rolle abgemessen Zeit -- -- Kind ungeschickt -- desto gewiß Anhaltender geschickt zeigen mögen -- 
  ehemals -- Grenzstein setzen -- umstehend Kind tüchtig Ohrfeige -- alt Leute erinnern genau Ort Stelle -- 
  wachsen heran -- zeigen außerordentlich Fähigkeit Geist Fertigkeit Körper -- Biegsamkeit sowohl Vorstellungsart -- Handlung Gebärden -- 
  Nachahmungsgabe überstieg Glaube -- 
  Knabe ahmt Person -- sehen glauben -- Gestalt -- Alter Wesen völlig unähnlich verschieden -- 
  fehlt Gabe Welt schicken -- sobald einigermaßen Kraft bewußt -- finden natürlich -- Vater entfliehen -- -- Vernunft Knabe zunehmen -- Geschicklichkeit vermehrt -- hart Begegnung nachzuhelfen nötig finden -- 
  glücklich fühlt lose Knabe frei Welt -- Eulenspiegelspossen überall Aufnahme verschafften -- 
  Stern führen Fastnachtszeit Kloster -- -- Pater -- Umgäng besorgen -- geistlich Maskerade christlich Gemeinde ergötzen -- sterben -- hülfreich Schutzengel auftreten -- 
  übernehmen sogleich Rolle Gabriel Verkündigung -- mißfiel hübsch Mädchen -- Maria obligeant Gruß -- äußerlich Demut innerlich Stolze -- zierlich aufnehmen -- 
  spielen sukzessiv Mysteri wichtig Rolle -- wissen -- Heiland Welt verspotten -- schlagen -- an Kreuz heften -- 
  kriegsknecht Gelegenheit Rolle spielen -- -- schicklich Weise rächen -- Gelegenheit jung Gericht prächtigsen Kleid Kais Könige stecken -- Augenblick -- -- Rolle zufrieden -- Himmel vorauszugeh Schritt nehmen -- unvermuten Teufelsgestalt begegnen -- Ofengabel herzlichst Erbauung sämtlich Zuschauer Bettler weidlich durchdrosch -- unbarmherzig Grube stürzen -- hervordringend Feuer auf übelste empfangen sehen -- 
  klug einsehen -- gekrönt Häupter frech Unternehmen vermerken -- privilegiert Ankläger Schergen-Amte Respekt -- -- ehe tausendjährig Reich anging -- Stille -- benachbart Stadt Gesellschaft -- Kind Freude nennen -- offen arme aufnehmen -- 
  verständig -- geistreich -- lebhaft Mensch -- einsahen -- Summe Existenz Vernunft dividieren -- niemals rein aufgehen -- wunderlich Bruch übrig bleiben -- 
  hinderlichen -- -- Maß verteilen -- gefährlichen -- Bruch -- suchen bestimmt Zeit vorsätzlich -- 
  Woche ausführlich Narr -- straften wechselseitig allegorisch Vorstellung -- übrig närrisches bemerken -- 
  Art roh Folge Ausbildung -- sittlich Mensch täglich bemerken -- warnen Strafe pflegen -- lustig sicher -- gewiß Schoßnarr verleugnen -- traktiern -- anstatt Weg Hilfe Selbstbetrug Haus Herrschaft gelangen -- Vernunft heimlich Knechtschaft zwingen -- einbilden -- verjagen -- 
  Narrenmaske Gesellschaft herum -- erlauben -- -- -- fremd Attribut -- charakteristisch auszuzieren -- 
  Karnavalszeit groß Freiheit -- wetteifert Bemühung geistliche -- Volk unterhalten anzuziehen -- 
  feierlich allegorisch Aufzug Tugend Laster -- Künste Wissenschaft -- weltteil Jahrszeite versinnlichen Volke Menge Begriff -- geben Idee entfernt Gegenstand -- scherz Nutzen -- Seite geistlich Mummerei abgeschmackt Aberglaube befestigten -- 
  jung Serlo Element -- eigentlich Erfindungskraft -- groß Geschick -- finden nutzen -- zurecht stellen -- scheinbar -- 
  Einfall -- Nachahmungsgabe -- beißend Witz -- Woche völlig frei -- Wohltäter -- üben -- Gesellschaft wert -- unentbehrlich -- 
  treiben Unruhe vorteilhaft Lage gegender Vaterlande -- Schule durchzugehen -- 
  gebildet bildlosen Deutschland -- Verehrung gute schöne Wahrheit Geist gebrechen -- Maske ausrichten -- müssen such Herz Gemüt wirken -- 
  kurz halten Gesellschaft -- merken -- Gelegenheit -- sämtlichen Stück Schauspieler Eigenheit -- Monotonie -- deutsch Theater herrschen -- albern Fall Klang Alexandriner -- geschraubtplatt Dialog -- Trockenheit Gemeinheit unmittelbar Sittenprediger fassen -- bemerken -- rühren Gefiel -- 
  Rolle gangbaren Stück -- Stück bleiben Gedächtnis -- eigentümlich Ton Schauspieler -- Beifall vortragen -- 
  zufälligerweis Streifereien -- Geld völlig ausgehen -- Einfall -- -- Stück -- Edelhöfen Dorf vorstellen -- überall sogleich Unterhalt Nachtquartier verschaffen -- 
  Schenke -- Zimmer Garten Theater aufschlagen -- schelmisch Ernst anscheinend Enthusiasmus wissen Einbildungskraft Zuschauer gewinnen -- Sinn täuschen -- offen Auge alt Schrank Burg -- Fächer Dolch umzuschaffen -- 
  Jugendwärme ersetzt Mangel tief Gefühl -- Heftigkeit scheinen Stärke -- Schmeichelei Zärtlichkeit -- 
  -- Theater kannen -- erinnern -- sehen gehören -- übrig erregt Ahnung Wunderbaren -- Wunsch -- nah -- 
  Ort Wirkung -- verfehlen wiederholen -- herzlichsen Schadenfreude -- Mensch -- gleich Weise -- Stegreife -- -- 
  lebhaft -- frei gehindert Geist verbesseren -- Rolle Stück wiederholen -- geschwind -- 
  rezitieren spielt Sinn gemäß -- Muster -- Anfangs nachahmen -- 
  Weg -- spielen verstellen -- 
  scheinen hingerissen -- laueren Effekt -- groß Stolz -- Mensch stufenweise Bewegung setzen -- 
  toll Handwerk -- treiben -- nötigt gewiß Mäßigung verfahren -- lernen -- teils zwingen -- teils Instinkt -- -- wovon Schauspieler Begriff scheinen -- Organ Gebärd ökonomisch -- 
  wissen roh unfreundlich Mensch bändigen -- interessieren -- überall Nahrung Obdach zufrieden -- jeder Geschenk dankbar annehmen -- reichen -- manchmal Geld -- Meinung -- Ausschlug -- schickt Empfehlungsschreibe -- wanderen Edelhofe -- Vergnügen erregen -- Genoß -- angenehmsen artigst Abenteuer bleiben -- 
  innerlich Kälte Gemüte lieben eigentlich -- Klarheit Blicks -- äußerer Eigenheit Mensch -- tragen mimisch Sammlung -- 
  Selbstigkeit äußerst beleidigt -- gefiel -- überall Beifall erregen -- 
  erlangen -- genau geben -- Sinn schärfen -- Darstellung -- gemein Leben schmeicheln -- 
  arbeitet Gemütsart -- Talent Lebensart dergestalt wechselsweise -- unvermerkt vollkommen Schauspieler ausbilden -- 
  -- seltsam scheinend -- natürlich Wirkung Gegenwirkung steigen -- Einsicht Übung -- Rezitation -- Deklamation Gebärdenspiel hoch Stufe Wahrheit -- Freiheit Offenheit -- Leben Umgang heimlich -- künstlich -- verstellen ängstlich scheinen -- 
  schicksalen Abenteuer sprechen Ort -- bemerken -- spät Zeit -- gemacht Mann -- Besitz entschieden Name -- gut obgleich fest Lage -- angewöhnen -- Gespräch fein Weise teils ironisch -- teils spöttisch Sophist -- fast ernsthaft Unterhaltung zerstören -- 
  gebraucht Manier Wilhelm -- sobald -- begegnen -- allgemein theoretisch Gespräch anzuknüpfen Lust -- 
  Demungeachtet beisammen -- beiderseitig Denkart Unterhaltung lebhaft müssen -- 
  Wilhelm wünschen -- Begriff -- fassen -- entwickeln -- Kunst Zusammenhang behandeln -- 
  ausgesprochen Regel festsetzen -- bestimmen -- -- schön -- Beifall verdienen -- -- behandeln Ernstlichst -- 
  Serlo hingegen Sache -- niemals direkt Frage antworten -- wissen -- Geschichte Schwank -- artig vergnüglichst Erläuterung beizubringen -- Gesellschaft unterrichten -- erheitern -- 
  Neunzehntes Kapitel -- 
  Wilhelm Weise angenehm Stunde zubracht -- befinden Melina übrig desto verdrießlicher Lage -- 
  erscheinen unser Freund manchmal böse Geist -- machen bloß Gegenwart -- flämisch Gesicht bitter Rede verdrießlich Augenblick -- 
  Serlo Gastrolle gelassen -- Hoffnung Engagement -- demungeachten sämtlichen Fähigkeit kennen lernen -- 
  Schauspieler gesellig versammelt -- Gewohnheit lesen lassen -- manchmal mitzulesen -- 
  Stück -- geben -- geben -- meistens teilweise -- 
  lassen -- Aufführung -- Stelle -- erinnern -- wiederholen -- vermehrt Einsicht Schauspieler -- verstärkt Sicherheit -- Punkt treffen -- 
  gering richtig Verstand verworren ungeläutert Genie Zufriedenheit anderer wirken -- erheben mittelmäßig Talent -- deutlich Einsicht -- unmerklich verschaffen -- bewundernswürdig Fähigkeit -- 
  tragen -- Gedicht lesen lassen -- Gefühl Reizes erhalten -- wohlvorgetragener Rhythmus Seele erregen -- anstatt Gesellschaft anfing -- Prosa vorzutragen -- wozu Schnabel wachsen -- 
  Gelegenheit sämtlichen angekommen Schauspieler kennen lernen -- -- -- beurteilen -- Stille vornehmen -- Talenten Revolution -- Gesellschaft drohen -- sogleich Vorteil ziehen -- 
  lassen Sache Weile beruhen -- lehnen Interzession Wilhelm Achselzuck -- ersehen -- jung Freund unerwartet Vorschlag -- 
  sollen auf Theater -- Bedingung wollen übrig engagieren -- 
  Leute unbrauchbar -- schildern -- versetzen Wilhelm -- annehmen -- dächen -- Talent müssen dieselbig bleiben -- 
  Serlo eröffnen -- Siegel Verschwiegenheit -- Lage -- Liebhaber Miene machen -- Erneuerung Kontrakt steigern -- sinnen -- nachgeben -- Gunst Publikum -- 
  Ließ -- Anhang folgen -- wodurch Gesellschaft -- mittelmäßig Glied verlören -- 
  hierauf zeigen Wilhelm -- -- Laert -- alt Polterer Frau Melina gewinnen hoffen -- 
  -- versprechen arm Pedante Jude -- Minister -- Bösewicht entschieden Beifall verschaffen -- 
  Wilhelm stutzen -- vernehmen Vortrag Unruhe -- sagen -- versetzen -- tief Atem holen -- sprechen freundlich Weise gute -- finden hoffen -- sehen schwach Seite -- Scharfsinne gewiß entgehen -- 
  Fleiß -- Übung nachdenken stark Seite -- versetzen Serlo -- 
  -- Naturalist Pfuscher -- -- Hoffnung geben -- beurteilen -- einzig Stock -- Stöck Unverbesserliche -- Eigendünkel -- Dummheit Hypochondrie ungelenk unbiegsam -- 
  Serlo legen weniger Wort Bedingung dar -- können wollen -- bitten Wilhelm schleunig Entscheidung -- verlassen gering Unruhe -- 
  wunderlich gleichsam Scherz unternommen Arbeit fingiert Reisebeschreibung -- Laert ausarbeiten -- Zustand täglich Leben wirklich Welt aufmerksam -- -- 
  begriff Absicht Vater -- Führung Journals lebhaft empfehlen -- 
  fühlen erstenmal -- angenehm nützlich können -- Mittelsperson vieler Gewerbe Bedürfnis -- tief Gebirg Wald fest Land Leben Tätigkeit verbreiten helfen -- 
  lebhaft Handelsstadt -- befinden -- Unruhe Laert -- überall herumschleppen -- anschaulichst Begriff Mittelpunktes -- woher ausfließen -- wohin zurückkehren -- erstemal -- Geist Anschauen Art Tätigkeit ergötzen -- 
  Zustande Serlo Antrag tun -- Wunsch -- Neigung -- Zutrau angeboren Talent -- Verpflichtung hilflos Gesellschaft regen -- 
  stehen -- -- abermals Scheideweg Frau -- Jugend erscheinen -- 
  sehen kümmerlich -- -- prächtig -- 
  folgen fühlst Art innerer Beruf -- Seite äußerer Anläs stark -- scheinen unmöglich entscheiden -- wünschest -- Übergewicht außen Wahl bestimmen mögen -- -- untersuchst -- äußerer Umstand -- Neigung Gewerbe -- Erwerbe Besitz einflößen -- innerst Bedürfnis erzeugen nähren Wunsch -- Anlage -- gut schöne ruhen -- körperlich geistig -- entwickeln ausbilden -- 
  Schicksal verehren -- Zutun hierh Ziel wünsche führen -- 
  Geschieht -- ehemals ausgedachen vorsetzen -- zufällig Mitwirken -- 
  Sonderbar -- 
  Mensch scheinen vertraut -- Hoffnung Wunsch -- Herz nähren bewahren -- -- begegnen -- gleichsam aufdringen -- erkennen weichen -- 
  -- unglücklich Nacht -- Mariane entfernen -- träumen lassen -- stehen -- bieten -- 
  hierher flüchten -- sachen hergeleiten -- Serlo unterzukommen suchen -- suchen -- bieten Bedingung -- Anfänger erwarten -- 
  bloß Liebe Mariane -- an Theater fesseln -- lieb Kunst -- Mädchen festknüpfen -- 
  Aussicht -- Ausweg Bühne bloß unordentlichen -- unruhig Mensch willkommen -- Leben fortsetzen wünschen -- Verhältnis bürgerlich Welt gestatteten -- -- Reiner -- Würdiger -- bewegen -- damalig Gesinnung ändern -- 
  vielmehr unwissend dein Plan verfolgen -- letzter Schritt billigen -- Nebenabsicht Spiel -- feierlich gegeben Wort halten -- edl Weise schwer Schuld befreien -- 
  -- Herzen Einbildungskraft bewegen -- wechseln lebhafteste -- 
  Mignon behalten können -- Harfner verstoßen brauchen -- Gewicht Waagschale -- schwanken -- Freundin Aurelie gewohnterweise besuchen -- 
  Zwanzigstes Kapitel -- 
  finden Ruhbette -- scheinen Still -- 
  Glaube spielen -- fragen -- 
  O -- versetzen lebhaft -- wissen -- hindern -- 
  -- wissen -- Beifall unser Parterr ablehnen -- -- umbringen -- 
  vorgestern dacht Herz müssen reißen -- 
  leiden -- gefiel -- studieren vorbereiten -- freuen -- willkommen Zeichen -- gelingen -- enden wiedertönen -- 
  sagen -- -- ich_es -- hingerissen -- verwirren -- Spiel groß Eindruck -- 
  Beifall laut -- denken -- wüßten -- entzücken -- dunkel -- heftig -- unbestimmten Anklang rühren -- zwing Bewunderung -- fühlen -- Schmerzenstön Unglücklichen -- eu Wohlwollen schenken -- 
  früh lernen -- wiederholt versuchen -- 
  müde -- zerbroch -- vorn -- 
  Abend spielen -- Schleppe -- langweilig aufzustehen -- verdrießlich Bette -- 
  ewig Zirkel -- 
  treten leidig Tröstung -- werfen weg -- Verwünsch -- 
  ergeben -- Notwendigkeit ergeben -- notwendig -- Grund richten -- 
  -- 
  bezahlen -- deutsch -- Charakter deutsche -- schwer -- schwer -- 
  O -- Freundin -- fallen Wilhelm -- können aufhören Dolch schärfen -- unablässig verwunden -- 
  bleiben -- 
  Jugend -- Gestalt -- Gesundheit -- Talent -- 
  verschulden verlieren -- übrig hinterdrein werfen -- 
  notwendig -- 
  schweigen Augenblick -- fahren -- 
  wissen -- Zeitverderb -- Zeitverderb Liebe -- 
  -- -- rein -- 
  armes verliebt Geschöpf -- verlieben -- 
  mitleiden -- Gott -- arm Geschöpf -- 
  Versank -- kurz Pause rufen heftig -- 
  gewohnen -- Hals werfen -- fühlen -- Mann Stande -- Wert Weibe fühlen -- Ehre wissen -- 
  heilig Engel -- Bild Seligkeit -- rein gutmütig Herz erschaffen -- Himmlischeres -- weiblich Wesen -- geliebt Manne hingeben -- 
  kalt -- stolz -- -- klar -- klug -- verdienen Weiber heißen -- Vorzug legen Fuß -- sobald lieben -- sobald hoffen -- Gegenliebe erwerben -- 
  O wissen Wille weggeworfen -- verzweifeln -- absichtlich verzweifeln -- 
  Blutstropfen -- gestraft -- Faser -- peinigen -- 
  lächeln -- lach theatralisch Aufwand Leidenschaft -- 
  fern unser Freund Anwandlung Lachen -- 
  entsetzlich -- halb natürlich -- halb erzwungen Zustand Freundin peinigen -- 
  Empfand Folter unglücklichen Anspannung -- Gehirn zerrütten -- Blut fieberhaft Bewegung -- 
  aufstehen -- Stube -- 
  sagen -- rufen -- lieben -- 
  wissen -- wert -- wend Gemüt -- dorthin -- beschäftigen -- -- 
  nehmen Rolle -- spielen -- übe alt -- kenn -- fleißig Fleißiger -- Einzeln -- übe übe - Freund -- Vertrauter -- entsetzlich Arbeit -- Gewalt entfernen -- 
  Verstand leiden -- Gehirn angespannen -- Wahnsinne retten -- überlaß Gefühl -- lieben -- -- 
  -- lieben -- lieben -- rufen tausend Träne -- lieben -- sterben -- 
  fassen Hand -- bitten inständig -- aufzureiben -- 
  O -- -- sonderbar -- Mensch Unmögliche -- Möglich versagen -- 
  bestimmen -- treu Herz finden -- Glückseligkeit -- 
  bestimmen -- Heil Leben Unglückliche festzuknüpfen -- schwer Treue Rohr Boden ziehen -- zerbrichen -- 
  Aurelie Geschichte Mariane vertrauen -- beziehen -- 
  starr Auge -- fragen -- sagen -- niemals Weib betrog -- leichtsinnig Galanterie -- frevelhaft Beteuerung -- herzlockend Schwüren Gunst abzulocken suchen -- 
  -- versetzen Wilhelm -- Ruhmredigkeit -- Leben einfach -- selten Versuchung geraten -- versuchen -- 
  Warnung -- schön -- edeln Freundin -- traurig Zustand -- versetzen sehen -- 
  nehmen Gelübde -- Herz angemessen -- Rührung -- einflößt -- Sprache Form bestimmen -- Augenblick heiligen -- flüchtig Neigung widersteh -- ernstlichst Busen bewahren -- weiblich Geschöpf Bekenntnis lieb Lippe vernehmen -- Leben widmen -- 
  wild Gleichgültigkeit -- entfernt -- Hand reichen -- Schritt -- 
  liegen -- rufen -- Weiberträn -- See wachsen -- 
  -- fahren fort -- Tausend retten -- -- Tausend Redlichen finden -- annehmen -- 
  wissen versprechen -- 
  wissen -- versetzen Wilhelm lächelnd -- halten Hand -- 
  nehmen -- versetzen -- Bewegung -- glauben -- fassen -- schnell fahren Tasche -- reißen Dolch Blitz heraus -- fahren Spitze Schneide rasch Hand weg -- 
  ziehen schnell -- laufen Blut herunter -- 
  Mann scharf zeichnen -- merken sollen -- rufen wild Heiterkeit -- hastig Geschäftigkeit übergehen -- 
  Schnupftuch umwickelt Hand -- hervordringend Blut stillen -- 
  verzeih Halbwahnsinnig -- rufen -- lassen Tropfen Blut reuen -- 
  versöhnen -- selber -- 
  Knien Abbitte -- lassen Trost -- heilen -- 
  eilt Schranke -- holen Leinwand Gerät -- stillt Blut -- besehen Wunde sorgfältig -- 
  Schnitt Ballen Daumen -- teilen Lebenslinie -- laufen Finger -- 
  verbinden still -- nachdenklich Bedeutsamkeit kehren -- 
  fragen einigemal -- gute -- Freund verletzen -- 
  still -- erwidern -- Finger Mund legen -- still -- 
  Nachricht Buchbinder -- 
  Hrn. Kapellmeister Reichard komponiert Lied einheften -- linke aufschlagen -- Seite 7. Kennst Land -- etc -- 
  S. 265 -- 
  Sehnsucht kennen -- etc -- 
  J. F. Unger Berlin Oster Messe 1795 folgend Buch beigesetzt Preis -- 
  Betrachtung Frieden -- Herr Pitt Franzosen widmen -- 
  8. 8 gr -- Gedicke -- Dienst Fr. -- Erinnerung Büsching verdienst Berlinische Schulwesen -- 
  8. 8 gr -- 
  gesammelt Schulschrifte -- 2r Band -- 
  8. 18 gr -- Girtanner -- D. Chef -- -- historisch Nachricht französisch Revolution -- 10r Band -- gr -- 8. 1 thl -- 
  12 gr -- Goethe -- Schrift 4r Band -- 
  1 thl -- 8 gr -- -- Wilhelm Meister Lehrjahre -- 2r Band -- 
  1 thl -- 8 gr -- 
  Presse Johanni erscheinen -- 
  Dienst Girtanner anfangsgründe antiphlogistisch Chemie -- 
  verbessert vermehrt Ausgabe -- 
  Moritz Götterlehr -- 
  Auflage -- 