Wahlverwandtschaft -- 
  Roman Goethe -- 
  -- 
  tübingen -- J. G. Cottaischen Buchhandlung -- 1809 -- 
  Wahlverwandtschaft -- 
  -- 
  Kapitel -- 
  Eduard -- nennen reich Baron Mannesalter -- Eduard Baumschule schön Stunde Aprilnachmittag zubrachen -- frisch erhalten Pfropfreiser jung Stamm bringen -- 
  Geschäft vollenden -- legte Gerätschaft Futteral betrachtet Arbeit Vergnügen -- Gärtner Hinzutrat teilnehmend Fleiße Herr ergötzen -- 
  Frau sehen -- fragt Eduard -- anschicken -- 
  drüben Anlage -- versetzen Gärtner -- 
  Mooshütt fertig -- Felswand -- Schlos bauen -- 
  schön ew -- Gnade fallen -- 
  vortrefflich Anblick -- unten Dorf -- Hand Kirche -- Turmspitze fast hinwegsiehen -- Schloß Garten -- 
  -- versetzen Eduard -- schritt Leute arbeiten sehen -- 
  -- fahren Gärtner fort -- öffnen rechts Tal sehen reich Baumwiese heit Ferne -- 
  Stieg Fels hinauf hübsch anlegen -- 
  gnädig Frau verstehen -- arbeiten Vergnügen -- 
  Gehen -- Eduard -- ersuch -- warten -- 
  Sage -- wünsch Schöpfung sehen erfreuen -- 
  Gärtner entfernen eilig Eduard folgen -- 
  steigen Terrasse hinunter -- mustert -- Vorbeigehen -- Gewächshäuser Treibebeete -- an Wasser -- Steg Ort -- Pfad Anlage Arm teilen -- 
  -- Kirchhof ziemlich Felswand hinging -- lassen liegen Einzuschlag -- links anmutig Gebüsch sacht Hinaufwand -- zusammentrafen -- setzen Augenblick wohlangebracht Bank nieder -- Betrat Sodann eigentlich Stieg -- allerlei Treppe Absätze -- schmal -- steil Weg Mooshütt leiten -- 
  Türe empfangen Charlotte Gemahl lassen dergestalt niedersitzen -- Türe Fenster verschieden Bild -- Landschaft gleichsam Rahmen zeigen -- Blick übersehen -- 
  Freut -- Hoffnung Frühling reichlich beleben -- 
  erinnern -- setzen hinzu -- hütte scheinen eng -- 
  geräumig -- versetzen Charlotte -- 
  freilich -- Eduard -- Platz -- 
  -- versetzt Charlotte -- -- 
  groß Gesellschaft Stelle bereiten -- 
  ungestört -- Eduard -- ruhig heiter Sinn -- gestehen -- Herz -- vertrauen -- -- 
  anmerken -- versetzen Charlotte -- 
  gestehen -- fahren Eduard fort -- Postbot früh drängen -- entschließen müssen -- lang geschwiegen -- 
  -- fragt Charlotte freundlich entgegenkommend -- 
  betreffen unser Freund -- Hauptmann -- antworten Eduard -- 
  Kennst traurig Lage -- -- -- verschulder setzen -- 
  schmerzlich Manne Kenntnisse -- Talent Fertigkeit -- Tätigkeit sehen -- zurückhalten wünschen -- 
  nähmen -- 
  überleg Seite betrachten -- versetzen Charlotte -- 
  Ansicht bereit mitteilen -- entgegnen Eduard -- 
  letzter Brief herrschen still Ausdruck tief Missmut -- Bedürfnis fehlen -- 
  wissen beschränken notwendige sorgen -- drücken annehmen -- 
  Lebzeit wechselseitig schuldig -- berechnen -- Kredit Debet verhalten -- geschäftlos -- eigentlich Qual -- 
  vielfache -- ausbilden -- Anderer Nutzen täglich stündlich gebrauch -- Vergnügen -- Leidenschaft -- 
  Hand Schoß legen -- studieren -- Geschicklichkeit verschaffen -- brauchen -- voll Maß besitzen -- -- lieb Kind -- peinlich Lage -- Qual doppelt dreifach Einsamkeit empfinden -- 
  denken -- Charlotte -- sein verschieden Ort Anerbietung geschehen -- 
  -- seinetwill -- tätig Freund Freundinne schreiben -- soviel wissen -- bleiben Wirkung -- 
  -- versetzen Eduard -- verschieden Gelegenheit -- Anerbietung Qual -- Unruhe -- 
  Keines Verhältnis gemäß -- 
  wirken -- aufopfern -- -- Gesinnung -- Art -- unmöglich -- 
  Jemehr betrachten -- jemehr fühlen -- desto lebhaft Wunsch sehen -- 
  schön liebenswürdig -- versetzen Charlotte -- Freund Zustand Teilnahme bedenksen -- erlauben auffordern -- -- gedenken -- 
  tun -- entgegnen Eduard -- 
  Nähe Vorteil Annehmlichkeit versprechen -- 
  Aufwande reden -- Fall gering -- ziehen -- bedenk -- Gegenwart minde Unbequemlichkeit verursachen -- 
  Flügel Schlosses wohnen -- finden -- 
  leisten -- Angenehme Umgang -- Vorteil -- 
  längst Ausmessung Gegend wünschen -- besorg leiten -- 
  Absicht -- Gut künftig verwalten -- sobald gegenwärtig Pächter verflossen -- 
  bedenklich Unternehmen -- 
  vorkenntnissen verhelfen -- 
  fühlen -- Mann Art abgehen -- 
  Landleute Kenntnis -- Mitteilung konfus -- 
  studiert Stadt Akademie klar ordentlich -- fehlen unmittelbar Einsicht Sache -- 
  Freund beide versprechen -- entspringen hundert Verhältnis -- vorstellen -- Bezug wovon voraussehen -- 
  danken -- freundlich angehören -- sprich frei umständlich sagen sagen -- unterbrechen -- 
  -- versetzen Charlotte -- 
  Bemerkung anfangen -- 
  Mann denken Einzeln -- Gegenwärtige -- -- -- wirken berufen -- weiber hingegen Leben zusammenhängen -- gleich -- Schicksal -- Schicksal Familie -- Zusammenhäng knüpfen -- Zusammenhängende fordern -- 
  Laß Blick gegenwärtig -- vergangen Leben werfen -- eingestehen -- Berufung Hauptmann unser Vorsätz -- unser Planen -- unser Einrichtung zusammentriffen -- 
  frühst Verhältnis gedenken -- 
  lieben jung Leute herzlich -- trennen -- 
  -- Vater -- sättigend Begierde Besitzes -- ziemlich alt reich Frau verbinden -- -- -- sonderlich Aussicht -- wohlhabend -- geliebt geehrt Manne Hand reichen müssen -- 
  frei -- -- Mütterche Besitz Vermögen lassen -- -- -- Reise zurückkamst -- 
  finden -- 
  freut Erinnerung -- lieben Erinnerung -- ungestört leben -- 
  drangst Verbindung -- willigen -- 
  ungefähr -- Frau alt -- Mann -- 
  zuletzt versagen -- einzig Glück halten schienst -- 
  wolltest Unruhe -- Hof -- Militär -- Reise erleben hattest -- Seite erholen -- Besinnung -- Leben genießen -- -- 
  einzig Tochter Pension -- freilich Mannigfaltiger ausbilden -- ländlich Aufenthalt geschehen -- -- Ottilie -- lieb Nicht -- dorthin -- häuslich Gehilfin Anleitung herangewachsen -- 
  geschehen Einstimmung -- bloß leben -- bloß früh sehnlich gewünscht -- spät erlangt Glück ungestört genießen möchten -- 
  unser ländlich Aufenthalt antreten -- 
  übernehmen innerer -- Äußere -- 
  Einrichtung -- entgegen -- leben -- laß versuchen -- fern Weise ausreichen -- 
  Zusammenhängend -- sagen -- eigentlich eu Element -- versetzen Eduard -- freilich Folge reden hören -- Entschließe geben -- sollst heutig -- 
  Anlage -- unser -- Art -- bauen -- entwickeln -- 
  Garten leisten -- Park -- Einsiedler tun -- 
  -- versetzt Charlotte -- -- 
  hindernd -- fremdes Herein bringen -- 
  Bedenke -- Vorsätz -- Unterhaltung betreffen -- gewissermaßen beiderseitig Zusammensein beziehen -- 
  wolltest Tagebuch Reise ordentlich Folge mitteilen -- Gelegenheit gehörig Papier Ordnung bringen -- Teilnahme -- Beihilfe -- unschätzbar verworren Heft Blatt erfreulich zusammenstellen -- 
  versprechen Abschrift helfen -- dachen bequem -- artig -- gemütlich heimlich -- Welt -- sehen -- Erinnerung durchreisen -- 
  Anfang -- 
  abend Flot vornehmen -- begleitest Klavier -- Besuchen Nachbarschaft Nachbarschaft fehlen -- 
  wahrhaft fröhlich Sommer zusammenbauen -- Leben genießen denken -- 
  -- versetzen Eduard Stirn rieb -- -- lieben oll verständig wiederhohlst -- Gedanke beygingen -- Gegenwart Hauptmann stören -- vielmehr beschleunigen neu beleben -- 
  Wanderung mitmachen -- -- verschieden Sinn -- anmerken -- 
  benutzn -- Alsdann hübsch -- 
  Laß aufrichtig gestehen -- entgegnet Charlotte Ungeduld -- Vorhaben Gefühl widersprechen -- Ahnung weissagen -- 
  Weise wäret Frau unüberwindlich -- versetzen Eduard -- verständig -- widersprechen -- Liebevoll -- hingeben -- gefühlvoll -- weh -- ahnungsvoll -- erschricken -- 
  abergläubisch -- versetzt Charlotte -- geben dunkel Anregung -- insofern sein -- meistenteils unbewußt Erinnerung glücklich unglücklich Folge -- fremd Handlung erleben -- 
  bedeutend Zustande -- Dazwischenkunft -- 
  Freund sehen -- Geschwister -- Liebende -- Gatte -- Verhältnis zufällig gewählt Hinzutritt Person verändern -- Lage völlig umgekehrt -- 
  geschehen -- versetzen Eduard -- Mensch -- dunkel leben -- -- Erfahrung aufgeklärt bewußt -- 
  Bewußtsein -- Liebster -- entgegnet Charlotte -- hinlänglich Waffe -- manchmal gefährlich -- führen -- treten hervor -- übereilen -- 
  Gönn -- entscheiden -- 
  Sache stehen -- erwidern Eduard -- -- mehrere -- übereilen -- 
  Grund wechselsweise vorbringen -- Entschluß -- gut -- Gäben Anheim -- 
  wissen -- versetzt Charlotte -- zweifelhaft Fall gerne wettest würfelst -- ernsthaft Sache hingegen Frevel halten -- 
  Hauptmann schreiben -- rufen Eduard -- 
  hinsetzen -- 
  ruhig -- vernünftig -- tröstlich Brief -- Charlotte -- 
  soviel -- versetzen Eduard -- 
  Fall -- versetzen Charlotte -- notwendig freundlich schreiben schreiben -- 
  Kapitel -- 
  Eduard finden Zimmer -- Wiederholung Lebensschicksale Mund Charlotte -- Vergegenwärtigung beiderseitig Zustand -- Vorsätz -- lebhaft Gemüt angenehm aufgeregt -- 
  Nähe -- Gesellschaft glücklich fühlen -- freundlich -- teilnehmend -- ruhig hindeutend Brief Hauptmann ausdachen -- 
  Schreibtisch Brief Freund aufnehmen -- nochmals durchzulesen -- treten sogleich traurig Zustand trefflich Mann entgegen -- Empfindung -- peinigen -- wachen -- scheinen unmöglich -- Freund ängstlich Lage überlassen -- 
  versagen -- Eduard wohnen -- 
  Jugend einzig -- verzogen Kind reich Eltern -- seltsamen höchst vorteilhaft Heirat alt Frau bereden wissen -- Weise verzärteln -- Betrag groß Freigebigkeit erwidern suchen -- baldigen Tod Herr -- Reise unabhängig -- Abwechslung Veränderung mächtig -- Übertriebene wollend -- vielerlei wollend -- freimütig -- wohltätig -- brav -- tapf Fall - Welt Wunsch entgegenstehen -- 
  Sinn gehen -- Besitz Charlotte gelangen -- hartnäckig -- romanenhaft Treue zuletzt erwerben -- fühlen erstenmal widersprechen -- erstenmal hindern -- Jugendfreund heranziehen -- gleichsam abschließen -- 
  verdrießlich -- ungeduldig -- einigemal Feder legen nieder -- einig -- schreiben -- 
  wünsch Frau -- verlangen -- unruhig ruhig Brief schreiben -- unmöglich -- 
  natürlich -- Aufschub suchen -- 
  Wort bitten Freund Verzeihung -- schreiben -- umständlich schreiben -- versprechen nächstens Bedeutender -- beruhigend Blatt -- 
  Charlotte benutzen Tags Spaziergang Stelle Gelegenheit Gespräch anzuknüpfen -- Überzeugung -- Vorsatz sicher abstumpfen -- öfter durchsprichen -- 
  Eduard Wiederholung erwünscht -- 
  äußern Weise freundlich angenehm -- 
  -- empfänglich -- auflodert -- lebhaft begehren zudringlich -- Hartnäckigkeit ungeduldig -- Äußerung vollkommen Schonung dergestalt mildern -- liebenswürdig finden müssen -- beschwerlich finden -- 
  Weise bringen Charlotte heiterst Laune -- anmutig Gesprächswendung Fassung -- zuletzt ausrufen -- gewiß -- Ehemann versagen -- Liebhaber zugestehen -- 
  -- -- fahren fort -- sollst gewahr -- Wunsch -- freundlich Lebhaftigkeit womit ausdrücksen -- ungerühren -- unbewegen lassen -- 
  nötig Geständnis -- 
  verbergen -- 
  befind ähnlich Lage -- Gewalt antun -- zumute -- 
  hören -- Eduard -- merk -- Ehestande manchmal streiten -- erfahren -- 
  Sollst erfahren -- Charlotte -- Ottilie -- Hauptmann -- 
  Höchst ungern wissen lieb Kind Pension -- drückend Verhältnis befinden -- 
  Luciane -- Tochter -- Welt gebären -- Welt bilden -- Sprache -- Geschichtlich Kenntnis mitteilen -- Note Variation Blatt wegspieln -- lebhaft Natur glücklich Gedächtnis -- sagen -- vergessen Augenblick erinnern -- Freiheit Betragen -- Anmut Tanze -- schicklich Bequemlichkeit Gespräch auszeichnen -- angeboren herrschend Wesen Königin Kreises -- Vorsteherin Anstalt Gottheit ansehen -- Hand gedeihen -- Ehre -- zutrauen erwerben Zufluß jung Person verschaffen -- Seite Brief monatsberichte Hymn Vortrefflichkeit Kinde -- Prosa übersetzen wissen -- 
  -- schließlich Ottilie erwähnen -- Entschuldigung Entschuldigung -- schön heranwachsend Mädchen entwickeln -- Fähigkeit Fertigkeit zeigen wollen -- 
  hinzufügen gleichfalls Rätsel -- lieben Kind Charakter Mutter -- wertest Freundin -- gewahr -- entwickeln Tochter gewiß -- Erzieherin Aufseherin -- herrlich Geschöpf heraufbilden -- 
  unser Plan -- Lebensverhältnissen zupfen zerren -- neu Heranziehen -- tragen -- überwinden unangenehm Empfindung -- Tochter -- wissen -- arm Ottilie abhängen -- Vorteil übermütig bedienen -- Wohltat gewissermaßen vernichten -- 
  bilden -- Vorzug manchmal grausam Weise geltend -- 
  stehen -- Druck manchmal leiden müssen -- 
  Prüfung wachsen Ottilies Wert -- peinlich Zustand deutlich einsehen -- Mühe geben -- anderwärts unterzubringen -- 
  stündlich Antwort -- Alsdann zaudern -- 
  stehen -- Bester -- 
  siehst -- tragen beiderseits Sorge treu freundschaftlich Herz -- 
  Laß gemeinsam tragen -- gegeneinander aufheben -- 
  wunderlich Mensch -- Eduard lächelnd -- 
  Sorge -- Gegenwart verbannen -- glauben -- abtun -- 
  viele aufopfern -- Einzeln herzugeben -- Forderung -- selten wachsen -- 
  Mutter -- 
  Knabe Jüngling leben -- augenblicklich Besorgnis -- 
  verspätet Ausritt -- müssen Unglück begegnen -- durchnetzt Regenschauer -- Fieber gewiß -- 
  verrei -- entfernen -- scheinen anzugehören -- 
  Betrachte genau -- fahren fort -- handeln töricht unverantwortlich -- edelst Natur -- Herz nahe angehen -- Kummer Druck lassen -- Gefahr aussetzen -- 
  selbstsüchtig nennen -- nennen -- 
  Nimm Ottilie -- laß Hauptmann -- Gott Name Versuch -- 
  wagen -- Charlotte bedenklich -- Gefahr -- 
  Glaubst -- rätlich -- Hauptmann Ottilie Hausgenossen sehen -- Mann ungefähr deinen -- --- schmeichelhaft Auge sagen -- Mann liebefähig Liebe wert -- Mädchen Ottilies Vorzug -- -- 
  wissen -- versetzen Eduard -- Ottilie stellen -- 
  erkläre mir_es -- Neigung Mutter erben -- 
  Hübsch -- -- Erinnre -- Hauptmann aufmerksam -- zurückkamen Tant treffen -- 
  Hübsch -- schön Auge -- wissen -- mindest Eindruck -- 
  löblich -- Charlotte -- gegenwärtig -- jüng -- Gegenwart alt Freundin Reiz -- aufblühend versprechend Schönheit hinaussahst -- 
  gehören Art -- Leben teil -- 
  Charlotte -- aufrichtig sprechen scheinen -- verhehlen -- 
  nämlich Reise zurückkehrenden Eduard Ottilie absichtlich vorführen -- geliebt Pflegetochter Partie zuwenden -- 
  -- Bezug Eduard -- denken -- 
  Hauptmann anstiften -- Eduard aufmerksam -- -- früh Liebe Charlotte hartnäckig Sinn behalten -- weder rechts links -- glücklich Gefühl -- -- lebhaft gewünscht Reihe Ereignissen scheinbar versagt Teilhaft -- 
  stehen Ehepaar Begriff Anlage herunter Schlos -- Bedienter hastig entgegen steigen lachend Mund unten herauf vernehmen lassen -- 
  ew -- Gnade schnell herüber -- 
  Herr Mittler Schloßhof sprengen -- 
  zusammengeschrien -- aufsuchen -- fragen -- Not tun -- 
  Not tun -- rufen -- 
  hören -- geschwind -- geschwind -- 
  drollig Mann -- rufen Eduard -- -- Charlotte -- 
  Geschwind -- befehlen Bedienten -- sagen -- tun Not -- Not -- 
  absteigen -- 
  Versorgen Pferd -- führen Saal -- setzen Frühstück -- -- 
  Laß nächster Weg nehmen -- Frau -- schlagen Pfad Kirchhof -- vermeiden pflegen -- 
  verwundern -- finden -- Charlotte Gefühl sorgen -- 
  möglichst Schonung alt Denkmäl vergleichen ordnen wissen -- angenehm Raum erscheinen -- Auge Einbildungskraft verweilen -- 
  alt Stein Ehre gönnen -- 
  Mauer aufrichten -- einfügen angebracht -- hoch Sockel Kirche vermannigfaltigen zieren -- 
  Eduard fühlen sonderbar überraschen -- Pfort herein treten -- drücken Charlotte Hand Auge stehen Tran -- 
  närrisch Gast verscheuchen -- 
  Ruhe Schloß -- spornstreichs durch Dorf Kirchhoftor geriten -- still halten Freund entgegen rufen -- -- 
  Tut Not -- bleiben Mittage -- 
  Haltet -- 
  -- 
  bemühen -- rufen Eduard entgegen -- reiten vollends Herein -- ernsthaft Ort -- sehen schön Charlotte Trauer ausgeschmücken -- 
  Herein -- rufen Reiter -- kommen weder Pferd -- Wagen -- Fuß -- 
  ruh Frieden -- schaffen -- 
  Gefallen mir_es lassen -- Fuß voran hereinschleppen -- 
  ist_es Ernst -- 
  -- rufen Charlotte -- Ernst -- 
  erstemal -- Gatten Not Verwirrung -- woraus helfen wissen -- 
  sehen -- versetzen -- 
  ich_es glauben -- 
  Führt -- laß künftig stecken -- 
  Folgt geschwind -- Pferd Erholung -- 
  finden Saal -- essen aufgetragen -- Mittler erzählt heutig Tat Vorhaben -- 
  seltsam Mann früherhin Geistlicher rastlosen Tätigkeit Amt auszeichnen -- Streitigkeit -- sowohl häuslich -- nachbarlich -- einzeln Bewohner -- sodann Gemeinde mehrere Gutsbesitzer -- still schlichen wissen -- 
  Dienst -- Ehepaar scheiden lassen -- Landeskollegien Händel Prozeß dorth Behelliget -- 
  nötig Rechtskunde -- zeitig gewahr -- 
  werfen Studium -- fühlen geschicktest Advokat wachsen -- 
  Wirkungskreis dehnen wunderbar -- Begriff Residenz ziehen -- herein vollenden -- unten herauf beginnen -- ansehnlich Lotteriegewinn -- mäßig kauft -- verpachtet Mittelpunkt Wirksamkeit -- fest Vorsatz -- vielmehr alt Gewohnheit Neigung -- Haus verweilen -- schlichen helfen -- 
  Namensbedeutung abergläubisch -- behaupten -- Name Mittler nötigen -- seltsamst Bestimmung ergreifen -- 
  Nachtisch auftragen -- Gast Wirt ernstlich vermahnt -- Entdeckung zurückhalten -- Kaffee fortmüssen -- 
  Eheleute machen umständlich Bekenntnis -- Sinn Sache vernehmen -- verdrießlich Tisch Auffuhr -- an Fenster springen Pferd satteln befehlen -- 
  kennen -- rufen -- verstehen -- boshaft -- 
  Streit -- 
  Hilfe nötig -- 
  glauben -- Welt -- Rat geben -- 
  dümm Handwerk treiben -- 
  Rate tue lassen -- 
  Gerät -- freu Weisheit Glück -- laufen übel -- Hand -- 
  Übel -- wissen -- besseres -- Starblind -- 
  -- lachen -- spielen Blindekuh -- ertappen -- -- 
  Tut -- 
  einerlei -- 
  Nehmt Freund -- lassen weg -- einerlei -- 
  vernünftigst missling sehen -- Abgeschmackteste gelingen -- 
  Zerbrecht Kopf -- wenn_es Weise übel ablaufen -- zerbrechen -- 
  Schicken -- helfen -- 
  euer Diener -- 
  schwingen auf Pferd -- Kaffee abwarten -- 
  siehst -- Charlotte -- eigentlich fruchten -- nah verbunden Person Gleichgewicht stehen -- 
  gegenwärtig verworren ungewisser -- -- vorher -- 
  Gatte schwanken -- Brief Hauptmann Wechsel Eduard letzter ankommen -- 
  entschließen -- angeboten Stelle annehmen -- keineswegs gemäß -- 
  vornehmen reich Leute Langeweile teilen Zutrau setzen -- vertreiben -- 
  Eduard übersehen Verhältnis deutlich malen scharf -- 
  unser Freund Zustande wissen -- rufen -- grausam -- Charlotte -- 
  wunderlich Mann -- Mittler -- versetzen Charlotte -- -- 
  Unternehmung Wagestücke -- 
  sehen Mensch voraus -- 
  Verhältnis fruchtbar Glück Unglück -- Verdienst Schuld sonderlich zurechnen -- 
  fühlen stark lang widerstehen -- 
  Laß Versuch -- 
  einzig bitte -- 
  kurz ansehen -- 
  Erlaube -- tätig verwend -- Einfluß -- Verbindung eifrig benutzen aufreg -- Stelle verschaffen -- Weise Zufriedenheit gewähren -- 
  Eduard versichern Gattin anmutigst Weise lebhaftesen Dankbarkeit -- 
  eilt Freiem froh Gemüt Freund Vorschlag schriftlich -- 
  Charlotte müssen Nachschrift Beifall eigenhändig hinzufüg -- freundschaftlich Bitte vereinigen -- 
  schreiben gewandt Feder gefällig verbindlich -- Art -- gewöhnlich -- begegnen -- verunstalten Papier zuletzt Tintenfleck -- ärgerlich groß -- wegwischen -- 
  Eduard scherzen -- Platz fügen Nachschrift hinzu -- Freund sollen Zeichen Ungeduld sehen womit erwarten -- Eile womit Brief schreiben -- Eilfertigkeit Reise einrichten -- 
  Bote fort Eduard glauben Dankbarkeit überzeugend ausdrücken -- abermals bestehen -- 
  Charlotte sollen sogleich Ottilie Pension hohlen lassen -- 
  bitten Aufschub wissen Abend Eduard Lust musikalisch Unterhaltung aufzuregen -- 
  Charlotte spielt Klavier -- Eduard bequem flöte -- 
  Zeit Mühe geben -- Geduld -- Ausdauer verleihen -- Ausbildung Talentes gehören -- 
  führen Partie ungleich -- Stelle -- geschwind -- halten -- geläufig -- schwer Duett durchzubringen -- 
  Charlotte wissen darein finden -- halten lassen fortreißen -- versehen doppelt Pflicht gut Kapellmeister klug Hausfrau -- Maß erhalten wissen -- einzeln Passage Takt bleiben -- 
  Kapitel -- 
  Hauptmann -- 
  verständig Brief vorausgeschicken -- Charlotte völlig beruhigen -- 
  Deutlichkeit -- Klarheit Zustand -- Zustand Freund -- heitern fröhlich Aussicht -- 
  Unterhaltung Stunde -- Freund geschehen pflegt sehen -- lebhaft -- fast erschöpfend -- 
  Abend veranlaßn Charlotte Spaziergang Anlage -- 
  Hauptmann gefiel Gegend bemerken Schönheit Weg sichtbar genießbar -- 
  geübt Auge genügsam -- Wünschenswerte kennen -- -- öfters geschehen pflegen -- Person Ihrig herumführt -- übl Humor -- verlangt Umstand zuließen -- Vollkommeneres erinnern anderswo sehen -- 
  Mooshütt erreichen -- finden lustigste ausgeschmücken -- künstlich Blume Wintergrün -- schön Büschel natürlich Weizen anderer Feld Baumfrücht angebrachen -- Kunstsinn Anordnende Ehre gereichn -- 
  obschon Mann lieben -- Geburts¬ Namenstag fei -- verarg -- dreifach Fest weniger Kranz widmen -- 
  dreifacher -- rufen Eduard -- 
  gewiß -- versetzt Charlotte -- unser Freund Ankunft behandeln billig fest -- denken -- euer Namenstag -- 
  Otto -- 
  Freund reichen Hand Tisch -- 
  erinnerst -- Eduard -- jugendlich Freundschaftsstück -- 
  Kind hießen -- Pension zusammenlebt Irrung entstehen -- treten freiwillig hübsch lakonisch Name -- 
  wobei großmütig warst -- Hauptmann -- 
  erinneren -- Name Eduard gefiel -- angenehm Lippe ausgesprochen gut Klang -- 
  sitzen Tischchen -- Charlotte eifrig Ankunft Gast sprechen -- 
  Eduard Zufriedenheit Gattin Stunde erinnern -- enthielt sagen -- Platz -- 
  Waldhörner lassen Augenblick Schloß herüber vernehmen -- bejahen gleichsam bekräftigt gut Gesinnung Wunsch beisammen verweilend Freund -- 
  Stillschweigend hören -- jeder zurückkehren -- Glück schön Verbindung doppelt empfinden -- 
  Eduard unterbrechen Pause -- Aufstand Mooshütt hinaustrat -- 
  Laß -- Charlotte -- Freund völlig Höhe führen -- glauben -- beschränkt Tal Erbgut Aufenthalt -- Blick frei Brust erweitern -- 
  diesmal -- versetzt Charlotte -- alt -- beschwerlich Fußpfad erklimmen -- -- hoffen -- Stufe Steig nächstens Bequemer hinauf leiten -- 
  gelangt Fels -- Busch Gesträuch letzter Höhe -- Fläche -- fortlaufend fruchtbar Rücken bilden -- 
  Dorf Schloß hinterwärts sehen -- 
  Tiefe erblicken ausgebreitet Teiche -- drüben bewachsen Hügel -- hinzogen -- steil Fels -- senkrecht letzter Wasserspiegel entschieden begrenzt bedeutend Form Oberfläche abbildeten -- 
  Schlucht -- stark Bach Teiche zufiel -- liegen Mühle halb verstecken -- Umgebung freundlich Ruheplätzchen erscheinen -- 
  mannigfaltig wechseln Halbkreise übersah -- Tiefe Höhe -- Büsch Wald -- Grün Folge füllereichst Anblick versprechen -- 
  einzeln Baumgruppe halten Stelle Auge fest -- 
  zeichnen Füßen schauend Freund Maß Pappel Platane Rand mittlerer Teich vorteilhaft -- 
  stehen Wachstum -- frisch -- gesund -- empor Breite strebend -- 
  Eduard lenken Aufmerksamkeit Freund -- 
  -- rufen -- Jugend pflanzen -- 
  jung Stämmche -- retten -- Vater -- Anlage Schloßgarten -- mitten Sommer ausroden lassen -- 
  Zweifel Trieb dankbar hervortun -- 
  kehren zufrieden heit -- 
  Gaste Flügel Schlosses freundlich geräumig Quartier angewiesen -- Buch -- Papier Instrument aufstellen geordnet -- gewohnt Tätigkeit fortzufahren -- 
  Eduard lassen Ruhe -- führen überall herum -- Pferd Fuße -- Gegend -- -- wobei Wunsch mitteilen -- gut Kenntnis vorteilhafter Benutzung lang hegen -- 
  -- Hauptmann -- -- Gegend Magnetnadel aufnähmen -- 
  leicht heiter Geschäft -- groß Genauigkeit gewähren -- bleiben nützlich Anfang erfreulich -- Beihilfe leisten wissen gewiß -- fertig -- 
  Denkst genau Ausmessung -- lassen Rat finden -- 
  Hauptmann Art Aufnehmen üben -- 
  nötig Gerätschaft mitbringen fing sogleich -- 
  unterrichtet Eduard -- Jäger Bauer -- Geschäft behilflich -- 
  günstig -- Abend frühsen bringen Aufzeichn Schraffieren -- 
  schnell laviern illuminieren -- Eduard Besitzung deutlichsten -- Papier -- Schöpfung -- hervorgewachsen -- 
  glauben kennen lernen -- scheinen gehören -- 
  Gelegenheit Gegend -- Anlage sprechen -- Übersicht Stande bringen -- einzeln -- zufällig Eindrücke -- Natur herumversuchen -- 
  Frau deutlich -- Eduard -- 
  tue -- versetzt Hauptmann -- Überzeugung anderer seinigen durchkreuzen -- Erfahrung lehren -- Ansicht Mensch mannigfaltig -- -- vernünftigst Vorstellung -- Punkt versammeln können -- 
  tue -- rufen -- dürfen Irre -- 
  -- -- Liebhaberei Ding beschäftigen -- liegen -- tun -- tun -- 
  tasten Natur -- Vorliebe Plätzchen -- wagen Hindernis wegzuräumen -- kühn aufzuopfern -- voraus vorstellen entstehen -- probieren -- geraten -- missraten -- verändern -- verändern lassen -- lassen verändern -- bleiben zuletzt Stückwerk -- fällen anregen -- befriedigen -- 
  Gestehe aufrichtig -- Eduard -- Anlage zufrieden -- 
  Ausführung Gedanke erschöpfen -- -- erinnern -- 
  mühsam Gestein hinaufgequält qualten -- -- hinaufführt -- 
  weder -- schreiten gewiß Freiheit -- 
  Takt Schrittes Augenblick unterbrechen -- lassen einwenden -- 
  -- fragt Eduard -- 
  -- versetzen Hauptmann -- Felseneck -- unscheinbar -- Teil bestehen -- wegbrechen -- erlangt schön geschwungen Wendung Aufstieg überflüssig Stein -- Stelle heraufzumauern -- Weg schmal verkrüppeln -- 
  eng Vertrauen -- Irre verdrießlich -- 
  -- bestehen lassen -- 
  Geld Mühe aufwenden -- Mooshütt hinaufwärts Anhöhe mancherlei angenehme leisten -- 
  Weise Freund Gegenwärtig Beschäftigung -- fehlen lebhaft vergnüglich Erinnerung vergangen -- woran Charlotte nehmen pflegen -- 
  setzen -- nächster Arbeit tun sein -- Reisejournale Weise Vergangenheit hervorzurufen -- 
  Eduard Charlotte Stoff Unterhaltung -- Tadel Parkanlagen -- gerecht scheinen -- Herz fühlen -- 
  verschweigen Hauptmann vertraut -- Gattin zuletzt beschäftigen -- Mooshütt hinauf Anhöhe stüfch Pfädche empor arbeiten -- halten lang -- Umschweifen Einsicht -- 
  Charlotte stehen betreffen -- 
  geistreich -- schnell einsehen -- -- Getane widersprechen -- -- -- wünschenswert finden -- Getadelt einzeln Teil leiben -- widerstrebt Überzeugung -- verteidigen Schöpfung -- schelten Mann -- Weit gehen -- Scherz -- Unterhaltung Werk -- Kosten denken -- erweitet Plan ziehen -- 
  bewegen -- verletzen -- verdrießlich -- alte fahren lassen -- abweisen -- entschließen -- stellen sogleich Arbeit -- Sache bedenken reif lassen -- 
  tätig Unterhaltung vermissen -- indes Mann Geschäft gesellig betrieb Kunstgärt Glashäuser Eifer besorgen -- gewöhnlich ritterlich Übung fortsetzn -- Jag -- Pferd Kaufen -- Tausche -- Bereiten Einfahr -- fühlt Charlotte täglich einsam -- 
  führen Briefwechsel -- Hauptmann Wille -- lebhaft -- einsam Stunde -- 
  Desto angenehm unterhaltend Bericht -- Pensionsanstalt erhalten -- 
  weitläufig Brief Vorsteherin -- gewöhnlich Tochter Fortschritt Behag verbreiten -- kurz Nachschrift hinzufügen -- nebst Beilage Hand männlich Gehilfe Institut -- mitteilen -- 
  Nachschrift Vorsteherin -- 
  Ottilie -- gnädig -- eigentlich wiederholen -- vorig Bericht enthalten -- 
  wissen Schelt zufrieden -- 
  bescheiden gefällig -- Zurücktret -- Dienstbarkeit fallen -- 
  ew -- Gnade neulich Geld verschieden Zeug schicken -- 
  angreifen -- liegen -- unberührt -- 
  halten freilich Sache reinlich -- scheinen Sinn Kleid wechseln -- 
  Mäßigkeit essen Trinke loben -- 
  unser Tisch Überfluß -- sehen Kind schmackhafen gesund Speise essen -- 
  Bedacht Überzeugung aufgetragen vorlegen -- aufgegessen -- 
  Ottilie niemals bringen -- 
  Geschäft -- Lücke ausfüllen -- Dienerinne versäumen -- Speise Nachtisch übergehen -- 
  Betrachtung -- manchmal -- spät erfahren -- Kopfweh linker Seite -- vorübergehen -- schmerzlich bedeutend -- 
  soviel schön lieb Kind -- 
  Beilage Gehilfe -- 
  vortrefflich Vorsteherin lassen gewöhnlich Brief lesen -- Beobachtung Zöglinge Eltern vorgesetzter mitteilen -- 
  ew -- Gnade richten les doppelt Aufmerksamkeit -- doppelt Vergnügen -- 
  Tochter Glück wünschen -- glänzend Eigenschaft vereinigen -- wodurch Welt emporsteigen -- minder glücklich preisen -- Pflegetochter Kind bescheren -- -- Zufriedenheit anderer gewiß Glück gebären -- 
  Ottilie fast einzig Zögling -- verehren Vorsteherin einig -- 
  Verarge tätig Frau keineswegs -- verlangen -- Frucht Sorgfalt äußerlich deutlich sehen -- verschlossen Frucht -- kernhaft -- schön Leben entwickeln -- 
  Dergleichen gewiß Pflegetochter -- 
  unterricht sehen gleich Schritt -- langsam -- langsam vorwärts -- -- 
  Kind nötig -- Anfang anfangen -- gewiß -- 
  vorhergehenden folgen -- begreifen -- 
  stehen unfähig -- stöckisch faßlich Sache -- zusammenhängen -- 
  Mittelglieder finden deutlich -- schwer begreiflich -- 
  langsam Vorschreite bleiben Mitschülerin -- Fähigkeit vorwärts eilen -- -- Unzusammenhängende -- fassen -- behalten bequem anwenden -- 
  lernen -- vermögen beschleunigt Lehrvortrage -- Fall Stunde -- trefflich -- rasch ungeduldig Lehrer geben -- 
  Handschrift klagen -- Unfähigkeit Regel Grammatik fassen -- 
  Beschwerde nah untersuchen -- 
  -- schreiben langsam Steif -- zaghaft ungestalt -- 
  französisch Sprache -- Fach -- schrittweise mitteilen -- begreifen -- 
  freilich wunderbar -- wissen viele -- fragen -- scheinen wissen -- 
  Bemerkung schließen -- sagen -- lernen Erzog -- erziehen -- Schülerin -- künftig Lehrerin -- 
  ew -- Gnade sonderbar -- erzieh Lehrer loben glauben -- gleich Erkläre -- 
  ew -- Gnade gut Einsicht -- tief Menschen Weltkenntnis beschränken wohlgemeint Wort gute nehmen -- 
  überzeugen -- Kind Freude hoffen -- 
  empfehlen Gnade bitte Erlaubnis schreiben -- sobald glauben -- Brief Bedeutend angenehmes enthalten -- 
  Charlotte freut Blatt -- 
  Inhalt treffen nah Vorstellung -- Ottilie hegen -- lächelns enthalten -- Anteil Lehrer herzlich scheinen -- Einsicht Tugend Zögling hervorzubringen pflegen -- 
  ruhig -- vorurteilsfrei Denkweise lassen Verhältnis -- -- liegen -- Teilnahme verständigen Mann Ottilie halten wert -- 
  Leben genügsam einsehen lernen -- wahr Neigung schätzen -- Welt Gleichgültigkeit Abneigung eigentlich Haus -- 
  Kapitel -- 
  topographisch Charte -- Umgebung -- ziemlich Maßstabe -- charakteristisch faßlich federstrich Farbe darstellen -- Hauptmann trigonometrisch Messung sicher gründen wissen -- fertig -- 
  Schlaf -- tätig Mann -- bedürfen -- stets augenblicklich Zweck widmen jederzeit Abend tun -- 
  Laß -- Freund -- Übrig -- Gutsbeschreibung -- wozu genugsam Vorarbeit -- nachh Pachtanschlag anderer entwickeln -- 
  Laß Festsetze einrichten -- Trenne eigentlich Geschäft Leben -- 
  Geschäft verlangen Ernst Strenge -- Leben Willkür -- Geschäft reinst Folge -- Leben tun Inkonsequenz Not -- liebenswürdig erheiternd -- 
  sicher -- desto frei -- anstatt Vermischung Sichr freie weggerissen aufheben -- 
  Eduard fühlt Vorschlag leisen Vorwurf -- 
  Natur unordentlich -- niemals -- Papier Fächer abzuteilen -- 
  abzutun -- bloß Abhing -- scheiden -- Geschäft Beschäftigung -- Unterhaltung Zerstreuung genügsam absonderen -- 
  -- Freund Bemühung übernehmen -- Sonderung bewirken -- spalten -- 
  errichten Flügel Hauptmann Repositur Gegenwärtige -- Archiv -- schaffen Dokument -- Papier -- Nachricht -- verschieden Behältnisse -- Kammer -- schränken Kist herbei -- geschwindest Wust erfreulich Ordnung bringen -- liegen rubrizieren bezeichnet Fach -- 
  wünschen vollständig finden hoffen -- 
  hierbei alt Schreiber Hand -- -- Nacht -- Pulte -- Eduard unzufrieden -- 
  kennen -- Eduard Freund -- tätig brauchbar Mensch -- 
  -- versetzen Hauptmann -- tragen neue -- alt Bequemlichkeit vollenden -- leisten -- siehsen -- -- sobald stören -- vermögen -- 
  Brachten Freund Weise -- versäumt Abends Charlotte regelmäßig besuchen -- 
  Fand Gesellschaft benachbart Ort Güt -- öfter geschehen -- Gespräch -- Lesen -- meist Gegenstand widmen -- Wohlstand -- Vorteil Behag bürgerlichen Gesellschaft vermehren -- 
  Charlotte -- ohnehin gewohnt Gegenwart nutzen -- fühlen -- Mann zufrieden -- persönlich fördern -- 
  verschieden häuslich Anstalt -- längst wünschen -- einleiten -- Tätigkeit Hauptmann bewirken -- 
  Hausapotheke -- weniger Mittel bestehen -- bereichern -- Charlotte -- sowohl faßlich Buch Unterredung -- Stand setzen tätig hülfreich Wesen öfter wirksam Übung bringen -- 
  gewöhnlich demungeachtet überraschend Notfall durchdachen -- Rettung Ertrunken nötig anschaffen -- Nähe Teiche -- Gewässer Wasserwerk -- öfters Unfall Art vorkommen -- 
  Rubrik besorgt Hauptmann ausführlich -- Eduard entschlüpft Bemerkung -- Fall Leben Freund seltsamst Weise Epoche -- 
  schweigen traurig Erinnerung auszuweichen scheinen -- halten Eduard gleichfalls -- Charlotte -- unterrichten -- Äußerung Hinausging -- 
  vorsorglich Anstalt loben -- Abends Hauptmann -- Notwendigste -- tüchtig Mann -- handhaben wissen -- 
  hierzu bekannt Feldchirurg vorschlagen -- leidlich Bedingung -- vorzüglich Mann Fache -- Behandlung heftig inn Übel öfters Genug tun berühmt Arzt -- augenblicklich Hilfe -- Land meisten vermißen -- 
  sogleich verschrieb Gatt freuen -- Summe -- willkürlich Ausgabe übrig bleiben -- nötigsten verwend Anlaß finden -- 
  benutzt Charlotte Kenntnis -- Tätigkeit Hauptmann Sinn fing Gegenwart völlig zufried Folge beruhigen -- 
  bereiten gewöhnlich -- fragen -- leben -- suchen Schädlich -- Tödlich entfernen -- 
  Bleiglasur Töpferwar -- Grünspan kupfern Gefäß Sorge -- 
  lassen hierüber belehren -- natürlicherweise müssen Grundbegriff Physik Chemie zurückgehen -- 
  Zufällige willkommen Anlaß Unterhaltungen Eduard Neigung -- Gesellschaft vorzulesen -- 
  wohlklingend tief Stimme -- lebhaft gefühlt Rezitation dichterisch rednerisch Arbeit -- angenehm berühmt -- 
  Gegenstand beschäftigter -- Schrift woraus Vorlas vorzüglich Werk physisch -- chemisch technisch Inhalt -- 
  besonderer Eigenheit -- mehrere Mensch teilen -- -- unerträglich fallen -- Lesen Buch -- 
  früh -- Vorlese Gedicht -- Schauspiel -- Erzählung -- natürlich Folge lebhaft Absicht -- vorlesend Dichter -- Schauspieler -- erzählende -- überraschen -- Pause -- Erwartung erregen -- freilich beabsichtigt Wirkung zuwider -- wissentlich Auge vorspringen -- 
  pflegt Fall setzen -- Rücken -- 
  Vorsicht unnötig -- diesmal Erregung Gefühl -- Überraschung Einbildungskraft ansehen -- denken -- sonderlich nehmen -- 
  abends fallen -- nachlässig setzen -- Charlotte Buch -- 
  alt Ungeduld erwachen verweisen -- gewissermaßen unfreundlich -- 
  Unarte -- Gesellschaft lästig -- allemal abgewöhnen -- 
  vorlese -- mündlich vortrügen -- 
  geschrieben -- Gedruckt treten Stelle Sinne -- Herzens -- reden bemühen -- fensterchen Stirn -- Brust angebrachen -- -- Gedanke einzeln zählen -- Empfindung einzeln reichen -- vorher wissen -- hinaus -- 
  Buch sehen -- Stück gerissen -- 
  Charlotte -- Gewandtheit groß klein Zirkel beweisen -- unangenehm -- heftig -- lebhaft Äußerung beseitigen -- verlängernd Gespräch unterbrechen -- stockendes anzuregen wissen -- diesmal gut Gabe verlassen -- 
  Fehler gewiß verzeihen -- bekennen Augenblick begegnen -- 
  hört Verwandtschaft lesen -- denken verwandte -- Paar Vettern -- Augenblick schaffen -- 
  Aufmerksamkeit kehren Vorlesung -- hören leblose Ding Rede -- blicken Buch -- zurecht finden -- 
  Gleichnisrede -- verführen verwirrt -- Eduard -- 
  freilich Erde Mineralien handeln -- Mensch wahr Narziß -- bespiegeln überall -- legen Folie Welt -- 
  -- fahren Hauptmann fort -- 
  behandeln finden -- Weisheit Torheit -- Wille Willkür Tier -- Pflanze -- Element Götter -- 
  Möchtet -- versetzen Charlotte -- augenblicklich Interesse wegführen -- kürzlich belehren -- eigentlich Verwandtschaft meinen -- 
  gerne -- erwidern Hauptmann -- Charlotte wenden -- freilich vermögen -- lernen -- lesen -- 
  wissenschaftlich Welt denken -- neu Lehre passen -- wissen sagen -- 
  schlimm -- rufen Eduard -- Leben lernen -- 
  Vorfahre halten Unterricht -- Jugend empfangen -- umlern -- Mode -- 
  Frau -- Charlotte -- nehmen genau -- aufrichtig -- eigentlich Wortverstand -- 
  Gesellschaft lächerlich -- fremd -- Kunst-Wort falsch anwenden -- 
  wissen -- Sinn Ausdruck Gegenständen brauchen -- 
  wissenschaftlich zusammenhängen -- Gelehrt überlassen -- -- bemerken -- schwerlich jemals vereinigen -- 
  fangen -- schnellsen Sache -- fragt Eduard Pause Hauptmann -- bedenkend erwidern -- 
  erlauben -- Schein ausholen -- Platz -- 
  Aufmerksamkeit versichern -- Charlotte -- Arbeit Seite legen -- 
  beginnen Hauptmann -- 
  Naturwesen -- gewahr -- bemerken -- Bezug -- 
  klingen freilich wunderlich -- aussprechen ohnehin verstehen -- bekannte völlig verständigen -- Unbekannt fortschreiten -- 
  dächen -- fallen Eduard -- machen Sache Beispiel bequem -- 
  Stelle Wasser -- Öl -- Quecksilber -- Einigkeit -- Zusammenhäng Teil finden -- 
  Einung verlassen -- Gewalt sonstig Bestimmung -- 
  beseitigen -- treten -- 
  Frage -- Charlotte beistimmend -- 
  Regentropfe vereinigen schnell Strom -- 
  Kind spielen erstaunt Quecksilber -- Kügelche trennen zusammenlaufen lassen -- 
  -- fügen Hauptmann hinzu -- bedeutend Punkt flüchtig vorbeigehen erwähn -- nämlich völlig rein -- Flüssigkeit möglich Bezug entschieden Kugelgestalt auszeichnen -- 
  fallend Wassertropf -- Quecksilberkügelchen sprechen -- fallend geschmolzen Blei -- völlig erstarren -- unten Gestalt Kugel -- 
  Lasse voreilen -- Charlotte -- treffen -- hinwollen -- 
  jeder Bezug -- Verhältnis -- 
  Verschiedenheit Wesen verschieden -- fahren Eduard eilig fort -- 
  Freund alt bekannte begegnen -- schnell zusammentret -- Vereinige -- verändern -- Wein Wasser vermischen -- 
  fremd verharren mechanisch misch Reiben keineswegs verbinden -- Öl Wasser zusammengerütteln Augenblick sonderen -- 
  fehlen -- Charlotte -- sehen einfach Form Mensch -- -- erinnern Sozietäte -- leben -- 
  meister Ähnlichkeit seelenlosen Wesen Masse -- Welt stellen -- Ständ -- Berufsbestimmung -- Adel Stand -- Soldat Zivilist -- 
  -- versetzen Eduard -- Sitten Gesetz vereinbar -- chemisch Welt Mittelglieder -- dasjenig verbind -- abweist -- 
  verbinden -- fallen Hauptmann -- Öl Laugensalz Wasser -- 
  geschwind Vortrag -- Charlotte -- zeigen -- Schritt halten -- 
  Verwandtschaft gelangen -- 
  -- erwidern Hauptmann -- voll Kraft Bestimmtheit kennen lernen -- 
  Natur -- Zusammentreffo schnell ergreifen wechselseitig bestimmen -- nennen verwanden -- 
  Alkalien Säure -- -- obgleich entgegengesetzen -- entgegengesetzen -- entschiedenst such fassen -- modifizieren Körper bilden -- Verwandtschaft auffallend -- 
  gedenken Kalk -- Säure Neigung -- entschieden Vereinigungslust äußern -- 
  sobald chemisch Cabinet ankommen -- verschieden Versuch sehen lassen -- unterhaltend gut Begriff geben Wort -- Name Kunstausdrück -- 
  Lasse gestehen -- Charlotte -- wunderlich Wesen verwandt nennen -- sowohl Blutsverwandte -- vielmehr Geist Seelenverwandte -- 
  weis Mensch wahrhaft bedeutend Freundschaft entstehen -- 
  entgegengesetzt Eigenschaft inniger Vereinigung -- 
  abwarten -- geheimnisvoll Wirkung Auge bringen -- 
  --- Eduard wenden -- Vorlese stören -- unterrichten -- dein Vortrag Aufmerksamkeit vernehmen -- 
  aufrufen -- versetzen Eduard -- Kommst -- eigentlich verwickelt Fall interessantesen -- 
  lernen Grade Verwandtschaft -- nähern -- stark -- entfernteren -- gering Beziehung kennen -- Verwandtschaften interessant -- Scheidung bewirken -- 
  traurig Wort -- rufen Charlotte -- Welt hören -- Naturlehr -- 
  -- erwidern Eduard -- 
  sogar bezeichnend Ehrentitel Chemiker -- Scheidekünstler nennen -- 
  tun -- versetzen Charlotte -- tun -- 
  Vereinig groß Kunst -- größeres Verdienst -- 
  Einungskünstler Fache Welt willkommen -- 
  -- lassen -- Zug -- Paar Fall wissen -- 
  schließen -- Hauptmann -- dasjenig -- benennen besprechen -- 
  Z. B. Kalkstein nennen rein Kalkerde -- innig zart Säur verbinden -- Luftform -- 
  Bringen Stück Steines verdünnt Schwefelsäure -- ergreifen Kalk erscheinen Gips -- zart luftig Säur hingegen entfliehen -- 
  Trennung -- Zusammensetzung entstehen glauben nunmehr berechtigen -- sogar Wort Wahlverwandtschaft anwenden -- aussehen Verhältnis vorziehen -- einer erwählt -- 
  verzeihen -- Charlotte -- Naturforscher verzeihen -- niemals Wahl -- eher Naturnotwendigkeit erblicken -- -- 
  Sache Gelegenheit -- 
  Gelegenheit Verhältnis Dieb -- Naturkörpern Rede -- scheinen Wahl bloß Hände Chemiker liegen -- Wesen zusammenbringt -- 
  beisammen -- gnade Gott -- 
  gegenwärtig Fall dauern arm Luftsäur -- Unendliche herumtreiben -- 
  -- versetzen Hauptmann -- Wasser verbind Mineralquell Gesunde Kranken Erquickung dienen -- 
  Gips reden -- Charlotte -- fertig -- Körper -- versorgen -- anstatt ausgetrieben Wesen Not unterkommen -- 
  müssen irren -- Eduard lächelnd -- stecken Tücke deinen Rede -- 
  Gestehe Schalkheit -- 
  deinen Auge kalk -- Hauptmann -- Schwefelsäure ergreifen -- anmutig Gesellschaft entziehen refraktären Gips verwandeln -- 
  Gewissen -- versetzt Charlotte -- Betrachtung -- Sorge -- 
  Gleichnisrede artig unterhaltend -- spielen Ähnlichkeiten -- 
  Mensch Stufe Element erhöhen -- schön Wort Wahl Wahlverwandtschaft freigebig -- tun -- zurückzukehr Wert Ausdruck Anlaß bedenken -- 
  Fall -- innig unauflöslich scheinend Verbindung zwei Wesen -- gelegentlich Zugesellung -- aufheben -- einer schön verbunden lose Weite hinausgetrieben -- 
  Chemiker galant -- Eduard -- gesellen -- keiner leer ausgehen -- 
  -- versetzt Hauptmann -- Fall bedeutendsn merkwürdigsen -- anziehen -- Verwandtsein -- Verlasse -- Vereinig gleichsam über Kreuz -- darstellen -- -- verbunden Wesen Berührung bringen -- bisherig Vereinigung verlassen auf verbinden -- 
  Fahrenlassen Ergreif -- Flieh Such -- glauben hoch Bestimmung sehen -- trauen Wesen Art wählen -- halten Kunstwort Wahlverwandtschaft vollkommen rechtfertigen -- 
  Beschreibe Fall -- Charlotte -- 
  dergleichen -- versetzen Hauptmann -- Wort abtun -- 
  -- sobald Versuch zeigen -- anschaulich Angenehmer -- 
  müssen schrecklich Kunstwort hinhalten -- Vorstellung gäben -- 
  totscheinend Tätigkeit innerlich bereiten Wesen wirkend Auge sehen -- Teilnahme schauen -- suchen -- anziehen -- ergreifen -- zerstören -- verschlingen -- aufzehren sodann innigst Verbindung erneut -- neu -- unerwartet Gestalt hervortreen -- traut ewig Leben -- Sinn Verstand -- Sinn genügend fühlen -- beobachten -- Vernunft hinlänglich -- fassen -- 
  leugnen -- Eduard -- seltsam Kunstwörter demjenigen sinnlich anschauen -- Begriff versöhnen -- beschwerlich -- lächerlich -- 
  können Buchstabe einstweilen Verhältnis ausdrücken -- wovon Rede -- 
  glauben -- pedantisch aussehen -- versetzen Hauptmann -- Zeichensprach kürzlich zusammenfassen -- 
  denken -- -- innig verbinden -- Gewalt trennen -- denken C -- D verhalten -- bringen Paar Berührung -- D -- C B werfen -- sagen -- verlassen -- verbinden -- 
  -- fallen Eduard -- Auge sehen -- Formel Gleichnisrede betrachten -- woraus Lehre unmittelbar Gebrauch ziehen -- 
  Stellst -- Charlotte -- -- -- eigentlich hängen Folge -- -- -- 
  C deutlich Kapitän -- diesmal einigermaßen entziehen -- 
  billig -- unbestimmte entweichen sollst -- D sorgen -- Frage liebenswürdig Dämch Ottilie -- Annäherung lang verteidigen -- 
  -- versetzt Charlotte -- -- scheinen -- unser Fall passen -- halt Glück -- völlig zusammentreffen -- Natur- Wahlverwandtschaft vertraulich Mitteilung beschleunigen -- 
  gestehen -- Nachmittag entschließen -- Ottilie berufen -- 
  bisherig treu Beschließerin Haushälterin abziehen -- heiraten -- 
  Seite meinetwillen -- Ottilies Wille bestimmen -- vorlesen -- 
  Blatt sehen -- freilich Inhalt -- 
  lies -- lies -- 
  Wort ziehen Brief hervor reicht Eduard -- 
  Kapitel -- 
  Brief Vorsteherinn -- ew -- Gnade verzeihen -- fassen -- 
  Vollendeter öffentlich Prüfung unser Zögling leisten -- sämtlicher Eltern vorgesetzter Verlauf melden -- -- Wenig sagen -- 
  Fräulein Tochter Sinn beweisen -- 
  beiliegenden Zeugnis -- Brief -- Beschreibung Preis enthalten -- Vergnügen ausdrücken glücklich gelingen empfinden -- Beruhigung -- Freude gereichen -- 
  meinig einigermaßen mindern -- voraussehen -- Ursache vorgeschritten Frauenzimmer halten -- 
  empfehlen Gnade nehmen Freiheit nächstens Gedanke vorteilhaftesten halten -- eröffnen -- 
  Ottilie schreiben freundlich Gehilfe -- 
  Brief Gehilfe -- 
  Ottilie lassen ehrwürdig Vorsteherin schreiben -- teils -- Art denken -- peinlich dasjenig Melde melden -- teils Entschuldigung bedürfen -- Mund legen -- 
  allzuwohl wissen -- Ottilie äußerer Stande -- liegen vermögen -- öffentlich Prüfung einigermaßen bange -- Vorbereitung -- -- gewöhnlich Weise -- Ottilie Schein vorbereiten -- 
  Ausgang Sorge rechtfertigen -- Preis erhalten Zeugnis empfangen -- 
  sagen -- 
  schreiben wohlgeformt Buchstabe -- frei Zug -- Rechn schnell -- schwierig Aufgabe -- lösen -- Untersuchung -- 
  Französischen überparlierten überexponiern -- Geschichte Name Jahrzahlen Hand -- Geographie vermissen Aufmerksamkeit politisch Einteilung -- 
  musikalisch Vortrag weniger bescheiden Melodi finden weder Ruhe -- 
  Zeichne gewiß Preis tragen -- Umriß rein Ausführung vieler Sorgfalt geistreich -- 
  unternehmen fertig -- 
  Schülerinn abtreten -- Prüfende Rat halten Lehrer Wort gönnen -- merken -- Ottilie -- geschehen -- Missbilligung Gleichgültigkeit sprechen -- 
  hoffen offen Darstellung Art -- Gunst erregen -- wagen doppelt Eifer -- Überzeugung sprechen -- sodann jung traurig Fall befinden -- 
  hört Aufmerksamkeit -- endigen -- vorsitzend Prüfend freundlich lakonisch -- 
  Fähigkeit voraussetzen -- Fertigkeit -- 
  Zweck Erziehung -- lauten deutlich Absicht Eltern vorgesetzter -- still halbbewußter Kind -- 
  Gegenstand Prüfung -- wobei Lehrer Schüler beurteilen -- 
  vernehmen -- schöpfen Hoffnung Kind -- lobenswürdig -- Fähigkeit Schülerin genau geben -- 
  Verwandel über Fertigkeit -- begünstigt Schülerin Beifall mangeln -- 
  hierauf folgen ergeben -- Übleres befürchten -- Zutrug -- 
  Vorsteherin -- Hirte einer schäfchen verlieren -- Fall -- ungeschmückt sehen -- -- Herr entfernen -- Unwille bergen Ottilie -- ruhig -- Preis freuen -- Fenster stehen -- sagen -- um Himmelswille -- dumm aussehen -- -- 
  Ottilie versetzen gelassen -- verzeih -- lieb Mutter -- Kopfweh ziemlich stark -- 
  wissen -- versetzt teilnehmend Frau kehren verdrießlich -- 
  -- 
  wissen -- Ottilie verändern Gesicht -- sehen -- Hand Schlafe bewegen -- 
  -- 
  Fräulein Tochter -- gnädig Frau -- lebhaft freimütig -- Gefühl heutig Triumph ausgelassen übermütig -- 
  springen Preis Zeugnissen Zimmer herum -- schüttelen Ottilie Gesicht -- 
  fahren -- rufen -- 
  gelassen antwortet Ottilie -- 
  letzter Prüfungstag -- 
  letzter bleiben -- rufen Fräulein springen hinweg -- 
  Ottilie scheinen gelassen -- -- 
  innerer unangenehm lebhaft Bewegung -- widerstehen -- zeigen ungleich Farbe Gesicht -- 
  linker Wange Augenblick rot -- bleich -- 
  Zeichen Teilnehmung zurückhalten -- 
  führen Vorsteherin Seite -- sprechen ernsthaft Sache -- 
  trefflich Frau erkennen Fehler -- 
  beriet -- besprach -- weitläufig -- ew -- Gnade unser Beschluß bitte vortragen -- Ottilie nehmen -- 
  Grund entfalten -- 
  Bestimme hierzu -- sag Behandlung gut Kind -- 
  Verläßt Fräulein Tochter -- vermuten stehen -- sehen Ottilie Freude zurückkehren -- 
  eins -- Folge vergessen -- 
  sehen -- Ottilie verlangen -- dringend bitten -- 
  Fall -- wiewohl selten -- ablehnen suchen fordern -- 
  tun Gebärde -- Sinn fassen unwiderstehlich -- 
  drücken flach Hand -- Höhe heben -- führen Brust -- vorwärts neigen dringend Fordernde Blick ansehen -- abstehen verlangen wünschen -- 
  sehen jemals Gebärde -- gnädig Frau -- Behandlung wahrscheinlich -- gedenken schon Ottilie -- 
  --- Eduard Brief vorgelesen -- lächeln kopfschütteln -- 
  Bemerkung Person Lage Sache fehlen -- 
  -- rufen Eduard -- 
  entscheiden -- -- 
  sorgen -- Liebe -- unser Vorschlag hervorrücken -- 
  höchst nötig -- Hauptmann Flügel hinüber ziehen -- 
  sowohl Abends Morgens arbeiten -- 
  Erhältst Ottilie Seite schönsn Raum -- 
  Charlotte lassen gefallen -- Eduard schildern künftig Lebensart -- 
  rufen -- 
  zuvorkommend Nicht -- Kopfweh linker Seite -- manchmal -- 
  Treffen sitzen gegeneinander -- Ellbogen -- linker stützen -- Kopf verschieden Seite Hand legen -- Paar artig Gegenbilder geben -- 
  Hauptmann gefährlich finden -- Eduard hingegen rufen -- nehmen -- Freund -- D -- 
  B anfangen -- C entrissen -- 
  -- dächen -- versetzt Charlotte -- verstünden -- 
  freilich -- rufen Eduard -- 
  kehren -- O -- rufen -- Aufsprang Charlotte fest Brust drücken -- 
  Kapitel -- 
  Wagen Ottilie bringen anfahren -- 
  Charlotte entgegen -- lieb Kind eilt nähern -- werfen Fuß umfaßt Knie -- 
  wozu Demütigung -- Charlotte -- einigermaßen verlegen aufheben -- 
  demütig meinen -- versetzen Ottilie -- vorig Stellung bleiben -- 
  erinnern -- hoch reichen Knie Liebe gewiß -- 
  stehen Charlotte umarmen herzlich -- 
  Mann vorstellen besonderer Achtung Gast behandeln -- 
  Schönheit überall willkommen Gast -- 
  scheinen aufmerksam Gespräch -- nehmen -- 
  Eduard Charlotte -- 
  angenehm unterhaltend Mädchen -- 
  Unterhaltend -- versetzt Charlotte Lächeln -- Mund auftun -- 
  -- erwidert Eduard -- besinnen scheinen -- 
  wunderbar -- 
  Charlotte Ankömmling Winke -- Hausgeschaft halten -- 
  Ottilie schnell Ordnung eingesehen -- -- empfinden -- 
  -- insbesondere besorgen -- Begriff -- 
  geschehen pünktlich -- 
  wissen anordnen -- befehlen scheinen -- säumen -- verrichtet Geschäft -- 
  sobald gewahr -- übrig bleiben -- bitten Charlotte Stunde einteilen -- genau beobachten -- 
  arbeiten Vorgesetzt Art -- Charlotte Gehilfe unterrichten -- 
  lassen gewähren -- 
  zuweilen sucht Charlotte anzuregen -- 
  schieben manchmal abgeschrieben Feder -- frei Zug Handschrift leiten -- scharf geschnitten -- 
  Frauenzimmer untereinander festgesetzen -- französisch reden sein -- Charlotte beharren -- Ottilie gesprächig fremd Sprache -- Übung Pflicht -- 
  scheinen -- 
  ergötzt Charlotte zufällig -- genau liebevoll Schilderung Pensionsanstalt -- 
  Ottilie lieb Gesellschafterin -- hoffen dereinst zuverlässig Freundin finden -- 
  Charlotte indes alt Papier -- Ottilie bezog -- Erinnerung bringen -- Vorsteherin -- Gehilfe Kind urteilen -- Persönlichkeit vergleichen -- 
  Charlotte Meinung -- können geschwind Charakter Mensch -- leben -- wissen -- erwarten -- bilden lassen -- allemal zugestehen verzeihen -- 
  finden Untersuchung neu -- bekannte bedeutend auffallend -- 
  z. B. ottilies Mäßigkeit essen Trinken Sorge -- 
  nächster Frau beschäftigen Anzug -- 
  Charlotte verlangen Ottilie -- sollen Kleid reich aussuchen erscheinen -- 
  sogleich schneiden tätig Kind geschenkt Stoff wissen -- gering Beihilfe anderer -- schnell höchst zierlich anpassen -- 
  -- modisch Gewänder erhöht Gestalt -- 
  Angenehme Person Hülle verbreiten -- glauben neu anmutig sehen -- Eigenschaft Umgebung mitteilen -- 
  Mann -- Anfang -- Name nennen -- wahr Augentrost -- 
  Smaragd herrlich Farbe Gesicht tun -- sogar Heilkraft edel Sinn ausüben -- wirken menschlich Schönheit groß Gewalt äußerer innerer Sinn -- 
  erblicken -- üble anwehen -- fühlen Welt Übereinstimmung -- 
  weis Gesellschaft Ottilies Ankunft gewinnen -- 
  Freund halten regelmäßig Stunde -- Minute Zusammenkunft -- 
  lassen weder essen -- Tee -- Spaziergang lang billig warten -- 
  eilen -- Abends -- sobald Tisch weg -- 
  Charlotte bemerken lassen unbeobachten -- 
  suchen erforschen -- hierzu Anlaß geben -- Unterschied bemerken -- 
  zeigen gesellig -- 
  Unterhaltung scheinen Bedenken -- Ottilies Teilnahme erregen geeignet -- Einsicht -- übrig Kenntnis gemäß -- 
  Lesen Erzähl halten inne -- wiederkommen -- 
  mild Mitteilender -- 
  Erwiderung wachsen Dienstbeflissenheit Ottilies -- 
  Haus -- Mensch -- Verhältnis kennen lernen -- desto lebhaft greifen -- desto schnell verstehen Blick -- Bewegung -- halb Wort -- laut -- 
  ruhig Aufmerksamkeit bleiben -- gelassen Regsamkeit -- 
  Sitz -- aufstehen -- -- -- Hole -- Bring -- Niedersitz -- Schein Unruhe ewig Wechsel -- ewig angenehm Bewegung -- 
  -- hören -- leise treten -- 
  anständig Dienstfertigkeit Ottilies Charlotte Freude -- 
  einzig angemessen vorkommen -- verbergen Ottilie -- 
  gehören -- Tag -- lobenswürdig Aufmerksamkeit -- schnell bücken -- Hand fallen lassen -- eilig aufheben suchen -- 
  bekennen gleichsam dienstpflichtig -- groß Welt bedenken -- Ergebenheit bezeigen -- 
  Frau Gesetz vorschreiben -- 
  jung -- 
  hoch Ältere Schuldigkeit -- dein gleich Artigkeit -- Jüngere Niedere zeigen menschlich -- Frauenzimmer geziemen -- Mann Weise ergeben dienstbar bezeigen -- 
  abgewöhnen suchen -- versetzen Ottilie -- 
  indessen Unschicklichkeit vergeben -- sagen -- kommen -- 
  Geschichte lehren -- behalten -- gesollt -- 
  wissen wozu brauchen -- 
  einzeln Begebenheit eindrücklich -- folgend -- 
  Carl England sogenannter Richter stehen -- fallen golden Knopf Stöckchen tragen herunter -- 
  Gewohnt -- Gelegenheit bemühen -- scheinen umzuseh Erwart -- diesmal Dienst erzeigen -- 
  regen -- bückt -- Knopf aufheben -- 
  schmerzlich -- wissen -- Augenblick Hand fallen sehen -- bücken -- 
  freilich schicklich -- -- fahren lächelnd fort -- jederzeit Geschichte erzählen -- künftig zurückhalten -- 
  indessen gut Anstalt -- Freund berufen fühlen -- ununterbrochen Fortgang -- 
  täglich finden Anlaß bedenken Unternehmen -- 
  Tag Dorf gehen -- bemerkn mißfällig -- Ordnung Reinlichkeit Dorf zurückstehen -- Bewohner Kostbarkeit Raum beide hinweisen -- 
  erinnerst -- Hauptmann -- Reise Schweiz Wunsch äußern -- ländlich sogenannter Parkanlage eigentlich verschönern -- gelegen Dorf -- Schweizer-Bauart -- Schweizer- Ordnung Sauberkeit -- Benutzung befördern -- einrichteen -- 
  z. B. -- versetzen Eduard -- gehen -- 
  Schloßberg verlaufen vorspringend Winkel herunter -- Dorf ziemlich regelmäßig Halbzirkel bauen -- fließen Bach -- Anschwelle Stein -- Pfähle -- Balken -- Nachbar sodann Plank verwahren -- fördern -- vielmehr übrig Schaden Nachteil bringen -- 
  Weg ungeschickt Bewegung herauf -- herab -- durch Wasser -- Stein -- 
  Leute Hand anlegen -- Zuschuß nötig -- Mauer Halbkreis aufführen -- Weg Haus erhöhen -- schön Raum herstellen -- Reinlichkeit Platz geben gehend Anstalt unzulänglich Sorge verbannen -- 
  Laß versuchen -- Hauptmann -- Lage Auge überlief schnell beurteilen -- 
  Bürger Bauer -- geradezu befehlen -- versetzen Eduard -- 
  Unrecht -- erwidern Hauptmann -- 
  machen dergleich Geschäft Leben Verdruß -- 
  schwer -- Mensch abwag -- aufopfern gewinnen -- 
  schwer -- Zweck verschmähen -- 
  verwechseln Zweck -- erfreuen -- Auge behalten -- 
  jeder Übel Stelle geheilen -- Vorschein -- bekümmern Punkt -- eigentlich Ursprung nehmen -- woher wirken -- 
  schwer Rat pflegen -- Menge -- Täglich verständig -- selten sehen -- 
  -- gemeinsam Anstalt gewinnen -- verlieren -- Vergleich ausrichten -- 
  eigentlich gemeinsam unumschränkt Majestätsrecht fördern -- 
  stehen sprechen -- bettelt Mensch -- Frech bedürftig aussehen -- 
  Eduard -- ungern unterbrechen beunruhigt -- Schalt -- einigemal vergebens gelassen abweisen -- Kerl murrend -- gegenscheltend -- Schritt entfernen -- Bettler trotzen -- Almose versagen -- beleidigen dürfen -- Schutz Gott Obrigkeit stehen -- Eduard Fassung -- 
  Hauptmann -- begütigen -- -- laß Vorfall Aufforderung annehmen -- ländlich Polizei hierüber erstrecken -- 
  Almose geben -- tun -- -- Haus -- 
  mäßig gleichförmig -- Wohltun -- 
  allzureichlich Gabe locken Bettler herbei -- anstatt abzufertigen -- Reise -- Vorbeifliege -- arme Straße Gestalt zufällig Glück erscheinen überraschend Gabe zuwerfen -- 
  Lage Dorfes -- Schloß -- Anstalt -- nachdenken -- 
  Dorfes liegen Wirtshaus -- wohnen Paar alt Leute -- Ort mußt Geldsumme niederlegen -- 
  Dorf hereingehend -- hinausgehend erhalten -- Haus stehen Schloß führen -- hinaufwend -- Stelle weisen -- 
  Komm -- Eduard -- abmachen -- Genauere nachholen -- 
  gehen Wirt alt Paar -- Sache abtun -- 
  wissen -- Eduard -- Schloßberg hinaufstiegen -- Welt ankommen gescheit Einfall fest Entschluß -- 
  Parkanlagen Frau beurteilen -- Wink Besseren geben -- -- leugnen -- sogleich mitteilen -- 
  vermuten -- versetzen Hauptmann -- billigen -- 
  Irre -- lassen liegen trutzt einzig Sache -- 
  vermeiden reden Mooshütt laden -- Ottilie Zwischenstunde hinaufgehen -- 
  -- versetzen Eduard -- abschrecken lassen -- 
  Gutem überzeugen -- geschehen -- Ruhe tun sehen -- 
  klug einleiten -- 
  Laß englisch Parkbeschreibung Kupfer Abendunterhaltung vornehmen -- nachher Guts-Charte -- 
  problematisch Scherz behandeln -- Ernst finden -- 
  Verabredung Buch aufschlagen -- worin jedesmal Grundriß Gegend landschaftlich Ansicht roh Naturzustande zeichnen -- sodann Blatt Veränderung vorstellen finden -- Kunst vornehmen -- bestehend Nutzen steigern -- 
  Hiervon Übergang Besitzung -- Umgebung -- ausbilden -- -- 
  Hauptmann entworfen Charte Grund legen nunmehr angenehm Beschäftigung -- Vorstellung -- Charlotte Sache anfangen -- losreißen -- 
  erfinden leichtern Aufgang Höhe -- oberwärts Abhange angenehm Hölzchen Lustgebäude aufführen -- Bezug auf Schloß -- Schloßfenster übersehen -- dorth Schloß Garten bestreichen -- 
  Hauptmann überlegen messen -- bringen Dorfweg -- Mauer Bache -- Ausfüllung Sprache -- 
  gewinnen -- -- bequem Weg Anhöhe hinauf führen -- soviel Stein -- Mauer bedürfen -- 
  sobald einer greifen -- beide Wohlfeiler geschwind bewerkstelligen -- 
  -- Charlotte -- Sorge -- 
  notwendig Bestimmt aussetzen -- wissen -- wieviel Anlage erforderlich -- teilen -- Woche -- Monat -- 
  Kasse Beschluß -- zahlen Zettel -- Rechnung führen -- 
  scheinst sonderlich vertrauen -- Eduard -- 
  willkürlich Ding -- versetzt Charlotte -- 
  Willkür wissen beherrschen -- 
  Einrichtung -- Arbeit rasch anfangen -- Hauptmann gegenwärtig -- Charlotte nunmehr fast täglich Zeug ernst bestimmt Sinn -- 
  lernen nah kennen -- -- wirken Stande bringen -- 
  Geschäft Tanze -- Person gleich Schritt halten -- unentbehrlich -- wechselseitig Wohlwollen notwendig entspringen -- Charlotte Hauptmann -- nah kennen lernen -- wohlwollt -- sicher Beweis -- schön Ruheplatz -- Anlage ausgesucht verziern -- Plane Entgegenstand -- lassen zerstören lassen -- minde unangenehm Empfindung -- 
  Kapitel -- 
  Charlotte Hauptmann gemeinsam Beschäftigung finden -- Folge -- Eduard Ottilie gesellen -- 
  sprechen ohnehin still freundlich Neigung Herzen -- 
  dienstfertig zuvorkommend -- meister -- Selbstlieb scheinen -- 
  Frage -- 
  Speise lieben -- genau bemerken -- wieviel Zucker Tee nehmen pflegen -- dergleichen -- Entging -- 
  sorgfältig -- Zugluft abzuwehren -- übertrieben Empfindlichkeit zeigen -- Frau -- lustig -- manchmal Widerspruch geraten -- 
  wissen Baum Blumengart Bescheid -- 
  wünschen suchen befördern -- ungeduldig -- verhüten -- Dergestalt -- kurz freundlich Schutzgeist unentbehrlich anfing Abwesenheit peinlich empfinden -- 
  hierzu -- gesprächig Offener scheinen sobald treffen -- 
  Eduard zunehmend Kindlich behalten -- Jugend ottilies zusagen -- 
  erinnern früh Zeit -- sehen -- steigen Erinnerung Epochen Neigung Eduard Charlotte -- 
  Ottilie schön Hofpaar erinnern -- Eduard Gedächtnis Jugend absprach -- behaupten Fall vollkommen gegenwärtig -- -- Hereintret -- Charlotte Schoß verstecken -- Furcht -- kindisch Überraschung -- 
  setzen -- 
  lebhaft Eindruck -- fallen -- 
  Verhältnissen Geschäft -- Freund vornehmen -- gewissermaßen stocken geraten -- nötig finden Übersicht verschaffen -- Aufsatz entwerfen -- Brief schreiben -- 
  bestellt Kanzlei -- alt Kopist müßig finden -- 
  gehen Arbeit geben -- bemerken -- Aufbürdet -- verrichten gewohnen -- 
  Aufsatz Hauptmann -- Brief Eduard gelingen -- 
  quält Konzipier Umschreibe -- Eduard -- wenigster -- fragen -- 
  zeigen -- Hauptmann vergessen chronometrisch Secund aufzuzieh -- erstemal -- scheinen -- empfinden -- ahnden -- anfangen gleichgültig -- 
  Mann einigermaßen Geschäftigkeit nachließen -- wachsen vielmehr Tätigkeit Frau -- 
  nehmen gewöhnlich Lebensweise Familie -- gegeben Person notwendig Umstand entspringen -- außerordentlich Neigung -- werdend Leidenschaft -- Gefäß -- ziemlich vergehen -- ehe Ingredien merklich Gärung verursachen schäumend Rand schwillen -- 
  unser Freund entstehend wechselseitig Neigung angenehmst Wirkung -- 
  Gemüt öffneen -- allgemein Wohlwollen entspringen besonderer -- 
  fühlen glücklich gönnt Glück -- 
  Zustand erheben Geist -- Herz erweitern -- tun vornimmen -- Richtung Unermeßliche -- 
  Freund Wohnung befangen -- 
  Spaziergäng dehnten -- Eduard Ottilie -- Pfade wählen -- Weg bahnen -- vorauseilen -- folgen Hauptmann Charlotte bedeutend Unterhaltung -- teilnehmend neuentdeckt Plätzch -- unerwartet Aussicht -- geruhig Spur rascheren Vorgänger -- 
  Tag leiten Spaziergang Schloßpfort Flügel hinunter Gasthofe -- Brücke Teiche -- hinging -- gewöhnlich Wasser verfolgen -- Ufer sodann buschig Hügel weiterhin Fels einschließen aufhören gangbar -- 
  Eduard -- Jagdwanderungen Gegend -- drang Ottilie bewachsen Pfade -- wissend -- alt -- Fels versteckt Mühle abliegen -- 
  betreten Pfad verlieren -- finden dicht Gebüsch moosig Gestein verirren -- -- 
  Rauschen Räd verkündigen sogleich Nähe gesucht Ort -- 
  Klippe vorwärts tretend sehen alt schwarz wunderlich Holzgebäude Grund -- steil Fels hoch Baum umschatten -- 
  entschließen Moos Felstrümmer hinabzusteigen -- Eduard voran -- Höhe -- Ottilie schreitend -- Furcht Ängstlichkeit -- schön Gleichgewicht Stein Stein folgen -- glauben himmlisch Wesen sehen -- schweben -- 
  manchmal unsicher Stelle ausgestreckt Hand ergreifen -- Schulter stützen -- verleugnen -- zarte weiblich Wesen -- berühren -- 
  fast wünschen -- straucheln -- gleit -- Arm auffangen -- Herz drücken -- 
  Bedingung tun -- Ursache -- 
  fürchten beleidigen -- beschädigen -- 
  meinen -- erfahren sogleich -- 
  herabgelangen -- hoch Baum ländlich Tisch sitzen -- freundlich Müllerin Milch -- bewillkommenden Müller Charlotte Hauptmann entgegen gesandt -- fing Eduard einig zaudern sprechen -- 
  bitte -- lieb Ottilie -- verzeih -- versagen -- 
  Geheimnis -- brauchen -- Gewand -- Brust Miniaturbild tragen -- 
  Bild Vater -- brav Mann -- -- Sinn Stelle Herz verdienen -- 
  vergeben -- Bild ungeschickt -- Metall -- Glas tausend Ängst -- Kind Höhe heben -- hintragen -- Kutsche schwanken -- durch Gebüsch dringen -- -- Fels herabstiegen -- 
  Möglichkeit schrecklich -- unvorgesehen Stoß -- Fall -- Berührung schädlich verderblich -- 
  Liebe -- entfern Bild -- Andenken -- Zimmer -- geben schönsn -- heilig Ort Wohnung -- Brust entfernen -- Nähe -- übertrieben Ängstlichkeit -- gefährlich scheinen -- 
  Ottilie schweigen -- sprechen hingesehen -- -- Übereilung Zaudern -- Blick gen Himmel Eduard wenden -- lösen Kette -- ziehen Bild hervor -- drücken Stirn reichen Freund -- Wort -- heben -- Haus -- 
  vermögen bezeigen -- freundlich Sorgfalt schätzen wissen -- 
  Freund wagen Bild Lippe drücken -- fassen Hand drücken Auge -- 
  schön Hand -- jemals zusammenschlossen -- 
  -- Stein Herzen fallen -- Scheidewand Ottilie niederlegen -- 
  Müller führen langt Charlotte Hauptmann bequemeren Pfade herunter -- 
  begrüßen -- Erfreute erquicken -- 
  Weg kehren -- Eduard schlagen Felspfad Seite Bache -- teich Gesicht kommen -- Anstrengung zurücklegen -- 
  durchstrich abwechselnd Gehölz erblicken -- Land -- mancherlei Dorf -- Flecken -- Meiereium grün fruchtbar Umgebung -- Vorwerk -- Höhe -- mitten Holze vertraulich liegen -- 
  schönsn zeigen groß Reichtum Gegend -- rückwärts -- sanfterstiegen Höhe -- lustig Wäldche gelangen -- Heraustreten Fels Schloß befinden -- 
  froh -- gewissermaßen unvermutet ankamen -- 
  Welt umgangen -- stehen Platz Gebäude hinkommen -- sehen Fenster Wohnung -- 
  steigen Mooshütt hinunter -- sitzen erstenmal vieren -- 
  natürlich -- einstimmig Wunsch aussprechen -- heutig Weg -- langsam Beschwerlichkeit -- dergestalt führen einrichten -- gesellig -- schlendernd Behaglichkeit zurücklegen -- 
  jeder Vorschlag -- berechnen -- Weg -- mehrere Stunde brauchen -- bahnen Stunde Schloß zurückführen müssen -- 
  legen Gedanke -- unterhalb Mühle -- Bach Teiche fließen -- wegverkürzend Landschaft zierend Brücke -- Charlotte erfindenden Einbildungskraft Stillstand gebot -- Kosten erinnern -- Unternehmen erforderlich -- 
  helfen -- versetzen Eduard -- 
  Vorwerk Walde -- schön liegen scheinen -- eintragen -- veräußern Gelöst Anlage verwenden -- genieß vergnüglich unschätzbaren Spaziergang Interesse wohlangelegn Kapital -- Mißmut -- letzter Berechnung Schlusse Jahr -- kümmerlich Einnahme ziehen -- 
  Charlotte Haushälterin erinnern -- 
  Sache Sprache kommen -- 
  Hauptmann Plan Zerschlagung grundstück Waldbauer -- Eduard kurz bequem Verfahren wissen -- 
  gegenwärtig Pachter -- Vorschlag tun -- erhalten -- Terminweise zahlen Terminweis planmäßig Anlage Strecke Strecke vornehmen -- 
  vernünftig gemäßigt Einrichtung müssen Beifall finden -- Gesellschaft Geist Weg schlängeln -- Nähe angenehmsen Ruhe- Aussichtsplatz entdecken hoffen -- 
  einzeln vergegenwärtig Abends Haus sogleich Chart -- 
  übersah zurückgelegt Weg Stelle vorteilhaft führen -- 
  früh Vorsatz nochmals durchgesproch neu Gedanke verbinden -- Platz Haus -- Schloß -- nochmals billigen Kreislauf Weg abschließen -- 
  Ottilie geschwiegen -- Eduard zuletzt Plan -- Charlotte liegen -- hinwandte Einlud -- Meinung sagen -- Augenblick anhalten -- liebevoll ermuntert -- schweigen -- gleichgültig -- -- 
  -- Ottilie -- Finger hoch Fläche Anhöhe setzen -- Haus hierher bauen -- 
  sehen Schloß -- 
  Wäldche bedeckt -- befänd Welt -- Dorf Wohnung verbergen sein -- 
  Aussicht Teiche -- Mühl -- Höhe -- Gebirg -- Land -- außerordentlich schön -- vorbeigehen bemerken -- 
  -- rufen Eduard -- einfallen -- 
  -- meinen -- Ottilie -- -- 
  Bleistift streichen länglich Viereck stark derb Anhöhe -- 
  Hauptmann fahren Seele -- 
  sorgfältig -- reinlich gezeichnet Plan ungern Weise verunstalten -- fassen leise Missbilligung Gedanke -- 
  Ottilie -- -- 
  entfernt Spazierfahrt -- Kaffee trinken -- Fisch genießen -- Haus schmecken -- 
  verlangen Abwechslung fremd Gegenstand -- 
  Schloß alt Vernunft hierher bauen -- 
  liegen schützen Winde -- nah täglich Bedürfnisse -- Gebäude hingegen -- gesellig Aufenthalt Wohnung -- dorthin schicken gut Jahrszeit angenehmst Stunde gewähren -- 
  Jemehr Sache Durchsprach desto günstig erscheinen -- Eduard Triumph bergen -- Ottilie Gedanke -- 
  stolz Erfindung -- 
  Kapitel -- 
  Hauptmann untersuchen frühst Platz -- entwerfen flüchtig -- Gesellschaft Ort Stelle nochmals entscheiden -- genau Riß nebst Anschlag Erforderlichen -- 
  fehlt nötig Vorbereitung -- 
  Geschäft verkauf Vorwerk sogleich angreifen -- 
  Mann finden Anlaß Tätigkeit -- 
  Hauptmann Eduard bemerkbar -- Artigkeit -- Schuldigkeit -- Charlotte Geburtstag Legung Grundstein feiern -- 
  bedurft -- alt Abneigung Eduard Fest überwinden -- 
  schnell Sinn -- Ottilies Geburtstag -- fallen -- gleichfalls feierlich begehen -- 
  Charlotte -- Anlage -- geschehen -- bedeutend -- ernstlich -- fast bedenklich vorkamen -- beschäftigen -- Anschlag -- Zeit Geldeinteilung nochmals durchgehen -- 
  Tag -- desto verlangen suchen Abends -- 
  Ottilie indessen völlig Herrin Haushaltes -- -- still sicher Betrag -- 
  Sinnesweise Haus Häuslich Welt -- Leben Freien zugewenden -- 
  Eduard bemerken -- eigentlich Gefälligkeit Gegend mitging -- gesellig Pflicht Abends lang draußen verweilen -- manchmal Vorwand häuslich Tätigkeit suchen -- hinein -- 
  wissen gemeinschaftlich Wanderung einrichten -- Sonnenuntergang Haus -- fing -- unterlassen -- Gedicht vorzulesen -- -- Vortrag Ausdruck rein leidenschaftlich Liebe legen -- 
  gewöhnlich sitzen Abends Tisch -- hergebracht Platz -- Charlotte Sofa -- Ottilie Sessel -- Mann nehmen Seite -- 
  Ottilie sitzen Eduard -- wohin Licht schieben -- lesen -- 
  Alsdann rücken Ottilie nah -- Buch sehen -- 
  traut Auge fremd Lippe -- Eduard gleichfalls rücken -- Weise bequem -- halten lang Pause nötig -- eher umwendet -- Seite kommen -- 
  Charlotte Hauptmann bemerkten sehen manchmal lächelnd -- Zeichen überraschen -- Ottilies still Neigung gelegentlich offenbaren -- 
  Abend -- Gesellschaft lästig Besuch verlieren gehen -- Eduard Vorschlag beisammen bleiben -- 
  fühlen auflegen Flot vornehmen -- Tagesordnung kommen -- 
  Charlotte suchen Sonat -- gewöhnlich ausführen Pflegt -- finden -- gestehen Ottilie einig Zaudern -- Zimmer nehmen -- 
  -- Flügel begleiten -- rufen Eduard -- Auge Freude glänzen -- 
  glauben -- versetzen Ottilie -- -- 
  bringen Note herbei setzen an Klavier -- 
  Zuhörende aufmerksam überraschen -- vollkommen Ottilie Musikstück eingelernen -- überraschen -- Spielart Eduard anpassen wissen -- 
  anzupassen wissen Ausdruck -- 
  Charlottes Geschicklichkeit frei Wille Abhing -- zögernd voreilend Gatten Liebe -- anhalten -- mitzugehen -- scheinen Ottilie -- Sonat einigemal spielen gehören -- Sinn eingelernen -- begleiten -- 
  Mangel ihrigen -- Art lebendig Entsprang -- taktgemäß bewegen -- höchst angenehm gefällig lauten -- 
  Komponist Freude -- Werk liebevoll Weise entstellen sehen -- 
  wundersam -- unerwartet Begegnung sehen Hauptmann Charlotte stillschweigend Empfindung -- kindisch Handlung betrachten -- besorglich Folge billigen Schelten -- beneiden -- 
  eigentlich Neigung Wachse -- gefährlich -- ernst -- sicher -- halten Fähiger -- 
  fing Hauptmann fühlen -- unwiderstehlich Gewohnheit Charlotte fesseln drohen -- 
  gewinnen -- Stunde auszuweichen -- Charlotte Anlage pflegen -- früh Aufstand -- anordnet Arbeit Flügel Schloß zurückziehen -- 
  halten Charlotte zufällig -- suchen wahrscheinlich Stelle -- glauben verstehen achten desto -- 
  Vermied Hauptmann Charlotte -- desto emsig -- glänzend Feier herannahend Geburtsfest Anlage betreiben beschleunigen -- 
  unten hinauf -- Dorfe -- bequem Weg führen -- lassen -- vorgeblich Stein brechen -- herunter arbeiten -- einrichten berechnen -- letzter Nacht Teil Wege begegnen -- 
  Haus Keller brechen graben -- schön Grundstein Fächern Deckplatt zugehauen -- 
  äußerer Tätigkeit -- freundlich geheimnisvoll Absicht -- innerer zurückgedrängt Empfindung -- lassen Unterhaltung Gesellschaft -- beisammen -- lebhaft -- dergestalt Eduard -- lückenhaft Empfand -- Hauptmann Abends aufrufen -- Violine hervorzunehm Charlotte Klavier begleiten -- 
  Hauptmann verlangen widerstehen -- führen -- Empfindung -- Behag Freiheit -- eins schwer Musikstück -- zuhörend Paar groß Vergnüge gereichen -- 
  versprechen öfter Wiederholung mehrere Zusammenübung -- -- Ottilie -- Eduard -- 
  bewundern -- freuen -- 
  Kapitel -- 
  Geburtstag herbeigekommen fertig -- Mauer Dorfweg Wasser einfaßen erhöht -- Weg Kirche vorbei -- Charlotte angelegt Pfade fortlaufen -- Fels hinaufwärts schlingen -- Mooshütt links -- völlig Wendung links lassen allmählich Höhe gelangen -- 
  Gesellschaft eingefunden -- 
  Kirche -- Gemeinde festlich Schmuck versammeln antreffen -- 
  Gottesdienste ziehen Knabe -- Jünglinge Mann -- anordnen -- voraus -- Herrschaft Besuch Gefolge -- Mädchen -- Jungfraue Frau machen Beschluß -- 
  Wendung Wege erhöht Felsenplatz einrichten -- lassen Hauptmann Charlotte Gast ausruhen -- 
  übersah Weg -- hinaufgeschrittene Männerschar -- nachwandelnd Frau -- vorbeizogen -- 
  herrlich Wetter wunderschön Anblick -- 
  Charlotte fühlen überraschen -- rühren drückt Hauptmann herzlich Hand -- 
  folgen Sachte fortschreitend Menge -- Kreis künftig Hausraum bilden -- 
  Bauherr -- Seinig vornehmst Gast eingelad Tiefe hinabzusteigen -- Grundstein Seite unterstützen Niederlasse bereit liegen -- 
  wohlgeputzt Maurer -- Kelle -- Hammer Hand -- halten Reimen anmutig Rede -- Prosa unvollkommen wiedergeben -- 
  Ding -- fing -- Gebäude beobachten -- Fleck stehen -- gründen -- vollkommen ausführen -- 
  eigentlich Sache Bauherr -- 
  Stadt Fürst Gemeine bestimmen -- wohin bauen -- land Vorrecht Grundherre -- sagen -- Wohnung stehen nirgends -- 
  Eduard Ottilie wagen Wort ansehen -- nahe stehen -- 
  -- Vollendung -- Sorge vieler Gewerk -- -- beschäftigen sein -- 
  -- Gründung -- Maurer Angelegenheit -- Keck heraussagen -- Hauptangelegenheit Unternehmen -- 
  ernst Geschäft Einladung ernsthaft -- 
  Feierlichkeit Tiefe begehen -- 
  innerhalb eng ausgegraben Raum erweisen Ehre Zeuge unser geheimnisvoll Geschäft erscheinen -- 
  zugehauen Stein niederlegen schön würdig Person geziert Erdwände zugänglich -- ausgefüllt -- 
  Grundstein -- Ecke Ecke Gebäude -- Rechtwinkligkeit Regelmäßigkeit -- wasser senkrecht Lage -- Lot Waage Mauer Wand bezeichnen -- können niederlegen -- 
  ruht Schwere -- 
  Kalk -- Bindungsmittel fehlen -- 
  Mensch Natur neigen -- zusammenhalten -- Gesetz verkitten -- stein Form zusammenpassen -- bindend Kraft vereinigen -- ziem Tätig müßig -- verschmäh Mitarbeiter -- 
  überreichen hierauf Kelle Charlotte -- Kalk Stein werfen -- 
  mehreren Gleich angesonn Stein alsobald niedergesenken -- worauf Charlotte übrig sogleich Hammer reichen -- dreimalig pochen Verbindung Stein Grund ausdrücklich segnen -- 
  Maurers Arbeit -- fahren Redner fort -- frei Himmel -- geschehen verborgene verborgener -- 
  regelmäßig aufgeführt Grund verschütten -- sogar Mauer aufführen -- Eingedenk -- 
  arbeiten Steinmetzen Bildhauer fallen Auge -- sogar heißen -- Tüncher Spur Hand völlig auslöschen Werk zueignen -- überziehen -- glätten färbt -- 
  liegen -- tun -- -- Maurer -- 
  Selbstbewußtsein nähren Ursache -- 
  Haus aufführen -- Boden platten pflastern -- außenseit Zierat überdecken -- sehen Hülle hinein erkennen regelmäßig sorgfältig Fuge -- Halt danken -- 
  -- Übeltat begehen -- fürchten -- ungeachtet Abwehren -- dennoch an Licht -- erwarten -- Geheim tun -- wider Wille kommen -- 
  Grundstein Denkstein -- 
  unterschiedlich gehauen Vertiefung verschieden eingesenken -- Zeugnis entfernt Nachwelt -- 
  metallen zugelötet Köcher enthalten schriftlich Nachricht -- Metall-Platten allerlei Merkwürdig eingegraben -- schön gläsern Flasche versenk alt Wein -- Bezeichnung Geburtsjahr -- fehlen Münze verschieden Art -- prägen -- erhalten Freigebigkeit unser Bauherr -- 
  Platz -- Gast Zuschauer Nachwelt übergeben Belieben trüge -- 
  Pause Geselle -- Fällen pflegen -- vorbereiten -- überraschen -- jung munter Offizier anfehen -- 
  beitragen -- Schatzkammer niederlegen -- Paar Knöpfe Uniform schneiden -- verdienen Nachwelt -- 
  -- tun -- ähnlich Einfall -- 
  Frauenzimmer säumen Haarkämme hineinzulegen -- Riechfläschchen Zierd schonen -- Ottilie zauderen -- Eduard freundlich Wort Betrachtung beigesteuert eingelegt Ding herausriß -- 
  lösen golden Kette Hals -- Bild Vater gehangen -- legen leise Hand Kleinode -- worauf Eduard veranstalten -- wohlgefugen Deckel sogleich aufstürzen einkitten -- 
  jung Gesell -- tätigst erweisen -- Rednermiene fahren fort -- 
  gründ Stein ewig -- Sicherung längsten Genuß gegenwärtig künftig Besitzer Haus -- 
  gleichsam Schatz vergraben -- denken -- gründlichst Geschäft -- Vergänglichkeit menschlich Ding -- 
  denken Möglichkeit -- festversiegelen Deckel aufheben können -- geschehen dürfen -- zerstören -- aufführen -- 
  -- aufführen -- Gedanke Zukunft -- Gegenwärtige -- 
  lassen -- begangen heutig Fest -- Arbeit sogleich fördern -- Gewerk -- unser Grund fortarbeiten -- feiern brauchen -- Bau eilig Höhe steigen vollenden -- Fenster -- -- Hausherr seinigen Gast fröhlich Gegend umschau -- sämtlich anwesend Gesundheit hiermit trinken -- 
  leeren wohlgeschliffen Kelchgla Zug werfen Luft -- 
  bezeichnen Übermaß Freude -- Gefäß zerstören -- Fröhlichkeit bedienen -- 
  diesmal ereignen -- Glas Boden -- Wunder -- 
  nämlich -- Bau vorwärts -- entgegengesetzt Ecke Grund völlig herausgeschlagen -- angefang Mauer aufführen -- Endzweck Gerüst erbauen -- nötig -- 
  Feierlichkeit Brett belegen Menge Zuschauer hinaufgelassen -- Vorteil Arbeitsleute geschehen -- 
  hinauf flog Glas auffangen -- Zufall glücklich Zeichen ansehen -- 
  weisen zuletzt herum -- Hand lassen -- Buchstabe E O zierlich Verschlingung eingeschniten -- 
  einer Glas -- Eduard Jugend verfertigen -- 
  Gerüste stehen leer -- leichteste Gast steigen hinauf -- umzuseh -- schön Aussicht Seite genügsam Rühm -- 
  entdecken -- hoch Punkt Geschoß hoch stehen -- 
  inneren Land kommen mehrere Dorf Vorschein -- silbernen Streife Flusses erblicken deutlich -- Türme Hauptstadt gewahr -- 
  Rückseite -- waldig Hügel -- erheben blau Gipfel fern Gebirg -- nächster Gegend übersehen -- 
  -- rufen -- Teiche See vereinigen -- Anblick wünschenswert -- 
  lassen -- Hauptmann -- 
  bilden Zeit Bergsee -- 
  bitte Platan Pappelgruppe schonen -- Eduard -- schön mittelst Teich stehen -- 
  sehen -- wenden Ottilie -- Schritt vorführen -- hinabweisen -- Baum pflanzen -- 
  stehen -- fragt Ottilie -- 
  -- versetzen Eduard -- Welt -- 
  -- lieb Kind -- pflanzen -- Wieg liegen -- 
  Gesellschaft begeben Schloß -- 
  aufgehoben Tafel Spaziergang Dorf einladen -- Anstalten Augenschein nehmen -- 
  -- Hauptmann Veranlassung -- Bewohner Haus versammeln -- stehen Reihe -- Familienweis gruppieren -- teils Abend fordern beschäftigen -- teils Bänke ausruhend -- 
  angenehm Pflicht -- Sonntag Festtag -- Reinlichkeit -- Ordnung erneuen -- 
  innerer Geselligkeit Neigung -- unser Freund erzeugen -- groß Gesellschaft unangenehm unterbrechen -- 
  vi zufrieden Saal finden -- häuslich Gefühl einigermaßen stören -- Brief -- Eduard überreichen -- Gast ankündigen -- 
  vermuten -- rufen Eduard Charlotte -- Graf ausbleiben -- -- 
  Baronesse -- versetzen Charlotte -- 
  gewiß -- 
  antworten Eduard -- Seite anlangen -- 
  bitt Nachtquartier übermorgen fortreisen -- 
  Anstalt Zeit -- Ottilie -- Charlotte -- 
  befehl Einrichtung -- fragt Ottilie -- 
  Charlotte -- Ottilie entfernen -- 
  Hauptmann erkundigt Verhältnis Person -- Allgemeinst kennen -- 
  -- anderwärts verheiraten -- leidenschaftlich liebgewonnen -- 
  doppelt Ehe Aufsehen stören -- dacht Scheidung -- 
  Baronesse -- Grafe -- 
  müssen Schein trennen -- Verhältnis bleiben -- Winter Residenz zusammensein -- entschädigt Sommer Lustreise Bäder -- 
  alt Eduard Charlotte sämtlich genau Freund Hofzeit -- 
  Verhältnis erhalten -- Freund billigen -- 
  diesmal Charlotte Ankunft gewissermaßen ungelegen -- Ursache genau untersuchen -- eigentlich Ottilies Wille -- 
  rein Kind früh gewahr -- 
  paar Wegbleibe -- Eduard Ottilie Hereintrat -- Vorwerksverkauf Ordnung bringen -- 
  Aufsatz fertig -- Abschrift -- fehlen alt Kanzellist krank -- 
  Hauptmann bieten -- Charlotte -- Einwendung -- 
  geben -- rufen Ottilie -- -- 
  fertig -- Charlotte -- 
  freilich müssen übermorgen früh -- Eduard -- 
  fertig -- rufen Ottilie -- Blatt Hand -- 
  morgens -- oberer Stock Gast umsahen -- entgegen verfehl -- Eduard -- reiten langsam Straße -- 
  Hauptmann beschreiben Figur Reiter genau -- 
  -- Eduard -- 
  einzeln -- siehst -- passen -- sehen -- 
  Mittler -- 
  -- langsam langsam reiten -- 
  Figur näh Mittler -- 
  empfangen freundlich -- langsam Treppe heraufstieg -- 
  gestern kommen -- rufen Eduard entgegen -- 
  Laute Fest lieben -- versetzen -- 
  kommen Geburtstag Freundin stille nachzufeiern -- 
  gewinnen -- fragt Eduard scherzend -- 
  Besuch -- wert -- Betrachtung schuldig -- gestern -- 
  Freut herzlich halb Haus Frieden stiften -- hören -- Geburtstag feiern -- 
  selbstisch nennen -- denken -- freu Frieden bewegen -- 
  Freust Freund Frieden halten hegen -- 
  -- tun -- 
  -- vornehmen -- 
  gestern Gesellschaft finden -- finden -- Charlotte -- 
  finden Graf Baronesse -- schaffen -- 
  Mitte Hausgenossen -- seltsam willkommen Mann umgeben -- fahren verdrießlich Lebhaftigkeit heraus -- sogleich Hut Reitgerte suchen -- 
  Schweben Unstern -- sobald ruh wohltun -- 
  gehen Charakter heraus -- 
  -- vertreiben -- 
  Dache bleiben -- nehmen -- bringen Unheil -- 
  Wesen Sauerteig -- Ansteckung fortpflanzen -- 
  suchen begütigen -- vergebens -- 
  Ehestand angreifen -- rufen -- Wort -- -- Grund sittlich Gesellschaft untergräbtn -- -- Herr -- -- 
  ehe Anfang Gipfel Kultur -- 
  Rohen mild -- Gebildetste gut Gelegenheit Milde beweisen -- 
  unauflöslich -- 
  bringen vieler Glück -- einzeln Unglück rechnen -- 
  Unglück reden -- 
  Ungeduld -- Mensch anfällen -- beliebt unglücklich finden -- 
  Lasse Augenblick vorübergehen -- glücklich preisen -- Bestandenes bestehen -- 
  trennen hinlänglich Grund -- 
  menschlich Zustand leiden Freude setzen -- berechnen -- Paar Gatte schuldig -- 
  unendlich Schuld -- Ewigkeit abgetragen -- 
  unbequem manchmal -- glauben -- -- 
  Gewissen verheiraten -- gerne möchten -- unbequem Mann Frau -- 
  sprechen lebhaft fortgesproch -- blasend Postillon Ankunft Herrschaft verkündigen -- abgemessen Seite gleich Schloßhof hereinfuhren -- 
  hausgenossen entgegen eilen -- verstecken Mittler -- lassen Pferd Gasthof bringen -- riten verdrießlich -- 
  Kapitel -- 
  Gast bewillkommen einführen -- freut Haus -- Zimmer betreten -- gut erleben sehen -- 
  Höchst angenehm Freund Gegenwart -- 
  Graf Baronesse hoch schön Gestalt zählen -- mittlerer Alter fast Jugend sehen -- 
  Blüte abgehen -- erreg Neigung entschieden Zutrauen -- 
  Paar zeigen höchst bequem Gegenwart -- 
  frei Weise Zustand Leben nehmen behandeln -- Heiterkeit scheinbar Unbefangenheit teilen sogleich -- hoch Anstand begrenzen -- Zwang bemerken -- 
  Wirkung lassen augenblick Gesellschaft empfinden -- 
  Neueintretend -- unmittelbar Welt kommen -- sogar Kleid -- Gerätschaft Umgebung sehen -- machen gewissermaßen unser Freund -- ländlich heimlich leidenschaftlich Zustande -- Art Gegensatz -- verlieren -- alt Erinnerung gegenwärtig Teilnahme vermischen -- schnell lebhaft Gespräch geschwind Zusammenverband -- 
  währen indessen -- Sonderung vorging -- 
  Frau ziehen Flügel finden -- mancherlei vertraut neust Form Zuschnitte Frühkleider -- Hüt dergleichen Muster anfingen -- genugsam Unterhaltung -- Mann Reisewag -- vorgeführt Pferd -- beschäftigter handeln tauschen anfingen -- 
  Tisch -- 
  Umkleidung geschehen zeigen angekommen Paar Vorteil -- 
  tragen neu gleichsam ungeseh Gebrauch Gewohnheit Bequemlichkeit eingeweihen -- 
  Gespräch lebhaft abwechselnd -- Gegenwart Person interessieren scheinen -- 
  bedient französisch Sprache -- Aufwartenden Mitverständnis ausschließen -- schweifen mutwillig Behag hoch mittlerer Weltverhältniß -- 
  einzig Punkt bleiben Unterhaltung lang billig haft -- Charlotte Jugendfreundin erkundigt Befremdung vernehmen -- ehestens scheiden -- 
  unerfreulich -- Charlotte -- abwesend Freund bergen -- Freundin -- lieben -- versorgen glauben -- -- sich_es versiehen -- hören -- Schicksal schwanken abermals unsicher Pfade Leben betreten -- 
  eigentlich -- gute -- versetzen Graf -- Schuld -- Weise überraschen -- 
  irdisch Ding -- ehelich Verbindung dauerhaft vorstellen -- letzter Punkt betreffen -- verführen Lustspiel -- wiederholen sehen -- Einbildung -- Gang Welt zusammentreffen -- 
  Komödie sehen Heirat letzter Ziel Hindernis mehrere Akt verschoben Wunsch -- Augenblick -- erreichen -- fallen Vorhang momentan Befriedigung klingen -- 
  Welt -- hinten fort spielen -- Vorhang aufgehen -- sehen hören -- 
  schlimm -- Charlotte lächelnd -- sehen -- Person Theater abtreten -- Rolle spielen -- 
  einwenden -- Graf -- 
  Rolle übernehmen -- Welt kennen -- sehen -- Ehestand entschieden ewig Dauer Beweglich Welt -- Ungeschicktes tragen -- 
  Freund -- Laune meist Vorschlag Gesetz hervortatn -- behaupten -- ehe sollen schließen -- 
  -- -- schön ungerade heilig Zahl Zeitraum hinreichend kennen lernen -- Kind heran bringen -- entzweien -- schön -- versöhnen -- 
  gewöhnlich rufen -- glücklich verstreichen -- 
  -- gehen vergnüglich -- 
  liegen -- Verhältnis lang dauern sehen -- Gefälligkeit wachsen -- jemehr Termin Aufkündigung nähern -- 
  gleichgültig -- unzufrieden Betrag begütigen einnehmen -- 
  vergäße -- Gesellschaft Stunde vergessen -- verfließe -- fände auf angenehmste überraschen -- verlaufen Termin bemerken -- stillschweigend verlängern -- 
  artig lustig klingen -- Charlotte empfinden -- Scherz tief moralisch Deutung geben -- dergleich Äußerung -- Ottilies Wille -- angenehm -- 
  wissen -- gefährlich -- allzufreier Gespräch -- strafbaren halbstrafbar Zustand gewöhnlichen -- gemein -- löblichen behandeln -- gehören gewiß ehelich Verbindung antasten -- 
  suchen gewandt Weise Gespräch abzulenken -- vermögen -- leid -- Ottilie eingerichtet aufstehen -- 
  ruhig aufmerksam Kind verstehen Haushofmeister Blick Wink -- trefflich geraten -- obgleich paar ungeschickt Bedienten Livree staken -- 
  fahren Graf -- Charlotte Ablenken empfindend -- Gegenstand äußeren fort -- 
  -- gewohnen Gespräch lästig -- lastet Sache Herz -- Schwierigkeit -- Gemahlin trennen sehen -- machen bitter ehelich Verbindung betreffen -- Baronesse eifrig wünschen -- 
  Freund -- fahren fort -- Gesetzvorschlag -- 
  Ehe Alsdann unauflöslich halten -- Teil -- -- drittenmal verheiraten -- 
  Person betreffen -- bekennen unwidersprechlich -- Ehe unentbehrlich halten -- 
  -- früh Verbindung betragen -- Eigenheit -- Trennung Anlaß geben übel Eigenschaft -- 
  wechselseitig erkundigen -- verheiratet Unverheiratete geben -- wissen -- Fall -- 
  freilich Interesse Gesellschaft vermehren -- Eduard -- 
  -- verheiraten -- fragen unser Tugende -- unser Mangel -- 
  Einrichtung -- fallen Baronesse lächelnd -- lieben Wirt Stufe glücklich überstiegen -- können vorbereiten -- 
  ist_es geraten -- Graf -- Tod willig tun -- Konsistori ungern pflegen -- 
  Lassen tote ruhen -- versetzt Charlotte -- halb ernst Blick -- 
  -- versetzt Graf -- Ehre gedenken -- 
  bescheiden begnügen -- mannigfaltiger zurückließen -- 
  -- Baronesse verhalten Seufzer -- Fall Opfer bringen müssen -- 
  -- versetzen Graf -- 
  müssen verzweifeln -- Welt gehofft Folge zeigen -- 
  Kind halten versprechen -- jung Leute selten -- Wort halten -- halten Welt -- 
  Charlotte -- froh -- Gespräch wenden -- versetzen Heiter -- 
  -- ohnehin gewöhnen -- stück- teilweise genießen -- 
  gewiß -- versetzen Graf -- schön Zeit nossen -- 
  zurückerinn -- Eduard schön Paar Hof -- weder glänzend Zeit hervorleuchtend Gestalt Rede -- 
  tanzen -- Auge richten umworben -- bespiegeln -- 
  verändern -- Charlotte -- Schön Bescheidenheit anhören -- 
  Eduard stille tadeln -- Graf -- beharrlich -- 
  wunderlich Eltern nachgeben -- Früh gewinn Kleinigkeit -- 
  annehmen -- fallen Baronesse -- 
  Charlotte Schuld -- rein Umherseh -- Eduard Herzen lieben heimlich Gatten bestimmen -- Zeug -- manchmal quälen -- unglücklich Entschluß drängen -- reisen -- entfernen -- entwöhnen -- 
  Eduard nickt Baronesse scheinen dankbar Vorsprach -- 
  einer -- fahren fort -- Charlotte Entschuldigung beifügen -- Mann werben -- Neigung auszeichnen -- nah kennen -- gewiß liebenswürdig zugestehen -- 
  lieb Freundin -- versetzen Graf lebhaft -- bekennen -- gleichgültig -- Charlotte befürchten -- 
  finden hübsch Zug Frau -- Anhänglichkeit Mann fortsetzen -- Art Trennung stören aufheben lassen -- 
  Eigenschaft besitzen Mann -- versetzt Baronesse -- -- Graf -- bemerken -- Gewalt Frauenzimmer neigen -- 
  sehen -- Vorsprach Mühe geben -- auszuwirken -- Freundin Augenblick erlangen -- 
  Vorwurf gefallen lassen -- versetzen Graf -- Charlottes Gemahl betreffen -- leiden -- schön Paar auseinander sprengen -- wahrhaft prädestiniert Paar -- zusammengeegben weder scheuen -- Verbindung hinzusehen brauchen -- 
  versuchen -- Charlotte -- einzubringen versäumen -- 
  halten -- Graf -- 
  Heirat -- fahren Heftigkeit fort -- eigentlich Heirat verhaßten Art -- Heirat -- verzeih lebhaft Ausdruck -- Tölpelhaftes -- verderben zartesen Verhältnis -- liegen eigentlich plump Sicherheit -- tun -- 
  verstehen -- scheinen verbinden einer nunmehr Weg gehen -- 
  Augenblick Charlotte -- allemal Gespräch abbrechen -- kühn Wendung Gebrauch -- gelingen -- 
  Unterhaltung allgemein -- Gatten Hauptmann nehmen -- Ottilie veranlassen äußeren -- Nachtisch Stimmung nossen -- woran zierlich Fruchtkörbe aufgestellt Obstreichtum -- bunt Prachtgefäßen schön verteilt Blumenfülle -- vorzüglichst Anteil -- 
  Parkanlag kommen Sprache -- sogleich Tisch besuchen -- 
  Ottilie ziehen Vorwande häuslich Beschäftigung -- eigentlich setzt Abschrift -- 
  Graf Hauptmann unterhalten -- gesellt Charlotte -- 
  Höhe gelangen -- Hauptmann gefällig hinunt eilt Plan hohlen -- Graf Charlotte -- Mann fällen außerordentlich -- 
  Zusammenhäng unterrichten -- 
  scheinen Tätigkeit ernst folgerechen -- 
  leisten -- hoch Kreis Bedeutung -- 
  Charlotte vernehmen Hauptmann Lob innig Behag -- 
  fassen bekräftigt Gesagte Ruhe Klarheit -- 
  überraschen -- Graf fortfuhr -- Bekanntschaft gelegen -- 
  wissen Stelle -- Mann vollkommen passen -- Empfehlung -- glücklich machen -- hoch Freund allerbeste verbinden -- 
  Donnerschlag Charlotte herabfiel -- 
  Graf bemerken -- 
  Frau -- gewohnen jederzeit bändigen -- behalten außerordentlichst Fall Art scheinbar Fassung -- 
  hören Graf -- fortfuhr -- 
  überzeugen -- geschwind -- 
  Brief Kopfe zusammenstellen -- drängen schreiben -- 
  verschaffen reitend Boten -- Abend wegschicken -- 
  Charlotte innerlich zerrissen -- 
  Vorschlag überraschen -- Wort hervorbringen -- 
  Graf fahren glücklicherweise Fort Planen Hauptmann sprechen -- Günstiges Charlotte allzusehr Auge fallen -- 
  -- Hauptmann Herauftrat Rolle Grafe entfalten -- 
  Auge Freund -- verlieren -- 
  notdürftig Verbeugung wenden Weg eilt hinunt Mooshütt -- 
  halb Weg stürzt Träne Auge -- werfen eng Raum Einsiedelei überlassen Schmerz -- Leidenschaft -- Verzweiflung -- Möglichkeit Augenblick vorher leise Ahnung -- 
  Seite Eduard Baronesse Teichen hergegangen -- 
  klug Frau -- unterrichten -- bemerken tastend Gespräch -- Eduard Ottilies Lobe weitläufig herausließ -- wissen natürlich Weise Gang bringen -- zuletzt Zweifel übrig bleiben -- Leidenschaft Weg -- angelangen -- 
  verheirateter Frau -- untereinander lieben -- stehen stillschweigend -- jung Mädchen -- Bündnis -- 
  Folge Zuneigung stellen weltgewandt Geist allzugeschwind dar -- 
  -- früh Charlotte Ottilie sprechen Aufenthalt Kind Land -- still Gemütsart -- billigen Vorschlag tun -- Ottilie Stadt Freundin bringen -- Erziehung einzig Tochter wenden -- gutartig Gespielin umsehen -- Kindesstatt eintret Vorteil mitgenießen sollen -- 
  Charlotte sich_es Überlegung nehmen -- 
  bringen Blick Eduard Gemüt Vorschlag Baronesse vorsätzlich Festigkeit -- schnell vorging -- desto schmeichelte äußerlich Eduard Wünschen -- 
  besitzen Frau -- Selbstbeherrschung außerordentlichen Fall gewöhnen sogar gemein Fall Verstellung behandeln -- neigen -- Gewalt üben -- Herrschaft verbreiten -- äußerlich gewinnen -- dasjenig innerlich entbehren -- gewissermaßen schadlos halten -- 
  Gesinnung schließen meist Art heimlich Schadenfreude Dunkelheit -- Bewußtlose -- womit Fall -- 
  freuen gegenwärtig gelingen -- künftig überraschend Beschämung -- 
  Baronesse boshaft -- Eduard Weinlese Güter Charlotte einladen Frage Eduard -- Ottilie mitbringen dürfen -- Weise beliebig Gunst auslegen -- beantworten -- 
  Eduard sprechen Entzück herrlichen Gegend -- Fluß -- Hügel -- Fels Weinberg -- alt Schloß -- Wasserfahrte -- Jubel Weinlese -- Keltern u. S. W. wobei Unschuld Herzen Voraus laut Eindruck freut -- dergleich Szene frisch Gemüt Ottilies -- 
  Augenblick Ottilie heran -- Baronesse schnell Eduard -- 
  vorhabend Herbstreise reden -- 
  gewöhnlich Geschähe worauf voraus freuen -- 
  Eduard versprechen -- nötigen Ottilie entgegen geschwind -- eilt -- lieb Kind -- mehrere Schritt voran -- 
  herzlich Freude drückt Wesen -- 
  küssen Hand -- Strauß Feldblumen drücken -- unterwegs zusammengepflückt -- 
  Baronesse fühlen Anblick Inneren fast erbittert -- 
  Neigung strafbar -- billigen -- liebenswürdig angenehm -- unbedeutend Neuling Mädchen keineswegs gönnen -- 
  Abendessen setzen -- völlig Stimmung Gesellschaft verbreiten -- 
  Graf -- Tisch schreiben Bo fortgeschicken -- unterhieln Hauptmann -- verständig bescheiden Weise ausforscht -- Abend Seite bringen -- 
  Grafe sitzend Baroneß finden Unterhaltung -- Eduard -- durstig -- aufgeregt -- Weine schonter lebhaft Ottilie unterhielt ziehen -- Seite Hauptmann Charlotte sitzen -- schwer -- beinahe unmöglich -- Bewegung innere verbergen -- 
  Baronesse -- Beobachtung anzustellen -- 
  bemerken Charlottes Unbehagen -- Eduard Verhältnis Ottilie Sinn -- überzeugen -- Charlotte bedenklich verdrießlich Gemahl Benehme -- überlegen -- nunmehr Zweck gelangen können -- 
  Tisch finden Zwiespalt Gesellschaft -- 
  Graf -- Hauptmann ergründen -- braucht ruhig -- keineswegs eitel lakonisch Manne verschieden Wendung -- erfahren wünschen -- 
  gehen miteinander Seite Saal -- indes Eduard -- aufgeregen Wein Hoffnung -- Ottilie Fenster scherzen -- Charlotte Baronesse stillschweigend Seite Saal nebeneinander gehen -- 
  schweigen müßig umherstehen bringen zuletzt Stockung übrig Gesellschaft -- 
  Frau ziehen Flügel -- Mann -- scheinen abschließen -- 
  Elftes Kapitel -- 
  Eduard begleiten Grafe Zimmer lassen durch Gespräch verführen -- bleiben -- 
  Graf verlieren vorig Zeit -- gedacht Lebhaftigkeit Schönheit Charlottes -- Kenner Feuer entwickeln -- 
  schön Fuß Gabe Natur -- 
  Anmut unverwüstlich -- 
  beobachten -- Schuh küssen -- barbarisch tief gefühlt Ehrenbezeugung Sarmate wiederholen -- besseres kennen -- Schuh geliebten verehrt Person Gesundheit trinken -- 
  Spitze Fuß bleiben Gegenstand Lobe vertraut Mann -- 
  gehen Person alt Geschichte Abenteuer kommen Hindernis -- ehemals Zusammenkünften Liebenden entgegengesetzen -- Mühe geben -- Kunstgriff erfund -- sagen -- lieben -- 
  Erinnerst -- fahren Graf fort -- welch Abenteuer freundschaftlich uneigennützig bestehen helfen -- hoch Herrschaft Oheim besuchen weitläufig Schlos zusammenkamen -- 
  Feierlichkeit Feierkleider hingegangen -- Nacht freiem liebevoll Gespräch verstreichen -- 
  Hinweg Quartier Hofdam merken -- Eduard -- 
  gelangen glücklich geliebter -- 
  -- versetzen Graf -- Anstand Zufriedenheit denken häßlich Ehrenwächterin behalten -- -- indessen Blick Wort unterhielten -- höchst unerfreulich -- 
  gestern -- versetzt Eduard -- anmelden lassen -- Frau Geschichte erinnern -- unser Rückzug -- 
  verfehlt Weg kommen Vorsaal Garden -- 
  finden wissen -- glauben Bedenken hindurch Posten -- übrig -- vorbei -- 
  Eröffne Türe Verwunderung -- 
  Weg Matratze verlegen -- Riese mehrere Reihe ausstrecken liegen schlafen -- 
  einzig wachend Posten verwundern -- jugendlich Mut Mutwille steigen gelassen ausgestreckt Stiefel weg -- schnarchend Enakskinder erwachen -- 
  Lust stolpern -- Graf -- Lärm geben -- 
  welcher seltsam Auferstehung sehen -- 
  Augenblick schlagen Schloßglocke zwölf -- 
  Mitternacht -- Graf lächelnd -- gerechen -- 
  -- Baron -- Gefälligkeit bitten -- führen führen -- Baronesse Versprechen geben besuchen -- 
  sprechen -- sehen -- natürlich vertraulich Stunde sehnen -- 
  Zeig Hinweg -- Rückweg finden Fall Stiefel wegzustolpern -- 
  gastlich Gefälligkeit erzeig -- versetzen Eduard -- Frauenzimmer drüben Flügel -- 
  wissen -- beieinand finden -- Händel anrichten -- wunderlich ansehen gewinnen -- 
  Sorge -- Graf -- Baronesse erwarten -- 
  gewiß Zimmer -- 
  Sache -- versetzen Eduard -- Licht -- Grafe vorleuchtend geheim Treppe hinunt -- lang Gang führen -- 
  öffnet Eduard Türe -- 
  erstieg Wendeltreppe -- eng Ruheplatz deuten Eduard Grafen -- Licht Hand -- Tapetentüre rechts -- Versuch sogleich öffnet -- Grafe aufnehmen Eduard dunkel Raum zurücklassen -- 
  Türe links Charlott Schlafzimmer -- 
  hören reden horchen -- 
  Charlotte sprechen Kammermädche -- 
  Ottilie Bette -- 
  -- versetzen -- sitzen unten schreiben -- 
  zünd Nachtlicht -- Charlotte -- gehen -- 
  spät -- 
  Kerze auslösch Bett -- 
  Eduard hören Entzück -- Ottilie schreiben -- 
  beschäftigen -- denken triumphierend -- 
  Finsternis engen sitzen -- schreiben -- glauben treten -- sehen -- umkehrt -- fühlt unüberwindlich verlangen nahe -- 
  Weg Halbgeschoß wohnen -- 
  finden unmittelbar Frau Türe -- sonderbar Verwechselung Seele -- suchen Türe aufzudrehen -- finden verschließen -- pocht leise -- Charlotte hören -- 
  groß Nebenzimmer lebhaft -- 
  wiederholen abermals unerwartet Vorschlag Grafe wenden -- 
  Hauptmann scheinen stehen -- 
  füllen Haus -- beleben Spaziergäng fort -- leer -- 
  sagen -- antizipiert -- gewöhnlich pflegen -- leidig Trost -- Schmerz lindern -- 
  verwünschen -- brauchen lindern -- verwünscht totenhafen -- lindern -- 
  zuletzt Zuflucht Träne willkommen -- selten finden -- 
  werfen Sofa überlassen Schmerz -- 
  Eduard seinerseits Türe weg -- pocht nochmals -- drittenmal stark -- Charlotte Nachtstille deutlich vernehmen erschreckt Auffuhr -- 
  Gedanke -- 
  können -- müssen Hauptmann -- -- 
  unmöglich -- 
  halten Täuschung -- gehören -- wünschen -- fürchten hören -- 
  Schlafzimmer -- treten leise verriegelten Tapetentüre -- 
  schelten Furcht -- 
  Gräfin bedürfen -- rufen fassen setzen -- -- 
  leis Stimme antworten -- 
  bin_es -- 
  -- entgegnet Charlotte -- Ton unterscheiden -- 
  stehen Hauptmann Gestalt Türe -- 
  laut klingen entgegen -- Eduard -- 
  öffnet Gemahl stehen -- 
  begrüßen Scherz -- 
  Tone fortzufahren -- 
  verwickelt rätselhaft Besuch rätselhaft Erklärung -- 
  eigentlich kommen -- zuletzt -- gestehen -- 
  Gelübde tun -- Abend deinen Schuh küssen -- 
  eingefallen -- Charlotte -- 
  Desto schlimm -- versetzen Eduard -- desto -- 
  Sessel setzen -- leicht Nachtkleidung Blick entziehen -- 
  werfen nieder erwehren -- Schuh küßen -- -- Hand bleiben -- Fuß ergriff zärtlich Brust drücken -- 
  Charlotte Frau -- Natur mäßig -- Ehestand -- Vorsatz Anstrengung -- Art Weise Liebhaberinne fortführen -- 
  niemals reizt Mann -- verlangen entgegen -- Kälte abstoßend Strenge glich liebevoll Braut -- Erlaubt innig Scheu tragen -- 
  finden Eduard Abend doppelt Sinn -- 
  sehnlich wünscht Gatten weg -- 
  Luftgestalt Freund scheinen Vorwurf -- 
  Eduard entfernen -- ziehen -- 
  gewiß Bewegung sichtbar -- 
  weinen -- weich Person meist Anmut verlieren -- gewinnen unendlich -- gewöhnlich stark fassen kennen -- 
  Eduard liebenswürdig -- freundlich -- dringend -- bitten -- bleiben -- fordern -- ernst Scherzhaft suchen bereden -- denken -- löschen zuletzt mutwillig Kerze -- 
  Lampendämmerung sogleich behauptet innerer Neigung -- behauptet Einbildungskraft Wirklich -- 
  Eduard halten Ottilie arme -- Charlotte schweben Hauptmann nah fern Seele -- verwebt -- wundersam -- Abwesende Gegenwärtig reizend wonnevoll durcheinander -- 
  lassen Gegenwart ungeheurer rauben -- 
  bringen Nacht allerlei Gespräch Scherze -- desto frei Herz -- 
  Eduard Morgens Busen Frau erwachen -- scheinen ahnungsvoll hereinzublicken -- Sonne scheinen Verbrechen beleuchten -- schlich leis Seite -- finden -- seltsam -- erwachen -- 
  Zwölftes Kapitel -- 
  Gesellschaft Frühstück -- aufmerksam Beobachter Betrag einzeln Verschiedenheit innerer Gesinnung Empfindung abnehmen -- 
  Graf Baronesse begegnen heiter Behag -- paar Liebende empfinden -- -- erduldet Trennung -- wechselseitig Neigung abermals versichern halten -- Charlotte Eduard gleichsam beschämt reuig Hauptmann Ottilie entgegen treten -- 
  Liebe beschaffen -- glauben verschwinden -- 
  Ottilie kindlich heit -- Weise nennen -- 
  Ernst erscheinen Hauptmann -- Unterredung Grafe -- aufregen geruht schlafen -- fühlbar -- eigentlich Bestimmung erfüll Grund bloß halbtätig Müßiggang hinschlenderen -- 
  Gast entfernen -- neu Besuch eintreffen -- Charlotte willkommen -- heraus -- zerstreuen wünschen -- Eduard ungelegen -- doppelt Neigung fühlt Ottilie beschäftigen -- Ottilie gleichfalls unerwünscht -- früh nötig Abschrift fertig -- 
  eilen -- fremde spät entfernt -- sogleich Zimmer -- 
  Abend -- 
  Eduard -- Charlotte Hauptmann -- fremde -- ehe Wagen setzen -- Strecke Fuß begleiten -- einig Spaziergang Teichen -- 
  Kahn ankommen -- Eduard ansehnlich Kosten Ferne verschreiben -- 
  versuchen -- bewegen lenken lassen -- 
  Ufer mittelst Teiche alt Eichbäumen anbinden -- künftig Anlage rechnen -- 
  Landungsplatz angebrachen -- Bäumen architektonisch Ruhesitz aufführen -- wonach See fahren -- Steuer -- 
  drüben Landung anlegen -- fragt Eduard -- 
  denken Platane -- 
  stehen rechts -- Hauptmann -- 
  Landet unten -- Schlos nah -- überlegen -- 
  Hauptmann stehen Hinterteile Kahn Ruder ergreifen -- 
  Charlotte steigen -- Eduard gleichfalls fassen Ruder -- abstoßen begreifen -- gedacht ottilies -- gedacht Wasserfahrt verspän -- wissen zurückführen -- 
  entschließen -- springen an Land -- reichen Hauptmann Ruder eilen -- flüchtig entschuldigend -- Haus -- 
  vernehmen -- Ottilie einschließen -- schreiben -- 
  angenehm Gefühl -- tun -- empfinden lebhaftester Missbehagen gegenwärtig sehen -- 
  Ungeduld vermehrt Augenblick -- 
  saal -- versuchen allerlei vermocht Aufmerksamkeit fesseln -- 
  wünschen sehen -- sehen -- ehe Charlotte Hauptmann zurückkommen -- 
  Nacht -- Kerze anzünden -- 
  treten herein -- glänzend Liebenswürdigkeit -- 
  Gefühl Freund tun -- Wesen heben -- 
  legen Original Abschrift Eduard Tisch -- 
  kollationieren -- lächelnd -- 
  Eduard wissen erwidern -- 
  -- besehen Abschrift -- 
  Blatt groß Sorgfalt -- zart weiblich Hand schreiben -- scheinen Zug verändern -- leicht frei -- erstaunt -- letzter Seite Auge überlufen -- 
  Gotteswill -- rufen -- -- 
  Hand -- 
  Ottilie Blatt -- Schluß schreiben -- 
  Ottilie schweigen -- blickt groß Zufriedenheit Auge -- 
  Eduard heben Arm empor -- liebst -- rufen -- Ottilie liebst -- halten umfassen -- 
  ergreifen -- unterscheiden -- 
  Augenblick Welt Eduard umgewenden -- -- Welt -- 
  stehen -- halten Hand -- sehen Auge -- Begriff umarmen -- 
  Charlotte Hauptmann treten herein -- 
  Entschuldigung lang Außenbleiben lächelen Eduard heimlich -- 
  O früh -- -- 
  setzen Abendessen -- 
  Person heutig Besuch beurteilen -- 
  Eduard liebevoll aufgeregt sprechen -- schonend -- billigend -- 
  Charlotte -- Meinung -- bemerken Stimmung scherzen -- -- scheidend Gesellschaft strengster Zungengericht ergehen lassen -- mild nachsichtig -- 
  Feuer herzlich Überzeugung rufen Eduard -- 
  Wesen Grund lieben -- übrig liebenswürdig -- 
  Ottilie schlagen Auge nieder -- Charlotte -- 
  Hauptmann Wort -- 
  Gefühl Hochachtung -- Verehrung -- ähnlich -- 
  erkennen schätzenswert Welt -- Gesinnung Gegenstand üben Gelegenheit finden -- 
  Charlotte suchen Schlafzimmer gelangen -- Erinnerung überlassen -- Abend Hauptmann vorgehen -- 
  Eduard an Ufer springend Kahn Land stoßen -- Gattin Freund schwankend Element überantworten -- nunmehr Charlotte Mann -- stille gelitt -- Dämmerung sitzen Führung zwei Ruder Fahrzeug beliebig Richtung fortbewegen -- 
  Empfand tief -- selten gefühlt Traurigkeit -- 
  Kreis Kahn -- Plätschern Ruder -- Wasserspiegel hinschauernd Windhauch -- Säusel Rohr -- letzter schweben Vogel -- Blink Widerblinko Stern -- Geisterhaft Stille -- 
  scheinen -- Freund fahren weg -- aussetzen -- lassen -- 
  wunderbar Bewegung Inneren -- weinen -- 
  Hauptmann beschreiben unterdessen -- Absicht Anlage -- 
  rühmt gut Eigenschaft Kahn -- Rudern Person bewegen regieren lassen -- 
  lernen -- angenehm Empfindung manchmal Wasser hinzuschwimm Fähr- Steuermann -- 
  Wort fallen Freundin bevorstehend Trennung auf Herz -- 
  Vorsatz -- denken -- 
  weiße -- vermuten er_es -- zufällig -- 
  bewußtlos Schicksal vorausverkündigen -- 
  ergreifen Wehmut -- Ungeduld -- bitten -- baldmöglichst land Schlos zurückkehren -- 
  erstemal -- Hauptmann Teiche Befuhr -- Tiefe untersuchen -- einzeln Stelle unbekannt -- 
  Dunkel fing -- richten Lauf -- bequem Ort Aussteigen vermutet Fußpfad entfernt wissen -- Schloß führen -- 
  Bahn einigermaßen ablenken -- Charlotte Art Ängstlichkeit Wunsch wiederholen -- Land -- 
  nähert erneut Anstrengung Ufer -- fühlt Entfernung anhalten -- fest gefahr Bemühung vergebens -- 
  -- 
  bleiben übrig Wasser steigen -- seicht -- Freundin Land tragen -- 
  glücklich bringen lieb Bürde hinüber -- stark schwank Sorge geben -- ängstlich arm Hals geschlungen -- 
  halten fest drücken -- 
  Rasenabhang lassen nieder -- Bewegung Verwirrung -- 
  liegen Hals -- schließen auf arme drückt lebhaft Kuß Lippe -- Augenblick liegen Fuß -- drücken Mund Hand rufen -- Charlotte -- vergeben -- 
  Kuß -- Freund wagen -- beinahe geben -- bringen Charlotte -- 
  drücken Hand -- heben -- 
  hinunterneigt Hand Schulter legen -- rufen -- Augenblick unser Leben Epoche machen -- verhindern -- wert -- hängen -- 
  scheiden -- Freund -- scheiden -- 
  Graf Anstalt Schicksal verbessern -- freuen schmerzen -- 
  verschweigen gewiß -- Augenblick nötigen Geheimnis entdecken -- 
  sofern -- verzeihen -- Mut Lage ändern -- abhängen Gesinnung ändern -- 
  heben ergriff Arm stützen -- kommen stillschweigend Schloß -- 
  stehen Schlafzimmer -- Gattin Eduard empfinden betrachten müssen -- 
  Widersprüchen tüchtig durch Leben mannigfaltig geübt Charakter Hilfe -- 
  gewohnt bewußt -- gebiet -- schwer -- ernst Betrachtung erwünscht Gleichgewicht nähern -- müssen lächeln -- wunderlich Nachtbesuch gedachten -- 
  schnell ergriff seltsam Ahnung -- freudig bänglich Erzittern -- fromm Wunsch Hoffnung auflösen -- 
  Gerührt knien nieder -- wiederholen Schwor Eduard Altar tun -- 
  Freundschaft -- Neigung -- Entsag gehen heiter Bild vorüber -- 
  fühlen innerlich herstellen -- 
  ergreifen süß Müdigkeit ruhig schlafen -- 
  Dreizehntes Kapitel -- 
  Eduard Seite verschieden Stimmung -- 
  schlafen denken -- einfällen auszuziehen -- 
  Abschrift Dokument küssen tausendmal -- Anfang Ottilies kindlich schüchterner Hand -- wagen Küssen -- Hand sehen glauben -- 
  O anderer Dokument -- stille -- schön Versicherung -- hoch Wunsch erfüllen -- 
  bleiben Hand -- Immerfort Herz drücken -- obgleich entstellen Unterschrift -- 
  abnehmend Mond steigen Wald hervor -- 
  warm Nacht locken Eduard Freie -- schweifen umher -- unruhig glücklich Sterblichen -- 
  wandeln Garten -- engen -- eilen Feld -- -- 
  Schlos ziehen -- finden Ottilies Fenster -- 
  setzen Terrassentreppe -- 
  Mauer Riegel -- -- trennen -- Herz trennen -- 
  Stünde -- Arm fallen -- ihrig -- bedürfen Gewißheit -- 
  still -- Lüftche regen -- still war_es -- wühlend Arbeit emsig Tier Erde vernehmen -- Nacht -- 
  hing glücklich Träum -- Schlief erwachen eher Sonne herrlich Blick heraufstieg frühst Nebel gewältigen -- 
  finden Wachende Besitzung -- 
  Arbeiter scheinen auszubleiben -- 
  kommen -- scheinen -- vorgesetzt Tagesarbeit Wunsch gering -- 
  fragt mehrere Arbeiter -- 
  versprechen stellen Lauf Tag -- 
  -- Vorsätz schleunig ausführen sehen -- 
  schaffen Freude -- 
  fertig -- -- 
  Weg bahnen -- Ottilie bequem -- Sitz Ort Stelle -- Ottilie ruhen können -- 
  Haus treiben -- 
  Ottilies Geburtstage richten -- 
  Eduard Gesinnung -- Handlung Maß -- 
  Bewußtsein lieben lieben treiben Unendliche -- 
  verändern Ansicht Zimmer -- Umgebung -- 
  finden Haus -- 
  Ottilies Gegenwart verschlingen -- 
  versinken -- Betrachtung steigen -- Gewissen sprechen -- Natur bändigen brechen -- Wesen strömen Ottilie -- 
  Hauptmann beobachten leidenschaftlich treiben wünschen traurig Folge zuvorzukommen -- 
  Anlage -- einseitig Trieb übermäßig fördern -- ruhig freundlich Zusammenleben berechnen -- 
  verkaufe Vorwerk Stande bringen -- Zahlung geschehen -- Charlotte Abred Kasse nehmen -- 
  Woche Ernst Geduld Ordnung üben Auge -- 
  übereilt Weise Ausgesetzt reichen -- 
  anfangen -- 
  Charlotte Lage lassen -- 
  beraten überein -- wollen planmäßig Arbeit beschleunigen -- Geld aufnehmen -- Abtragung Zahlungstermine anweisen -- Vorwerksverkauf zurückbleiben -- 
  lassen fast Verlust -- Zession Gerechtsame -- frei Hand -- leisten -- Gang -- Arbeiter vorhanden -- gelangen gewiß Zweck -- 
  Eduard stimmen -- Absicht übereintreffen -- 
  innerer Herz beharren indessen Charlotte bedacht vorsetzen -- männlich stehen Freund gleich Sinn Seite -- 
  Vertraulichkeit vermehren -- 
  erklären wechselseitig Eduard Leidenschaft -- beraten -- 
  Charlotte schließen Ottilie nah -- beobachten streng -- jemehr Herz gewahr -- desto tief blicken Herz Mädchen -- 
  sehen Rettung -- Kind entfernen -- 
  scheinen glücklich Fügung -- Luciane ausgezeichnet Lob Pension erhalten -- 
  Großtant -- unterrichten -- allemal nehmen -- -- Welt einführen -- 
  Ottilie Pension zurückkehren -- Hauptmann entfernen -- wohlversorgen -- stehen weniger Monat -- -- 
  Verhältnis hoffen Charlotte Eduard herstellen -- legen verständig zurecht -- Wahn bestärken -- früh beschränkt Zustand können zurückkehren -- gewaltsam Entbunden lassen Enge bringen -- 
  Eduard empfinden indessen Hindernis -- Weg legen -- 
  bemerken -- Ottilie auseinander halten -- erschweren sprechen -- nähern -- Gegenwart mehreren -- hierüber verdrießlich -- -- 
  Ottilie flüchtig sprechen -- Liebe versichern -- Gattin -- Hauptmann beschweren -- 
  fühlen -- heftig treiben Kasse erschöpfen Weg -- tadelen bitter Charlotte Hauptmann -- Geschäft Abred handelten -- Abred willigen -- veranlassen notwendig -- 
  Haß parteiisch -- Liebe -- 
  Ottilie entfremdet einigermaßen Charlotte Hauptmann -- 
  Eduard einst Ottilie letzteren beklagen -- Freund Verhältnis aufrichtig handeln -- versetzen Ottilie unbedachtsam -- mißfallen -- redlich -- 
  hört Charlotte sagen -- Eduard Flötendudelei verschonen -- 
  Zuhörer lästig -- 
  denken -- geschmerzen -- akkompagniern -- 
  -- Geist zuflüsteren -- schweigen -- heraus -- 
  Eduard Gesichtszüge verwandeln -- 
  verdrossen -- lieb Forderung angreifen -- kindlich Streben mind Anmaßung bewußt -- 
  unterhalten -- erfreut -- Schonung Freund behandeln -- 
  denken -- schrecklich -- Ohr unzulänglich Talent verletzen lassen -- 
  beleidigen -- wütend vergeben -- 
  fühlt Pflicht losgesprochen -- 
  Notwendigkeit Ottilie -- sehen -- zuzuflüstern -- vertrauen -- wachsen -- 
  entschloß schreiben -- geheim Briefwechsel bitten -- 
  Streifch Papier -- worauf lakonisch tun -- liegen Schreibtisch Zugwind heruntergeführen -- Kammerdiener hereintreten -- Haar kräuseln -- 
  gewöhnlich -- Hitze Eisens versuchen -- bückt Papierschnitzel Erde -- diesmal ergreifen Billet -- zwicken eilig versengen -- 
  Eduard Mißgriff bemerkend reißen Hand -- 
  setzen -- schreiben -- zweitenmal Feder -- 
  fühlt Bedenken -- Besorgnis -- überwand -- 
  Ottilie blättch Hand drücken -- Augenblick nähern -- 
  Ottilie versäumt Antwort -- 
  ungelesen stecken Zettelch Weste -- modisch verwahren -- 
  schieben heraus fallen -- bemerken -- Boden -- 
  Charlotte heben -- reichen flüchtig Überblick -- 
  Hand -- -- ungern verlörest -- 
  betreffen -- 
  verstellen -- denken -- 
  Inhalt Blättchen gewahr -- irren Ähnlichkeit Hand -- 
  hoffen -- denken letzterer -- 
  warnen -- doppelt warnen -- sonderbaren zufällig Zeichen -- hoch Wesen sprechen scheinen -- Leidenschaft unverständlich -- vielmehr führen -- empfand Beschränkung halten scheinen -- unangenehm -- 
  freundlich Geselligkeit verlieren -- 
  Herz verschließen -- Freund Frau nötigen -- gelingen -- früh Neigung Busen aufzufinden -- beleben -- 
  still Vorwurf -- hierüber müssen -- unbequem suchen Art Humor helfen -- -- Liebe -- gewohnt Anmut ermangelen -- 
  Prüfung helfen Charlotte innerer Gefühl hinweg -- 
  ernst Vorsatz bewußt -- schön edel Neigung Verzicht -- 
  wünschen Hilfe -- 
  Entfernung -- fühlen -- hinreichend -- Übel heilen -- 
  nehmen Sache Kind Sprache bringen -- vermögen -- Erinnerung Schwanken stehen Weg -- 
  suchen ausdrücken -- Allgemeiner passen Zustand -- aussprechen scheuen -- 
  Wink -- Ottilie geben -- deuten Herz -- 
  warnen fühlen -- Warnung bedürfen -- 
  schweigend halten Liebenden auseinander -- Sache -- 
  leise Andeutung -- manchmal entschlüpfen -- wirken Ottilie -- 
  Eduard Charlottes Neigung Hauptmann überzeugen -- überzeugen -- Charlotte Scheidung wünschen -- anständig Weise bewirken denken -- 
  Ottilie tragen Gefühl Unschuld -- Weg erwünschtest Glück -- leben Eduard -- 
  lieb Gute stärken -- seinetwill Freudiger -- aufgeschlossen -- finden Himmel Erde -- 
  setzen -- Weise -- täglich Leben fort -- nachdenken -- scheinen gewöhnlich Gang -- ungeheur Fall -- Spiel stehen -- fort leben -- Rede -- 
  Vierzehntes Kapitel -- 
  Grafe indessen Brief Hauptmann ankommen -- doppelt -- Vorzeig -- schön Aussicht Ferne darwieser -- hingegen -- entschieden Anerbiet Gegenwart enthalten -- bedeutend Hof Geschäftsstelle -- Charakter Major -- ansehnlich Gehalt -- Vorteil -- verschieden Nebenumstände geheim halten -- 
  unterrichten Hauptmann Freund Hoffnung verbergen nahe bevorstehen -- 
  indessen setzen gegenwärtig Geschäft lebhaft fort still Einrichtung -- Abwesenheit ungehindert Fortgang -- 
  liegen -- Termin bestimmen -- Ottilies Geburtstag beschleunigen -- 
  wirken Freund -- obschon ausdrücklich Einverständnis -- -- 
  Eduard zufrieden -- vorauserheben Geld Kasse verstärken -- Anstalt rücken rascheste vorwärts -- 
  Teiche See verwandeln Hauptmann liebsn widerran -- 
  unter Damm verstärken -- mittlerer abzutrag -- Sache Sinn wichtig bedenklich -- 
  Arbeit -- ineinander wirken -- anfangen -- jung Architekt -- ehemalig Zögling Hauptmann -- erwünscht -- teils Anstellung tüchtig Meister -- teils Verding Arbeit -- lassen -- Sache fördert Werk Sicherheit Dauer versprechen -- wobei Hauptmann stille freuen -- Entfernung fühlen -- 
  Grundsatz -- übernommen unvollendet Geschäft scheiden -- Stelle genügsam ersetzen sehen -- 
  verachten -- -- Abgang fühlbar -- Verwirrung Kreis anrichten -- ungebildet Selbstler zerstören wünschen -- wobei fortwirken -- 
  arbeitet Anstrengung -- Ottilies Geburtstag verherrlichen -- aussprechen -- aufrichtig bekennen -- 
  Charlottes obgleich neidlos Gesinnung entschieden Fest -- 
  Jugend Ottilies -- Glücksumstände -- Verhältnis Familie berechtigen Königin Tage erscheinen -- 
  Eduard sprechen -- entspringen -- überraschen erfreuen -- 
  kommen stillschweigend Vorwande überein -- -- Beziehung -- Lusthaus richten -- Anlaß Volke Freund fest ankündigen -- 
  Eduard Neigung grenzenlos -- 
  Ottilie zuzueignen begehren -- kennen Maß Hingeben -- Schenken -- Versprechen -- 
  Gabe -- Ottilie verehren -- Charlotte ärmlich Vorschlag tun -- 
  sprechen Kammerdiener -- Garderobe besorgt Handelsleut Modehändler beständig Verhältnis bleiben -- -- unbekannt sowohl angenehmst Gabe Art überreichen -- bestellen sogleich Stadt niedlichst Koffer rot Saffian überzogen -- Stahlnägel beschlagen -- anfüllen Geschenk Schale würdig -- 
  Vorschlag Eduard -- 
  Feuerwerk vorhanden -- abzubrennen versäumen -- 
  verstärken erweitern -- 
  Eduard ergriff Gedanke versprechen Ausführung sorgen -- 
  Sache Geheimnis bleiben -- 
  Hauptmann unterdessen -- nah heranrückt -- polizeilich Einrichtung treffen -- nötig halten -- Maß Mensch berufen locken -- 
  sogar Bettelns -- anderer Unbequemlichkeit -- wodurch Anmut Fest stören -- Vorsorge nehmen -- 
  Eduard Vertrauter beschäftigen vorzüglich Feuerwerk -- 
  mittelsten Teiche Eichbäum abgebrannen -- Platane Gesellschaft aufhalten -- Wirkung gehörig Ferne -- Abspiegelung Wasser -- Wasser brennend schwimmen bestimmen -- Sicherheit Bequemlichkeit anschauen -- 
  Vorwand lassen Eduard Raum Platane Gesträuch -- Gras Moos säubern -- erscheinen Herrlichkeit Baumwuchse sowohl Höhe Breite gereinigt Boden -- 
  Eduard Empfand groß Freude -- 
  -- ungefähr Jahreszeit pflanzen -- 
  -- -- 
  --- Sobald Haus -- schlagen alt Tagebücher -- Vater -- Land -- ordentlich führen -- 
  Pflanzung erwähnen -- häuslich wichtig Begebenheit -- Eduard erinnern -- müssen notwendig anmerken stehen -- 
  durchblättern Band -- Umstand finden -- erstaunt -- erfreuen Eduard -- wunderbarst Zusammentreffe bemerken -- 
  -- Baumpflanzung -- Ottilies Geburt -- 
  Fünfzehntes Kapitel -- 
  leuchten Eduard sehnlich erwarten stellen Gast -- 
  Einladung umh geschickt -- Leg Grundstein versäumen -- wovon Artiges erzählt -- Feierlichkeit verfehlen -- 
  Tafel erscheinen Zimmerleute Musik Schloßhofe -- reich Kranz tragend -- stufenweise übereinander schwankend Laub Blumenreifen zusammengesetzt -- 
  sprechen Gruß -- erbat gewöhnlich Ausschmückung seiden Tücher Band schön Geschlecht -- 
  Indes Herrschaft speisten -- setzen jauchzend Zug fort -- Dorfe aufgehalt Frau Mädchen gleichfalls Band bringen -- kommen -- begleiten erwarten Menge -- Höhe gerichtet Haus stehen -- 
  Charlotte halten Tafel Gesellschaft einigermaßen -- 
  feierlich förmlich Zug finden einzeln Partien -- Rang Ordnung -- Platz gemächlich -- 
  Charlotte zögeren Ottilie Sache -- 
  Ottilie letzter Herantrat -- scheinen Trompet Pauke warten -- Feierlichkeit Ankunft beginnen müssen -- 
  Haus roh ansehen nehmen -- grün Reisig Blume -- Angabe Hauptmann -- architektonisch ausgeschmücken -- mitwisser Eduard Architekt veranlassen -- Gesim Datum Blume bezeichnen -- 
  hinegehen -- zeitig langt Hauptmann -- verhindern -- Name Ottilies Giebelfelde glänzen -- 
  wissen Beginn geschickt Weise abzulehn fertig Blumenbuchstabe Seite bringen -- 
  Kranz aufgesteckt umh Gegend sichtbar -- 
  Bunt flattert Band Tücher Luft kurz Rede verschollt groß Wind -- 
  Feierlichkeit -- Tanz geebnet Laube umkreisten Platz Gebäude angehen -- 
  schmuck Zimmergeselle führen Eduard flinkes Bauermädchen -- fordern Ottilie -- stehen -- 
  Paar finden sogleich Nachfolger wechseln Eduard -- Ottilie ergriff Runde -- 
  jung Gesellschaft mischen fröhlich Tanz Volk -- indes alt Beobachtet -- 
  Sodann -- ehe Spaziergängen zerstreuen -- abgereden -- Untergang Sonne Platane versammeln wollen -- 
  Eduard finden -- ordnet Abred Kammerdiener -- Seite -- Gesellschaft Feuerwerker -- Lusterscheinunge besorgen -- 
  Hauptmann bemerken getroffen Vorrichtung Vergnügen -- erwartend Andrang Zuschauer Eduard sprechen -- hastig bitten -- mögen Feierlichkeit überlassen -- 
  Volk oberwärts abgestochen rasen entblößt Damm drängen -- Erdreich uneben unsicher -- 
  Sonne -- Dämmerung treten -- Erwartung groß Dunkelheit Gesellschaft Platane Erfrischung bedienen -- 
  finden Ort unvergleichlich freut Gedanke -- künftig Aussicht weiten mannigfaltig begrenzt See genießen -- 
  ruhig Abend -- vollkommen Windstille versprach nächtlich Fest begünstigen -- entsetzlich Geschrei entstehen -- 
  Scholl Damm losgetrennen -- mehrere Mensch Wasser stürzen -- 
  erdreich nachgegeben drängen Trete zunehmend Menge -- 
  Platz vorwärts -- 
  springen hinzu -- schauen -- 
  hinreichen -- 
  Nebst Entschlossen eilt Hauptmann -- treiben sogleich Menge Damm herunter Ufer -- hülfreich frei Hand geben -- Versinkende herauszuziehen suchen -- 
  -- teils -- teils fremd bestreben -- Trocken -- Knabe -- allzu ängstlich bemühen -- Damm nähern -- entfernen -- 
  Kraft scheinen verlassen -- einigemal Hand -- Fuß Höhe -- 
  Unglücklicher Weise Kahn Seite -- Feuerwerk füllen -- langsam auslad Hilfe verzögeren -- 
  Hauptmann Entschluß fassen -- werfen Oberkleider weg -- Auge richten -- tüchtig kräftig Gestalt flößen Zutraue -- Schrei Überraschung drang Menge hervor -- Wasser stürzen -- 
  jeder Auge begleiten -- geschickt Schwimmer Knabe erreichen -- tot -- Damm bringen -- 
  indessen rudert Kahn herbei -- Hauptmann Bestieg forschen genau anwesende -- retten -- 
  Chirurg übernehmen totgeglaubt Knabe -- Charlotte treten hinzu -- bitten Hauptmann sorgen -- Schloß zurückzukehr Kleid wechseln -- 
  zauderen -- gesetzen verständig Leute -- nahe gegenwärtig -- Rettung einzeln beitragen -- heiligste versichern -- retten -- 
  Charlotte sehen Haus -- denken -- Wein Tee -- nötig -- verschließen -- Fall Mensch gewöhnlich verkehrt handeln -- eilen zerstreut Gesellschaft -- Platane befinden -- Eduard beschäftigen zuzureden -- 
  bleiben -- kurz gedenken Zeichen geben Feuerwerk beginnen -- Charlotte treten hinzu bitten -- vergnügen verschieben Platze -- gegenwärtig Augenblick genossen können -- erinnern -- Gerettet Retter schuldig -- 
  Chirurg Pflicht -- versetzen Eduard -- 
  verseh Zudring hinderlich Teilnahme -- 
  Charlotte bestehen Sinn winken Ottilie -- sogleich weggehen anschicken -- 
  Eduard ergreifen Hand rufen -- 
  Lazarett endigen -- 
  barmherzig Schwester -- 
  Scheintote erwach Lebendig abtrocknen -- 
  Charlotte schweigen -- 
  folgen -- -- letzter folgen -- 
  Eduard Ottilie finden Platane -- 
  bestehen bleiben -- dringend -- ängstlich bitten -- Schlos zurückkehren -- 
  -- Ottilie -- rufen -- Außerordentliche geschehen glatt gewöhnlich Weg -- 
  überraschend Vorfall Abend bringen schnell -- 
  -- 
  dir_es geschworen -- sagen schwören -- -- 
  Kahn Seite schwamm Herüber -- 
  Kammerdiener -- verlegen anfragen -- 
  nunmehr Feuerwerk -- 
  Brennt -- rufen entgegen -- 
  bestellen -- Ottilie -- sollst sehen -- 
  Erlaube Seite sitzend -- genießen -- 
  Zärtlich bescheiden setzen berühren -- 
  Rakete rauschen -- Kanonenschlag donneren -- Leuchtkugel steigen -- Schwärmer schlängeln platzt -- Räd gischten -- jeder einzeln -- paaren -- -- Gewaltsamer hintereinander -- 
  Eduard Busen brennen -- verfolgt lebhaft zufrieden Blick feurig Erscheinung -- 
  ottilies zart -- aufgeregt Gemüt rauschend blitzend Entstehe verschwinden eher ängstlich angenehm -- 
  lehnen schüchtern Eduard -- Annäherung -- Zutrau voll Gefühl -- angehören -- 
  Nacht eintreten -- Mond aufgehen Pfade Rückkehrenden beleuchten -- 
  Figur -- Hut Hand -- vertreten Weg -- sprechen Almosen -- festlichen versäumen -- 
  Mond scheinen Gesicht Eduard erkennen Zug zudringlich Bettler -- 
  glücklich -- ungehaln -- einfallen -- Bettel höchlich verpönen -- 
  forschen Tasche Goldstück -- 
  glücklich -- Glück Grenze scheinen -- 
  Haus indes erwünscht gelingen -- 
  Tätigkeit Chirurg -- Bereitschaft Nötigen -- Beistand Charlottes -- wirkt Knabe Leben herstellen -- 
  Gast zerstreuen -- sowohl Feuerwerk Ferne sehen -- -- verworren Szene ruhig Heimat betreten -- 
  Hauptmann -- geschwind umgekleiden -- nötig Vorsorge tätig Anteil nehmen -- beruhigen finden Charlotte -- 
  zutraulich Freundlichkeit erklären -- Abreise nahe bevorstehen -- 
  Abend erleben -- Entdeckung Eindruck -- sehen -- Freund aufopferen -- retten retten -- 
  wunderbar Ereignis scheinen bedeutend Zukunft unglücklich weissagen -- 
  Eduard -- Ottilie Hereintrat -- bevorstehend Abreise Hauptmann gleichfalls ankündigen -- 
  argwohnen -- Charlotte Nähere wissen -- Absicht beschäftigen -- übel empfinden -- 
  Gegenteil vernehmen aufmerksam zufrieden ehrenvoll Lage Hauptmann versetzen -- 
  Unbändig drang geheim Wunsch Begebenheit -- 
  Charlotte verbinden -- Ottilie -- 
  fest größeres Geschenk -- 
  erstaunt Ottilie -- Zimmer treten köstlich Koffer Tisch finden -- 
  säumen eröffnen -- 
  zeigen schön packen ordnen -- auseinander nehmen -- lüften wagen -- 
  Musselin -- Batist -- Seide -- Schal Spitze wetteifert Feinheit -- Zierlichkeit Kostbarkeit -- 
  Schmuck vergessen -- 
  begriff Absicht -- Kopf Fuß kleiden -- kostbar fremd -- Gedanke zuzueignen Getraute -- 
  Sechzehntes Kapitel -- 
  morgens Hauptmann verschwinden -- dankbar gefühlt Blatt Freund zurückbleiben -- 
  Charlotte Abends vorher halb einsilbig Abschied nehmen -- 
  Empfand ewig Trennung ergeben darein -- 
  Brief Grafe -- Hauptmann zuletzt mitteilen -- Aussicht vorteilhafen Heirat Rede -- obgleich Punkt Aufmerksamkeit schenken -- halten Sache gewiß entsagen rein völlig -- 
  glauben Gewalt -- ausgeüben -- fordern -- 
  unmöglich -- Gleich -- 
  Sinn beginnen Gespräch Gemahl -- so_mehr zuversichtlich -- Empfand -- Sache allemal abtun müssen -- 
  Freund verlassen -- -- 
  vormals -- kommen -- völlig alt Zustand zurückkehren -- 
  Eduard -- vernehmen Leidenschaft schmeicheln -- glauben Charlotte Wort früh Witwenstand bezeichnen -- obgleich unbestimmt Weise -- Scheidung Hoffnung wollen -- 
  antwortet lächeln -- 
  -- 
  kommen -- verständigen -- 
  finden betrügen -- Charlotte versetzen -- 
  Ottilie Lage bringen -- gegenwärtig wählen -- finden doppelt Gelegenheit -- Verhältnis geben wünschenswert -- 
  Pension zurückkehren -- Tochter Großtante ziehen -- angesehen Haus aufnehmen -- einzig Tochter Vorteil standesmäßigen Erziehung genießen -- 
  indessen -- versetzen Eduard ziemlich fassen -- Ottilie freundlich Gesellschaft verwöhnen -- schwerlich willkommen -- 
  verwöhnen -- Charlotte -- letzter -- 
  indessen Epoche -- Besinnung auffordern -- ernstlich ermahnen -- gute sämtlich Mitglied unser Zirkel denken Aufopferung versagen -- 
  finden billig -- versetzt Eduard -- Ottilie aufgeopferen -- geschähen gegenwärtig fremd Mensch hinunt stieße -- 
  Hauptmann Geschick aufgesuchen -- Ruhe -- Behag wegscheiden lassen -- 
  wissen Ottilie bevorstehen -- übereilen -- 
  bevorstehen ziemlich klar -- versetzen Charlotte Bewegung -- Absicht allemal aussprechen -- fahren fort -- liebst Ottilie -- gewöhnst -- 
  Neigung Leidenschaft entspringen nähren Seite -- 
  Wort aussprechen -- Stunde gestehen bekennen -- 
  soviel Vorsicht -- fragen -- -- 
  sogleich antworten -- versetzt Eduard -- zusammennahmr -- lassen soviel sagen -- Alsdann entschließen abzuwart Zukunft lehren -- sagen -- Sache -- 
  vorauszusehen -- versetzt Charlotte -- bedürfen Weisheit -- soviel lassen Fall sagen -- jung -- Blindlings -- wohin -- 
  sorgen -- Freund -- Hofmeister -- 
  erwarten -- Äußerstes verlieren -- erwarten tadelnsweren lächerlich finden -- 
  mir_es verdenken -- versetzt Eduard -- offen rein Sprache Gattin erwidern vermögen -- Schelt -- Ottilies Glück Herzen liegen -- künftig -- berechnen -- Gegenwärtig -- 
  Denke -- aufrichtig Selbstbetrug -- Ottilie Gesellschaft rissen -- fremd Mensch untergeben -- fühlen grausam -- Veränderung zumuten -- 
  Charlotte Entschlossenheit Gemahl Verstellung gewahr -- 
  fühlen -- entfernen -- 
  Bewegung rufen -- Ottilie glücklich -- Entzweit -- 
  Gatte -- Kind Vater entreißen -- 
  Kind -- dächen -- sorgen -- Eduard lächelnd kalt -- freundlich fügen hinzu -- 
  Äußerste denken -- 
  äußerste liegen Leidenschaft allernachsen -- bemerken Charlotte -- 
  lehne -- -- gut Rat -- Hilfe bieten -- 
  trüb Fall wirken helfen Klarst sehen -- 
  diesmal ich_es -- 
  -- liebst Eduard -- laß gewähren -- 
  zumuen -- wohlerworben Glück -- schönsen -- geradehin Verzicht leisten -- 
  -- versetzt Eduard Verlegenheit -- 
  -- versetzen Charlotte -- Ottilie Nähe behalten -- stehsen -- entspringen -- 
  dringen -- überwinden -- Betrüg -- 
  Eduard fühlen -- 
  ausgesprochen Wort fürchterlich -- aussprechen -- Herz erlauben -- Augenblick auszuweichen -- erwidern Eduard -- 
  klar -- vorhast -- 
  Absicht -- versetzt Charlotte -- Vorschlag überlegen -- 
  -- 
  Pension Ottilie gemäßesen -- betrachten -- Kind -- 
  groß Lage versprechen -- bedenke -- -- 
  legen umständlich Gemahl Verhältnis dar schließen Wort -- 
  Meinung betreffen -- Haus Dame Pension vorziehen mehrere Ursache -- -- Neigung -- Leidenschaft jung Mann -- Ottilie gewinnen -- vermehren -- 
  Eduard scheinen Beifall geben -- Aufschub suchen -- 
  Charlotte -- ausgehen Entscheidend -- ergreifen sogleich Gelegenheit -- Eduard unmittelbar widersprechen -- Abreise Ottilies -- stille vorbereiten -- nächster Festzusetz -- 
  Eduard schauderen -- halten verraten liebevoll Sprache Frau ausgedachen -- künstlich planmäßig -- ewig Glück trennen -- 
  scheinen Sache überlassen -- innerlich Entschluß fassen -- 
  Atem -- bevorstehend unabsehlich Unheil Entfernung Ottilies abwenden -- entscheiden Haus verlassen -- vorbewußt Charlottes -- Einleitung täuschen verstehen -- Ottilies Abreise gegenwärtig -- Augenblick sehen wollen -- 
  Charlotte -- gewonnen glauben -- Vorschub -- 
  befehlen Pferd -- Kammerdiener nötig Anweisung einpacken folgen sollen -- -- Stegreife -- setzen schreiben -- 
  Eduard Charlotte -- 
  Übel -- Liebe -- befallen -- heilbar -- fühlen -- Augenblick verzweifeln -- Aufschub finden -- -- 
  Aufopfre fordern -- 
  verlass Haus kehr günstig ruhiger Aussicht -- 
  Sollst indessen besitzen -- Ottilie -- 
  wissen -- fremd Mensch -- 
  Sorge -- behandle -- -- Liebevoller -- freundlich zart -- 
  versprech heimlich Verhältnis Ottilie suchen -- 
  lassen unwissend -- leben -- gute denken -- 
  Denken -- 
  -- bitte -- innigst -- lebhaft -- machen Versuch Ottilie irgendwo unterzugeben -- Verhältnis bringen -- 
  Bezirk dein Schloß -- dein Park -- fremd Mensch anvertrauen -- gehören bemächtigen -- 
  Ehrst Neigung -- Wunsch -- Schmerz -- schmeichelst Wahn -- Hoffnung -- 
  Genesung widerstreben -- anbieten -- 
  --- letzter Wendung fließen Feder -- Herz -- 
  Papier -- fing bitterlich weinen -- 
  Weise Glück -- Unglück Ottilie lieben -- entsagen -- 
  fühlen -- 
  entfernen -- wissen entstehen -- 
  wiedersehen -- wiedersähe -- Sicherheit versprechen -- 
  Brief schreiben -- Pferd stehen Tür -- Augenblick müssen fürchten Ottilie irgendwo erblick Entschluß vereiteln sehen -- 
  fassen -- denken -- Augenblick zurückzukehr Entfernung wünschen nah -- 
  Gegenteil stellen Ottilie -- Haus drängen -- bleiben -- 
  siegelen Brief -- eilt Treppe hinab schwingen auf Pferd -- 
  wirtshause vorbeiritt -- Bettler Laube sitzen -- gestern Nacht reichlich beschenken -- 
  sitzen behaglich Mittagsmahl -- stehen neigen ehrerbietig -- anbetend Eduard -- 
  Gestalt gestern erscheinen -- Ottilie Arm führen -- erinnern schmerzlich glücklich Stunde Leben -- 
  leiden vermehrten -- Gefühl zurückließ unerträglich -- nochmals blickt Bettler -- 
  O Beneidenswerter -- rufen -- 
  gestrig Almose zehren -- gestrig Glück -- 
  Siebzehntes Kapitel -- 
  Ottilie treten an Fenster wegreiten hört Eduard Rücken -- 
  wunderbar -- Haus verlassen -- sehen -- Morgengruß bieten -- 
  unruhig nachdenklich -- Charlotte weit Spaziergang ziehen mancherlei Gegenstände sprechen -- Gemahl -- scheinen -- vorsätzlich -- erwähnen -- 
  Doppelt betreffen -- Zurückkunft Tisch Gedecke besetzen finden -- 
  vermissen ungern geringscheinend Gewohnheit -- schmerzlich empfind Entbehr bedeutend Fall -- 
  Eduard Hauptmann fehlen -- Charlotte lang erstenmal Tisch anordnen -- Ottilie scheinen absetzen -- 
  Frau sitzen -- Charlotte sprechen unbefang Anstellung Hauptmann weniger Hoffnung sehen -- 
  einzig tröstet Ottilie Lage -- glauben -- Eduard -- Freund Strecke begleiten -- nachgeritten -- 
  -- Tisch aufstanden -- sehen Eduard Reisewag Fenster -- Charlotte einigermaßen unwillig fragen -- hierher bestellen -- antworten -- Kammerdiener -- aufpacken wollen -- 
  Ottilie braucht Fassung -- Verwunderung Schmerz verbergen -- 
  Kammerdiener treten herein verlangen -- 
  Mundtas Herr -- paar silbern Löffel mancherlei Ottilie Reise -- läng außenbleiben deuten scheinen -- 
  Charlotte verweisen begehren trocken -- Versteh sagen wollen -- Herr beziehen -- Beschluß -- 
  gewandt Mann -- freilich -- Ottilie sprechen -- vorwand Zimmer locken -- wissen entschuldig verlangen beharren -- Ottilie gewähren wünschen -- Charlotte lehnen -- Kammerdiener müssen entfernen -- Wagen rolln fort -- 
  Ottilie schrecklich Augenblick -- 
  verstehen -- begreifen -- Eduard Geraume entreißen -- fühlen -- 
  Charlotte fühlt Zustand lassen -- 
  wagen Schmerz -- Träne schildern -- leiden unendlich -- 
  bitten Gott -- weghelfen -- überstand Nacht -- wiedergefunden -- glauben anderer Wesen antreffen -- 
  fassen -- ergeben -- -- groß Verlust -- befürchten -- 
  nächster Sorge -- Bewußtsein wiedergekehren -- sogleich -- -- Entfernung Mann -- gleichfalls entfernen -- 
  ahndet Eduard Drohung -- wodurch Aufenthalt Charlotte sichern -- dienen Betrag Charlotte Beruhigung -- 
  sucht Kind beschäftigen lassen selten -- ungern -- wissen -- Wort entschieden Leidenschaft wirken vermögen -- kennen Besonnenheit -- Bewußtsein -- bringen Ottilie Sprache -- 
  Trost -- gelegentlich -- Bedacht Vorsatz -- Weise Betrachtung anstelln -- 
  lebhaft -- -- Dankbarkeit Ruhe leidenschaftlich Verlegenheite hinaushelfen -- 
  Laß freudig Munter eingreifen -- Mann unvollenden zurückgelassen -- bereiten schön Aussicht Rückkehr -- stürmend ungeduldig Wesen zerstören -- Mäßigung erhalten fördern -- 
  Mäßigung sprechen -- lieb Tante -- versetzen Ottilie -- bergen -- Unmäßigkeit Mann -- Wein betreffen -- einfällen -- 
  betrüben ängstigen -- bemerken müssen -- rein Verstand -- Klugheit -- Schonung anderer -- Anmut Liebenswürdigkeit -- mehrere Stunde -- verlieren gehen -- gut trefflich Mann hervorzubringen gewähren vermögen -- Unheil Verwirrung hereinzubrechen drohen -- 
  gewaltsam Entschließung veranlassen -- 
  Charlotte -- setzt Gespräch fort -- 
  fühlen -- Ottilie bloß Eduard Sinn -- gewöhnlich -- öfter wünschenswert -- Vergnügen -- Gesprächigkeit -- Tätigkeit gelegentlich Weingenuß steigern pflegen -- 
  Äußerung Charlotte Ottilie Mann -- Eduard -- heran denken -- desto auffallend -- Charlotte bevorstehend Heirat Hauptmann -- bekannt gewiß Sache sprechen -- wodurch anderer ansehen gewinnen -- Eduard früh Versicherung vorstellen -- 
  vermehrt Aufmerksamkeit Ottilies Äußerung -- Wink -- Handlung -- Schritt Charlottes -- 
  Ottilie klug -- scharfsinnig -- argwöhnisch wissen -- 
  Charlotte durchdrang indessen einzeln Umgebung scharfem Blick wirken klar Gewandtheit -- wobei Ottilie beständig nehmen nötigen -- 
  ziehen Haushalt -- Bänglichkeit -- Enge -- -- genau betrachten -- halten leidenschaftlich Vorfall Art glücklich Schickung -- 
  bisherig Weg grenzenlos geraten schön Zustand reichlich Glücksgüter -- zeitig besinnen -- vordringlich Leben treiben -- zerstören -- erschüttern -- 
  Parkanlag Gange -- stören -- 
  lassen vielmehr dasjenig fortsetz -- Grund künftig Ausbildung liegen müssen -- bewenden -- 
  zurückkehrend Gemahl erfreulich Beschäftigung finden -- 
  Arbeit Vorsätz Verfahren Architekt loben -- 
  See liegen kurz ausbreiten Auge -- neu entstanden Ufer zierlich mannigfaltig bepflanzen Berast -- 
  Haus rauh Arbeit vollbringen -- Erhaltung nötig -- besorgt -- Abschluß Vergnügen vorn anfangen -- 
  ruhig heit -- Ottilie scheinen -- 
  beobachtet Symptom -- Eduard erwarten -- -- 
  interessiert Betrachtung -- 
  Willkommen Anstalt -- Bauerknabe versammeln abzielt -- weitläufig geworden Park rein erhalten -- 
  Eduard Gedanken hegn -- 
  lassen Knabe Art heiter Montierung -- abendstunde anzogen -- reinigen säubern -- 
  Garderobe Schloß -- verständigst -- genauest Knabe vertraut Aufsicht -- Architekt leiten -- ehe sich_es versehen -- Knabe gewiß Geschick -- 
  finden bequem Dressur verrichtet Geschäft Art Manöver -- 
  gewiß -- Scharreis -- gestielt Messerklinge -- Reche -- Spat hacken wedelartig Besen einherzogen -- Korb hinterdrein kommen -- Unkraut Stein Seite schaffen -- hoch eisern Walzenrad herzog -- hübsch erfreulich Aufzug -- Architekt artig Folge Stellung Tätigkeit Frie Gartenhauses anmerken -- Ottilie hingegen Art Parade rückkehrend Hausherr begrüßen -- 
  Mut Lust Ähnlichem empfangen -- 
  zeith Mädchen Dorf Nähen -- Strick -- Spinn weiblich Arbeit ermuntern suchen -- 
  Tugende zunehmen Anstalten Reinlichkeit Schönheit Dorfes -- 
  Ottilie wirken stets -- zufällig -- Gelegenheit Neigung -- 
  Gedachte vollständig Folgerechter -- 
  Anzahl Mädchen lassen Chor bilden -- Anzahl Knabe -- 
  folgen gut Sinn -- deutlich -- suchen Mädchen Anhänglichkeit Haus -- Eltern Geschwister einflößen -- 
  gelingen -- 
  -- lebhaft Mädchen klagen -- Geschick -- Haus allemal wollen -- 
  Ottilie Mädchen Feind -- freundlich -- 
  ziehen -- laufen -- erlauben -- 
  tätig -- munt unermüden -- 
  Anhänglichkeit schön Herrin scheinen Kind Bedürfnis -- 
  anfänglich duldet Ottilie Begleitung Kindes -- fassen Neigung -- trennn Nanny begleiten Herrin überall -- 
  öfters Weg Garten freut schön gedeihen -- 
  Beeren- Kirschenzeit -- Spätlinge Nanny schmecken lassen -- 
  übrig Obste -- Herbst reichlich Ernte versprechen -- gedacht Gärtner beständig Herr niemals herbeizuwünsch -- 
  Ottilie hören gut alt Manne -- 
  verstehen Handwerk vollkommen hören -- Eduard vorzusprechen -- 
  Ottilie freuen -- Pfropfreiser Frühjahr schön bekommen -- erwidern Gärtner bedenklich -- 
  wünschen -- Herr Freude erleben mögen -- 
  Herbst -- sehen -- köstlich Sorte Herr Vater alt Schloßgarten stehen -- 
  jetzig Herr Obstgärtner zuverlässig Kartäuser -- 
  Katalog finden lauter honett Name -- 
  pfropfen erziehen Frucht tragen -- Mühe wert -- Baum Garten stehen -- 
  wiederholtesen fragt treu Diener -- fast Ottilie -- Rückkunft Herr -- Termin -- 
  Ottilie angeben -- lassen Mann still Betrübnis merken -- glauben vertrau -- peinlich Gefühl Unwissenheit -- Weise aufgedrungen -- 
  Rabatt Beete trennen -- 
  säen -- pflanzen -- stehen völlig Flor -- bedurft Pflege -- Nanny Gießen bereit -- 
  Empfindung betrachtet Ottilie spät Blume -- anzeigt -- Glanz Fülle dereinst Eduard Geburtstag -- Feier manchmal versprechen -- prangen -- Neigung Dankbarkeit ausdrücken -- 
  Hoffnung fest sehen lebendig -- 
  Zweifel Sorge umflüsteren stets Seele gut Mädchen -- 
  eigentlich offen Übereinstimmung Charlotte bringen -- 
  freilich Zustand beide Frau verschieden -- 
  alte bleiben -- Gleis gesetzmäßig Leben zurückkehren -- gewinnen Charlotte gegenwärtig Glück -- froh Aussicht Zukunft öffnen -- Ottilie hingegen verlieren -- sagen -- -- 
  Leben Freude Eduard finden -- gegenwärtig Zustande fühlt unendlich Leere -- wovon ahnden -- 
  Herz suchen -- fühlen mangle -- Herz verlieren -- fühlen entbehren -- 
  Sehnsucht verwandeln Unmut Ungeduld -- weiblich Gemüt -- erwarten Abwart gewöhnen -- Kreis herausschreiten -- tätig -- unternehmen Glück -- 
  Ottilie Eduard entsagen -- 
  -- obgleich Charlotte klug -- Überzeugung -- Sache annehmen -- entscheiden voraussetzt -- freundschaftlich ruhig Verhältnis Gatten Ottilie -- 
  liegen Nacht -- einschließen -- Knium eröffnet Koffer betrachtet Geburtstagsgeschenke -- brauchen -- zerschneiden -- fertigen -- 
  eilt Mädchen Sonnenaufgang Haus -- Glückseligkeit finden -- frei hinaus -- Gegend -- ansprach -- 
  Boden verweilen -- 
  springen Kahn -- rudern mitten See -- ziehen Reisebeschreibung hervor -- lassen bewegt Welle schaukeln -- lesen -- träumt Fremde finden Freund -- herzen nahe bleiben -- ihrigen -- 
  achtzehnt Kapitel -- 
  wunderlich tätig Mann -- kennen lernen -- Mittler -- Unheil -- Freund ausbrechen -- Nachricht erhalten -- obgleich Hilfe anrufen -- Fall Freundschaft -- Geschicklichkeit beweisen -- üben neigen -- lassen denken -- 
  scheinen rätlich -- Weile zaudern -- 
  wissen -- schwer -- gebildet Mensch sittlich Verworrenheit Hilfe -- ungebildeten -- 
  überlassen -- zuletzt aushalt -- eilt Eduard aufsuchen -- Spur kommen -- 
  Weg führen angenehm Tal -- anmutig grün baumreich Wiesengrund Wasserfülle lebendig Bach durchschlängelen durchrauschte -- 
  sanft Anhöhe ziehen fruchtbar Feld wohlbestanden Obstpflanzung -- 
  Dorf liegen nah -- friedlich Charakter einzeln Partien -- malen -- scheinen Leben vorzüglich geeignet -- 
  wohlerhalten Vorwerk reinlich bescheiden Wohnhaus -- Garten umgeben -- fallen Auge -- 
  vermuten -- Eduard gegenwärtig Aufenthalt -- irren -- 
  einsamen Freund soviel sagen -- still Gefühl Leidenschaft überlassen mancherlei Plan ausdacht -- mancherlei Hoffnung nähren -- 
  leugnen -- Ottilie sehen wünsch -- wünschen hierher führen -- locken -- Erlaubt unerlaubte denken verwehren -- 
  schwankt Einbildungskraft Möglichkeit herum -- 
  besitzen -- rechtmäßig besitzen -- Besitz zueignen -- 
  still -- unabhängig leben -- glücklich -- selbstquälerisch Einbildungskraft führen -- glücklich -- 
  verfloss ewig Schwank Hoffnung Schmerz -- Träne Heiterkeit -- Vorsätz -- Vorbereitung Verzweiflung -- 
  Anblick Mittler überraschen -- 
  Ankunft längst erwarten -- halb willkommen -- 
  Glaubte Charlotte senden -- allerlei Entschuldigung Verzögerung sodann entscheidend Vorschlag bereiten -- hoffen Ottilie vernehmen -- Mittler leiben himmlisch Bote -- 
  verdrießlich verstimmen Eduard vernehmen -- Mittler kommen dorth -- eigen Antrieb -- 
  Herz verschließen Gespräch anfangs einleiten -- 
  wissen Mittler -- liebevoll beschäftigt Gemüt dringend Bedürfnis äußeren -- vorgehen -- Freund auszuschütten -- lassen fallen -- einig Hin- widerred -- diesmal Rolle herauszugehen -- Vermittler vertraute spielen -- 
  hiernach -- freundlich Weise -- Eduard einsamen Leben tadelen -- erwidern -- 
  O wissen -- angenehm zubringen -- 
  beschäftigen -- Nähe -- 
  unschätzbar Vorteil denken -- Ottilie befinden -- -- stehen -- ausruhen -- 
  sehen handeln gewöhnlich -- schaffen vornehmen -- freilich meisten schmeicheln -- 
  bleiben -- 
  fern glücklich -- 
  arbeiten Phantasie -- Ottilie nähern -- 
  schreiben süß zutraulich Brief Name -- antwort verwahr Blatt -- 
  versprechen Schritt -- halten -- 
  binden -- wenden -- 
  Charlotte Grausamkeit -- Versprechen Schwor fordern -- schreiben -- Nachricht geben wollen -- 
  -- wahrscheinlich finden unerhört -- unerträglich -- 
  lieben -- glauben -- wissen -- entschließen -- wagen -- flieh Arm werfen -- 
  -- denken manchmal -- -- 
  Vorsaal regen -- sehen Türe -- 
  hereintreen -- denken -- hoffen -- 
  -- 
  mögliche unmöglich -- bild -- Unmögliche müssen -- 
  nachts aufwach -- Lampe unsicher Schein Schlafzimmer werfen -- Gestalt -- Geist -- Ahnung -- vorüberschweben -- herantreten -- ergreifen -- Augenblick -- Art Versicherung -- denken -- -- 
  einzig Freude bleiben -- 
  nah -- träumen -- fern Traume -- sonderbar -- liebenswürdig Person Nachbarschaft kennen lernen -- erscheinen Bild Traum -- sagen -- sehen -- 
  Findest schönerer lieberes -- 
  mischen Bild Traum -- 
  begegnen -- schieben durch- übereinander -- 
  unterschreiben Kontrakt -- Hand meinig -- Name meinig -- löschen -- verschlingen -- 
  Schmerz wonnevoll Gaukeleien Phantasie -- 
  manchmal tun -- rein Idee beleidigen -- -- fühlen -- lieb -- Beschreibung ängsten -- 
  manchmal necken Art qualten -- sogleich verändern Bild -- schön -- rund himmlisch Gesichtchen verlängern -- 
  -- 
  quälen -- unbefriedigt zerrütten -- 
  lächeln -- Mittler -- -- lächeln -- 
  O schäm Anhänglichkeit -- -- -- törichn rasend Neigung -- 
  -- gelieben -- erfahren -- -- 
  Leben Vorspiel -- Hinhalte -- Zeitvertreib -- Zeitverderb -- kennen lernen -- lieben eigentlich lieben -- 
  -- Gesicht -- Rücken -- Vorwurf -- 
  pfusch -- stümp meister Ding -- 
  -- finden worin Meister zeigen -- 
  sehen -- Talent Lieben übertreffen -- 
  Jammervolles -- schmerzen- Tränenreich -- finden -- -- schwerlich aufgeben -- 
  lebhaft herzlich Äußerung Eduard erleichtern -- einzeln Zug wunderlich Zustand deutlich Auge treten -- schmerzlich Widerstreit überwältigen Träne ausbrechen -- reichlich fließen -- Herz Mitteilung weich -- 
  Mittler -- rasch Naturell -- unerbittlich Verstand verleugnen -- schmerzlich Ausbruch Leidenschaft Eduard Ziel Reise verschlagen -- äußern aufrichtig derb Missbilligung -- 
  Eduard -- heißen -- sollen ermannen -- sollen bedenken -- Manneswürde schuldig -- sollen vergessen -- Mensch hoch Ehre gereich Unglück fassen -- Schmerz Gleichmut Anstand ertragen -- höchlich schätzen -- verehrt Muster aufstellen -- 
  Aufgeregt -- durchdrung peinlichst Gefühl -- Eduard -- müssen Wort hohl nichtig vorkommen -- 
  Glücklich -- behagliche Rede -- fahren Eduard -- schämen -- Einsähe -- unerträglich Leidenden -- 
  unendlich Geduld geben -- unendlich Schmerz starr behagliche anerkennen -- 
  Fall -- -- Trost niederträchtig Verzweiflung Pflicht -- 
  Verschmäht edl Grieche -- Held schildern wissen -- keineswegs -- seinigen schmerzlich Drange weinen lassen -- 
  Sprüchwort -- Tränenreiche Mann -- 
  Verlas -- trocken Herzens -- trocken Auge -- 
  verwünsch Glückliche -- Unglückliche Spektakel dienen -- 
  grausamst Lage körperlich geistig Bedrängnis Edel gebärden -- Beifall erhalten -- verscheiden applaudieren -- Gladiator Anstand Auge umkommen -- 
  Mittler -- danken Besuch -- erzeigt Liebe -- Garten -- Gegend umsähen -- 
  -- 
  Suche Gefaßter ähnlich -- 
  Mittler einlenken Unterhaltung abbrechen -- anknüpfen -- 
  Eduard gemäß -- Gespräch fortsetzen -- ohnehin Ziel abzulaufen streben -- 
  freilich -- Eduard -- helfen Hin- wiederdenken -- Hin- widerrede -- reden gewahr -- entscheiden fühlen -- wozu entschließen -- wozu entschließen -- 
  sehen gegenwärtig -- zukünftig Leben -- Elend Genuß wählen -- 
  Bewirk -- gut Mann -- Scheidung notwendig -- geschehen -- schaffen Charlott Einwilligung -- 
  ausführen -- glauben erlangen -- 
  -- Mann -- beruhigen -- glücklich -- 
  Mittler stocken -- 
  Eduard fahren fort -- Schicksal Ottilies trennen Grunde -- 
  sehen Glas -- 
  Namenszug darein geschnitten -- 
  fröhlich Jubelnder werfen Luft -- trinken -- felsigen Boden zerschellen -- auffangen -- 
  hoch Preis einhandeln trinken täglich -- täglich überzeugen -- Verhältnis unzerstörbar -- Schicksal beschließen -- 
  O wehe -- rufen Mittler -- Freund Geduld -- 
  begegnen Aberglaube -- schädlich Mensch einkehren -- verhassen bleiben -- 
  spielen Voraussagungen -- Ahnungen Träum alltäglich Leben bedeutend -- 
  Leben bedeutend -- bewegen Braust -- Gewitter Gespenster fürchterlich -- 
  Lasse Ungewißheit Leben -- rufen Eduard -- hoffen bangen -- bedürftig Herz Art Leitster -- hinblick -- Steuer -- 
  lassen fallen -- versetzen Mittler -- Konsequenz hoffen -- finden -- warnend Symptom achten Mensch -- schmeichelnder versprechend Aufmerksamkeit richten Glaube lebendig -- 
  Mittler sogar dunkel Region führen -- unbehaglich fühlen -- lang verweilen -- dringend Wunsch Eduard -- Charlotte heißen -- Williger -- 
  Eduard Augenblick entgegensetzen -- 
  gewinnen -- erforsch Frau stehen -- -- Gesinnung übrig bleiben -- 
  eilt Charlotte -- fassen heit finden -- 
  unterrichtet vorgefallen -- 
  Eduard Rede Wirkung abnehmen -- 
  treten Seite behutsam heran -- gewinnen -- Wort Scheidung vorbeigehen aussprechen -- 
  verwundern -- erstaunt -- Gesinnung -- erheiteren -- Charlotte -- Gefolge Unerfreulichen -- -- 
  glauben -- hoffen -- geben -- Eduard nähern -- 
  -- Hoffnung finden -- 
  verstehe -- 
  fallen Mittler -- vollkommen -- versetzen Charlotte -- Tausendmal segnen Nachricht -- rufen -- Hand zusammenschlagend -- 
  kenn Stärke Argument männlich Gemüt -- 
  Heirat beschleunigen -- befestigen -- herstellen -- 
  tausend Wort wirken Hoffnung -- fürwahr gut Hoffnung -- 
  -- fahren fort -- betreffen -- Ursache verdrießlich -- 
  Fall -- sehen -- Eigenlieb schmeicheln -- 
  Tätigkeit verdienen -- 
  kommen -- Arzt -- Freund -- Kur gelangen -- Gott Wille arme -- selten reiche heilen -- bezahlen -- 
  glücklicherweise helfen Sache -- Bemühung -- Zureden fruchtlos bleiben sein -- 
  Charlotte verlangen -- sollen Nachricht Eduard bringen -- Brief mitnehmen sehen -- -- herstellen -- 
  eingehen -- 
  tun -- rufen -- 
  Schreiben -- Bote -- 
  Schritt hinwend Nötiger -- 
  kommen -- Glück wünschen -- kommen Taufe -- 
  Charlotte diesmal -- öfters -- Mittlerum unzufrieden -- 
  rasch Wesen bringen hervor -- Übereilung schuld Missling -- 
  abhängig augenblicklich vorgefaßt Meinung -- 
  Charlottes Bote Eduard -- halb Schrecken empfangen -- 
  Brief entscheiden -- 
  wagt aufbrechen -- stehen betreffen -- Blatt lesen -- versteineren folgend Stelle -- womit endigen -- 
  -- Gedenke nächtlichen Stunde -- Gattin abenteuerlich Liebender besuchtesen -- unwiderstehlich zogst -- Geliebte -- Braut Arm schlossest -- 
  Laß seltsam Zufälligkeit Fügung Himmel verehren -- neu Band Verhältnis sorgen -- Augenblick Glück unser Leben auseinander fallen verschwinden drohen -- 
  Augenblick Seele Eduard vorging schwer schildern -- 
  Gedränge treten zuletzt alt Gewohnheit -- alt Neigung hervor -- töten Lebensraum ausfüllen -- 
  Jagd Krieg Edelmann bereiten Aushülfe -- 
  Eduard sehnen äußer Gefahr -- innerlich Gleichgewicht halten -- 
  sehnt Untergang -- unerträglich drohen -- Trost denken -- Geliebte -- Freund glücklich können -- 
  stellen Wille Hindernis entgegen -- Entschluß verheimlichten -- 
  Förmlichkeite setzen Testament -- süß Empfindung -- Ottilie vermachen -- 
  Charlotte -- ungeborene -- Hauptmann -- Dienerschaft sorgen -- 
  ausgebrochen Krieg begünstigt Vorhaben -- 
  militärisch Halbheit Jugend schaffen -- Dienst verlassen -- herrlich Empfindung -- Feldherr ziehen -- sagen -- Anführung Tod wahrscheinlich Sieg gewiß -- 
  Ottilie -- Charlott Geheimnis -- betroffen Eduard -- -- -- 
  sagen -- 
  hoffen -- wünschen -- 
  Blick Innere gewähren Tagebuch -- mitteilen gedenken -- 