Wilhelm Meister Lehrjahre -- 
  Roman -- 
  Herausgegebe Goethe -- 
  Band -- Berlin -- 
  Johann Friedrich Unger -- 1795 -- 
  Wilhelm Meister Lehrjahre -- 
  Buch -- 
  Kapitel -- 
  Schauspiel dauern -- 
  alt Barbara treten einigemal an Fenster horchen -- Kutsch rasseln -- 
  erwartet Mariane -- schön Gebieterin -- Nachspiel -- jung Offizier kleiden -- Publikum entzücken -- groß Ungeduld -- -- mäßig Abendessen vorzusetzen -- diesmal Paket überraschen -- Norberg -- jung reich Kaufmann -- Postwag schicken -- zeigen -- Entfernung geliebter gedenken -- 
  Barbara alt Dienerin -- vertraute -- Ratgeberin -- Unterhändlerin Haushälterin Besitz -- Siegel eröffnen Abend Neugierd widerstehen -- Gunst freigebig Liebhaber Mariane Herzen liegen -- 
  groß Freude Paket fein Stück Nesseltuch neusten Band Mariane -- Stück Kattu -- Halstüch Röllchen Geld finden -- 
  Neigung -- Dankbarkeit erinnern abwesend Norberg -- lebhaft -- Mariane gedenken -- erinnern -- schuldig Treue hoffen erwarten müssen -- 
  Nesseltuch -- Farbe halbaufgerollten Band beleben -- liegen Christgeschenk Tischchen -- Stellung Licht erhöht Glanz Gabe -- Ordnung -- alt Tritt Mariane Treppe vernehmen -- entgegen eilen -- 
  verwundern treten -- weiblich Offizierchen -- Liebkosung -- vorbei drängen -- ungewöhnlich Bewegung Zimmer treten -- Federhut Degen Tisch werfen -- unruhig nieder feierlich angezündet Lichter Blick gönnen -- 
  -- Liebchen -- rufen alte verwundern -- 
  Ums Himmelswille -- Töchterch -- gibt_es -- 
  Sieh Geschenk -- 
  -- zärtlichst Freund -- 
  Norberg schicken Stück Musselin Nachtkleide -- -- scheinen eifrig freigebig jemals -- 
  alte kehren -- Gabe -- womit bedacht -- vorweisen -- Mariane -- Geschenken wegwendend -- Leidenschaft ausraufen -- fort -- fort -- hören -- gehorchen -- -- -- 
  Norberg zurückkehren -- -- -- machen -- -- hättest tausend Zunge -- solltest Vorsatz ausreden -- 
  geben -- lieben lieben -- 
  Gesicht -- 
  Leidenschaft überlassen -- ewig dauern -- 
  alte fehlt Gegenvorstellungen Grund -- ferner Wortwechsel heftig bitter -- springen Mariane fassen Brust -- 
  alt lachte überlauen -- 
  sorgen -- rufen -- Kleid -- Leben sicher -- 
  Fort -- ziehen -- 
  hoff Mädchen abbitten -- flüchtig Junker Leide_es zufügen -- herunter Rock fort herunter -- unbequem Tracht -- gefährlich merken -- 
  Achselbänder begeistern -- 
  alt Hand legen -- Mariane reißen -- 
  geschwind -- rufen -- 
  Besuch erwarten -- 
  -- versetzt alt -- 
  jung -- zärtlich -- unbefiedert Kaufmannssohn -- 
  -- versetzen Mariane -- 
  scheinen -- Großmut eur herrschend Leidenschaft -- erwidern alte spottend -- 
  nehmen Unmündig -- Unvermögende groß Eifer -- 
  reizend -- uneigennützig Geberin angebeten -- 
  -- Spott -- 
  lieben -- 
  Lieb -- -- 
  Entzück sprechen erstenmal Wort -- 
  Leidenschaft -- vorstellen -- Begriff -- 
  -- Hals werfen -- 
  fassen -- ewig halten -- 
  Liebe zeigen -- Liebe Umfang genießen -- 
  -- Mäßigt -- alte gelassen -- mäßigen -- 
  eur Freude Wort unterbrechen -- Norberg -- vierzehn -- 
  Brief -- Geschenk begleiten -- -- 
  Morgensonne Freund rauben -- mir_es verbergen -- 
  vierzehn -- 
  Ewigkeit -- 
  vierzehn -- vorfallen -- verändern -- 
  Wilhelm treten Herein -- 
  Lebhaftigkeit fliegen entgegen -- Entzück umschlang rot Uniform -- drücken weiß atlaswestch Brust -- 
  wagen beschreiben -- geziemt -- Seligkeit zwei liebend aussprechen -- 
  alte murrend Seite -- entfernen lassen Glückliche -- 
  Kapitel -- 
  Wilhelm Mutter Morgens begrüßen -- eröffnen -- Vater verdrießlich -- täglich Besuch Schauspiel nächstens untersagen -- 
  -- fahren fort -- manchmal Theater gehen -- verwünsch -- häuslich Ruhe unmäßig Leidenschaft Vergnügen stören -- 
  Vater wiederholen -- wozu nützen -- 
  verderben können -- -- 
  hören -- versetzen Wilhelm -- hastig antworten -- um Himmelswille Mutter -- 
  unnütz -- unmittelbar Geld Beutel bringen -- allernächst Besitz verschaffen -- 
  alt Haus Raum -- nötig neu bauen -- 
  Verwenden Vater jährlich ansehnlich Handelsgewinne Verschönerung Zimmer -- 
  seiden Tapet -- englisch Mobilie unnütz -- 
  Können geringeren begnügen -- 
  bekennen -- gestreifter Wand -- hundertmal wiederholt Blume -- Schnörkel -- Körbchen Figur unangenehm Eindruck -- 
  höchstens Theatervorhang -- 
  ist_es sitzen -- 
  warten -- wissen -- Höhe -- mannigfaltigst Gegenstand sehen -- unterhalten -- aufklären erheben -- -- 
  Mache mäßig -- Mutter -- Vater Abends unterhalten -- glauben -- zerstreu -- tragen -- verdrießlich -- Schuld -- 
  müssen verwünscht Puppenspiel vorwerfen lassen -- zwölf heilig Christ -- Geschmack Schauspiele beibringen -- 
  Schelt Puppenspiel -- lassen Liebe Vorsorge gereuen -- 
  vergnügn Augenblick -- leer Haus Genoß -- sehen Augenblick -- wissen -- sonderbar vorkommen -- -- Empfang gewöhnlich Christgeschenke -- Türe niedersitzen heißen -- Zimmer herein -- 
  eröffnen -- wiederlaufen -- Eingang unerwartet Festlichkeit ausgefüllt -- 
  baut Portal Höhe -- mystisch Vorhang verdecken -- 
  stehen ferne -- Neugierd groß -- sehen blinkend rasselnd halb durchsichtig Hülle verbergen -- weisen Stühlchen Gebot Geduld warten -- 
  sitzen still -- Pfeife Signal -- Vorhang rollt Höhe -- zeigen Hochrot gemalt Aussicht Tempel -- 
  Hohepriester Samuel erscheinen Jonathan -- wechselnd wunderlich Stimme kommen höchst ehrwürdig -- 
  Betrat Saul Szene -- Verlegenheit Impertinenz schwerlöthig Krieger -- seinigen herausgefordern -- 
  zwerggestaltet Sohn Isai Schäferstab -- Hirtentasch Schleuder hervorhüpfn sprechen -- 
  Großmächtigster König Herr Herr -- entfall Mut deswillen -- Majestät erlauben -- hingeh gewaltig Riese Streit treten -- -- 
  Akt geenden Zuschauer höchst begierig sehen vorgehen -- jeder wünscht Musik aufhören -- 
  Vorhang Höhe -- 
  David weiht Fleisch Ungeheures vögeln Himmel Tier Feld -- Philister sprechen Hohn -- stampfen Fuß -- fallen Klotz Sache herrlichen Ausschlag -- 
  nachh Jungfraue singen -- 
  Saul Tausend schlagen -- David Zehntausend -- Kopf Riese Überwind hergetrag -- schön Königstochter Gemahlin erhalten -- verdroß Freude -- Glücksprinz zwergmäßig bilden -- 
  Idee Goliath David verfehlen charakteristisch -- 
  bitte -- Puppe hingekommen -- 
  versprechen -- Freund zeigen -- Vergnügen -- neulich Kinderspiel unterhalten -- 
  wundern -- Ding lebhaft erinnerst -- 
  nahmst groß Anteil -- 
  wissen -- Büchelche entwendetest Stück auswendig lerntest -- gewahr -- Abends Goliath David Wach Machtest -- perorieren Ließest -- Riese Stoß gabst unförmlich Haupt Stecknadel wächsern Griff David Hand klebtest -- 
  herzlich mütterlich Freude Gedächtni pathetisch Rede -- sogleich vornehmen -- hölzern Truppe übergeben -- 
  denken -- verdrießlich Stunde -- 
  -- Las gereuen -- versetzen Wilhelm -- 
  scherze vergnügt Stunde -- 
  erbat Schlüssel -- eilen -- finden Puppe Augenblick Zeit versetzen -- beleben scheinen -- Lebhaftigkeit Stimme -- Bewegung Hand beleben glauben -- 
  Stube verwahren sorgfältig -- 
  Kapitel -- 
  Liebe -- allgemein behaupten hören -- schöne -- Herz empfinden -- unser Held dreifach glücklich preisen -- gönnen -- Wonne einzig Augenblick Umfange genießen -- 
  Mensch vorzüglich begünstigen -- indes meister früh Empfindung hart Schule führen -- -- kümmerlich Genuß -- zwingen -- Wunsch entsagen -- -- hoch Glückseligkeit vorschweben -- entbehren lernen -- 
  flügeln Einbildungskraft Wilhelm Begierde reizend Mädchen erheben -- kurz Umgange Neigung gewinnen -- finden Besitz Person -- lieben -- verehren -- 
  günstig Licht theatralisch Vorstellung erscheinen -- Leidenschaft Bühne verbinden Liebe weiblich Geschöpf -- 
  Jugend lassen reich Freude genießen -- lebhaft Dichtung erhöhen erhalten -- 
  Zustand geliebter Betrag Stimmung -- Empfindung Hilfe -- Furcht -- Geliebt übrig Verhältnis entdecken -- verbreitet liebenswürdig Anschein Sorge Scham -- Leidenschaft lebhaft -- Unruhe scheinen Zärtlichkeit vermehren -- lieblichste Geschöpf arme -- 
  Taumel Freude erwachen -- Leben Verhältnis zurückblicken -- erscheinen neu -- Pflicht heilig -- Liebhabereie lebhaft -- Kenntnis deutlich -- Talent kräftig -- Vorsatz entschieden -- 
  -- Einrichtung treffen -- Vorwurf Vater entgehen -- Mutter beruhigen Mariane Liebe ungestört genießen -- 
  verrichten Tag Geschäft pünktlich -- entsagen gewöhnlich Schauspiel -- Abends Tisch unterhaltend -- schlich -- Bette -- Mantel hüllen -- sacht Garten hinaus eilen -- Lindor Leander Busen -- unaufhaltsam geliebter -- 
  bringen -- fragt Mariane -- Abends Bündel hervorweisen -- alt -- Hoffnung angenehm Geschenk -- aufmerksam betrachten -- 
  erraten -- versetzen Wilhelm -- 
  verwundert Mariane -- entsetzen Barbara -- aufgebunden Serviett verworren Haufen spannenlang Puppe sehen lassen -- 
  Mariane lachen laut -- Wilhelm verworren Draht auseinander wickeln Figur einzeln vorzeigen bemühen -- 
  alt schlich verdrießlich Seite -- 
  bedürfen Kleinigkeit -- Liebende unterhalten -- vergnügen Freund Abend auf gut -- 
  Truppe mustern -- Figur genau betrachten Belacht -- 
  König Saul schwarz Samtrocke golden Krone Mariane fallen -- sehen -- -- Steif pedantisch -- 
  Desto behagen Jonathan -- glatt Kinn -- gelb rot Kleid Turban -- 
  wissen artig Draht drehen -- lassen Reverenze Liebeserklärung hersagen -- 
  Prophet Samuel mindeer Aufmerksamkeit schenken -- Wilhelm Brustschildchen anpreisen erzählen -- Schillertaft Leibrock alt Kleide Großmutter nehmen -- 
  David klein -- Goliath -- halten Jonathan -- 
  wissen artig -- zuletzt Liebkosung Puppe unser Freund herüber tragen -- diesmal gering Spiel Einleitung glücklich Stunde -- 
  Süßigkeit zärtlichen Traum Lärm wecken -- Straße entstehen -- 
  Mariane rufen alte -- -- Gewohnheit fleißig -- veränderlich Material Theatergarderobe Gebrauch nächster Stück anpassen beschäftigen -- 
  Auskunft -- Gesellschaft lustig Geselle Italiener Keller heraus Taumle -- frisch Auster -- ankommen -- Champagner schonen -- 
  Schade -- Mariane -- eingefallen -- -- 
  -- versetzen Wilhelm reichen alt Louisdor -- verschaffen -- wünschen -- Sie_es genießen -- 
  alte behend -- kurz stehen artig bestellt Tisch wohlgeordnet Kollation Liebenden -- 
  alte müssen setzen -- aß -- trank lassen -- 
  Fall fehlen Unterhaltung -- 
  Mariane Jonathan -- alte wissen Gespräch Wilhelm Lieblingsmaterie wenden -- 
  -- -- Aufführung Puppenspiel Weihnachtsabend unterhalten -- lustig hören -- 
  unterbrechen -- Ballett angehen -- 
  kennen herrlich Personal -- Wirkung hervorbrachte -- 
  -- Mariane -- erzählen -- dir_es Mute -- 
  schön Empfindung -- lieb Mariane -- versetzen Wilhelm -- alt Zeit alt unschädlich Irrtum erinnern -- Augenblick geschehen -- Höhe glücklich erreichen -- umseh zurückgelegt Weg überschauen -- 
  angenehm -- selbstzufried -- Hindernis erinnern -- peinlich Gefühl unüberwindlich halten -- dasjenig -- entwickeln -- vergleichen -- unentwickelt -- 
  unaussprechlich glücklich fühlen -- Augenblick reden -- vorwärts reizend Land schau -- Hand Hand durchwandern -- 
  Ballett -- fallen alte -- 
  fürcht -- ablaufen -- -- 
  O -- versetzen Wilhelm -- -- 
  wunderlich Sprung Mohr Mohrinn -- Schäfer Schäferinn -- Zwerg Zwergin -- dunkel Erinnerung Leben bleiben -- 
  fallen Vorhang -- Türe schließen Gesellschaft eilt betrunken taumelnd Bette -- wissen -- einschlafen -- erzählen -- Frage -- ungern Wärterin entlassen -- Ruhe bringen -- 
  magisch Gerüste verschwinden -- mystisch Schleier weggehoben -- Türe frei Stube -- Abenteuer Spur zurückgelassen -- 
  Geschwister laufen Spielsache -- schlich -- scheinen unmöglich -- Türpfost -- gestern Zauberei -- 
  verloren Liebe suchen -- Unglücklicher -- scheinen -- 
  freudetrunken Blick -- Mariane werfen -- überzeugen -- fürchten -- jemals Fall -- 
  Kapitel -- 
  einzig Wunsch nunmehr -- fahren Wilhelm fort -- Aufführung Stück sehen -- 
  liegen Mutter -- suchen gelegen Stunde Vater bereden -- Mühe vergebens -- 
  behaupten -- selten Vergnügen können Mensch Wert -- Kind alte wüßten schätzen -- täglich begegnen -- 
  -- Weihnachten -- warten -- Erbauer heimlich Direktor unser Schauspiel Lust fühlen -- Vorstellung wiederholen Nachspiel frisch fertig geworden Hanswurst produzieren -- 
  jung Mann Artillerie -- Talenten begabt -- mechanisch Arbeit schicken -- Vater Baues wesentlich Dienst leisten reichlich beschenken -- Christfeste Familie dankbar erzeig -- Haus Gönner Geschenk eingerichteen Theater -- ehemals müßig Stunde bauen -- schnitzen malen -- 
  -- Hilfe Bedienten Puppe regiert verstellt Stimme verschieden Rolle hersagen -- 
  schwer -- Vater bereden -- Freund Gefälligkeit zugestand -- Kind Überzeugung abschlagen -- 
  -- Theater aufstellen -- Nachbarskinder gebet Stück wiederholen -- 
  erstemal Freude Überraschung Staunen -- zweitenmal Wollust Aufmerkens Forschen -- 
  zugehen -- Anliegen -- 
  Puppe reden -- erstemal -- bewegt -- vermuten -- hübsch -- aussehen -- reden bewegen -- Licht Leute möchten -- Rätsel beunruhign desto -- wünschen -- Bezaubert Zauberer -- Hand verdecken Spiel Zuschauer Freude Illusion genießen -- 
  Stück -- Vorbereitung Nachspiel -- Zuschauer aufgestand schwatzen durcheinander -- 
  drängen nah Türe hören inwendig Klappern -- Aufraum beschäftigen -- 
  heben unterer Teppich guckt Gestelle -- 
  Mutter bemerken ziehen -- sehen -- Freund Feind -- Saul Goliath heißen -- Schiebkast packen -- erhalten halbbefriedigt Neugierde frisch Nahrung -- 
  groß erstaun Leutnant Heiligtume geschäftig erblicken -- 
  nunmehr Hanswurst -- Absätz klapperen -- unterhalten -- 
  verlieren tief nachdenken Entdeckung ruhig unruhig vorher -- 
  erfahren -- -- wissen -- -- 
  fehlt Zusammenhäng -- eigentlich -- 
  Kapitel -- 
  Kind -- fahren Wilhelm fort -- wohleingerichteten geordnet Haus Empfindung -- ungefähr Ratte Maus -- aufmerksam Ritze Loch -- verboten Naschwerk gelangen -- genießen verstohlenen wollüstig Furcht -- kindisch Glück ausmachen -- 
  Geschwistern aufmerksam -- Schlüssel stecken bleiben -- 
  groß Ehrfurcht -- verschlossen Tür Herz herumtrug -- Woche Monat vorbeigehen müssen -- manchmal -- Mutter Heiligtum öffnen -- heraus holen -- verstohlen Blick -- desto schnell -- Augenblick benutzen -- Nachlässigkeit Wirtschafterinne manchmal treffen lassen -- 
  Tür -- erachten -- Türe Speisekammer -- Sinn schärfsen richten -- 
  ahnungsvoll Freude Leben glich Empfindung -- Mutter manchmal Hineinrief -- heraustrage helfen -- gedörrt Pflaume Güte List danken -- 
  aufgehäuft Schatz übereinander umfing Einbildungskraft Fülle -- wunderlich Geruch -- mancherlei Spezereien durcheinander aushauchen -- lecker Wirkung -- niemals versäumt -- Nähe -- eröffnet Atmosphäre weiden -- 
  merkwürdig Schlüssel bleiben Sonntag morgens -- Mutter Geläute übereilen -- Haus tief Sabbatstill liegen -- stecken -- 
  bemerken -- etlichemal sacht Wand -- still fein andrängt -- Türe öffnen -- Schritt Nähe vieler langgewünscht Glückseligkeit fühlen -- 
  besehen Kasten -- Säck -- Schachtel -- Büchse -- Gläs schnell zweifelnd Blick -- wählen nehmen -- Griff vielgeliebt gewelkt Pflaume -- versehen getrocknet Äpfeln -- genügsam eingemacht Pomeranzenschale -- Beute Weg rückwärts glitschen -- paar nebeneinanderstehend Kasten Auge fallen -- Dräht -- Häkchen versehen -- übel verschlossen Schieber heraushingen -- 
  Ahndungsvoll fallen -- überirdisch Empfindung entdecken -- Helde Freudenwelt aufeinander packen -- 
  oberer aufheben -- betrachten -- unter hervorziehen -- verwirrt leicht Dräht -- Unruhe Bangigkeit -- Köchin benachbart Küche Bewegung -- -- -- zusammendrücken -- Kasten zuscheben -- geschrieben büchelchen -- worin Komödie David Goliath aufgezeichnen -- ausgelegen -- stecken -- Beute leis Treppe hinauf Dachkammer retten -- 
  wandter verstohlen einsamen Stunde -- Schauspiel wiederholt lesen -- auswendig lernen -- Gedanke vorstellen -- herrlich müssen -- Gestalt Finger beleben -- 
  Gedanke David Goliath -- 
  Winkel Boden -- Stall -- Garten -- allerlei Umstand -- studiert Stück hinein -- ergriff Rolle -- lernen auswendig -- meist Platz Haupthelden setzen pflegen -- übrig Trabante Gedächtnis mitlaufen lassen -- 
  liegen großmütig Rede David -- übermütig Riese Goliath herausfordern -- Nacht Sinn -- murmelt -- -- Vater -- manchmal Ausruf bemerken -- Gedächtnis Knabe pries -- wenig zuhören mancherlei behalten -- 
  hierdurch verwegener -- rezitiert Abends Stück groß Teil Mutter -- Wachsklümpch Schauspieler bereiten -- 
  merken -- Drang -- gestehen -- 
  Glücklicher Weise fallen Entdeckung -- Leutnant Wunsch äußern -- Geheimnis einweihen -- 
  Mutter sogleich Nachricht unerwartet Talent Sohnes -- wissen einleiten -- Paar Zimmer oberer Stock -- gewöhnlich leer stehen -- überloßen -- Zuschauer sitzen -- Schauspieler -- Proszenium abermals Öffnung Türe ausfüllen -- 
  Vater Freund veranstalten erlauben -- scheinen Finger sehen -- Grundsatz -- müssen Kind merken lassen -- leiben -- greifen -- meinen -- müssen Freude ernst scheinen -- manchmal verderben -- Zufriedenheit übermäßig übermütig machen -- 
  Kapitel -- 
  Leutnant schlagen nunmehr Theater -- besorgt übrige -- 
  merken -- Woche mehrmals ungewöhnlich Haus -- vermuten Absicht -- 
  Begierde wachsen unglaublich -- fühlen -- Sonnabends -- zubereiten -- nehmen -- 
  erscheinen gewünschen -- 
  abends Führer -- hinauf -- 
  Zitternd Freude treten hinein -- erblicken Seite Gestelles herabhängend Puppe Ordnung -- auftreten -- betrachten sorgfältig -- steigen Tritt -- Theater erheben -- Welt schweben -- 
  Ehrfurcht Brettche hinunt -- Erinnerung -- herrlich Wirkung außen tun -- Gefühl -- Geheimnis einweihen -- umfaßten -- 
  machen Versuch -- -- 
  -- Gesellschaft Kind laden -- halten trefflich -- Feuer Aktion Jonathan fallen lassen -- nötigen -- Hand hinunt greifen -- holen -- Zufall -- Illusion unterbrechen -- Gelächter verursachen -- unsäglich kränken -- 
  scheinen Versehen Vater willkommen -- Vergnügen -- Söhnche fähig sehen -- wohlbedächtig -- geendigtem Stück Fehler hing -- -- artig -- versagen -- 
  kränken innig -- traurig Abend -- kommend Verdruß verschlafen -- Gedanke selig -- -- Unglück -- trefflich spielen -- 
  Beifall Zuschauer -- behaupten -- obgleich Leutnant Absicht grob fein Stimme tun -- perorieren meist affektiern Steif -- sprech Anfänger David Jonathan vortrefflich -- lobt Mutter freimütigen Ausdruck -- Goliath herausfordern -- König bescheiden Sieger vorstellen -- 
  bleiben groß Freude Theater aufschlagen -- Frühling herbeikommen -- Feuer bestehen -- liegen Frey spielstund Kammer -- lassen Puppe wacker spielen -- 
  laden Geschwister Kamerad hinauf -- -- -- 
  Einbildungskraft brütet Welt -- Gestalt gewinnen -- 
  Stück -- wozu Theater Schauspieler schaffen stempeln -- etlichemal aufführen -- Freude -- 
  Buch Großvater deutsch Schaubühne verschieden italienisch-deutsch Oper Hand kommen -- vertiefen jedesmal vorn Person überrechnen -- sogleich -- -- Aufführung Stückes schreiten -- 
  müssen König Saul schwarz Samtkleide Chaumigrem -- Cato Darius spielen -- wobei bemerken -- Stück niemals -- meistenteils Akt -- Totstech -- aufführen -- 
  -- Oper mannigfaltig Veränderung Abenteuer anziehen müssen -- 
  finden stürmisch Meer -- Gott -- Wolke herabkommen -- -- vorzüglich glücklich -- Blitz Donner -- 
  helfen Pappe -- Farbe Papier -- wissen trefflich Nacht -- Blitz fürchterlich ansehen -- donner gelingen -- sagen -- 
  finden Oper Gelegenheit -- David Goliath anzubringen -- regelmäßig Drama angehen -- 
  fühlen täglich Anhänglichkeit eng Plätzch -- Freude Genoß -- gestehen -- Geruch -- Puppe Speisekammer ziehen -- beitragen -- 
  dekorationen Theater nunmehr ziemlich Vollkommenheit -- -- Jugend Geschick -- Zirkel umgehen -- Pappe auszuschneiden -- Bild illuminieren -- -- 
  desto weh -- Personal Ausführung Sache hinderen -- 
  Schwester -- Puppe aus ankleidet -- erregt Gedanke -- Held beweglich Kleid verschaffen -- 
  trennt Läppch Leib -- setzen -- -- -- spart Geld -- kaufen neu Band Flitter -- bettelt Stückchen Taft -- schaffen Theater-Garderobe -- reifröck Dame vergessen -- 
  Truppe Kleidern groß Stück versehen -- denken -- Aufführung folgen -- -- Kind öfter pflegen -- fassen weit Plan -- Anstalt -- Versuch -- bleiben liegen -- 
  Fehler anklagen -- 
  groß Freude liegen Erfindung -- Beschäftigung Einbildungskraft -- 
  Stück interessiert Szene Wille -- lassen Kleid -- 
  Anstalt ursprünglich Kleidungsstücke Held Unordnung geraten verschleppen -- Stück aufführen -- 
  überlassen Phantasie -- probieren bereiten ewig -- bauen tausend Luftschlösser -- spüren -- Grund Gebäude zerstören -- 
  Erzählung Mariane Freundlichkeit Wilhelm aufboten -- Schläfrigkeit verbergen -- 
  scherzhaft Begebenheit Seite scheinen -- einfach -- Betrachtung ernsthaft -- 
  setzen zärtlich Fuß Fuß geliebter -- scheinbar Zeichen Aufmerksamkeit Beifall -- 
  trinken Glase -- Wilhelm überzeugen -- Wort Geschichte Erde fallen -- 
  Pause rufen -- 
  -- Mariane -- jugendlich Freude mitteilen -- 
  Gegenwärtig beschäftigen -- wechselseitig vorig Lebensweise bekümmern -- sagen -- Umstand erziehen -- 
  lebhaft Eindruck -- erinnerst -- 
  Frage Mariane Verlegenheit setzen -- alte sogleich Hilfe kommen -- 
  Glaube -- klug Weib -- -- früh begegnen -- aufmerksam -- artig Begebenheite erzählen -- -- erzählen -- Sache Geschick geben wüßten -- 
  bedürfen -- rufen Wilhelm -- 
  lieb zärtlich -- -- lieblich Geschöpf -- Augenblick Leben verdrießen -- zubrachen -- 
  Laß Einbildungskraft Leben nehmen -- erzählen -- erzählen -- 
  täuschen -- Liebe verloren Zeit gewinnen suchen -- 
  eifrig bestehen -- befriedigen -- alt -- 
  Erzähl -- Liebhaberei Schauspiel wachsen -- üben -- glücklich zunehmen -- nunmehr gut Schauspieler gelten -- 
  gewiß lustig Begebenheite mangeln -- 
  Mühe wert -- Ruhe legen -- Flasche Reserve -- wissen -- ruhig zufrieden zusammensitzen -- 
  Mariane schaun traurig Blick -- Wilhelm bemerken -- Erzählung fortfuhr -- 
  Kapitel -- 
  Zerstreuung Jugend -- Gespannschaft vermehren anfing -- tun einsam still Vergnügen Eintrag -- 
  wechselsweise Jäger -- Soldat -- Reuter -- Spiel bringen -- Vorzug -- Stande -- nötig Gerätschaft schicklich ausbilden -- 
  Schwert meistens Fabrik -- verziert vergoldet Schlitten -- geheim Instinkt lassen ruhen -- Miliz Antike umgeschaffen -- 
  Helm verfertiget -- papiern Büschen schmücken -- Schild -- sogar Harnisch -- Arbeit -- Bedienten Haus -- Schneider -- Nähterinn Nadel zerbrachen -- 
  jung Geselle wohlgerüsten -- übrig -- gering -- ausstaffieren -- stattlich Korps -- 
  marschieren Höf Garten -- schlagen brav Schild Köpfe -- Mißhelligkeit -- beilegen -- 
  Spiel -- unterhalten -- etlichemal treiben -- befriedigen -- 
  Anblick vieler gerüstet Gestalt müssen notwendig Ritteridee aufreizen -- -- Lesen alt Roman fallen -- Kopf anfüllten -- 
  befreien Jerusalem -- Koppen Übersetzung Hand fallen -- herumschweifend Gedanke bestimmt Richtung -- 
  Gedicht lesen -- Stelle -- auswendig wissen -- Bild umschwebten -- 
  fesselen Chlorinde Lassen -- 
  Mannweiblichkeit -- ruhig Fülle Dasein -- tun Wirkung Geist -- entwickeln anfing -- gemacht Reiz Armidens -- Garten verachten -- 
  hundert hundertmal -- Abends Altan -- Giebeln Haus angebrachen -- spaziern -- Gegend hinsehen -- herabgewichen Sonne zitternd Schein Horizont heraufdämmern -- Stern hervortraen -- Winkel Tiefe Nacht hervordringen -- klingend Ton Grill feierlich Stille schrillt -- Geschichte traurigen Zweikampf Tankred Chlorinden -- 
  -- billig -- Partei Christ -- stehen heidnisch Heldin ganz Herz -- unternehmen -- Turm Belagerer anzünden -- 
  Tankred vermeint Krieger Nacht begegnen -- düstern Hülle Streit beginnen -- gewaltig kämpfen -- -- 
  Wort aussprechen -- Lebensmaß Chlorinde voll -- Stunde -- sterben -- Träne Auge kommen -- reichlich fließen -- unglücklich Liebhaber Schwert Brust stoßen -- Sinkend Helm lösen -- erkennen -- Taufe bebend Wasser holen -- 
  Herz -- bezauberten Walde Tankreden Schwert Baum treffen -- Blut Hieb fließen -- Stimme Ohren tönen -- Chlorinde verwund -- Schicksal bestimmen -- lieben überall unwissend verletzen -- 
  bemächtigt Geschichte Einbildungskraft -- -- Gedicht lesen -- dunkel Seele bilden -- dergestalt einnehmen -- Weise vorstellen gedachten -- 
  Tankreden Reinald spielen -- finden Rüstung bereit -- fertigen -- 
  dunkelgrau Papier Schuppe ernsen Tankred -- Silber Goldpapier glänzend Reinald zieren -- 
  Lebhaftigkeit Vorstellung erzählt Gespann -- entzücken -- begreifen -- aufführen -- aufführen -- 
  Zweifel helfen vieler Leichtigkeit -- 
  disponiern paar Zimmer benachbart Gespiel Haus -- berechnen -- alt Tante nimmermehr hergeben -- Theater -- wovon bestimmt Idee -- Balken setzen -- Kulisse geteilt spanisch Wänd hinstell Grund Tuch nehmen müssen -- 
  woher Material Gerätschaft -- bedacht -- 
  Wald finden Auskunft -- 
  geben alt Bedienter Haus -- Förster -- Wort -- jung Birk Fichtum schaffen -- geschwinder hoffen Herbeigebracht -- 
  finden Verlegenheit -- Stück -- ehe Baum verdorren -- Stande bringen können -- 
  Rat teuer -- fehlt Platz -- Theater -- Vorhang -- 
  spanisch Wand einzig -- 
  Verlegenheit gehen Leutnant -- weitläufig Beschreibung Herrlichkeit machen -- geben -- 
  begreifen -- behilflich -- schieben Stube -- Tisch Haus Nachbarschaft finden -- stellen Wand -- hintere Aussicht grün Vorhäng -- Baum Reihe stellen -- 
  indessen Abend -- Licht anzünden -- Mägde Kind sitzen Platz -- Stück angehen -- Heldenschar anziehen -- spüren erstenmal -- wissen -- sagen -- 
  Hitze Erfindung -- Gegenstande durchdrunger -- vergessen -- wissen müssen -- sagen -- Lebhaftigkeit Ausführung übrig einfallen -- glaubt Held darstellen -- handeln reden -- Person -- Welt versetzen -- 
  stehen erstaunt -- fragen -- -- -- Tankred vorne denken -- fing -- auftretend -- Vers Heldengedicht herzusagen -- 
  Stelle erzählende überging -- Rede Person vorkommen -- Gottfried -- Sprache -- herauskommen -- müssen groß Gelächter Zuschauer abziehen -- Unfall -- tief Seele kränken -- 
  verunglückt Expedition -- Zuschauer sitzen -- sehen -- 
  kleiden -- raffen -- entschließen -- David Goliath spielen -- 
  Gesellschaft ehemals Puppenspiel aufführen -- sehen -- teilen Rolle -- versprechen Best -- drollig Junge malen schwarz Bart -- -- Lücke einfallen -- hanswurst Pos ausfüllen -- 
  Anstalt -- -- Ernst Stückes zuwider -- ungern geschehen lassen -- 
  schworen -- Verlegenheit retten -- -- groß Überlegung -- Vorstellung Stück wagen -- 
  Kapitel -- 
  Mariane -- Schlaf überwältigen -- lehnen Geliebten -- fest drückt Erzählung fortfuhr -- indes alt Überrest Wein gut Bedacht Genoß -- 
  Verlegenheit -- -- Freund finden -- Stück existieren spielen unternahmen -- vergessen -- 
  Leidenschaft -- Roman -- lesen -- Geschichte lehren -- Schauspiel darstellen -- unbiegsam Stoff widerstehen -- 
  völlig überzeugen -- Erzählung ergötzen -- vorstellen groß Wirkung müssen -- Auge -- Bühne vorgehen -- 
  Schule Weltgeschichte vortragen -- zeichnen sorgfältig -- besonderer Weise erstechen vergiften -- Einbildungskraft Exposition Verwicklung hinweg eilt interessant Akt -- fing -- Stück hinten hervor schreiben -- einzig Anfang kommen -- 
  gleich lesen -- teils eigen Antrieb -- teils Veranlassung gut Freund -- Geschmack kommen Schauspiel aufführen -- Wust theatralisch Produktion -- Zufall Hand führen -- 
  Glückliche -- fällen -- Menge Abwechslung Befriedigung finden -- 
  Urteil Weise bestochen -- 
  Stück gefiel -- fallen hoffen -- -- angenehm Täuschung durchlas -- lebhaft Vorstellungskraft -- Rolle denken -- verführen glauben -- darstellen -- gewöhnlich wählt Austeilung -- schicken -- einigermaßen angehen -- paar Rolle -- 
  Kind wissen Spiel -- Stab Flint -- stückch Holz Degen -- jeder bündelch Puppe -- Winkel Hütte -- 
  Sinn entwickelt Privattheater -- 
  völlig Unkenntnis Kraft unternahmen -- bemerken qui pro -- -- überzeugen -- müssen nehmen -- wofür geben -- 
  gemein Gang -- merkwürdig Albernheit erzählen übrig bleiben -- 
  spielen weniger Stück -- Mannsperson auftreten -- verkleidet unserer -- ziehen zuletzt Schwester Spiel -- 
  Haus halten nützlich Beschäftigung laden Gesellschaft -- 
  Artillerielieutenant verlassen -- 
  zeigen -- -- deklamieren gestikulieren -- erntet Bemühung meistens -- theatralisch Kunst verstehen glauben -- 
  verfiel Trauerspiel -- 
  sagen hören -- glauben -- leicht Tragödie schreiben vorstellen -- Lustspiel vollkommen -- 
  fühlen tragisch Versuch unser Element -- suchen Höhe Stand -- Vortrefflichkeit Charakter -- Steifheit Affektation nähern -- dünkn -- vollkommen glücklich -- rasen -- Füßen stampfen Wut Verzweiflung Erde werfen -- 
  Knabe Mädchen Spiel beisammen -- Natur regen -- Gesellschaft verschieden Liebesgeschicht teilen anfing -- meistenteils Komödie Komödie spielen -- 
  glücklich Paar drückt Theaterwände Hand zärtlichster -- verschwamm Glückseligkeit -- -- bebändert aufgeschmücken -- idealisch vorkamen -- indes unglücklich Nebenbuhler Neid verzehrten -- Trutz Schadenfreude allerlei Unheil anrichten -- 
  Spiel -- obgleich Verstand unternehmen Anleitung durchführen -- Nutzen -- 
  übt Gedächtnis unser Körper -- erlangt Geschmeidigkeit sprech Betrag -- frühen gewinnen -- 
  Epoche -- Geist richten Theater -- finden größ Glück -- Schauspiel lesen -- schreiben spielen -- 
  Unterricht Lehrer dauern fort -- Handelsstand widmen -- unser Nachbar Comptoir tun -- selbig entfernt Geist gewaltsam -- niedrig Geschäft halten müssen -- 
  Bühne Tätigkeit widmen -- Glück Zufriedenheit finden -- 
  erinneren Gedicht -- Papier finden -- Muse tragisch Dichtkunst Frauengestalt -- Gewerbe personifizieren -- wert Person Wacker zanken -- 
  Erfindung gemein -- erinneren -- Vers taugen -- sollt sehen -- Furcht -- Abscheus -- Liebe Leidenschaft Wille -- herrschen -- 
  ängstlich alt Hausmutter geschildern Rocken Gürtel -- schlüsseln Seite -- Brüll Nase -- fleißig -- Unruhe -- zänkisch haushältisch -- kleinlich beschwerlich -- 
  kümmerlich beschreiben Zustand -- Rute bücken knechtisch Tagewerk Schweiße Angesicht verdienen -- 
  treten -- 
  Erscheinung bekümmerten Herz -- 
  Herrlich bilden -- Wesen Betrag Tochter Freiheit ansehen -- 
  Gefühl Stolz -- Kleid ziemen -- umhüllten jeder Glied -- zwäng -- reichlich Falte Stoff wiederholt -- tausendfach Echo -- reizend Bewegung Göttlichen -- 
  welch Kontrast -- 
  Seite Herz wenden -- denken -- 
  vergessen -- Muse kenntlich -- 
  Krone Dolch -- Kette Maske -- Vorgänger überliefern -- zuteilen -- 
  Wettstreit heftig -- Rede beide Person kontrastieren gehörig -- vierzehnten gewöhnlich schwarz weiße nah malen pflegen -- 
  alt redet -- Person geziemt -- Stecknadel aufheben -- -- -- Königreiche verschenken -- 
  warnend Drohung alte verschmähen -- versprochen Reichtum Rücken -- enterbt nackt übergeben Muse -- golden Schleier Zuwarf Blöße bedecken -- 
  -- denken -- o Geliebte -- rufen -- Mariane fest drücken -- -- lieblich Gottheit -- Vorsatz stärken -- Weg begleiten -- welcher schön Wendung Gedicht nehmen -- interessant Schluß -- 
  Gedicht -- Wahrheit Leben -- dein arme finden -- laß süß Glück Bewußtsein genießen -- 
  Druck Armes -- Lebhaftigkeit erhöht Stimme -- Mariane erwachen -- verbergen Liebkosung Verlegenheit -- 
  Wort letzter Teil Erzählung vernehmen -- wünschen -- Held Lieblingsgeschicht aufmerksamer Zuhörer künftig finden mögen -- 
  Kapitel -- 
  bringen Wilhelm Nächte Genusse vertraulich Liebe -- Erwartung neu selig Stunde -- 
  -- verlangen Hoffnung Mariane hinziehen -- fühlen neu beleben -- fühlen -- anderer Mensch beginnen -- vereinigen -- Befriedigung Wunsch reizend Gewohnheit -- 
  Herz streben -- Gegenstand Leidenschaft veredeln -- Geist -- geliebt Mädchen empor heben -- 
  klein Abwesenheit ergriff Andenken -- 
  notwendig -- unentbehrlich -- Bande Menschheit knüpfen -- 
  rein Seele fühlen -- Hälfte -- Hälfte -- 
  dankbar hingegebe Grenze -- 
  Mariane Zeitlang täuschen -- teilen Empfindung lebhaft Glück -- -- 
  manchmal kalt Hand Vorwurf Herz fahren -- 
  Busen Wilhelm sicher -- flügeln Liebe -- 
  -- Wolke -- Leidenschaft emportragen -- Bewußtsein Zustand Herabsank -- bedauern -- 
  Leichtsinn Hilfe -- niedrig Verworrenheit leben -- Verhältnis Betrog -- vielmehr kennen -- erscheinen Vorfall -- aussetzen -- einzeln -- Vergnügen Verdruß lösen -- Demütigung Eitelkeit -- Mangel augenblicklich Überfluß vergüten -- Not Gewohnheit Gesetz Rechtfertigung anführen -- lassen unangenehm Empfindung Stunde Stunde -- abschütteln -- 
  arm Mädchen Augenblick gut Welt hinüber rücken fühlen -- -- herab -- Licht Freude öde -- verworfen Leben herunter sehen -- fühlen -- elend Kreatur Weib -- verlangen Liebe Ehrfurcht einflößen -- finden äußerlich innerlich bessern -- 
  -- aufrichten -- 
  blickte suchen -- Geist leer -- Herz Widerhalt -- 
  traurig Zustand -- desto heftig Schloß Neigung geliebter fest -- Leidenschaft wachsen -- Gefahr -- verlieren -- nah rücken -- 
  schweben Wilhelm glücklich hoch Region -- Welt aufgehen -- reich herrlich Aussicht -- 
  lassen Übermaß Freude -- stellen hell Seele -- dunkel durchwühlt -- 
  -- 
  hingegeben -- 
  -- gelieben -- gesucht -- angebetet Geschöpf -- treu Glaube hingegeben -- undankbaren überlassen -- 
  stehen -- redet -- Herz fließen beständig -- Fülle prächtig Wort erhabensten Gesinnung -- 
  glauben hell Wink Schicksal verstehen -- Mariane Hand reichen -- stockend -- schleppend bürgerlich Leben heraus reißen -- retten wünschen -- 
  Vater Haus -- Seinig verlassen -- scheinen leichtes -- 
  jung neu Welt -- Mut -- Weit Glück Befriedigung rennen -- Liebe erhöhen -- 
  Bestimmung Theater nunmehr klar -- hoch Ziel -- vorgestecken -- scheinen nah -- Mariane Hand hinstrebt -- selbstgefällig Bescheidenheit erblickt trefflich Schauspieler -- Schöpfer künftig National-Theater -- vielfältig seufzen hören -- 
  -- innerst Winkel Seele schlummern -- regen -- 
  bilden vielerlei Idee Farbe Liebe Gemälde Nebelgrund -- Gestalt freilich fließen -- desto reizend Wirkung -- 
  Kapitel -- 
  sitzen Haus -- kramt Papier -- rüsten Abreise -- 
  bisherig Bestimmung schmecken -- Seite legen -- Wanderung Welt unangenehm Erinnerung frei -- 
  Werk Geschmack -- Dichter Kritiker bekannt Freund Erwählte stellen -- Kunstrichter nutzen -- erneuern Begierde Belehrung -- Buch Durchsah finden -- theoretisch Schrift meist unaufgeschnitten -- 
  -- völlig Überzeugung Notwendigkeit Werk -- anschaffen -- Wille kein Hälfte hinein lesen -- 
  desto eifrig Beispiel halten -- Art -- Versuch -- 
  Werner treten herein -- Freund bekannt Heft beschäftigen -- rufen -- Papieren -- 
  weten -- Absicht -- einer vollenden -- 
  siehst -- Beginnst allenfalls neu -- -- 
  vollenden Sache Schüler -- -- üben -- fertig -- -- 
  lassen Frage aufwerfen -- Hoffnung jung Mensch fassen können -- gewahr -- Ungeschicktes unternehmen -- Arbeit fortfähren -- -- niemals Wert -- weder Mühe verschwenden -- 
  wissen -- Sache -- Stande bringen -- warst müde -- ehe Hälfte -- 
  Direktor unser Puppenspiel warst -- Kleid Zwerggesellschaft -- dekorationen ausgeschnitten -- 
  -- Trauerspiel aufführen -- höchstens gabst Akt -- bunt -- Leute erstachen -- 
  Zeit sprechen -- Schuld -- Kleid -- unser Puppe anpassen Leib fest nähen -- herunter trennen lassen -- Aufwand weitläufig unnützen Garderobe machen -- 
  Warst -- neu Stück Band verhandeln -- Liebhaberei anzufeuern nutzen wissen -- -- Werner lachen rufen -- 
  erinner Freude -- euren theatralisch Feldzüg Vorteil ziehen -- Lieferant Krieg -- 
  Befreiung Jerusalem rüsteten -- schön Profit -- ehemals Venezianer ähnlich Fall -- 
  finden vernünftig Welt -- Torheit anderer Vorteil ziehen -- 
  wissen -- edler vergnügen -- Mensch Torheit heilen -- 
  -- kenn -- eitl bestreben -- 
  gehören -- einzig Mensch klug reich -- meistens Unkost -- 
  fallen Jüngling Scheideweg Hand -- versetzen Wilhelm -- Heft übrig Papier herausziehen -- 
  fertig -- -- 
  Lege Seite -- wirf Feuer -- versetzen Werner -- 
  Erfindung geringsen lobenswürdig -- vormals ärgert Komposition -- ziehen Unwille Vater -- 
  artig Vers -- Vorstellungsart grundfalsch -- 
  erinneren dein personifiziert Gewerbe -- zusammengeschrumpft erbärmlich Sybille -- 
  Bild elend Kramlad aufgeschnappt -- 
  Handlung hattesen Begriff -- wissen -- Geist ausgebreitet -- ausgebreiteter müssen -- Geist echt Handelsmann -- 
  Überblick verschaffen Ordnung -- Geschäft führen -- 
  lassen jederzeit überschauen -- nötig -- Einzeln verwirren lassen -- 
  Vorteil gewähren doppelt Buchhaltung Kaufmanne -- 
  schön Erfindung menschlich Geist -- Haushalter Wirtschaft einführen -- 
  Verzeih -- Wilhelm lächelnd -- fängst Form -- Sache -- gewöhnlich vergessen eur Addier Bilanzier eigentlich Fazit Leben -- 
  siehsen -- Freund -- Form Sache eins -- einer bestehen -- 
  Ordnung Klarheit vermehrt Lust sparen erwerben -- 
  Mensch -- übel haushalten -- befinden Dunkelheit -- Posten gerne rechnen -- schuldig -- 
  gut Wirt angenehm -- Summe wachsend Glück ziehen -- 
  Unfall -- verdrießlich überraschen -- erschreckt -- wissen sogleich -- erworben Vorteil Waagschal legen -- 
  überzeugen -- Freund -- Geschmack unser Geschäft finden könntest -- Würdest überzeugen -- Fähigkeit Geist frei Spiel -- 
  -- Reise -- Vorhabe -- Gedanke bringen -- 
  O gewiß -- 
  Glaube -- fehlen Anblick Tätigkeit -- unesren -- Kommst -- gesell -- Art Spedition Spekulation Geld Wohlbefinden -- Welt notwendig Kreislauf führen -- reißen wissen -- 
  Wirf Blick natürlich künstlich Produkt Weltteil -- betrachten wechselsweise Notdurfte -- 
  welch angenehm geistreich Sorgfalt -- -- Augenblick meisten suchen -- fehlen -- schwer -- kennen -- -- verlangen -- schnell verschaffen -- vorsichtig Vorrat setzen -- Vorteil jeder Augenblick Zirkulation genießen -- 
  -- dünken -- -- Kopf -- Freude -- 
  Wilhelm scheinen abneigen -- Werner fahren fort -- besuch paar Handelsstädte -- paar Hafen -- gewiß fortgerissen -- 
  siehst -- Mensch beschäftiget -- siehst -- herkommen -- hingehen -- gewiß Vergnügen Hand sehen -- 
  gering Ware siehst Zusammenhang Handel -- Hältst gering -- Zirkulation vermehrt -- Leben Nahrung ziehen -- 
  Werner -- richtig Verstand Umgange Wilhelm ausbilden -- gewöhnen -- Gewerbe -- Geschäft Erhebung Seele denken -- glauben -- Mehrerem tun -- verständig geschätzt Freund -- -- scheinen -- unreell Welt Wert -- Gewicht Seele legen -- 
  manchmal denken -- können fehlen -- falsch Enthusiasmus müssen überwältig -- Mensch Weg bringen -- 
  Hoffnung fahren fort -- 
  Welt Erde bemächtigen -- leben Herrlichkeit Überfluß -- 
  klein Raum unser Weltteil Besitz nehmen -- Besitz befestiget -- Amt bürgerlich Geschäft tragen -- rechtmäßiger Erwerb -- billig Eroberung Handel -- 
  Fürst Welt Fluß -- Weg -- Hafen Gewalt -- nehmen -- vorbei -- stark Gewinn -- Freude Gelegenheit ergreifen -- Tätigkeit Zoll Artikel nehmen -- teils Bedürfnis -- teils Übermut Mensch unentbehrlich -- 
  versichern -- dichterisch Einbildungskraft anwend Wolltest -- könntest Göttin unüberwindlich Siegerin deinigen kühn entgegenstellen -- 
  führen freilich Ölzweig Schwert -- Dolch Kette kennen -- Krone teilet Liebling -- -- Verachtung -- echt Quelle geschöpftem Golde Perle glänzen -- tief Meere geschäftig Diener holen -- 
  Wilhelm verdroß Ausfall -- verbergen Empfindlichkeit -- erinnern -- Werner Apostrophen Gelassenheit anhören pflegen -- 
  billig -- gerne sehen -- Handwerk auf gut denken -- müssen seinig -- Leidenschaft widmen -- unangefochten lassen -- 
  -- rufen Werner -- menschlich Ding herzlich Anteil nimmst -- Schauspiel -- Glück -- mutig Unternehmung begleiten -- deinen Auge Mensch gewähren sehen -- 
  reizend Anblick Schiffes -- glücklich Fahrt anlangen -- reich Fange frühzeitig zurückkehren -- 
  verwandte -- bekannte -- Teilnehmer -- fremd Zuschauer hingerissen -- Freude sehen -- eingesperrt Schiffer an Land springen -- ehe Fahrzeug berühren -- frei fühlen -- nunmehr -- falsch Wasser entziehen -- getreu Erde anvertrauen -- 
  Zahl -- Freund -- erscheinen Gewinn -- Glück Göttin lebendig Mensch -- Gunst wahrhaft empfinden -- leben Mensch sehen -- lebendig bemühen sinnlich genießen -- 
  Elftes Kapitel -- 
  -- Vater Freund nah kennen lernen -- paar Mann verschieden Denkungsart -- Gesinnung übereinkamen -- Handel edelst Geschäft halten -- höchst aufmerksam Vorteil -- Spekulation bringen -- 
  alt Meister Tod Vater kostbar Sammlung Gemälde -- Zeichnung -- Kupfersticher Antiquität Geld setzen -- Haus neust Geschmack Grund aufbauen möblieren -- übrig Vermögen möglich Weise gelten -- 
  ansehnlich alt Werner Handlung geben -- tätig Handelsmann berühmt -- Spekulation gewöhnlich Glück begünstigen -- 
  wünschen alt Meister -- Sohne Eigenschaft geben -- fehlen -- Kind Gut hinterlassen -- Besitz groß Wert legen -- besonderer Freund Prächtige -- Auge fallen -- innerer Wert Dauer -- 
  Haus müssen Solid massiv -- Vorrat reichlich -- Silbergeschirr schwer -- Tafelservice kostbar -- Gast selten -- Mahlzeit Fest -- sowohl Kosten Unbequemlichkeit wiederholen -- 
  Haushalt gelassen einförmig Schritt -- bewegen erneuern -- -- Genuß -- 
  entgegengesetzt Leben führen alt Werner dunkel finster Haus -- 
  Geschäft eng Schreibstube uralt Pulte vollenden -- essen -- trinken -- genießen -- Familie müssen Freund -- Fremd -- Haus Verbindung stehen -- Tisch sehen -- Stuhl uralt -- laden täglich -- sitzen -- 
  gut Speise ziehen Aufmerksamkeit Gast -- bemerken -- gemein Geschirr auftragen -- 
  Keller halten Wein -- ausgetrunken gewöhnlich gut ersetzen -- 
  leben Vater -- öfter kommen -- gemeinschaftlich Geschäft beratschlagt -- Versendung Wilhelm Handelsangelegenheit beschließen -- 
  Welt umsehen -- alt Meister -- Geschäft fremd Ort betreiben -- jung Mensch groß Wohltat erweisen -- zeitig Bestimmung Leben einweiht -- 
  Sohn Expedition glücklich kommen -- Geschäft wissen -- neugierig -- meinig betragen -- fürcht -- Lehrgeld geben -- Ihrig -- 
  alt Meister -- Sohne Fähigkeit Begriff -- Wort Hoffnung -- Freund widersprechen vortrefflich Gabe jung Mann herausstreichen -- 
  Hierin Betrog -- alt Werner -- praktisch Ding trauten -- -- prüfen -- versetzen gelassen -- 
  versuchen -- Weg schicken -- geben Vorschrift -- wonach richten -- verschieden Schuld einzukassieren -- alt Bekanntschaft erneuern -- -- 
  Spekulation neulich unterhalten -- befördern helfen -- genau Nachricht Ort Stelle sammeln -- lassen -- 
  vorbereiten -- versetzt alt Meister -- sobald aufbrechen -- 
  nehmen Pferd -- Expedition schicken -- 
  suchen -- 
  Krämer H * * * -- schuldig -- Mann -- eins Zahlungsstatt anbieten -- Sohn kennen -- brauchbar Tier -- 
  hohl -- Postwag hinüber fahren -- übermorgen Zeit -- indessen Mantelsack Brief zurechen -- Anfang künftig Woche aufbrechen -- 
  Wilhelm gerufen Entschluß -- 
  froh -- Vorhaben Hand -- Gelegenheit Mitwirken zubereiten -- 
  Leidenschaft -- rein Überzeugung -- handle vollkommen -- Druck bisherig Leben entziehen -- edler Bahn folgen -- Gewisse mindesten regen -- Sorge entstehen -- vielmehr Betrug heilig halten -- 
  gewiß -- Eltern verwandte Folge Schritt preisen segnen -- erkennen Wink leitend Schicksal zusammentreffend Umstand -- 
  Nacht -- Stunde -- Geliebte sehen -- 
  sitzen Zimmer überdachen Reiseplan -- 
  künstlich Dieb Zauberer Gefangenschaft manchmal Fuß festgeschlossenen Kette herausziehen -- Überzeugung nähren -- Rettung -- nah kurzsichtig Wächter glauben -- 
  schlagen nächtlich Stunde -- entfernt Haus -- schütteln Druck -- wandelt still Gasse -- 
  Platz heben Hand gen Himmel -- fühlen -- -- 
  denken arm geliebter -- blendend Theatergerüste -- schweben Fülle Hoffnung -- manchmal erinnern Ruf Nachtwächter -- Erde wandlen -- 
  Geliebte Treppe entgegen -- schön -- lieblich -- 
  weiß Negligé empfangen -- glauben reizend sehen -- 
  weiht Geschenk abwesend Liebhaber arme gegenwärtig -- wahr Leidenschaft verschwenden Reichtum Liebkosung -- Natur eingeben -- Kunst lehren -- Liebling -- fragen -- glücklich -- selig fühlen -- 
  entdeckt Vorgegang -- lassen Plan -- Wunsch sehen -- 
  wollen suchen -- Alsdann abholen -- hoffen -- Hand versagen -- 
  arm Mädchen schweigen -- verbergen Träne drücken Freund Brust -- -- verstummen günstigst auslegt -- Antwort wünschen -- zuletzt bescheidenst -- freundlich fragen -- Vater glauben dürfen -- 
  antworten Seufzer -- Kuß -- 
  Zwölftes Kapitel -- 
  erwacht Mariane neu Betrübnis -- finden -- sehen -- bleiben Bette weinen -- 
  alte setzen -- suchen einzured -- trösten -- gelingen -- verwundet Herz schnell heilen -- 
  Augenblick nahe -- arm Mädchen letzter Leben entgegen sehen -- 
  ängstlicher Lage fühlen -- 
  Geliebt entfernen -- unbequem Liebhaber drohen -- groß Unheil stehen bevor -- -- -- zusammentreffen -- 
  Beruhiger -- liebchen -- rufen alte -- verwein schön Auge -- 
  Unglück -- Liebhaber besitzen -- 
  Zärtlichkeit schenken -- dankbar -- -- Art sorgen -- gewiß Freund nennen verdienen -- 
  ahndet Geliebten -- versetzen Mariane Träne -- Trennung bevorstehen -- Traum entdecken -- sorgfältig verbergen suchen -- 
  Schlief ruhig Seite -- 
  hören ängstlicher -- unvernehmlich Ton stammeln -- 
  bange -- wecken -- 
  -- 
  Liebe -- Zärtlichkeit -- Feuer umarmt -- -- 
  O Mariane -- rufen -- schrecklich Zustande entreißen -- 
  danken -- Hölle befreien -- 
  träumen -- fahren fort -- befänd -- entfernt -- unbekannt Gegend -- Bild schweben -- schön Hügel -- Sonne beschien Platz -- reizend kamsen -- 
  währen -- Bild hinunt gleiten -- Hinunter gleiten -- strecken Arm -- reichen Ferne -- 
  sinken Bild nähert See -- Fuße Hügel ausbreiten liegen -- eher Sumpf See -- 
  Mann Hand -- scheinen hinaufführen -- leiten seitwärts -- scheinen ziehen -- 
  rufen -- erreichen -- hoffen warnen -- 
  -- scheinen Boden fest halten -- -- -- hindert Wasser -- sogar Schreie erstickt beklemmt Brust -- 
  erzählt Arm -- Schrecken Busen erholen -- glücklich pries -- fürchterlich Traum selig Wirklichkeit verdrängen sehen -- 
  alte suchen Prosa Poesie Freundin Gebiet gemein Leben herunter locken -- bedient gut Art -- Vogelsteller gelingen pflegen -- Pfeifch Ton nachzuahmen suchen -- häufig Garn sehen wünschen -- 
  loben Wilhelm -- rühmt Gestalt -- Auge -- Liebe -- 
  arm Mädchen hören gerne -- stehen -- lassen ankleiden -- scheinen ruhig -- 
  Kind -- liebchen -- fahren alte schmeichelnd fort -- betrüben -- beleidigen -- denken Glück rauben -- 
  Absicht verkennen -- vergessen -- jederzeit sorgen -- 
  Sage -- sehen -- ausführen -- 
  -- versetzt Mariane -- elend -- Leben elend -- lieben -- lieben -- sehen -- trennen -- wissen -- überleben -- 
  Norberg -- Existenz schuldig -- entbehren -- 
  Wilhelm einschränken -- -- -- 
  -- unglücklicherweise Liebhaber -- Herz bringen -- meister Prätention -- 
  Spott -- Unglückliche denken Haus verlassen -- Theater -- Hand anbieten -- 
  leer Hand -- 
  Wahl -- fahren Mariane fort -- entscheiden -- 
  stoß -- wissen einer -- wahrscheinlich tragen Pfand Busen -- fesseln -- Bedenke entscheiden -- lassen -- 
  folgen -- 
  einiger Stillschweigen rufen alte -- Jugend Extremen schwanken -- 
  finden natürlich -- verbinden -- Vergnügen Vorteil bringen -- 
  Liebst -- bezahlen -- -- klug -- auseinander halten -- 
  -- Mache -- denken -- folgen -- 
  Vorteil -- Eigensinn Direktor -- Sitten Truppe stolz -- vorschützen -- 
  Liebhaber wohnen -- heimlich vorsichtig Werk -- 
  Stunde Gelegenheit sorgen -- Mußt Hernach Rolle spielen -- vorschreiben -- 
  wissen Umstand helfen -- 
  Käme Norberg -- Wilhelm entfernt -- 
  wehren -- arme denken -- 
  wünsch Sohne Glück -- reich Vater -- 
  Mariane Vorstellung kurzen bessern -- 
  Zustand Harmonie Empfindung -- Überzeugung bringen -- wünscht schmerzlich Verhältnis vergessen -- tausend Umstand müssen Augenblick erinnern -- 
  Dreizehntes Kapitel -- 
  Wilhelm indessen Reise vollenden -- überreichen -- Handelsfreund Haus finden -- Empfehlungsschreiben Gattin Abwesend -- 
  Frage Bescheid -- heftig Gemütsbewegung -- Haus Verwirrung -- 
  währen -- vertraut -- verheimlich -- Stieftochter Schauspieler gehen -- Mensch -- Gesellschaft kurz -- Ort aufhalten -- französisch Unterricht geben -- 
  Vater -- Schmerz Verdruß -- Amt laufen -- Flüchtig verfolgen lassen -- 
  Schalt Tochter heftig -- schmäht Liebhaber -- Lobenswürdige übrig bleiben -- beklagen Wort Schande -- Familie kommen -- setzen Wilhelm gering Verlegenheit -- heimlich Vorhaben Sibylle gleichsam prophetisch Geist voraus tadeln Gestraft fühlen -- 
  stark inniger Anteil müssen Schmerz Vater nehmen -- Amt zurückkommen -- still Trauer halb Wort Expedition Frau erzählen -- -- -- eingesehen Brief -- Pferd Wilhelm vorführen lassen -- Zerstreuung Verwirrung verbergen -- 
  Wilhelm gedingen sogleich Pferd besteigen -- Haus entfernen -- -- gegeben Umstand -- unmöglich -- Mann Sohn Haus -- schuldig -- unbewirten Nacht Dache behalten -- entlassen -- 
  Freund traurig Abendessen einnehmen -- unruhig Nacht ausgestanden -- eilen Frühmorgen sobald Leute entfernen -- -- wissen -- Erzählung Äußerung empfindlich quälen -- 
  riten langsam nachdenkend Straße -- Anzahl gewaffnet Leute durch Feld -- weit lang Röcke -- Aufschläg -- unförmlich Hüt plump Gewehr -- treuherzig Gange bequem Trag Körper sogleich Kommando Landmiliz erkennen -- 
  alt Eich halten still -- setzen Flint nieder -- lagern bequem Rasen -- Pfeif rauchen -- 
  Wilhelm verweilen -- lassen jung Mensch -- Pferd herbeikommen -- Gespräch -- 
  müssen Geschichte Entflohene -- -- Bemerkung -- weder jung Paar Eltern sonderlich günstig -- vernehmen -- 
  erfahren -- hierher kommen -- jung Leute Empfang nehmen -- benachbart Städtchen einholen anhalten -- 
  fern Wagen herbeikommen -- Bürgerwache lächerlich fürchterlich umgeben -- 
  unförmlich Stadtschreiber riten voraus -- komplimentieren gegenseitig Aktuar -- jung Mann -- Wilhelm sprechen -- Grenze Gewissenhaftigkeit wunderlich Gebärde -- Geist Zauberer -- inner- außerhalb Kreis -- gefährlich nächtlich Operation -- 
  Aufmerksamkeit Zuschauer indes Bauerwag richten -- betrachtet arm verirrter Mitleider -- paar Bündel Stroh sitzen -- zärtlich anblickt -- Umstehender bemerken scheinen -- 
  Zufälligerweis nötigen sehen -- letzter Dorfe unschicklich Art fort bringen -- alt Kutsche -- schön transportieren -- zerbrechen -- 
  erbat Gelegenheit Gesellschaft Freund -- -- Überzeugung -- kapital Verbrechen betreffen -- Kette beschweren nebenher lassen -- 
  Kette tragen freilich -- Anblick zärtlich Gruppe interessant -- jung Mann Anstand bewegen -- wiederholen geliebter Hand küßen -- 
  unglücklich -- rufen Umstehenden -- schuldig scheinen -- 
  belohnen grausam Mensch treu Liebe -- Eltern -- Glück Kind gänzlich vernachlässigen -- reißen Ungestüm arm Freude -- lang Trübe bemächtigen -- 
  Indes Umstehenden verschieden Weise Teilnahme erkennen geben -- Gericht Zeremonie absolvieren -- Wagen -- Wilhelm -- Schicksal Verliebte -- eilt Fußpfade voraus -- Amtmanne -- ehe Zug ankäme -- Bekanntschaft -- 
  erreichen Amtshaus -- Bewegung Empfang Flüchtling bereit -- Aktuar einholt -- umständlich Erzählung -- gehen -- weitläufig Lob Pferd -- gestern Jude tauschen -- jeder Gespräch verhindern -- 
  unglücklich Paar außen Garten -- Pfort Amtshause zusammenhehen -- absetzen -- Stille hineingeführen -- 
  Aktuar schonend Behandlung Wilhelm aufrichtig Lob -- eigentlich Amtshause versammelt Volk necken -- angenehm Schauspiel gedemütigt Mitbürgerin entziehen -- 
  Amtmann -- außerordentlich Fall sonderlich Liebhaber -- meistenteils Fehler -- Wille gewöhnlich fürstlich Regierung derben Verweis belohnen -- schwer Schritt Amtsstube -- wohin Aktuar -- Wilhelm angesehen Bürger folgen -- 
  schön vorführen -- -- Frechheit -- lassen Bewußtsein hereintreten -- 
  Art -- gekleiden betragen -- zeigen -- Mädchen -- halten -- 
  fing -- fragen -- Zustand unschicklich reden -- 
  Aktuar Gebot schweigen -- halten Feder gebrochen Blatt -- 
  Amtmann setzen Fassung -- -- räuspern -- fragt arm Kind -- Nahme heißen alt -- 
  bitte -- Herr -- versetzen -- wunderbar vorkommen -- Name Alter fragen -- wissen -- heißen -- alt ältest Sohn -- 
  wissen -- wissen -- Umschweif sagen -- 
  Vater Heirat Haus halten -- 
  hübsch Partien -- Stiefmutter Furcht Ausstattung vereiteln wissen -- 
  jung Melina kennen lernen -- lieben -- Hindernis voraussahen -- Verbindung Weg Stunde -- entschließen weit Welt Glück suchen -- Haus gewähren scheinen -- 
  mitnehmen -- -- Diebe Räuber entflohen -- Geliebter verdienen -- Kette Bande belegen herumgeschleppt -- 
  Fürst gerecht -- Härte billigen -- 
  strafbar -- Weise -- 
  alt Amtmann hierüber doppelt dreifach Verlegenheit -- 
  gnädigst Ausputzer summt Kopf -- geläufig Rede Mädchen Entwurf Protokoll gänzlich zerrütten -- 
  Übel groß -- wiederholt ordentlich Frage einlassen -- -- -- standhaft berufen -- 
  Verbrecherin -- -- 
  Strohbündeln Schande hierher führen -- hoch Gerechtigkeit -- Ehre bringen -- 
  Aktuar indessen Wort nachgeschrieben -- flüstert Amtmanne -- 
  sollen -- förmlich Protokoll nachher verfassen lassen -- 
  alt Mut -- fing -- süß Geheimnissen Liebe dürren Wort hergebracht trocken Formel erkundigen -- 
  Wilhelm steigen Röt Gesicht -- Wang artig Verbrecherin belebt gleichfalls reizend Farbe Schamhaftigkeit -- 
  schweigen stockt -- Verlegenheit zuletzt Mut erhöhen scheinen -- 
  versichern -- rufen -- stark -- Wahrheit bekennen -- sprechen müssen -- zaudern stocken -- Ehre -- 
  -- Augenblick -- Neigung Treue gewiß -- Ehemann ansehen -- gerne gönnen -- Liebe fordern -- überzeugt Herz versagen -- 
  -- -- 
  Augenblick gestehen zauderen -- Furcht -- Bekenntnis geliebter schlimm Folge -- Ursache -- 
  Wilhelm fassen -- Geständnis hören -- hoch Begriff Gesinnung Mädchen -- indes Gerichtspersonen frech Dirne erkannt -- gegenwärtig Bürger Gott danken -- dergleich Fall Familie vorkommen -- 
  Wilhelm versetzen Mariane Augenblicke Richtstuhl -- legen schön Wort Mund -- lassen Aufrichtigkeit herzlich Bekenntnis edl -- 
  heftigste Leidenschaft -- Liebenden helfen -- bemächtigen -- 
  verbergen -- bitten zaudernd Amtmann heimlich -- Sache -- klar -- bedürf Untersuchung -- 
  helfen -- Mädchen abtreten -- jung Mensch -- Türe Fessel abnehmen -- hereinkommen lassen -- 
  scheinen Schicksal nachdenkend -- 
  Antwort gesetzt -- Seite heroisch Freimütigkeit zeigen -- empfehlen hingegen Bestimmtheit Ordnung Aussage -- 
  Verhör endigen -- vorig übereinstimmen -- -- Mädchen schonen -- hartnäckig leugnen -- -- lassen vortret -- entstehen Szene -- Herz unser Freund gänzlich -- 
  Roman Komödie vorgehen pflegen -- unangenehm Gerichtsstube Auge -- Streit wechselseitig Großmut -- Stärke Liebe Unglück -- 
  -- -- schüchtern Zärtlichkeit -- Auge Sonne Mensch verbergen -- abgesondert Einsamkeit -- tief Geheimnis genießen wagen -- feindselig Zufall hervorgeschleppen -- Alsdann mutig -- stark -- tapferer zeigen -- brausend großtuend Leidenschaft -- 
  Trost schließen Handlung ziemlich -- 
  leidlich Verwahrung nehmen -- -- Abend Frauenzimmer Eltern hinüber bringen -- 
  setzen fest -- Mittelsmann -- glücklich anständig Verbindung beide Liebende befördern -- 
  erbat Amtmanne Erlaubnis -- Melina reden -- Schwierigkeit verstatten -- 
  Vierzehntes Kapitel -- 
  Gespräch bekannte vertraut lebhaft -- 
  Wilhelm niedergeschlagen Jüngling Verhältnis Eltern Frauenzimmers entdecken -- Mittler anbieten -- Hoffnung zeigen -- erheitern traurig sorgenvoll Gemüt gefangener -- fühlen befreien -- Schwiegerelter versöhnen -- künftig Erwerb Unterkommen Rede -- 
  Verlegenheit -- versetzen Wilhelm -- scheinen Beiderseit Natur bestimmen -- Stande -- wählen -- Glück -- 
  angenehm Gestalt -- wohlklingend Stimme -- gefühlvoll Herz -- Schauspieler ausstatten -- 
  Empfehlung dienen -- Freude -- 
  dank Herz -- versetzen -- schwerlich Gebrauch -- denken -- -- Theater kehren -- 
  übel -- Wilhelm Pause -- erstaunen erholen -- denken -- Schauspieler -- jung Gattin befreien -- Theater aufsuchen -- 
  scheinen notwendig -- frosch Wasser suchen -- 
  Augenblick zweifeln -- müssen erstaun Gegenteil erfahren -- 
  -- versetzen -- vornehmen -- Theater kehren -- vielmehr bürgerlich Bedienung -- wollen -- annehmen -- erhalten -- 
  sonderbar Entschluß -- billigen -- besonderer Ursache niemals ratsam -- Lebensart -- ergreifen -- verändern -- überdies wissen Stand -- Annehmlichkeit -- reizend Aussicht darböen -- Schauspieler -- 
  sehen -- -- versetzen -- 
  -- Wilhelm -- 
  Herr -- selten Mensch Zustande zufrieden -- befinden -- wünschen Nächst -- gleichfalls heraussehnen -- -- 
  Indes bleiben Unterschied -- versetzen Melina -- schlimmen schlimmeren -- Erfahrung -- Ungeduld -- handeln -- 
  stückch Brot kümmerlich -- unsicher mühselig Welt -- 
  beinahe -- Tür betteln -- 
  neid Mitgenossen -- Parteilichkeit Direktor -- veränderlich Laune Publikums auszustehen -- 
  Wahrhaftig -- Fell Bär -- Gesellschaft Affen Hunden Kette herumgeführen prügeln -- Tone Dudelsack Kind Pöbel tanzen -- 
  Wilhelm denken allerlei -- gut Mensch Gesicht sagen -- 
  fern Gespräch herum -- 
  lassen desto aufrichtig weitläufiger heraus -- 
  -- Täte Not -- -- Direktor stadtrat Füße fiele -- Erlaubnis -- Woche Messe paar Grosch Ort zirkulieren lassen -- 
  unsrigen -- Mann -- bedauern -- anderer Ursache Mißvergnüg -- 
  Akteur steigern -- schlechn -- Einnahme einigermaßen Ausgabe setzen -- Publikum -- Haus stehen leer -- -- Grund -- Schaden Kummer spielen -- 
  -- Herr -- -- sagen -- annehmen -- bitte -- sprechen ernstlichst Eltern geliebter -- 
  Versorge -- geben Schreiber Einnehmer-Dienst -- glücklich schätzen -- 
  Wort wechseln -- schied Wilhelm Versprechen -- früh Eltern angehen sehen -- ausrichten können -- 
  -- müssen folgend Ausrufung Luft -- unglücklich Melina -- Stande -- liegen armselig -- Herr -- 
  Mensch Welt -- innerer Beruf Handwerk -- Kunst Lebensart ergriffen -- müssen Zustand unerträglich finden -- 
  Talente Talent gebären -- finden Schönstes -- 
  Erde Beschwerlichkeit -- innerer Trieb -- Lust -- Liebe helfen Hindernis überwinden -- Weg bahn -- eng Kreis -- worin kümmerlich abängstigen -- emporheben -- Bretter Brett -- Rolle -- Schulknaben Pensum -- 
  Zuschauer siehsen -- Werkeltag vorkommen -- freilich einerlei -- Pult liniiert Buch sitzen -- Zins einzutragen Rest herauszustochern -- 
  fühlst zusammenbrennend -- zusammentreffend -- Geist erfund -- begreifen ausführen -- fühlst -- Mensch bess Funke leben -- -- Nahrung erhalten -- geregen -- Asche täglich Bedürfnis Gleichgültigkeit tief bedeckt -- spät fast ersticken -- 
  fühlst Seele Kraft aufzublasen -- Herz Reichtum -- erweckten Nahrung geben -- 
  Hunger treiben -- Unbequemlichkeit zuwider -- verbergen -- stand Feind lauern -- Freudigkeit Gleichmut überwinden -- 
  Tust -- Grenze gemein Stelle sehnen -- Würdest ausfüllen -- Geist Mut verlangen -- 
  Gib Soldat -- Staatsmann -- Geistlich Gesinnung -- Kümmerlich Stand beschweren -- 
  -- sogar Mensch geben -- Lebensgefühl verlassen -- Leben Wesen Sterblichen -- kummervoll Staubgleich erklären -- 
  Regt lebendig Seele Gestalt wirkend Mensch -- wärmt Brust teilnehmend Feuer -- verbreitet Gestalt Stimmung -- innersten -- sein Ton Kehl -- Wort Lippe lieblich anhören -- Fühltest -- Würdest gewiß Ort Gelegenheit aufsuchen -- fühlen -- 
  Wort Gedanke Freund ausgekleiden -- steigen Gefühl innigst Behagen Bette -- 
  Roman -- Stelle Unwürdig morgend Tag -- entwickelt Seele -- angenehm Phantasia begleitet Reich Schlaf sanft hinüber -- überließ Geschwister -- Träum -- offen arme aufnahmen -- ruhend Haupt unser Freund Vorbilde Himmel umgaben -- 
  frühen erwachen -- dachen vorstehend Unterhandlung -- 
  kehrt Haus verlaßenen Eltern -- Verwunderung aufnehmen -- 
  tragen Anbring bescheiden -- finden Schwierigkeit -- vermuten -- 
  geschehen -- außerordentlich streng hart Leute Nichtzuändernde Gewalt setzen -- übel vermehren pflegen -- Geschehene Gemüt meister unwiderstehlich Gewalt -- unmöglich scheinen -- nehmen sogleich -- geschehen -- gemein Platz -- 
  ausgemachen -- Herr Melina Tochter heiraen -- Unart Heiratsgut mitnehmen versprechen -- Vermächtnis Tante -- -- gering Interesse -- Vater Hand lassen -- 
  Punkt -- bürgerlich Versorgung finden groß Schwierigkeit -- 
  ungeraten Kind Auge sehen -- Verbindung hergelaufen Mensch angesehen Familie -- sogar Superintendenten verwanden -- Gegenwart beständig aufrücken lassen -- hoffen -- fürstlich Kolleg Stelle anvertrauen -- 
  Eltern stark -- Wilhelm -- eifrig sprechen -- Mensch -- geringschätzt -- Rückkehr Theater gönnen -- überzeugen -- Glückes wert -- Argument ausrichten -- 
  geheim Triebfedern -- Mühe geben -- Eltern überreden -- 
  Vater -- Tochter gerne behalten -- haßt jung Mensch -- Frau Auge werfen -- Stieftochter glücklich Nebenbuhlerin Auge leiden -- 
  müssen Melina wider Wille jung Braut -- groß Lust bezeigen -- Welt sehen -- Welt sehen lassen -- abreisen -- Gesellschaft Unterkomm finden -- 
  Fünfzehntes Kapitel -- 
  Glückliche Jugend -- glücklich Zeit Liebesbedürfnisses -- 
  Mensch Kind -- Echo stundenlang ergötzen -- Unkost Gespräch tragen -- Unterhaltung zufrieden -- unsichtbar Gegenmann letzter Silbe ausgerufen Wort wiederholen -- 
  Wilhelm früheren -- spät Zeit Leidenschaft Mariane -- Reichtum Gefühl hinübertrug -- Bettler ansehen -- Almosen leben -- 
  Gegend reizend -- reizend vorkommen -- Sonne beschien -- Auge verschöneren verherrlichen -- umgeben -- berühren -- 
  stehen Theater Wand -- wozu Privilegium Direktor erbeten -- 
  freilich perspektivisch Magie verschwinden -- mächtiger Zauberei Liebe fing wirken -- 
  Stundenlang schmutzig Lichtwag stehen -- Qualm Unschlitt-Lampe einziehen -- Geliebte hinaus blicken -- -- Hereintrat freundlich ansehen -- Wonne verlieren dicht Balken Latten-Gerippe -- paradiesisch Zustand versetzen fühlen -- 
  ausgestopft Lämmche -- Wasserfall Zindel -- pappen Rosenstöck einseitig Strohhütte erregn lieblich dichterisch Bild uralt Schäferwelt -- 
  sogar Nähe häßlich erscheinend Tänzerinn zuwider -- Brette vielgeliebter stehen -- 
  gewiß -- Liebe -- Rosenlaube -- Myrtenwäldch Mondschein beleben -- sogar Hobelspän Papierschnitzel Anschein belebt Natur geben -- 
  stark Würze -- schal ekel Brühen schmackhaft -- 
  solch Würze bedurfen freilich -- Zustand leidlich -- Folge angenehm -- gewöhnlich Stube -- gelegentlich antreffen -- 
  fein Bürgerhause erziehen -- Ordnung Reinlichkeit Element -- worin atmen -- Vater Prunklieb erben -- wissen -- Knabenjahren -- Zimmer -- Reich ansehen -- stattlich auszustaffieren -- 
  bettvorhäng Falte aufgezog Quast befestigen -- Thron vorstellen pflegen -- Teppich Mitte Zimmer -- feiner Tisch anzuschaffen wissen -- Buch Gerätschaft legen stellen fast mechanisch -- niederländisch Maler Gruppe Still-Lebe heraus nehmen -- 
  weiß Mütz Turban zurecht binden -- Ärmel Schlafrocks orientalisch Kostüm stutzen lassen -- 
  hiervon Ursache -- lang weit Ärmel Schreiben hindern -- 
  Abends -- fürchten -- stören -- tragen gewöhnlich seiden Schärpe Leib -- manchmal Dolch -- alt Rüstkammer zueignen -- Gürtel stecken -- zugeteilt tragisch Rolle memorieren probieren -- Sinn Gebet kniend Teppich verrichten -- 
  glücklich pries früh Zeit Schauspieler -- Besitz majestätischen Kleid -- Rüstung Waffe -- stet Übung edl Betragen -- Geist Spiegel herrlichst prächtigsten -- Welt Verhältnis -- Gesinnung Leidenschaft hervorbringen -- darstellen scheinen -- 
  dachen Wilhelm häuslich Leben Schauspieler Reihe würdig Handlung Beschäftigung -- Erscheinung Theater äußerer Spitze -- 
  Silber -- Läuter-Feuer herum treiben -- farbig schön Auge Arbeiter erscheinen -- andeuten -- Metall nunmehr fremd Zusätz reinigen -- 
  stutzen Anfangs -- Geliebten befinden -- glücklich Nebel -- umgeben -- Tisch -- Stuhl Boden -- 
  Trumm augenblicklichen -- leicht falsch Putz liegen glänzend Kleid abgeschuppt Fisch zerstreut wild Unordnung -- 
  Werkzeug menschlich Reinlichkeit -- Kämme -- Seif -- Tücher Pomade Spur Bestimmung gleichfalls verstecken -- 
  Musik -- Rolle Schuh -- wäsch italienisch Blume -- Etuis -- Haarnadeln -- Schminktöpfch Band -- Buch Strohhüte -- kein verschmäht Nachbarschaft -- gemeinschaftlich Element -- Puder Staub -- vereinigen -- 
  Wilhelm Gegenwart bemerken -- vielmehr -- gehören -- berühren -- Lieb müssen -- finden zuletzt verworren Wirtschaft Reiz -- stattlich Prunkordnung niemals empfinden -- 
  --- Schnürbrust wegnehmen -- Klavier -- Röck auf Bette legen -- setzen -- unbefangen Freimütigkeit Natürliche -- Anstand verheimlichen pflegen -- verbergen suchen -- -- sagen -- Augenblick nah -- Gemeinschaft unsichtbar Bande befestigen -- 
  Aufführung übrig Schauspieler -- Besuchen manchmal antreffen -- Begriff vereinigen -- 
  Geschäftig Müßiggange scheinen Beruf Zweck wenigster denken -- poetischen Wert Stück hören niemals reden -- weder unrichtig urteilen -- Frage -- 
  Stück -- 
  Zugstück -- 
  spielen -- 
  geben -- Frage Bemerkung Art -- 
  gewöhnlich Direktor -- Gage karg -- ungerecht -- Publikum -- Beifall selten Mann belohnen -- deutsch Theater täglich verbessere -- Schauspieler Verdienst ehren -- ehren können -- 
  sprechen Kaffeehäuser Weingärt -- vorgefallen -- wieviel Kamerad Schuld Abzug leiden müssen -- Disproportion wöchentlich Gage -- Kabal Gegenpartei -- wobei zuletzt verdient Aufmerksamkeit Publikum Betracht -- Einfluß Theater Bildung Nation Welt vergessen -- 
  Ding -- Wilhelm unruhig Stunde -- kommen gegenwärtig Gedächtnis -- Pferd langsam Haus tragen -- verschieden Vorfall -- begegnen -- überlegen -- 
  Bewegung -- Flucht Mädchen Bürgerfamilie -- Städtchen kommen -- Auge sehen -- Szene Landstraße Amtshause -- Gesinnung Melina -- vorgehen -- stellen dar -- bringen lebhaft -- vordringenden Geist Art sorglich Unruhe -- Ertrug -- Pferd Sporen Stadt zueilten -- 
  Weg rannt Unannehmlichkeit entgegen -- 
  Werner -- Freund vermutlich Schwager -- warten -- ernsthaft -- bedeutend unerwartet Gespräch anfangen -- 
  Werner geprüft -- bestimmt Leute -- gewöhnlich kalt Leute nennen pflegen -- Anlaß weder schnell sichtlich auflodern -- Umgang Wilhelm anhaltend Zwist -- wodurch Liebe desto fest knüpfen -- 
  ungeachtet verschieden Denkungsart finden Rechnung -- 
  Werner -- vortrefflichen -- obgleich gelegentlich ausschweifend Geist Wilhelm Zügel Gebiß anlegen scheinen -- Wilhelm fühlen herrlich Triumph -- bedächtig Freund warm Aufwallung fortnehmen -- 
  üben -- gewohnt täglich sehen -- sagen -- verlangen finden -- besprech -- Unmöglichkeit -- verständlich -- vermehren -- 
  Grund gehen -- Mensch -- -- Ziel -- niemals begreifen -- Gesinnung reduzieren können -- 
  Werner bemerken -- Wilhelm Besuch selten -- Lieblingsmaterien zerstreuen abbrach -- lebhaft Ausbildung seltsam Vorstellung vertieft -- freilich frei -- Gegenwart Freund Ruhe Zufriedenheit findend Gemüt sichersen erkennen lassen -- 
  pünktlich bedächtig Werner suchen anfangs Fehler Betrag -- stadtgespräch Spur bringen -- Unvorsichtigkeit Wilhelm Gewißheit nah führen -- 
  lassen Untersuchung -- entdecken -- Wilhelm Schauspielerin öffentlich besuchen -- Theater sprechen Haus bringen -- trostlos -- nächtlich Zusammenkunft sein -- hören -- Mariane verführerisch Mädchen -- Freund wahrscheinlich um Geld bringen -- nebenher unwürdigst Liebhaber unterhalten lassen -- 
  sobald Verdacht Gewißheit erheben -- beschließen Angriff Wilhelm -- Anstalten völlig Bereitschaft -- verdrießlich verstimmen Reise zurückkommen -- 
  Werner tragen denselbig Abend -- wissen -- lassen -- dringend Ernst wohldenkend Freundschaft -- lassen Zug unbestemmen -- Freund Bitterkeite kosten -- ruhig Mensch Liebende tugendhaft Schadenfreude freigebig ausspenden pflegen -- 
  denken -- richten -- 
  Wilhelm versetzen innig Bewegung -- Sicherheit -- 
  Kennst Mädchen -- Schein Vorteil -- treu Tugend gewiß Liebe -- 
  Werner beharrt Anklage -- erbieten Beweis Zeuge -- 
  Wilhelm verwerfen -- entfernt Freund verdrießlich erschüttern -- -- ungeschickt Zahnarzt schadhaft festsitzend Zahn fassen vergebens rücken -- 
  Höchst unbehaglich finden Wilhelm -- schön Bild Mariane Grill Reise -- Werner Unfreundlichkeit Seele trüben beinahe entstellen sehen -- 
  Griff sicherst -- völlig Klarheit Schönheit herstellen -- nachts gewöhnlichen hineilen -- 
  empfangen lebhaft Freude -- Ankunft vorbei geritt -- Nacht erwarten -- lassen denken -- Zweifel Herz vertreiben -- 
  Zärtlichkeit schließen Vertrauen -- erzählen -- Publikum -- Freund versündiget -- 
  Mancherlei lebhaft Gespräch führen Zeit Bekanntschaft -- Erinnerung schön Unterhaltung zwei Liebenden bleiben -- 
  Schritt -- Irrgart Liebe bringen -- angenehm -- Aussicht reizend -- Gedächtnis rufen -- 
  suchen Vorzug behalten -- -- uneigennützig lieben -- jeder wünschen Wettstreit überwinden -- überwinden -- 
  Wilhelm wiederholen Mariane -- gehören -- Aufmerksamkeit Schauspiel ziehen -- Gestalt -- Spiel -- Stimme fesseln -- zuletzt Stück -- spielen -- besuchen -- auf Theater geschlichen -- -- bemerken -- gestehen -- sprechen Entzück glücklich Abend -- Gelegenheit finden -- Gefälligkeit erzeig -- Gespräch einleiten -- 
  Mariane Wort -- bemerken -- behaupten -- Spaziergang sehen -- bezeichnen Beweis Kleid -- selbigen angehabt -- behaupten -- fallen -- Bekanntschaft wünschen -- 
  glauben Wilhelm -- 
  lassen überreden -- -- nähern -- unwiderstehlich Zug hingeführen -- absichtlich Kulisse treten -- nah sehen -- Bekanntschaft -- zuletzt -- Zurückhaltung Blödigkeit überwinden -- Gelegenheit geben -- gleichsam nötigen -- Glas Limonade herbeizuholen -- 
  liebevoll Wettstreit -- Umstand kurz Roman verfolgt -- verging Stunde schnell -- Wilhelm verlassen völlig beruhigen Geliebte -- fest Vorsatze -- Vorhaben unverzüglich Werk richten -- 
  Sechzehntes Kapitel -- 
  Abreise nötig -- Vater Mutter besorgt -- Kleinigkeit -- Equipage fehlen -- verzögert Aufbruch -- 
  Wilhelm benutzen -- Mariane Brief schreiben -- wodurch Angelegenheit Sprache bringen -- unterhalten vermeiden -- 
  Folgendermaße lauten Brief -- 
  -- lieben Hülle Nacht -- dein arme bedecken -- sitzen denken schreiben -- Sinn treiben -- deinetwillen -- 
  O Mariane -- -- glücklichst Mann -- Bräutigam -- ahnungsvoll -- welcher Welt entwickeln -- festlich Teppich stehen -- -- heilig Zeremonie -- gedankenvoll lüstern geheimnisreich Vorhäng versetzen -- woher Lieblichkeit Liebe entgegen säuseln -- 
  gewinnen -- sehen -- Hoffnung Entschädigung -- ewig -- deinig bleiben -- 
  wiederholen wünschen -- nötig -- scheinen -- habest verstehen -- 
  leisen Ton Treue -- -- halten wünschen -- sagen wagen -- Herz forschen verlangen ewig Verbindung -- Verstanden gewiß -- Herz Wunsch keimen -- vernommen Kuß -- anschmiegend Ruhe glücklich Abend -- 
  lernen Bescheidenheit kennen -- vermehrt Liebe -- 
  künstlich betragen -- überflüssig Sonnenschein Entschluß Herzen Liebhaber reife bringen -- Erklärung hervor locken -- Versprechen befestigen -- ziehst -- schließest halbgeöffnet Brust dein geliebter -- suchst anscheinend Gleichgültigkeit Beistimmung verbergen -- verstehen -- 
  welch Elender müssen -- Zeichen rein -- uneigennützig -- Freund besorgt Liebe erkennen -- 
  Vertrau ruhig -- 
  gehören -- Kein verlassen verlieren -- leben -- 
  Nimm -- Hand -- feierlich überflüssig Zeichen -- 
  Freude Liebe empfinden -- Seligkeite bestätigt Gedanke Dauer -- 
  Frage -- 
  Sorge -- 
  Schicksal sorgen Liebe -- gewiß -- Liebe genügsam -- 
  Herz Eltern Haus verlassen -- -- Geist Bühne schweben -- 
  O Geliebte -- 
  Mensch gewähren -- Wunsch verbinden -- -- 
  Schlaf Auge -- ewig Morgenröte steigen Liebe Glück -- 
  halten -- auffahr -- hinrenn Einwilligung erzwingen -- früh Welt Ziel hinstreben -- 
  -- -- bezwingen -- 
  unbesonnen törichen -- verwegen Schritt -- Plan entwerfen -- ruhig ausführen -- 
  Direktor Serlo -- Reise -- Leute Lebhaftigkeit Freude Theater wünschen -- gewiß willkommen -- eurer Truppe Ursache eintreten -- spielen Serlo -- anfangs Schritt verbergen -- 
  leidlich Unterhalt finden -- sehen Publikum -- lern Gesellschaft kennen -- hole -- 
  Mariane siehst -- gewinnen -- gewiß -- sehen -- weit Welt wissen -- lebhaft denken -- 
  Liebe vorstell -- sichern -- bitte verschmähsen -- ehe scheid -- Hand Priester reichsen -- ruhig -- 
  Formel -- schön Formel -- Segen Himmel Segen Erde -- 
  Nachbarschaft -- ritterschaftlich -- heimlich -- 
  Anfang Geld -- teilen -- hinreichen -- ehe verzehren -- Himmel helfen -- 
  -- Liebste -- bange -- 
  Fröhlichkeit beginnen -- glücklich erreichen -- 
  zweifeln -- Fortkomme Welt finden können -- Ernst -- fühlen Mut -- mehrere reichlich Unterhalt gewinnen -- 
  Welt undankbar -- sagen -- finden -- undankbar -- Art wissen -- 
  glühen Seele Gedanke -- aufzutret Mensch Herz hinein reden -- hören sehnen -- 
  tausendmal freilich -- Herrlichkeit Theater einnehmen -- bingen Seele gehen -- elendest sehen einbilden -- können trefflich Wort an Herz reden -- 
  Ton -- Fistel zwingen -- klingen Reiner -- unerhört -- Bursche grob Ungeschicklichkeit versündigen -- 
  Theater Streit Kanzel -- -- dünken -- hadern -- 
  wünschen -- Ort edle Mensch Gott Natur verherrlichen -- 
  Traum -- Liebste -- 
  Herz fühlen -- Liebe -- ergreif glänzend Gedanke sagen -- will_es aussagen -- hoffen -- einst Paar Geist Mensch erscheinen -- Herz aufzuschließen -- Gemüt berühren -- himmlisch Genüß bereiten -- gewiß Busen Freude gewähren -- himmlisch nennen -- Augenblick rücken -- erhaben fühlen -- 
  schließen -- -- wissen -- -- angehen -- Bewegung Rad -- Herz drehen -- Wort vermögend ausdrücken -- 
  Nimm Blatt indes -- Liebe -- durchgelesen finden -- vorne anfangen -- enthalten -- wissen nötig -- Vorbereitung -- Fröhlichkeit süß Liebe deinen Busen zurückkehren -- 
  kommen Gefangener -- Kerker lauschend Fessel abfeilt -- sag Nacht sorglos schlafend Eltern -- -- 
  Leb -- Geliebte -- 
  Leb -- 
  diesmal schließen -- Auge -- dreimal zugefallen -- tief Nacht -- -- 
  Siebzehntes Kapitel -- 
  endigen -- Wilhelm -- Brief schön gefalten Tasche -- Mariane hinsehnen -- düster -- wider Gewohnheit Wohnung hinschlich -- 
  Plan -- Nacht anmelden -- Geliebte kurz verlassen -- -- ehe weggingen -- Brief Hand drücken -- Rückkehr tief Nacht Antwort -- Einwilligung erhalten -- Liebkosung erzwingen -- 
  fliegen Arm -- Busen fassen -- 
  Lebhaftigkeit Empfindung verbirgen anfangs -- Herzlichkeit antworten -- ängstlich Zustand verbergen -- schützt Krankheit -- Unpäßlichkeit -- beklagen Kopfweh -- Vorschlag -- Nacht wollen -- einlassen -- 
  ahndet böse -- Drang -- fühlt -- Stunde -- Brief übergeben -- 
  behalten -- verschieden Bewegung Rede höflich Weise wegzugehen nötigen -- ergriff Taumel ungenügsamen Liebe Halstücher -- stecken Tasche -- verlassen wider Wille Lippe Türe -- 
  schlich Haus -- bleiben -- kleiden -- suchen frei Luft -- 
  Straße abgegangen -- begegnet unbekannte -- gewiß Gasthofe fragen -- Wilhelm erbieten -- Haus zeigen -- Fremd erkundigt Name Straße -- Besitzer verschieden Gebäude -- vorbei gehen -- sodann Polizei-Einrichtung Stadt -- interessant Gespräch begreifen -- Tore Wirtshaus ankamen -- 
  Fremd nötigt Führer hinein treten -- Glas Punsch trinken -- Name Geburtsort -- Geschäft -- hierher bringen -- ersuchen Wilhelm gleich vertrauen -- 
  verschweigen Name -- Wohnung -- 
  Enkel alt Meister -- schön Kunstsammlung besitzen -- fragt Fremde -- 
  -- bin_es -- Großvater sterben -- schmerzen lebhaft -- schön Sache verkaufen sehen -- 
  Vater Summe Geld erhalten -- 
  wissen -- 
  O -- Schatz Haus sehen -- 
  Großvater bloß Sammler -- verstehen Kunst -- früh glücklich Italien -- Schatz bringen -- Preis sein -- 
  besitzen trefflich Gemälde Meister -- traut Auge -- Handzeichnung durchsehen -- Marmorn unschätzbar Fragment -- Bronzen besitzen instruktiv Suit -- Münze Kunst Geschichte zweckmäßig sammeln -- weniger geschnitten Stein verdient Lob -- aufstellen -- Zimmer Säle alt Haus symmetrisch bauen -- 
  denken -- Kind verlieren -- Sache herunter nehmen eingepacken -- 
  traurig Zeit Leben -- 
  wissen -- leer Zimmer vorkamen -- Gegenstand verschwinden sehen -- Jugend unterhalten -- unveränderlich halten -- Haus Stadt -- 
  Irre -- Vater gelöst Kapital Handlung Nachbars -- Art Gesellschaft Handel eingehen -- 
  -- gesellschaftlich Spekulation glücken -- zwölf Vermögen vermehren -- desto heftig Erwerb stellen -- alt Werner Sohn -- Handwerke schicken -- -- 
  tun leid -- Ort Zierde verlieren -- Cabinet Großvater -- 
  vorher -- ehe verkaufen -- sagen -- Ursache -- Kauf Stande -- 
  reich Edelmann -- Liebhaber -- wichtig Handel Urteil verlassen -- hierher schicken -- verlangt Rat -- 
  besehen Cabinet -- raten Freund -- gefordert Summe Anstand bezahlen -- 
  munter Knabe herum -- erklärt Gegenstand Gemälde -- wissen Cabinet auszulegen -- 
  erinner Person -- erkennen -- 
  -- verändern -- 
  -- erinneren -- Lieblings-Bild -- weglassen -- 
  -- stellen Geschichte -- krank Königssohn Braut Vater Liebe verzehren -- 
  gut Gemälde -- zusammensetzen -- sonderlich Farbe -- Ausführung manierieren -- 
  verstehen -- verstehen -- Gegenstand -- Gemälde reizen -- Kunst -- 
  scheinen Großvater denken -- groß Sammlung bestehen trefflich Sache -- Verdienst Meister bewunderten -- vorstellen -- hing Bild äußersten Vorsaal -- Zeichen -- schätzen -- 
  -- Kind spielen -- Bild unauslöschlich Eindruck -- Kritik -- verehr -- auslösch -- Bild stehen -- 
  jammeren -- jammern Jüngling -- süßen Trieb -- schön Erbteil -- Natur -- verschließen -- Feuer -- erwärmen beleben -- Busen verbergen -- Innerst ungeheur Schmerz verzehren -- 
  bedaur Unglückliche -- widmen -- Herz würdig Gegenstand wahr rein Verlangen finden -- 
  Gefühl freilich Betrachtung entfernen -- Kunstliebhaber Werk Meister ansehen pflegen -- wahrscheinlich -- Cabinet Eigentum Haus bleiben -- Sinn Werk aufgehen -- Neigung Kunstwerke sehen -- 
  gewiß Verkaufe Kabinett leid -- reifer öfters vermissen -- Bedenke -- gleichsam müssen -- Liebhaberei -- Talent entwickeln -- Leben wirken -- Leblose Bild tun -- bescheide -- verehr Schicksal Best Best einleiten wissen -- 
  hören Wort Schicksal jung Manne aussprechen -- Alter befinden -- gewöhnlich lebhaft Neigung Wille hoch Wesen unterzuschieben pflegen -- 
  glauben Schicksal -- 
  -- walten -- unser lenken -- 
  Rede Glaube -- Ort auszulegen -- Ding -- unbegreiflich -- einigermaßen denkbar suchen -- Frage -- Vorstellungsart unser reichen -- 
  Geweb Welt Notwendigkeit Zufall bilden -- Vernunft Mensch stellen -- wissen beherrschen -- behandeln notwendig Grund Dasein -- Zufällige wissen lenken -- leiten nutzen -- -- fest unerschütterlich stehen -- verdienen Mensch Gott Erde nennen -- 
  Wehe -- Jugend gewöhnen -- Notwendig Willkürlich finden -- Zufällige Art Vernunft zuschreiben -- folgen sogar Religion -- 
  -- eigen verstande entsagen -- Neigung unbedingt Raum geben -- 
  bilden -- fromm -- Überlegung hinschlendern -- angenehm Zufall determinieren lassen -- Resultat schwankend Leben Name göttlichen Führung geben -- 
  niemals Fall -- Umstand veranlaßn -- gewiß Weg einschlagen -- gefällig Gelegenheit entgegen -- Reihe unerwartet Vorfälle an Ziel bringen -- Auge fassen -- 
  Ergebenheit Schicksal -- zutrauen Leitung einflößen -- -- 
  Gesinnung Mädchen Tugend -- Geld Beutel behalten -- Anläs -- beide -- 
  Mensch freuen -- wissen -- nütze -- Willkür beschränken arbeiten -- 
  Glück Hand -- Künstler roh Materie -- Gestalt umbilden -- 
  Kunst -- Fähigkeit angeboren -- lernen sorgfältig ausüben -- 
  mehreres abgehandelt -- trennen -- sonderlich überzeugt scheinen -- bestimmt folgend Ort Zusammenkunft -- 
  Wilhelm Straße nieder -- hört Klarinett -- Waldhörner Fagotte -- schwollen Busen -- 
  durchreisend Spielleute machen angenehm Nachtmusik -- 
  sprechen -- Stück Geld folgen Mariane Wohnung -- 
  hoch Baum ziert Platz Haus -- stellen Sänger -- ruht Bank Entfernung -- überlassen schwebend Tön -- labend Nacht säuselten -- 
  hold Stern hingestrecken golden Traum -- 
  -- hören Flöt -- Herz -- fühlen -- Andenken -- Liebe Nacht wohlklingend -- Entfernung Melodien binden -- Entfernung fein Stimmung Liebe -- 
  liebend Herz -- Magnetuhre -- regen -- bewegen -- Eins -- wirken -- Kraft -- durchgehen -- 
  arme Möglichkeit fühlen -- trennen -- -- fern -- Heilort Liebe suchen -- -- 
  mir_es geschehen -- abwesend -- Gedanke verlieren -- Buch -- Kleid berühren -- glauben Hand fühlen -- Gegenwart umkleiden -- 
  Augenblick erinnern -- Licht Tag Auge kalt Zuschauer fliehen -- genieß Götter schmerzlosen Zustand rein Seligkeit verlassen entschließen dürfen -- 
  -- erinnern -- -- 
  Rausch Taumelkelch Erinnerung erneuern -- Sinn himmlisch Strick binden Fassung reißen -- 
  -- Gestalt -- -- 
  verlieren Andenken -- Ruhe verlangen -- umfaßt Baum -- kühlt heiß Wange Rinde -- Wind Nacht saugn begierig Hauch -- rein Busen bewegen Hervordrang -- 
  fühlt Halstuch -- Mitgenommen -- vergessen -- stecken vorig Kleide -- 
  Lippe lechzen -- Glied zitteren verlangen -- 
  Musik hören -- -- Element fallen -- Empfindung empor tragen -- 
  Unruhe vermehren -- Gefühl sanft Tön nähren lindern -- 
  setzt Schwelle nieder -- beruhigen -- 
  küssen messingen Ring -- womit Tür pochen -- küßte Schwelle -- Füß gehen -- erwärmt Feuer Brust -- 
  sitzen Weile stillen -- dachen Vorhängen -- weiß Nachtkleid rot Band Kopf süß Ruhe -- denken nahe -- vorkommen -- müssen träumen -- 
  Gedanke lieblich -- Geist Dämmerung -- Ruhe verlangen wechseln -- Liebe laufen schaudernd Hand tausendfältig Sait Seele -- -- Gesang Sphäre still stehen -- leisen Melodi Herzen belauschen -- 
  Hauptschlüssel -- Mariane Türe öffnen -- halten -- Heiligtum Liebe eindringen -- 
  entfernen langsam -- schwanken halb träumend Bäume -- Haus -- umwenden -- vermögen -- -- Ecke -- -- Mariane Türe öffnet -- dunkel Gestalt heraus bewegen -- 
  -- deutlich sehen -- ehe fassen Aufsah -- Erscheinung Nacht verlieren -- glauben weiß Haus vorbei streifen sehen -- 
  stehen blinzen -- ehe ermannt nacheilt -- Phantom verschwinden -- 
  wohin folgen -- 
  Straße Mensch aufnehmen -- -- 
  -- Blitz Gegend Winkel erhellt -- geblendet Auge vorig Gestalt -- Zusammenhäng Pfade Finsternis vergebens suchen -- war_es Auge -- Herz -- 
  Gespenst Mitternacht -- ungeheuer Schrecken erzeugen -- folgend Augenblick Fassung Kind Schrecken halten -- fürchterlich Erscheinung Zweifel Seele lassen -- Wilhelm groß Unruhe -- Eckstein gelehnen -- Helle Morgen Geschrei Hähn achtet -- früh Gewerbe lebendig anfingen -- Haus treiben -- 
  -- -- unerwartet Blendwerk triftigst Grund beinahe Seele vertreiben -- schön Stimmung Nacht -- Erscheinung denken -- -- 
  Herz letzen -- Siegel wiederkehrend Glaube aufzudrücken -- Halstuch vorig Tasche -- 
  Rauschen Zettel -- herausfiel -- ziehen Tuch Lippe -- heben Las -- -- leiben -- Narr -- gestern -- 
  Nacht kommen -- 
  glauben -- leid tun -- wegzugehen -- Geduld -- Messe kommen -- 
  Höre -- tun schwarz-grün-braune Jacke -- siehst Hexe Endor -- weiß Negligee schicken -- weiß schäfch arme -- 
  Schick Zettel alt Sibylle -- Teufel Iris bestellen -- -- 
  Wilhelm Meister Lehrjahr -- 
  Buch -- 
  Kapitel -- 
  -- -- lebhaft Kraft -- unser Auge -- Absicht erreichen streben -- -- Zweck loben tadeln -- Teilnahme versprechen -- sobald Sache entscheiden -- wenden Auge sogleich weg -- endigen -- abgetan liegen -- Aufmerksamkeit keineswegs fesseln -- früh Unternehmung übl Ausgang prophezeien -- 
  Leser umständlich Jammer Not unser verunglückt Freund unterhalten -- befiel -- Hoffnung Wunsch -- unerwartet Weise -- zerstören -- 
  überspringen vielmehr -- suchen -- Art Tätigkeit Genuß finden hoffen -- vorher kürzlich -- Zusammenhäng Geschichte nötig -- vortragen -- 
  Pest -- bös Fieber rasen gesunden -- vollsaftig Körper -- anfallen -- schnell heftig -- arm Wilhelm unvermutet unglücklich Schicksal überwältigen -- Augenblick Wesen zerrütten -- 
  ungefähr Zurüstung Feuerwerk Brand geraten -- künstlich gebohrt gefüllt Hülsen -- -- gewiß Plan geordnet abgebrannen -- prächtig abwechselnd Feuer-Bild Luft zeichnen -- nunmehr unordentlich gefährlich zischen sausen -- gehen Busen Glück Hoffnung -- Wollust Freude -- Wirklich Geträumt scheiternd -- 
  wüs Augenblick erstarren Freund -- Rettung hinzu eilen -- -- treffen -- Wohltat -- Sinn verlassen -- 
  lauten -- ewig wiederkehrend Vorsatz erneuerten Schmerzen folgen -- Gnade Natur -- 
  Stunde Wilhelm Geliebte verlieren -- Schmerz unermüdet erneuert Versuch -- Glück -- Seele entfloh -- fest halten -- Möglichkeit Vorstellung erhaschen -- abgeschieden Freude kurz Nachlebe verschaffen -- 
  Körper -- Verwesung dauern -- tot nennen -- Kraft -- vergebens alt Bestimmung wirken suchen -- Zerstörung Teil -- belebt -- abarbeiten -- -- aufgerieben -- gleichgültig Staub zerlegt sehen -- entstehen erbärmlich -- leer Gefühl Tod -- Atem Ewiglebende erquicken -- 
  -- -- lieblich Gemüte zerreißen -- zerstören -- ertöen -- schnellheilend Kraft Jugend Gewalt Schmerzen Nahrung Heftigkeit -- 
  streiche Wurzel treffen -- 
  Werner -- Not Vertrauter -- greifen voll Eifer Feuer Schwert -- verhaßt Leidenschaft -- Ungeheuer -- innerste Leben dringen -- 
  Gelegenheit glücklich -- Zeugnis Hand -- wieviel Geschichte Erzählung Wusst nutzen -- 
  trieb_es Heftigkeit Grausamkeit Schritt Schritt -- lassen Freund Labsal mindest augenblicklich Betrug -- vertreten Schlupfwinkel -- Verzweiflung retten -- Natur -- Liebling Grund lassen -- Krankheit anfiel -- Seite Luft -- 
  lebhaft Fieber Gefolge -- Arznei -- Überspannung Mattigkeit -- Bemühung Familie -- Liebe Mitgeboren -- Mangel Bedürfnis fühlbar -- Zerstreuung verändert Zustand -- kümmerlich Unterhaltung -- 
  -- -- Kraft erschöpfen -- Wilhelm -- entsetzen -- qualvoll Abgrund dürr Elend hinab -- ausgebrannn hohl Becher Vulkan hinunt blicken -- 
  nunmehr bitterst Vorwurf -- -- groß Verlust -- schmerzlosen -- ruhig -- gleichgültig Augenblick können -- 
  verachten Herz -- sehnt Labsal Jammer Träne -- 
  erwecken -- bringen Andenken Szene Glück -- 
  groß Lebhaftigkeit malen -- streben hinein -- möglichst Höhe hinauf arbeiten -- Sonnenschein vorig Glied beleben -- Busen heben scheinen -- rückwärts schrecklich Abgrund -- laben Auge zerschmetternd Tiefe -- werfen Hinunter -- erzwingen Natur bitterst Schmerz -- 
  wiederholt Grausamkeit zerriß -- Jugend -- reich eingehüllt Kraft -- wissen -- verschleudern -- Schmerz -- Verlust erregen -- erzwungen leiden zusellen -- verlorener Wert geben -- 
  überzeugen -- Verlust einzig -- letzter -- Leben empfinden können -- Trost verabscheuen -- leiden vorstellen unternehmen -- 
  Kapitel -- 
  Gewöhnt -- Weise quälen -- greifen übrig -- lieb Liebe groß Freude Hoffnung geben -- Talent Dichter Schauspieler -- hämisch Kritik Seite -- 
  Arbeit geistlos Nachahmung hergebracht Form -- innerer Wert -- steif Schulexerzitien erkennen -- Funke Naturell -- Wahrheit Begeisterung fehlen -- 
  Gedicht finden monoton Silbenmaß -- -- armseligen Reim halten -- gemein Gedanke Empfindung hinschleppten -- benehmen Aussicht -- Lust -- Seite allenfalls aufrichten -- Schauspieler-Talente -- 
  Schalt -- Eitelkeit entdecken -- Anmaßung Grund liegen -- 
  Figur -- Gang -- Bewegung Deklamation müssen herhalten -- sprechen Art Vorzug -- jeder Verdienst -- Gemein empor heben -- entscheidend -- vermehren stumm Verzweiflung hoch Grad -- 
  -- hart -- lieb Weibe entsagen -- Empfindung schmerzlich -- Umgang Muse reißen -- Gemeinschaft unwürdig erklären -- schön nächster Beifall -- Person -- unser Betragen -- Stimme öffentlich geben -- Verzicht -- 
  Weise Freund völlig resignieren -- Eifer Handelsgeschäft widmen -- 
  erstaun Freund groß Zufriedenheit Vater Comptoir Börse -- Laden Gewölbe tätig -- -- Korrespondenz Rechnung -- aufgetrag -- besorgt verrichtet groß Fleiß Eifer -- 
  freilich heiteren Fleiße -- Geschäftig Belohnung -- dasjenig -- wozu gebären -- Ordnung Folge verrichten -- still Fleiße Pflicht -- Vorsatz Grund -- Überzeugung nähren innerer Selbstgefühl belohnen -- -- -- schön Bewußtsein Krone reichen -- vordringend Seufzer ersticken vermögen -- 
  Weise Wilhelm Zeitlang emsig fortgeleben überzeugen -- hart Prüfung Schicksal veranstalten -- 
  froh -- Weg Leben Zeit -- obgleich unfreundlich -- warnen sehen -- anstatt schwer Mißgriff büßen -- wozu jugendlich Dünkel verleiten -- 
  gewöhnlich wehren Mensch -- Tor -- Busen hegen -- verabschieden -- Hauptirrtum bekennen -- Wahrheit einzugestehen -- Verzweiflung bringen -- 
  entschließen -- lieb Vorstellung entsagen -- nötig -- Unglücke völlig überzeugen -- 
  Hoffnung Liebe -- poetisch Hervorbringen persönlich Darstellung -- triftig Grund -- vernichten -- Mut fassen -- Spur Torheit -- -- erinnern -- völlig auszulöschen -- 
  kühl Abend Kaminfeuer anzünden -- holen Reliquienkästchen hervor -- hunderterlei Kleinigkeit finden -- bedeutend Augenblick Mariane erhalten -- rauben -- 
  vertrocknet Blume erinnern -- frisch Haar blühen -- jeder Zettelch glücklich Stunde -- wozu Einlud -- Schleife lieblich Ruheplatz Haupt -- schön Busen -- 
  mußte Weise Empfindung -- töten glauben -- bewegen anfangen -- 
  mußte Leidenschaft -- -- abgeschied geliebter -- Herr -- Gegenwart Kleinigkeit mächtig -- 
  merken -- traurig unangenehm Trüber -- einzig -- durchdringend Sonnenblick aufmunternd Glanz heiteren Stunde darstellen -- 
  Bewegung bewahren Heiligtümer Rauch Flamm aufgehen -- 
  einigemal halten zaudernd inne -- Perlenschnur flohrn Halstuch übrig -- entschließen -- dichterisch Versuch Jugend abnehmend Feuer auffrischen -- 
  sorgfältig aufheben -- -- frühsen Entwicklung Geist -- Feder fließen -- 
  liegen Schrift Bündel binden Boden Koffer -- wohin packen -- Flucht mitzunehmen hoffen -- 
  eröffnen -- Band -- 
  Brief -- gewiß Umstand schreiben siegeln -- Freund -- richten -- Antrifft -- bringen -- eröffnen -- überfällen sonderbar Empfindung -- Siegel erbrechen -- unser verändert Person unterhalten -- 
  ähnlich Gefühl ergriff Heftigkeit unser Freund -- Paket eröffnen -- zerteilten Heft Feuer werfen -- gewaltsam aufloderten -- Werner Hereintrat -- lebhaft Flamm verwundern -- fragen -- vorgehen -- 
  geben Beweis -- Wilhelm -- ernst -- Handwerk aufgeben -- wozu gebären -- Wort werfen Paket Feuer -- 
  Werner abhalten -- geschehen -- 
  sehen -- Extrem kommst -- -- 
  Arbeit -- vortrefflich -- vernichten -- 
  Gedicht vortrefflich -- existieren -- 
  -- Anlage -- gute leisten -- Kunst enthalten -- Verführung ernstlich nehmen -- 
  freilich regen Mensch gewiß unbestimmt verlangen -- dasjenig sehen -- nachzuahmen -- verlangen beweisen -- Kraft wohnen -- -- Unternehmen -- Stande -- 
  Sieh Knabe -- jedesmal -- Seiltänzer Stadt -- Planken Balken balancieren -- anderer Reiz ähnlich Spiel hinziehen -- 
  Zirkel Freund bemerken -- 
  virtuoser hören lassen -- finden -- sogleich Instrument lernen anfangen -- 
  irr Weg herum -- glücklich Fehlschluß wünschen Kraft gewahr -- 
  Werner widersprechen -- Unterredung lebhaft -- Wilhelm Bewegung Argument -- quälen -- Freund wiederholen -- 
  Werner behaupten -- vernünftig -- Talent -- einigermaßen Neigung Geschick -- -- niemals groß Vollkommenheit ausüben -- aufgeben -- 
  find Leere -- ausfüllen -- hervorbringen können -- wodurch Vergnügen bereiten -- 
  Freund -- hierin anderer Meinung -- fallen sogleich -- Lebhaftigkeit -- 
  irrst -- Freund -- glaubst -- Werk -- Vorstellung Seele füllen -- unterbrochen -- gegeizt Stunde können hervorbringen -- 
  -- Dichter -- geliebt Gegenstand leben -- 
  -- Himmel innerlich köstlichst begabt -- -- vermehrend Schatz Busen bewahren -- außen ungestört Schätz still Glückseligkeit leben -- Reicher vergebens aufgehäuft Gut hervorzubringen suchen -- 
  Sieh Mensch -- Glück Vergnügen rennen -- 
  wünsche -- Mühe -- Geld jagen rastlos -- wonach -- 
  -- Dichter Natur erhalten -- Genuß Welt -- Mitgefühl -- harmonisch Zusammensein unvereinbar Ding -- 
  Beunruhiget Mensch -- Begriff Sache verbinden -- Genuß Hand wegstiehlen -- gewünschen spät -- erreichen erlangt Herz Wirkung tun -- Begierde Ferne ahnden lassen -- 
  gleichsam Gott Schicksal Dichter hinüber setzen -- 
  sehen Gewirre Leidenschaft -- Familie Reiche zwecklos bewegen -- sehen unauflöslich Rätsel Mißverständnisse -- einsilbig Wort Entwicklung fehlen -- unsäglich verderblich Verwirrung verursachen -- 
  fühlen Traurig Freudig jeder Menschenschicksal -- 
  weltmensch abzehrend Melancholie Verlust hinschleichen -- ausgelassen Freude Schicksal entgegen -- schreiten empfänglich leichtbeweglich Seele Dichter -- wandelnd Sonne -- Nacht fort -- leisen Übergäng stimmen Harfe Freude Leid -- 
  Eingebor Grund Herzen wachsen schön Blume Weisheit hervor -- wachend träum -- ungeheur Vorstellung Sinn ängstigen -- leben Traum Leben wachend -- selten -- geschehen -- Vergangenheit Zukunft -- 
  Dichter Lehrer -- Wahrsager -- Freund Gott Mensch -- 
  -- -- kümmerlich Gewerbe herunter steigen -- -- Vogel bauen -- Welt überschewben -- hoch Gipfel nist -- Nahrung Knosp Früchte -- Zweig verwechselnd -- nehmen -- Stier Pflug ziehen -- Hund Fährte gewöhnen -- Kette schließen Meierhof Belle sicheren -- 
  Werner -- denken -- Verwunderung zuhören -- 
  Mensch -- fallen -- Vögel sein -- spinnen weben -- holdselig beständig Genuß zubringen können -- 
  Ankunft Winter fern Gegende begäben -- Mangel auszuweichen -- Frost sicheren -- 
  Dichter Zeit leben -- Ehrwürdige erkennen -- rufen Wilhelm -- leben -- 
  Genügsam Innerst ausstatten bedurft außen -- Gabe -- schön Empfindung -- herrlich Bild Mensch süßen -- Gegenstand anschmiegend -- Wort Melodi mitteilen -- bezaubert jeher Welt -- Begabt reichlich Erbteil -- 
  Könige Höfen -- Tisch reich -- Tür Verliebte horchen -- Ohr Seele verschließen -- selig preisen entzücken Stille stehen -- Gebüschen -- wandeln -- Stimme Nachtigall gewaltig rührend hervordringen -- 
  finden gastfrei Welt -- niedrig scheinend Stand erhöhen desto -- Held lauschen Gesäng -- Überwind Welt huldigt Dichter -- fühlen -- -- -- ungeheur Sturmwind vorüberfahren -- Liebende wünschen verlangen Genuß tausendfach harmonisch fühlen -- beseelt Lippe schildern verstehen -- Reiche Besitztümer -- Abgötter Auge kostbar sehen -- Glanze -- Wert fühlend erhöhend Geist beleuchten erscheinen -- 
  -- -- -- Götter bilden -- erheben -- herniederbringen -- Dichter -- 
  Freund -- versetzen Werner einig nachdenken -- bedauern -- -- lebhaft fühlst -- Gewalt Seele verbannen strebst -- 
  müssen irren -- tätest -- einigermaßen nachgeben -- Widerspruch hart Entsagen aufzureiben -- unschuldig Freude Genuß übrig entziehen -- 
  dir_es gestehen -- Freund -- versetzen -- lächerlich finden -- bekennen -- Bild verfolgen -- fliehen -- -- Herz untersuch -- früh Wunsch fest -- fest haften -- 
  bleiben Unglücklichen gegenwärtig übrig -- 
  voraussagen -- arm Geist sobald zerschmettern -- Unendliche greifen -- gewiß umfassen hoffen -- 
  voraussagen -- Verzweiflung bringen -- 
  -- Gericht ergehen -- -- verlieren -- anstatt Gottheit wünschen hinüber führen -- bleiben übrig -- bittersen Schmerz überlassen -- 
  O Bruder -- fahren fort -- leugnen -- heimlich Anschlag Klobe -- Strickleiter befestigen -- gefährlich hoffend schweben Abenteurer Luft -- Eisen brechen -- liegen zerschmetteren Fuß Wunsch -- 
  Trost -- Hoffnung -- 
  -- rufen -- Aufsprang -- unglückselig Papier keiner übrig lassen -- 
  fassen abermals Paar Heft -- reißen werfen Feuer -- 
  Werner abhalten -- vergebens -- 
  Laß -- rufen Wilhelm -- elend Blatt -- 
  weder Stufe Aufmunterung -- 
  übrig bleiben -- an Leben peinigen -- 
  Welt Gespött dienen -- anstatt Mitleider Schauer erregen -- 
  Weh Schicksal -- 
  versteh Klage Dichter -- Not weise geworden Traurig -- 
  halten unzerstörbar -- unverwundlich -- -- 
  sehen -- tief Schade auswachsen -- herstellen -- fühlen -- Grab nehmen -- 
  -- Leben Schmerz weichen -- zuletzt umbringen -- Andenke bleiben -- leben sterben -- Andenken Unwürdig -- -- Freund -- 
  Herz reden -- gewiß Unwürdig -- 
  Stand -- Schicksal tausendmal entschuldigen -- 
  grausam -- Kälte -- Härte unbarmherzig einweihen -- zerrüttet Sinn gefangen halten verhindern -- -- schuldig -- 
  wissen -- Zustand versetzen -- fallen auf's Gewissen -- Verzweiflung -- Hilflosigkeit verlassen -- 
  -- entschuldigen -- 
  -- 
  wieviel Mißverständnisse Welt verwirren -- wieviel Umstand groß Fehler Vergebung erflehen -- -- 
  denken -- Stille sitzend -- Ellenbogen stützen -- -- 
  -- -- Treue -- Liebe -- Zuschwur -- 
  unsanft Schlag schön Leben endigen -- verbinden -- -- 
  brechen Strom Träne -- Gesicht Tisch werfen -- übergeblieben Papier benetzen -- 
  Werner stehen groß Verlegenheit -- 
  rasch Aufloder Leidenschaft vermuten -- 
  Etlichemal Freund Rede fallen -- etlichemal Gespräch hinlenken -- vergebens -- 
  Widerstand Strome -- 
  übernehmen ausdauernd Freundschaft Amt -- 
  lassen heftigsen Anfall Schmerzen vorüber -- -- still Gegenwart -- aufrichtig rein Teilnehmung sehen lassen -- bleiben Abend -- Wilhelm still Nachgefühl Schmerzen versenken -- erschreckt Ausbruch Leidenschaft -- bemeisteren gut Rat eifrig zureden überwältigen glauben -- 
  Kapitel -- 
  Rückfäll pflegen Wilhelm meist desto eifrig Geschäft Tätigkeit widmen -- gut Weg -- Labyrinth -- anzulocken suchen -- entfliehen -- 
  Art -- Fremde betragen -- Leichtigkeit -- fast lebend Sprache Korrespondenz führen -- geben Vater Handelsfreunde Hoffnung -- tröstet Krankheit -- Ursache -- Pause -- Plan unterbrechen -- 
  beschließen Wilhelm Abreise zweitenmal -- finden Pferd -- Mantelsack -- erheiteren frei Luft Bewegung -- Gebirg nähern -- Auftrag ausrichten -- 
  durchstrich langsam Täl Berg Empfindung groß Vergnügen -- 
  Überhangende Fels -- rauschend Wasserbäche -- bewachsen Wand -- tief Grund erstenmal -- frühsen Jugendträume Gegende schweben -- 
  fühlt Anblick verjüngen -- erduldet Schmerz Seele weggewaschen -- völlig Heiterkeit Stelle verschieden Gedicht -- Pastor fido -- einsamen Platz scharenweis Gedächtnisse zuflossen -- 
  erinnern Stelle Lied -- besonderer Zufriedenheit rezitieren -- 
  belebt Welt -- liegen -- Gestalt Vergangenheit -- Schritt Zukunft voll Ahnung wichtig Handlung merkwürdiger Begebenheit -- 
  mehrere Mensch -- -- folgend -- herkamen -- Gruß vorbeigingen -- Weg Gebirge -- steil Fußpfade -- eilig fortsetzn -- unterbrach einigemal still Unterhaltung -- aufmerksam -- 
  gesellt gesprächig Gefährte -- erzählt Ursache stark Pilgerschaft -- 
  Hochdorf -- -- Abend Komödie geben -- wozu Nachbarschaft versammeln -- 
  -- rufen Wilhelm -- einsam Gebirge -- undurchdringlich Wälder Schauspielkunst Weg finden -- Tempel aufbauen -- Fest wallfahren -- 
  wundern -- -- hören -- Stück aufführen -- 
  Fabrik Ort -- Leute ernähren -- 
  Unternehmer -- sagen menschlich Gesellschaft entfernt leben -- wissen Arbeiter Winter beschäftigen -- veranlassen -- Komödie spielen -- 
  leiden Karte -- wünschen roh Sitte abhalten -- 
  bringen lang Abend -- -- alte Geburtstag -- geben Ehre besonderer Festlichkeit -- 
  Wilhelm Hochdorf -- übernachten -- steigen Fabrik -- Unternehmer Schuldner Liste stehen -- 
  Name nennen -- rufen alte verwundern -- ei -- Herr -- Sohn brav Mann -- Geld schuldig -- 
  Herr Vater Geduld -- Bösewicht müssen -- eilig fröhlich bezahlen -- 
  -- sehen -- Ernst -- 
  rufen Frau herbei -- erfreut -- jung Mann sehen -- versichern -- Vater gleich -- bedauern -- Fremden Nacht beherbergen können -- 
  Geschäft klar berichtigen -- Wilhelm stecken Röllchen Gold Tasche -- wünschen -- übrig Geschäft möchten -- 
  Stunde Schauspiel heran -- erwartet Oberforstmeister -- anlangen -- Jäger eintreten -- groß Verehrung empfangen -- 
  Gesellschaft nunmehr Schauspielhaus führen -- wozu Scheune einrichten -- Garten liegen -- 
  Haus Theater -- sonderlich Geschmack -- munt artig anlegen -- 
  Maler -- Fabrik arbeiten -- Theater Residenz gehandlangen -- Wald -- Straße Zimmer -- freilich roh -- hingestellen -- 
  Stück herumziehend Truppe borgen -- Weise zurecht schnitten -- 
  -- unterhalten -- 
  Intrig -- Liebhaber Mädchen vormund wechselsweise entreißen -- bringen allerlei interessant Situation hervor -- 
  Stück -- Freund langen -- mancherlei Betrachtung -- voll Handlung -- Schilderung wahr Charakter -- 
  Gefiel ergötzen -- 
  Anfang Schauspielkunst -- 
  roh Mensch zufrieden -- vorgehen sehen -- gebildet empfinden -- Nachdenke ausgebilden angenehm -- 
  Schauspieler hie gerne nachgeholfen -- fehlen -- viele -- 
  still Betrachtung stören Tabaksdampf -- stark stark -- 
  Oberforstmeister Anfang Stück Pfeif anzünden -- nehmen mehrere Freiheit heraus -- 
  machen Hund Herr schlimm Auftritt -- 
  ausgesperrt -- finden Weg Hintertür herein -- laufen Theater -- rannen wider Akteurs -- gesellt Sprung Orchester Herr -- Platz Parterre einnehmen -- 
  Nachspiel Opfer dargebracht -- 
  Porträt -- alt Bräutigamskleide vorstellen -- stehen Altar Kränze behangen -- 
  Schauspieler huldigen demutvoll Stellung -- 
  jung Kind treten -- wissen kleiden -- hervor -- halten Rede Vers -- wodurch Familie sogar Oberforstmeister -- Kind erinnern -- Träne bewegen -- 
  endigt Stück -- Wilhelm umhin -- Theater besteigen -- Aktrice Nähe besehen -- Spiel loben -- Zukunft Rat geben -- 
  übrig Geschäft unser Freund -- groß klein Gebirgsort verrichten -- laufen glücklich -- vergnügen -- 
  Schuldner bat Aufschub -- unhöflich -- leugneten -- 
  Auftrag verklagen -- müssen Advokat aufsuchen -- instruiere -- Gericht stellen -- dergleichen verdrießlich Geschäft -- 
  schlimm ergehen -- Ehre erzeigen -- 
  Leute finden -- einigermaßen unterrichten -- -- nützlich Handelsverhältnis hoffen -- 
  unglücklicherweise Regentage einfielen -- Reise Pferd gegender unerträglich Beschwerde verknüpfen -- dankt Himmel -- flach Land nähern -- Fuß Gebirges -- schön fruchtbar Ebene -- sanft Fluß -- Sonnenscheine -- heiter Landstädtchen liegen -- Geschäft -- entschließen -- Paar verweilen -- Pferd -- schlimm Weg gelitt -- Erholung verschaffen -- 
  Kapitel -- 
  Wirtshause Markt abtreten -- lustig -- lebhaft -- 
  Gesellschaft Seiltänzer -- Springer Gaukler -- stark Mann -- Weib Kind einziehen -- machen -- öffentlich Erscheinung bereiten -- Unfug -- 
  streiten Wirt -- -- Zank unleidlich -- Äußerung Vergnügen unerträglich -- 
  Unschlüssig -- bleiben -- stehen Tor -- Arbeiter -- Platze Gerüst aufzuschlagen anfingen -- 
  Mädchen -- Rose Blume herumtragen -- bieten Korb dar -- kauft schön Strauß -- Liebhaberei band Zufriedenheit betrachten -- Fenster -- Seite Platzes stehend -- Gasthaus Auftat -- wohlgebildeter Frauenzimmer zeigen -- 
  ungeachtet Entfernung bemerken -- angenehm Heiterkeit Gesicht beleben -- 
  blond Haar fallen nachlässig auflösen Nacken -- scheinen fremde umzusehen -- 
  treten jung Mensch -- Frisierschurz umgegürten -- weiß Jäckchen -- Türe Haus -- Wilhelm -- begrüßen -- Frauenzimmer Fenster lassen fragen -- schön Blume abtreten -- -- 
  stehen Dienst -- versetzen Wilhelm -- leicht Bo Bouquet überreichen -- schöne Kompliment -- freundlich Gegengruß erwidern -- Fenster zurückziehen -- 
  Nachdenkend artig Abenteuer Zimmer Treppe hinauf -- jung Geschöpf entgegen Sprang -- Aufmerksamkeit ziehen -- 
  kurz seiden Westchen geschlitzt spanisch Ärmel -- knapp -- Beinkleid Puffe stehen Kind artig -- 
  schwarz Haar Locke Zöpfen Kopf kräuseln gewunden -- 
  Gestalt Verwunderung -- einig -- Knabe Mädchen erklären -- 
  entscheiden letzter -- halten -- vorbei -- bieten gut -- fragt -- angehören -- sehen -- Glied springend tanzend Gesellschaft müssen -- 
  scharfen -- schwarz Seitenblick -- losmachen -- Küche laufen -- Antwort -- 
  Treppe hinauf -- finden weit Vorsaal Mannsperson -- Fechte üben -- vielmehr Geschicklichkeit versuchen scheinen -- 
  offenbar Gesellschaft -- Haus befinden -- wild ansehen -- 
  Wilhelm -- Ursache -- bewundern -- schwarzbärtig nervig Streiter Kampfplatz verlassen -- bieten -- vieler Artigkeit -- Wilhelm Rapier -- 
  Schüler -- versetzen -- Lehre nehmen -- zufrieden -- Gang wagen -- 
  fochten -- obgleich Fremd Ankömmling überlegen -- höflich versichern -- Übung ankommen -- Wilhelm zeigen -- gut gründlich deutsch Fechtmeister unterrichten -- 
  Unterhaltung Getöse unterbrechen -- bunt Gesellschaft Wirtshause ausziehen -- Stadt Schauspiel benachrichtigen -- Kunst begierig -- 
  Tambour folgen Entrepreneur Pferd -- Tänzerin ähnlich Gerippe -- Kind halten -- Bändern Flinter herausputzen -- 
  übrig Truppe Fuß -- wovon Schulter Kind -- abenteuerlich Stellung -- bequem tragen -- jung -- schwarzköpfig -- düster Gestalt Wilhelm Aufmerksamkeit auf erregen -- 
  Pagliasso laufen andringend Menge drollig -- teilen begreiflich Späß -- Mädchen küßen -- Knabe pritschen -- Zettel -- erwecken Volke unüberwindlich Begierde -- nah kennen lernen -- 
  gedruckt Anzeige mannigfaltig Kunst Gesellschaft -- Monsieur Narziss Demoiselle Landrinette herausgestrichen -- -- Hauptperson -- Klugheit -- Zug enthalten -- vornehmer ansehen geben -- groß Neugier erwecken -- 
  Zuge schön Nachbarin Fenster sehen lassen -- Wilhelm verfehlen -- Gesellschafter erkundigen -- 
  -- einstweilen Laert nennen -- Erbot -- Wilhelm hinüber begleiten -- 
  Frauenzimmer -- lächelnd -- paar Trümmer Schauspielergesellschaft -- kurz scheitern -- 
  Anmut Orts bewegen -- bleiben -- gesammelt Barschaft Ruhe verzehren -- indes Freund ausgezogen -- Unterkomm suchen -- 
  Laert begleiten sogleich bekannte Philines Türe -- Augenblick stehen lassen -- benachbart Laden Zuckerwerk holen -- 
  gewiß danken -- -- -- artig Bekanntschaft verschaffen -- 
  Frauenzimmer paar leicht Pantöffelch hoch Absätz Stube entgegen treten -- 
  schwarz Mantille weiß Negligé werfen -- -- reinlich -- häuslich bequem ansehen -- kurz Röckchen lassen niedlichst Fuß Welt sehen -- 
  willkommen -- rufen Wilhelm -- nehmen schön Blume -- 
  führen Hand Zimmer -- Strauß Brust drücken -- 
  niedergesetzen -- gleichgültig Gespräch begreifen -- reizend Wendung geben wissen -- schütten Laert gebrannt Mandeln Schoß -- sogleich nasch Anfing -- 
  sehen -- welcher Kind jung Mensch -- rufen -- überreden -- Freundin Nascherei -- ist_es -- leben -- Leckere genießen -- 
  Lasse gestehen -- versetzen Laert -- hierin -- mehrer -- Gesellschaft leisten -- 
  -- -- schön -- Dächt fahren spazier nähm Mittagsmahl Mühle -- -- 
  -- Philin -- unser bekannte Veränderung -- 
  Laert springen fort -- niemals -- Wilhelm Augenblick Haus -- Haar -- Reise verworren aussahen -- Ordnung bringen lassen -- 
  -- -- rufen Diener -- nötigen Wilhelm artigster Weise -- Rock auszuziehen -- Pudermantel anlegen -- Gegenwart frisieren lassen -- 
  versäumen -- -- wissen -- beisammen bleiben -- 
  Knabe -- trotzig unwillig ungeschickt -- benehmen -- raufen Wilhelm -- scheinen fertig -- 
  Philine verweisen einigemal Unart -- stoßen ungeduldig hinweg -- jagt Tür hinaus -- 
  übernehmen Bemühung -- kräuselt Haar unser Freund Leichtigkeit Zierlichkeit -- eilen scheinen -- Arbeit aussetzen -- vermeid Knium seinigen berühren -- Strauß Busen nah Lippe bringen -- Versuchung setzen -- Kuß drücken -- 
  Wilhelm Pudermesser Stirn reinigen -- -- stecken -- gedenken -- 
  artig Messer -- Griff eingelegt Stahl zeigen freundlich Wort -- gedenken -- 
  Wilhelm stecken -- danken -- bitten Erlaubnis -- Gegengeschenk -- 
  fertig -- 
  Laert Kutsche bringen -- beginnen lustig Fahrt -- 
  Philine werfen arme -- anbettelt -- Schlag hinaus -- munter freundlich Wort zurufen -- 
  mühle ankommen -- essen bestellen -- Musik Haus hören lassen -- 
  bergleute -- -- Zith Triangel -- lebhaft grell Stimme -- verschieden artig Lied vortrugen -- 
  dauern -- herbeiströmend Menge Kreis schließen -- Gesellschaft nicken Beifall Fenster -- 
  Aufmerksamkeit sehen -- erweitern Kreis -- scheinen wichtig Stückche vorbereiten -- 
  Pause treten Bergmann Hack hervor -- stellen -- indes ernsthaft Melodie spielen -- Handlung Schürfen -- 
  währen -- treten Bauer Menge -- pantomimisch drohend verstehen -- hinwegbegeben sollen -- 
  Gesellschaft verwundern -- erkennen -- Bauer verkleideten -- Bergmann -- Mund Auftat -- Art Rezitativ schelten -- Wage -- Acker hantieren -- 
  Fassung -- fing -- Landmann belehren -- Einzuschlag -- Begriff Bergbau -- 
  Bauer -- fremd Terminologie verstehen -- allerlei albern Frage -- worüber Zuschauer -- klüg fühlen -- herzlich Gelächter aufschlugen -- 
  Bergmann suchen rektifizieren -- beweisen Vorteil -- zuletzt fließ -- unterirdisch Schatz Land herausgewühlen -- 
  Bauer -- Schlag drohen -- lassen besänftigen -- schied Freund -- ziehen Bergmann honorabelste Art Streite -- 
  -- Wilhelm Tische -- Dialog lebhaftesen -- nützlich Ständen Theater -- Vorteil Staat ziehen müssen -- Handlung -- Gewerbe Unternehmung Mensch gut -- lobenswürdigen Seite Gesichtspunkt Theater brächte -- Staat ehren schützen -- 
  stellen lächerlich Seite Mensch dar -- Lustspieldichter gleichsam hämisch Kontrolleur -- Fehler Mitbürger überall wachsam Auge -- froh scheinen -- einer anhängen -- 
  angenehm würdig Arbeit Staatsmann -- natürlichen -- wechselseitig Einfluß Stände überschauen -- Dichter -- Humor -- Arbeit leiten -- 
  überzeugen -- können Weg unterhaltend -- nützlich lustig Stück ersonnen -- 
  -- Laert -- überall herumgeschwärmt -- bemerken -- wissen verbieten -- hindern ablehnen -- selten gebiet -- befördern belohnen -- 
  lassen Welt -- schädlich -- zürnt schlagen drein -- 
  lassen Staat Staatsleute weg -- Philin -- Perück vorstellen -- Perücke -- aufhaben erregen Finger krampfhaft Bewegung -- ehrwürdig Herr herunter nehmen -- Stube herumspring Kahlkopf auslachen -- 
  lebhaft Gesang -- schön vortragen -- schneiden Philin Gespräch -- treiben schnell Rückfahrt -- Kunst Seiltänzer Abend sehen versäumen -- 
  Drollig Ausgelassenheit -- setzen Freigebigkeit Arm Heimweg fort -- zuletzt -- Reisegefährt Geld ausging -- Mädchen Strohhut alt Weibe Halstuch Schlage hinaus werfen -- 
  Philine laden Begleiter Wohnung -- -- -- Fenster öffentlich Schauspiel Wirtshause sehen können -- 
  ankamen -- finden Gerüst aufschlagen -- Hintergrund aufgehängt Teppiche zieren -- 
  Schwungbretter legen -- Schlappseil Pfoste befestigen -- Strafe Seil Böck ziehen -- 
  Platz ziemlich Volk füllen -- Fenster Zuschauer Art besetzen -- 
  Pagliaß bereitet Versammlung Albernheit -- worüber Zuschauer lachen pflegen -- Aufmerksamkeit gut Laune -- 
  Kind -- Körper seltsamsen Verrenkung darstellen -- erregt Verwunderung -- Grausen -- Wilhelm tief Mitleiden enthalten -- Kind -- Anblicke nehmen -- Mühe -- sonderbaren Stellung hervorbringen -- 
  erregt lustig Springer lebhaft Vergnügen -- einzeln -- zuletzt vorwärts rückwärt Luft überschlugen -- 
  laut Händeklatsche Jauchze erscholl Versammlung -- 
  Aufmerksamkeit Gegenstand wenden -- 
  Kind -- einer -- müssen Seil betreten -- Lehrling -- Übung Schauspiel verlängern -- Schwierigkeit Kunst Licht setzen -- 
  zeigen Mann erwachsen Frauensperson ziemlich Geschicklichkeit -- Monsieur Narziss -- Demoiselle Landrinette -- 
  treten Art Zelt -- aufgespannt rot Vorhäng hervor -- erfüllen angenehm Gestalt zierlich Putz glücklich genährt Hoffnung Zuschauer -- 
  -- munter Bürschchen mittler Größe -- schwarz Auge stark Haarzopf -- -- niedlich stark bilden -- zeigen Seil leicht Bewegung -- Sprung seltsam Positur -- 
  Leichtigkeit -- Verwegenheit -- Genauigkeit -- womit Kunststück ausführt -- erhöht Schritt Sprung allgemein Vergnüge -- 
  Anstand -- womit betragen -- anscheinend Bemühung -- geben ansehen -- Herr Meister Truppe sein -- halten Ranges wert -- 
  Begeisterung Volks teilen Zuschauer Fenster -- Dame sehen unverwandt Narzissen -- Herr Landrinette -- 
  Volk jauchzen -- fein Publikum enthalten Klatschen -- Pagliasse lachen -- 
  schlich Weg -- Truppe -- Geld sammeln -- zinnern Teller Menge drängen -- 
  Sache -- dünken -- -- Wilhelm Philine -- Fenster liegen -- bewundern Verstand -- womit gering Kunststückche -- anbringen -- gelten wissen -- Ungeschicklichkeit Kind Virtuosität arbeiten -- Aufmerksamkeit erregen -- angenehmsen unterhalten -- 
  Volk verlaufen -- Platz leer -- indes Philine Laert Gestalt Geschicklichkeit Narzisses Landrinett Streit geraten -- wechselsweise neckten -- 
  Wilhelm wunderbar Kind Straße spielend Kind stehen -- Philine aufmerksam -- sogleich -- lebhaft Art -- Kind rufen winken -- -- singend Treppe hinunter klappert heraufführter -- 
  Rätsel -- rufen -- Kind Türe herein ziehen -- 
  bleiben Eingange stehen -- hinaus schlüpfen -- legen Hand Brust -- linker Stirn -- bücken tief -- 
  Fürcht -- lieben -- Wilhelm -- -- 
  unsicher Blick -- treten Schritt nah -- 
  nennst -- fragen -- -- 
  heiß Mignon -- -- 
  -- -- 
  zählen -- -- 
  Vater -- -- 
  Teufel tot -- -- 
  wunderlich -- 
  rufen Philine -- 
  fragen -- bringen Antwort gebrochen Deutsch sonderbar feierlich Art -- legen jedesmal Hand Brust Haupt -- neigen tief -- 
  Wilhelm ansehen -- 
  Auge Herz unwiderstehlich geheimnisvoll Zustande wesen anziehen -- 
  schätzen zwölf dreizehn -- Körper bauen -- Glied stark Wuch versprechen -- zurückgehaltenen ankündigen -- 
  Bildung regelmäßig auffallend -- Stirn geheimnisvoll -- Nase außerordentlich schön -- Mund -- Alter schließen scheinen -- manchmal Lippe Seite zucken -- treuherzig reizend -- 
  bräunlich Gesichtsfarbe Schminke erkennen -- 
  Gestalt prägen Wilhelm tief -- -- schweigen vergessen Gegenwärtig Betrachtung -- 
  Philine weckt Halbtraume -- Kind übriggeblieben Zuckerwerk reichen -- Zeichen -- entfernen -- 
  Bückling -- -- fahren blitzschnell Türe hinaus -- 
  nunmehr herbei -- bekannte Abend trennen -- reden vorher Spazierfahrt morgenden -- 
  abermals Ort -- benachbart Jägerhause -- Mittagsmahl einnehmen -- 
  Wilhelm sprechen Abend Philines Lobe -- worauf Laert leichtsinnig antworten -- 
  -- abermals Stunde Fechten üben -- gehen Philines Gasthofe -- bestellt Kutsche anfahren sehen -- 
  verwundern Wilhelm -- Kutsche verschwinden -- -- Philin Haus -- antreffen -- 
  -- erzählen -- paar fremde -- ankommen -- Wagen setzen -- fahren -- 
  Freund -- Gesellschaft angenehm Unterhaltung versprechen -- Verdruß verbergen -- 
  lacht Laert -- rufen -- 
  fällen -- 
  sehen ähnlich -- 
  Lassen Jagdhause -- -- -- ihretweg Promenade versäumen -- 
  Wilhelm unterwegs Inkonsequenz Betragen tadeln fortfuhr -- Laert -- 
  inkonsequent finden -- Charakter treu bleiben -- 
  vornimmen versprechen -- geschehen stillschweigend Bedingung -- bequem -- Vorsatz auszuführ Versprechen halten -- 
  verschenken -- bereit -- Geschenkt geben -- 
  seltsam Charakter -- versetzen seltsam -- Heuchlerin -- 
  lieben -- Freund -- Geschlecht rein darstellen -- hass Ursache -- 
  wahr Eva -- Stammmutter weiblich Geschlecht -- -- Wort -- 
  mancherlei Gespräch -- Laert Haß weiblich Geschlecht lebhaft ausdrucken -- Ursache angeben -- Wald kommen -- Wilhelm verstimmen eintreten -- Äußerung Laert Erinnerung Verhältnis Mariane lebendig -- 
  finden beschattet Quelle -- herrlich alt Baum -- Philin -- steinern Tisch -- sitzen -- 
  singen lustig Liedchen entgegen -- Laert Gesellschaft fragen -- rufen -- 
  schön anführen -- -- verdienen -- 
  unterwegs setzt Freigebigkeit Probe -- bemerken -- karg Näscher -- -- bestrafen -- 
  Ankunft fragen Kellner -- -- gewöhnlich Geläufigkeit Zunge -- -- -- hererzählen -- 
  Verlegenheit -- blickt -- stottert -- fragen Preis -- 
  Bedenken -- rufen -- Tafel Geschäft Frauenzimmer -- lassen sorgen -- 
  fing -- unsinnig Mittagmahl bestellen -- wozu Boten Nachbarschaft holen -- 
  Kellner -- paar schiefer Mäuler vertrauter -- helfen -- Vorstellung herrlichen Gastmahl dergestalt ängstigen -- Spaziergange Wald entschließen -- schwerlich -- 
  Viertelstund Hand lachen -- lachen -- Gesicht denken -- 
  Tisch erinnern Laert ähnlich Fall -- kommen Gang -- lustig Geschichte -- Mißverständniß Prellereien erzählen -- 
  jung Mann -- Bekanntschaft Stadt -- Buch Wald schlichen -- setzen -- rühmt schön Platz -- 
  Riesel Quelle -- Bewegung Zweig -- einfallend Licht Gesang Vögel aufmerksam -- 
  Philine singen Liedche Kuckuck -- Ankömmling behagen scheinen -- empfehlen -- 
  Natur Naturszen hören -- rufen Philine -- weg -- unerträglich -- Vergnügen vorrechnen lassen -- genießen -- 
  schön Wetter -- spazieren -- tanzen -- aufspieln -- 
  Augenblick Musik -- an schön Wetter denken -- 
  Tänzer interessieren -- Violine -- paar schön schwarz Auge sehen -- tun paar blau Auge -- 
  Quelle Brunnen -- alt morsch Linden -- 
  -- sprechen -- Wilhelm -- sitzen -- Blick Auge -- wehren -- Türe Herzens vordringen -- 
  -- versetzt Verlegenheit -- Mensch Mensch Interessanteste -- interessieren -- 
  -- umgiben -- Element -- leben -- Werkzeug -- bedienen -- 
  Jemehr aufhalten -- jemehr merken nehmen -- desto schwach Gefühl unser Wert Gefühl Gesellschaft -- 
  Mensch -- Wert Garten -- Gebäude -- Kleid -- Schmuck Besitztum legen -- gesellig gefällig -- verlieren Mensch Auge -- erfreuen versammeln weniger glückt -- 
  sehen Theater -- 
  Schauspieler elend -- unschicklich Dekoration vergessen -- dahingegen schön Theater Mangel gut Schauspieler fühlbar -- 
  Tisch setzen Philine beschatten hoch Gras -- 
  Freund müssen Blume Menge herbeischaffen -- 
  Wand voll Kranz -- setzen -- unglaublich reizend -- 
  Blume reichen -- flocht -- Mann setzen -- 
  allerlei Scherz Anspielung fertig -- drücken Wilhelm groß Anmut auf Haupt -- rücken -- sitzen scheinen -- 
  -- scheinen -- leer ausgehen -- Laert -- 
  nicht -- versetzen Philine -- 
  sollen keineswegs beklagen -- 
  Kranz Haupt -- setzen Laert -- 
  Wären Nebenbuhler -- -- heftig streiten -- meister begünstigtst -- 
  wären Tor -- versetzen -- hinüberbog -- Mund Kuß reichen -- sogleich umwendet -- Arm Wilhelm schlingen -- lebhaft Kuß Lippe drücken -- 
  schmecken -- fragen neckisch -- 
  Wunderlich -- rufen laerte -- 
  scheinen niemals Wermut schmecken können -- 
  -- Philin -- Gabe -- Neid Eigensinn genießen -- 
  -- rufen -- Lust -- Stunde tanzen -- unser Springer sehen -- 
  Haus -- finden Musik -- 
  Philin -- Tänzerin -- beleben Gesellschafter -- 
  Wilhelm ungeschickt -- fehlt künstlich Übung -- 
  Freund nehmen -- unterrichten -- 
  verspäten -- 
  Seiltänzer Kunst produzieren anfangen -- 
  Platze Zuschauer eingefunden -- unser Freund -- ausstiegen -- Getümmel merkwürdig -- Anzahl Mensch Tore Gasthofe -- Wilhelm eingekehren -- hingezogen -- 
  Wilhelm springen hinüber -- sehen -- -- entsetzen erblicken -- durch Volk drängen -- Herr Seiltänzergesellschaft -- interessant Kind Haaren Haus Schleppe bemühen -- Peitschenstiel unbarmherzig Körper losschlug -- 
  Wilhelm fahren Blitz Mann -- fassen Brust -- 
  Laß Kind -- schreien Rasend -- bleiben Stelle -- 
  fassen Kerl Gewalt -- Zorn geben -- Kehl -- ersticken glauben -- Kind loslassen -- Angreifende verteidigen suchen -- 
  Leute -- Kind Mitleide fühlen -- Streit anfangen gewagt -- fallen Seiltänzer sogleich Arm -- entwaffnet -- droht Schimpfrede -- 
  -- Waffe Munde reduzieren -- fing gräßlich drohen fluchen -- Faule unnütz Kreatur wollen Schuldigkeit -- verweig Eiertanz tanzen -- Publikum versprechen -- wollen totschlagen -- sollen hindern -- 
  suchen -- Kind -- Menge verkrochen -- aufsuchen -- 
  Wilhelm halten -- rufen -- 
  sollen eher Geschöpf weder sehen berühren -- Gericht Rechenschaft gibst -- stehlen -- auf äußerer treiben -- sollst entgehen -- 
  Rede -- Wilhelm Hitze -- Gedanke Absicht -- dunkel Gefühl -- -- Inspiration aussprechen -- bringen wütenden Mensch Ruhe -- 
  rufen -- 
  unnütz Kreatur schaffen -- 
  Zahl -- Kleid kosten -- behalten -- Abend einig -- 
  eilt -- unterbrochen Vorstellung fortsetzen -- Unruhe Publikum bedeutend Kunststück befriedigen -- 
  Wilhelm suchen nunmehr -- still -- Kind -- nirgends finden -- 
  Boden -- Dach benachbart Haus sehen -- 
  Ort suchen -- müssen beruhigen -- abwarten -- herbei wollen -- 
  Indes Narziss Haus kommen -- Wilhelm Schicksal Herkunft Kind befragen -- 
  wissen -- Gesellschaft -- erzählt Leichtigkeit Leichtsinne Schicksal -- 
  Wilhelm Beifall Glück wünschen -- erfreuen -- äußern gleichgültig -- 
  gewohnen -- -- lachen -- Kunst bewundern -- außerordentlichen Beifall bessern -- 
  Entrepreneur zahlen -- sehen -- zurechen -- 
  beurlaubt -- eilig entfernen -- 
  Frage -- schnell wollen -- lächelt jung Mensch -- gestehen -- Figur Talent solideren Beifall zugezogen -- Publikum -- 
  Frauenzimmer Botschaft erhalten -- eifrig verlangt -- nah kennen lernen -- fürcht -- Besuch -- ablegen -- Mitternacht fertig -- 
  fahren fort groß Aufrichtigkeit Abenteuer erzählen -- Name -- Straße Haus anzeigen -- Wilhelm Indiskretion ablehnen höflich entlassen -- 
  Laert indessen Landrinette unterhalten -- versichern -- vollkommen würdig -- Weib bleiben -- 
  Unterhandlung Entrepreneur Kind -- unser Freund dreißig Taler überlassen -- schwarzbärtig heftig Italiener Anspruch völlig abtreten -- Herkunft Kind bekennen -- Tod Bruder -- -- außerordentlichen Geschicklichkeit -- Teufel nennen -- nehmen -- 
  meist Aufsuche Kind -- 
  vergebens durchkroch Winkel Haus Nachbarschaft -- verschwinden -- fürchten -- Wasser sprungen -- Leid angetan -- 
  Philines reiz Unruhe unser Freund ableiten -- 
  bringen traurig nachdenklichen -- 
  Abends -- Springer Tänzer Kraft aufboten -- Publikum auf gute empfehlen -- Gemüt erheiteren zerstreuen -- 
  Zulauf benachbart Ortschaft Anzahl Mensch außerordentlich zunehmen -- wälzt Schneeball Beifall ungeheuer Größe -- 
  Sprung Degen Fass papiern Boden Sensation -- 
  stark Mann lassen Grausen -- entsetzen erstaunen -- Kopf Füßen Paar auseinander geschoben Stühl legen -- hohlschwebenden Leib Amboß heben -- wacker Schmiedegeselle -- Hufeis fertig schmieden -- 
  sogenannter Herkules-Stärk -- Reihe Mann Schulter Reihe stehend -- abermals Frau Jünglinge tragen -- zuletzt lebendig Pyramid entstehen -- Spitze Kind Kopf stellen -- Knopf Wetterfahne zieren -- Gegende sehen -- endigen würdig Schauspiel -- 
  Narziss Landrinette lassen Tragsessel Schulter übrig vornehmst Straße Stadt laut Freudengeschrei Volk tragen -- 
  werfen Band -- Blumenstrauß seiden Tücher -- drängen -- Gesicht fassen -- 
  scheinen glücklich -- ansehen -- Blick würdigen -- 
  Schauspieler -- Schriftsteller -- Mensch Gipfel wünsche sehen -- edl Wort Eindruck hervorbrächen -- 
  köstlich Empfindung müssen -- -- edlen -- Menschheit würdig Gefühl schnell elektrisch Schlag ausbreiten -- Entzück Volke erregen -- Leute körperlich Geschicklichkeit tun -- Menge Mitgefühl Menschlichen geben -- Vorstellung Glück Unglück -- Weisheit Torheit -- Unsinn Albernheit entzünden -- erschüttern -- stockend Innere frei -- lebhaft rein Bewegung setzen -- 
  sprechen Freund -- weder Philin Laert stimmen scheinen -- Diskurs fortsetzen -- unterhieln Lieblingsbetrachtunge -- spät Nacht Stadt spaziern -- alt Wunsch -- -- Edle -- Schauspiel versinnlichen -- Lebhaftigkeit Freiheit losgebunden Einbildungskraft verfolgen -- 
  Kapitel -- 
  Tag -- Seiltänzer groß Geräusch abgezog -- finden Mignon sogleich -- treten hinzu -- Wilhelm Laert Fechtübungen Saale fortsetzten -- 
  stecken -- fragen Wilhelm freundlich -- Sorge -- 
  Kind antworten -- -- 
  -- rufen Laert -- kaufen -- 
  -- bezahlen -- fragt Kind trocken -- 
  -- hundert Dukat -- versetzen Laert -- gibst -- frei -- -- 
  -- fragt Kind -- -- O -- aufführen -- -- 
  dienen -- versetzen -- 
  Augenblick merken genau -- Kellner Freund Dienst leisten -- litt Tag -- Zimmer -- 
  -- Geschäft langsam unbehilflich -- genau Sorgfalt -- 
  stellen Gefäß Wasser -- wusch Gesicht Emsigkeit Heftigkeit -- fast Backen aufrieb -- Laert erfahren Frage Necken -- Schminke Wang Weise suchen -- Eifer -- womit -- Röt -- durch Reiben hervorbringen -- hartnäckigst Schminke halten -- 
  bedeuten -- lassen -- Ruhe kommen -- zeigen schön braun -- obgleich wenig Rot erhöht Gesichtsfarbe -- 
  frevelhaft Reiz Philines -- geheimnisvoll Gegenwart Kind -- gestehen -- unterhalten -- bringen Wilhelm verschieden sonderbar Gesellschaft -- rechtfertigen fleißig Übung Fecht Tanz Kunst -- wozu Gelegenheit finden glauben -- 
  verwundern -- gewissermaßen erfreut -- Tag Herr Frau Melina ankommen -- -- froh Gruß -- Direktrice übrig Schauspieler erkundigen -- groß Schrecken vernahmen -- entfernen -- zerstreuen -- 
  jung Paar Verbindung -- -- wissen -- Wilhelm behilflich -- Ort Engagement umgesehen -- keiner finden -- Städtchen weisen -- Person -- unterwegs begegnen -- Theater sehen -- 
  Philine Madam Melina -- Herr Melina lebhaft Laert -- Bekanntschaft machen -- keineswegs fallen -- 
  wünschen Ankömmling -- Wilhelm günstig Gesinnung beibringen -- wiederholt versichern -- Leute -- 
  eigentlich bisherig lustig Leben Abenteurer Erweiterung Gesellschaft Weise stören -- Melina fing Wirtshause -- -- Philine wohnen -- Platz finden -- markten quängeln -- 
  Geld besseres Quartier -- reichlicher Mahlzeit prompter Bedienung -- 
  kurz machen Wirt Kellner verdrießlich Gesicht -- -- froh leben -- fallen lassen -- geschwind bezahlt -- lang denken -- verzehren -- müssen Mahlzeit -- Melina regelmäßig sogleich berichtigen -- jederzeit vorn durchgenommen -- Philin -- Umstand -- wiederkäuend Tier nennen -- 
  verhaßt Madam Melina lustig Mädchen -- 
  jung Frau Bildung -- fehlen gänzlich Geist Seele -- 
  deklamiert Übel -- deklamieren -- merken -- Wortdeklamation -- einzeln Stelle lasten -- Empfindung ausdrucken -- 
  -- Mann -- unangenehm -- 
  vielmehr schreiben -- umging -- gewöhnlich schön Verstand -- -- Wort Anempfinderin nennen -- wissen Freund -- Achtung -- besonderer Aufmerksamkeit schmeicheln -- Idee eingehen -- Horizont -- Ekstase Erscheinung aufnehmen -- 
  verstehen sprechen schweigen -- tückisch Gemüt -- Vorsicht aufzupassen -- schwach Seite -- 
  Kapitel -- 
  Melina indessen Trümmer vorig Direktion genau erkundigen -- 
  sowohl Dekoration Garderobe Handelsleute versetzen -- Notarius Auftrag Direktrice erhalten -- gewiß Bedingung -- Liebhaber finden -- Verkaufe frei Hand willigen -- 
  Melina Sache besehen -- ziehen Wilhelm -- 
  Empfand -- Zimmer eröffnen -- gewiß Neigung -- gestehen -- 
  schlecht Zustande gekleckst Dekoration -- scheinbar türkisch heidnisch Kleid -- alt Karikatur-Röcke Mann Frau -- Kutte Zauberer -- Jude Pfaffe -- ' Empfindung erwehren -- glücklichst Augenblick Leben Nähe ähnlich Trödelkram finden -- 
  Melina Herz sehen -- eifrig zugesetzen -- Summe Geld Befreiung -- Aufstellung Belebung zerstreut Glied schönen herzugeben -- 
  welch glücklich Mensch -- rufen Melina -- -- hundert Taler besäße -- Anfang Besitz theatralisch Bedürfnis erlangen -- 
  Schauspiel beisammen -- Stadt -- Gegend gewiß sogleich ernähren -- 
  Wilhelm schweigen -- verlassen nachdenklich eingesperrt Schatz -- 
  Melina Diskurs Projekt Vorschlag -- Theater einrichten -- Vorteil finden -- 
  suchen Philine Laert interessieren -- Wilhelm Vorschlag -- Geld herzuschießen -- Sicherheit annehmen -- 
  fallen Gelegenheit -- verweilen -- entschuldigt -- Anstalt -- Reise fortsetzen -- 
  indessen Mignon Gestalt Wesen reizender -- 
  Lassen Kind sonderbares -- 
  Treppe weder -- springen -- steigen Geländer Gang weg -- ehe sich_es versehen -- sitzen Schranke -- bleiben Weile ruhig -- 
  Wilhelm bemerken -- besonderer Art Gruß -- 
  grüßen -- -- Brust geschlagen arme -- 
  stumm -- Zeit antworten verschieden Frage -- sonderbar -- -- unterscheiden -- Witz Unkenntnis Sprache -- gebrochen französisch Italienisch durchflochten Deutsch sprechen -- 
  Dienst Kind unermüden -- früh Sonne -- verlieren Abends zeitig -- schliefr Kammer nackt Erde -- bewegen -- Bette Strohsack annehmen -- 
  finden -- wusch -- 
  Kleid reinlich -- obgleich fast doppelt dreifach flicken -- 
  Wilhelm -- früh Messe gehen -- wohin folgen -- Ecke Kirche Rosenkranze knien andächtig beten -- 
  bemerken -- Haus -- vielerlei Gedanke Gestalt -- bestimmt denken -- 
  neu andring Melina Summe Gelde -- Auslösung erwähnt Theatergerätschaften -- bestimmen Wilhelm -- Abreise denken -- 
  Seinig -- gehören -- heutig Posttage schreiben -- fing Brief Werner -- Erzählung Abenteuer -- wobei -- bemerken -- mehrmals Wahrheit entfernt -- ziemlich kommen -- -- Verdruß -- hinterer Seite Briefblatt Vers schreiben finden -- Madam Melina Schreibtafel kopieren anfangen -- 
  unwillig zerreißen Blatt verschieben Wiederholung Bekenntniß nächster Posttag -- 
  Kapitel -- 
  Gesellschaft befinden abermals beisammen -- Philin -- jeder Pferd -- vorbei -- Wagen -- Anfuhr -- äußerst aufmerksam -- rufen Lebhaftigkeit -- Pedant -- 
  allerliebst Pedant -- 
  -- 
  rufen winkt Fenster hinaus -- Wagen halten stillen -- 
  kümmerlich arm Teufel -- schaben -- graulich-braun Rocke übelkonditioniert Unterkleider Magister -- Akademie vermodern pflegen -- halten -- steigen Wagen -- entblössen -- Philin grüß Hut Abtat -- übelgepuderen -- steif Perücke -- Philine werfen hundert Kußhand -- 
  Glückseligkeit finden -- Mann lieben Liebe genießen -- Vergnügen gering -- -- übrig -- Augenblick lieben -- leichtfertig Weise -- 
  Lärm -- womit alt Freund empfangen -- vergessen übrig -- nachfolgten -- 
  glauben Wilhelm Frauenzimmer ältlich Mann -- Hereintrat -- kennen -- 
  entdecken -- -- -- Gesellschaft -- Vaterstadt spielen -- mehrmals sehen -- 
  Tochter heran gewachsen -- alte verändern -- 
  spielen gewöhnlich gutmütig -- polternd alte -- wovon deutsch Theater leer -- gemein Leben selten antrifft -- 
  Charakter Landsleute -- Prunk leisten -- denken selten -- Art geben -- Zierlichkeit Anmut -- verfallen vielmehr -- Geist Widerspruch treiben -- Fehler -- mürrisch Wesen -- lieb Tugend Kontrast darstellen -- 
  Rolle spielen Schauspieler -- spielen ausschließlich -- ähnlich Art betragen gemein Leben annehmen -- 
  Wilhelm geraten Bewegung -- sobald erkennen -- erinnern -- Mann geliebt Mariane Theater sehen -- hört Schelt -- hört schmeichelnd Stimme -- rauh Wesen Rolle begegnen -- 
  lebhaft Frage Ankömmling -- Unterkomm auswärts finden hoffen -- 
  beantworten -- müssen vernehmen -- Gesellschaft -- erkundigen -- besetzen -- sogar Sorge -- bevorstehend Krieg auseinander -- 
  polternd alt Töchter Verdruß lieb Abwechslung vorteilhaft Engagement aufgeben -- Pedante -- unterwegs antreffen -- Wagen mieten -- hierher -- -- finden -- Rat teuer -- 
  -- übrig Angelegenheit lebhaft unterhalten -- bringen Wilhelm nachdenklich -- 
  wünscht alte sprechen -- wünschen fürchtet Mariane hören -- befinden groß Unruhe -- 
  artigkeiten neuangekommenen Frauenzimmer Traume reißen -- Wortwechsel -- erheben -- aufmerksam -- 
  Friedrich -- blond Knabe -- Philine aufwarten pflegen -- diesmal lebhaft widersetzen -- Tisch decken Essen herbeischaffen -- 
  verpflichten -- rufen -- dienen -- Mensch aufwarten -- 
  geraten heftig Streit -- 
  Philine bestehen -- Schuldigkeit -- hartnäckig widersetzen -- Umstand -- können -- wohin wollen -- 
  Glaube -- entfernen können -- rufen -- trotzig weg -- Bündel -- eilen sogleich Haus hinaus -- 
  Gehen -- Mignon -- Philine -- schaffen -- brauchen -- sagen Kellner -- Hilf aufwarten -- 
  Mignon treten Wilhelm -- fragt lakonisch Art -- -- -- Wilhelm versetzen -- tun Kind -- Mademoiselle -- 
  Kind besorgt -- warten Abend Sorgfalt Gästen -- 
  Tisch suchen Wilhelm alt Spaziergang -- gelingen -- mancherlei Frage -- gehen -- wendet Gespräch ehemalig Gesellschaft -- Wilhelm wagen zuletzt Mariane fragen -- 
  sagen abscheulichen Geschöpf -- rufen alt -- verschworen -- denken -- 
  Wilhelm erschrak Äußerung -- groß Verlegenheit -- alte fortfuhr -- Leichtfertigkeit Liederlichkeit schmälen -- 
  Freund Gespräch abbrechen -- müssen polternd Ergießunge wunderlich Mann aushalten -- 
  schämen -- fahren fort -- neigen -- 
  Mädchen nah -- gewiß entschuldigen -- 
  artig -- -- gefällig Sinn leidlich -- 
  vorstellen -- Frechheit Undank Hauptzüge Character -- 
  Wilhelm fassen -- schlimme hören -- Verwunderung bemerken -- Ton alten mild -- Rede stocken -- Schnupftuch Tasche -- Träne trocken -- zuletzt Rede völlig unterbrachen -- 
  -- rufen Wilhelm -- 
  Empfindung entgegengesetzt Richtung -- 
  Verberg -- nehmen Schicksal Mädchen Anteil glauben -- lassen wissen -- 
  sagen -- versetzt alt -- ernstlich -- verdrießlich Ton überging vergeben -- dulden -- 
  -- fahren fort -- gewisses zutrauen -- liebt Tochter -- -- Frau leben -- Entschluß fassen -- nehmen -- Hand alte retten -- Anleitung versprechen -- 
  Frau sterben -- Projekt zerschlagen -- 
  Aufenthalts Vaterstadt -- -- merken sichtbar Traurigkeit -- fragt -- weichen -- 
  machen Reise -- 
  fahren Wagen -- bemerken -- gestehen -- Hoffnung -- groß Furcht schweben -- unser Direktor verstoßen -- 
  dauern kurz -- Entdeckung -- kündigen Kontrakt -- ohnedies Woche stehen -- sogleich -- zahlen fordern -- lassen -- Vorstellung ungeachtet -- Städtchen -- schlecht Wirtshause -- 
  Henker hol liederlich Dirn -- rufen alt Verdruß -- -- Stunde Leben verdorben -- 
  erzählen -- annehmen -- tun -- hängen -- Abwesenheit sorgen -- 
  Geld Teich werfen -- anwend -- räudig Hund erziehen -- jemals Geschöpf mindeer Aufmerksamkeit wenden -- 
  war_es -- 
  Anfang erhalten Danksagungsbrief -- Nachricht Ort Aufenthalt -- zuletzt Wort -- Geld -- Woche schicken -- 
  O Verstellung Leichtsinn weiber zusammengepaaren -- bequem Leben -- ehrlich Kerl verdrießlich Stunde schaffen -- 
  Kapitel -- 
  denken Wilhelm Zustand -- Unterredung Haus -- 
  alt Wunde aufgerissen -- Gefühl -- Liebe unwürdig -- lebhaft -- Interesse alte -- Lobe -- wider Wille geben müssen -- unser Freund Liebenswürdigkeit erscheinen -- heftig Anklage leidenschaftlich Mann enthalten -- Wilhelm Auge herabsetzen -- 
  bekannt Mitschuldige Vergehung -- schweigen zuletzt scheinen Tadelhaft -- vielmehr traurig Gedanke -- Wöchnerin -- Mutter Welt Hilfe herumirren -- wahrscheinlich Kind herumirren -- 
  Vorstellung -- schmerzlichst Gefühl erregn -- 
  Mignon warten -- leuchten Treppe hinauf -- 
  Licht niedergesetzen -- bitten -- erlauben -- Abend Kunststück aufwarten dürfen -- 
  verbeten -- wissen -- -- 
  gut Geschöpf abschlagen -- 
  kurz treten Herein -- 
  tragen Teppich Arm -- Erde ausbreiten -- 
  Wilhelm lassen gewähren -- 
  bringen Licht -- stellen eins Winkel Teppich -- 
  Körbchen Eier -- holen -- Absicht deutlich -- 
  künstlich Abgemesse Schritt nunmehr Teppich -- legen gewiß Maß Ei auseinander -- rufen Mensch herein -- Haus aufwartet Violine spielen -- 
  treten Instrument Ecke -- verbinden Auge -- Zeichen -- fing Musik -- aufgezogen Räderwerk -- Bewegung -- Takt Melodie Schlage Kastagnetten begleiten -- 
  Behend -- -- rasch -- genau führt Tanz -- 
  treten scharf sicher Ei hinein -- eiern nieder -- Augenblick denken -- müssen einer zertreter -- schnell Wendung fortschleudern -- 
  nichn -- 
  berühren keiner -- Art Schritt -- eng weiten -- sogar Sprung -- zuletzt halb kniend Reihe durchwand -- 
  Unaufhaltsam -- Uhrwerk -- laufen Weg -- sonderbar Musik vorne anfangend losrauschend Tanze Wiederholung Stoß -- 
  Wilhelm sonderbaren Schauspiel hingerissen -- vergessen Sorge -- folgen Bewegung geliebt Kreatur -- verwundern -- Tanze Charakter vorzüglich entwickeln -- 
  Streng -- scharf -- trocken -- heftig -- sanft Stellung feierlich angenehm -- zeigen -- 
  empfinden -- Mignon fühlen -- Augenblick -- 
  sehnt -- verlassen Wesen Kindesstatt Herzen einzuverleiben -- Arm nehmen -- Liebe Vater Freude Leben erwecken -- 
  Tanz -- rollt Ei Füßen sachen Häufchen -- lassen keiner -- beschädigen keiner -- stellen -- Bind Auge -- Kunststück Bücklinge endigen -- 
  Wilhelm danken -- Tanz -- sehen wünschen -- artig unvermutet vortragen -- 
  streichelen -- bedauern -- sauer lassen -- 
  versprechen neu Kleid -- worauf heftig antworten -- Farbe -- 
  versprechen -- deutlich wissen -- -- 
  Ei -- Teppich Arm -- fragt Befehl -- schwingen Türe hinaus -- 
  Musikus erfahren -- Mühe geben -- Tanz -- bekennen Fandango -- vorzusingen -- spielen -- 
  Bemühung Geld anbieten -- nehmen -- 
  Kapitel -- 
  unruhig Nacht -- Freund teils wachend -- teils schwer Träum ängstigen -- zubracht -- Mariane Schönheit -- kümmerlich Gestalt -- Kind Arm -- berauben -- angebroch -- Mignon Schneider hereintreten -- 
  bringen grau Tuch blau Taft -- erklären Art -- neu Westchen Schifferhos -- Knabe Stadt sehen -- blau Aufschläg Bänder wollen -- 
  Wilhelm Verlust Mariane munter Farbe ablegen -- 
  Grau -- Kleidung Schatten -- gewöhnen -- himmelblaues Futter Kragen Farbe beleben einigermaßen still Kleidung -- 
  Mignon -- begierig Farbe tragen -- treiben Schneider -- kurz Arbeit liefern versprechen -- 
  Tanz- Fecht-Stunden -- Freund Laert -- glücken -- 
  Melina Ankunft unterbrechen -- umständlich zeigen -- Gesellschaft beisammen -- Stück aufführen können -- 
  erneuert Antrag -- Wilhelm Geld Etablissement vorstrecken sollen -- wobei vormals Unentschlossenheit zeigen -- 
  Philine Mädchen kommen hierauf lachen lärmen herein -- 
  abermals Spazierfahrt ausgedachen -- 
  Veränderung Ort Gegenstand Lust -- Sehnt -- 
  täglich Ort essen -- hoch Wunsch -- 
  diesmal Wasserfahrt -- 
  Schiff -- womit Krümmung angenehm Fluß hinunterfahren -- Pedante bestellen -- 
  Philine treiben -- Gesellschaft zauderen -- eingeschiffen -- 
  fangen -- Philin -- Bank niederlassen -- 
  Kürzeste -- versetzt Laert -- extemporiert Stück -- 
  Nehme Rolle -- Charakter angemessensen -- sehen -- gelingen -- 
  Fürtrefflich -- Wilhelm -- Gesellschaft -- verstellen -- jeder Sinn folgen -- Anmut Zufriedenheit wohnen -- verstellen -- -- 
  übel tun -- geben Verstellung Anfange -- nachh Maske aufrichtig -- -- 
  -- Laert -- angenehm Weiber -- niemals natürlich Gestalt sehen lassen -- 
  -- versetzen Madam Melina -- eitel Mann -- einbilden -- liebenswürdig -- Natur hervorbringen -- 
  indessen angenehm Busch Hügel -- Garten Weinberg hingefahren -- jung Frauenzimmer -- Madam Melina -- drücken Entzück Gegend -- 
  letzter fing sogar artig Gedicht beschreibend Gattung ähnlich Naturszene feierlich herzusag Philine unterbrechen -- schlagen Gesetz -- unterfangen sollen -- unbelebt Gegenstand sprechen -- setzen vielmehr Vorschlag extemporierten Komödie Eifer -- 
  polternd alt pensioniert Offizier -- Laert vazierend Fechtmeister -- Pedant Jude vorstellen -- wollen Tirolerin -- überlassen übrig Rolle wählen -- 
  fingieren -- Gesellschaft weltfremd Mensch -- Marktschiff kommen -- 
  fing sogleich Jude Rolle spielen -- allgemein Heiterkeit verbreiten -- 
  fahren -- Schiffer still halten -- Erlaubnis Gesellschaft einnehmen -- Ufer stehen -- winken -- 
  -- brauchen -- rufen Philine -- blind Passagier fehlt Reisegesellschaft -- 
  wohlgebildet Mann steigen Schiff -- Kleidung ehrwürdig Mien geistliche nehmen -- 
  begrüßt Gesellschaft -- Weise danken -- Scherz -- 
  Rolle Landgeistlichen -- Verwunderung artigster durchsetzen -- ermahnt -- Histörchen erzählt -- schwach Seite blicken lassen -- Respekt erhalten wissen -- 
  indessen -- einzigesmal Charakter herausgegangen -- Pfand geben -- 
  Philine Sorgfalt sammeln -- geistlich Herr Küssen künftig Einlösung bedrohen -- Strafe nehmen -- 
  Melina völlig ausplündern -- Hemdenknöpfe Schnalle -- Bewegliches Leib -- Philin nehmen -- 
  reisend Engländer vorstellen -- Weise Rolle hineinkommen -- 
  indes angenehmsen vergehen -- jeder Einbildungskraft Witz möglichsen anstrengen -- jeder Rolle angenehmen unterhaltend Scherze ausstaffiert -- 
  Ort -- aufhalten -- Wilhelm geraten geistliche -- -- Aussehen Rolle -- nennen -- Spaziergange interessant Gespräch -- 
  find Übung -- unbekannte -- Schauspieler -- Gesellschaft Freund bekannte -- nützlich -- 
  gut Art -- Mensch heraus umweg hinein führen -- 
  Truppe einführen -- manchmal Weise üben müssen -- Publikum gewiß gewinnen -- Monat geschrieben Stück aufführen -- worauf freilich Schauspieler mehrere Probe müssen vorbereiten -- 
  dürfen -- versetzen Wilhelm -- extemporiert Stück denken -- Stegreife sogleich komponieren -- -- wovon Plan -- Handlung Szeneneinteilung geben sein -- Ausführung Schauspieler überlassen bleiben -- 
  -- unbekannte -- Ausführung betreffen -- Stück -- sobald Schauspieler Gang sein -- außerordentlich gewinnen -- 
  Ausführung Wort -- freilich überlegend Schriftsteller Arbeit zieren -- Ausführung Gebärden Mine -- Ausrufung gehören -- Stumm -- halblaut Spiel -- verlieren scheinen -- 
  Schauspieler Deutschland -- Körper zeigen -- denken fühlen -- schweigen -- Zaudern -- Winke -- zart anmutig Bewegung Körper Rede vorbereiten -- Pause Gespräch gefällig Pantomime verbinden wissen -- Übung -- glücklich Naturell Hilfe kommen -- lehren -- Schriftsteller wetteifern -- Gang -- Trost der -- Theater besuchen -- wünschen -- 
  -- versetzen Wilhelm -- glücklich Naturell -- letzter -- Schauspieler -- Künstler -- Mensch -- hochaufgestecken Ziel bringen -- 
  letzter -- Anfang bleiben -- Mitte dürfen Künstler fehlen -- Bildung -- -- früh Bildung -- -- Genie zuschreiben -- Übler -- gewöhnlich Fähigkeit besitzen -- leicht verbilden heftig falsch Weg stoßen -- -- 
  -- versetzen Wilhelm -- Genie retten -- Wunde -- schlagen -- heil -- 
  nicht -- versetzen -- notdürftig -- glaub Eindruck Jugend verwinden -- 
  löblich Freiheit -- umgeb schön edl Gegenstand -- Umgange gut Mensch aufwachsen -- Meister lehren -- wissen müssen -- übrig leicht begreifen -- lernen -- verlernen brauchen -- Handlung leiten -- künftig leicht Bequemer vollbringen -- abgewöhnen -- Mensch reiner -- vollkommener glücklich Leben fahren -- anderer -- Jugendkräft Widerstand Irrtum zugesetzen -- 
  Erziehung sprechen schreiben -- sehen Mensch -- einfach Begriff -- schließen -- fassen Ausführung übertragen -- 
  -- Wilhelm -- Mensch beschränken -- Ebenbild erziehen -- 
  glücklich -- Schicksal annehmen -- Weise erziehen -- 
  Schicksal -- versetzen lächelnd -- vornehm -- teur Hofmeister -- 
  Vernunft menschlich Meister halten -- 
  Schicksal -- Weisheit Ehrfurcht tragen -- Zufall -- wirken -- ungelenk Organ -- 
  selten scheinen genau rein ausführen -- beschließen -- 
  scheinen sonderbar Gedanke aussprechen -- versetzen Wilhelm -- 
  nichn -- 
  meister -- Welt begegnen -- rechtfertigen Meinung -- 
  Zeig Begebenheite Anfange Sinn -- meister albern hinaus -- 
  scherzen -- 
  -- fahren fort -- -- einzeln Mensch begegnen -- -- 
  setzen -- Schicksal gut Schauspieler bestimmen -- -- gut Schauspieler versorgen -- -- unglücklicherweise führen Zufall jung Mann Puppenspiel -- früh enthalten -- Abgeschmackte nehmen -- Albernes leidlich -- interessant finden -- jugendlich Eindruck -- verlösch -- gewiß Anhänglichkeit entziehen -- falsch Seite empfangen -- 
  auf Puppenspiel -- fallen Wilhelm Bestürzung -- 
  willkürlich -- fällen -- nehmen anderer -- 
  Gesetzt Schicksal Maler bestimmen -- Zufall belieben -- Jugend schmutzig Hütte -- Stall Scheune verstoßen -- glauben -- Mann jemals Reinlichkeit -- Adel -- Freiheit Seele erheben -- 
  lebhafter Sinn Unreine Jugend anfassen -- Art veredeln -- desto gewaltsam Folge Leben rächen -- -- inzwischen überwinden suchen -- auf's innig verbinden -- 
  früh schlecht unbedeutend Gesellschaft leben -- -- gut -- zurücksehn Eindruck -- Erinnerung jugendlich -- selten wiederholend Freude -- bleiben -- 
  denken -- Gespräch übrig Gesellschaft entfernen -- 
  Philin Anfang Seite treten -- 
  Seitenweg -- 
  Philine bringen Pfänder hervor -- allerlei Weise lösen müssen -- wobei Fremde artigst Erfindung ungezwungen Teilnahme Gesellschaft -- Frauenzimmer -- empfehlen -- fließen Stunde Tag scherzen -- singen -- Küssen allerlei Neckereie angenehmsen vorbei -- 
  Kapitel -- 
  Haus begeben -- sehen Geistliche -- verschwinden -- Ort finden -- 
  artig Manne -- Lebensart scheinen -- Madam Melina -- Gesellschaft -- freundlich aufnehmen -- Abschied verlassen -- 
  besonnen -- Laert -- sonderbaren Mann ehemals sehen -- 
  Begriff -- Abschied befragen -- 
  -- versetzen Wilhelm -- gewiß entlassen -- Näheres Umstand entdecken -- 
  müssen irren -- irgendwo sprechen -- 
  könnten -- Philin -- irren -- 
  Mann eigentlich falsch ansehen bekannte -- aussehen Mensch -- Hans Kunz -- 
  heißen -- Laert -- sehen Mensch -- 
  wissen -- sagen -- versetzt Philin -- begreifen -- lassen -- 
  Wort auslegen -- 
  Kutsch fahren -- 
  loben Sorgfalt Laert -- bestellen -- 
  Philine Madam Melina Wilhelm Platz -- übrig richten -- -- 
  Laert reten Wilhelm Pferd -- heraus kommen -- Stadt -- 
  Philine sitzen Wagen -- artig Lied sing Gespräch Geschichte lenken wissen -- behaupten -- Glück dramatisch behandeln können -- 
  klug Wendung jung Freund gut Laune setzen -- komponiert Reichtum lebendig Bildervorrat sogleich Schauspiel Akte -- Szene -- Charakter Verwicklung -- 
  finden -- Arien Gesänge einzuflechn -- dichtet Philin -- eingehen -- passen bekannt Melodi -- singen Stegreife -- 
  schön -- Schön -- wissen allerlei Neckereie unser Freund beleben -- -- -- 
  grausam Entdeckung Seite Mariane gerissen -- Gelübde treu bleiben -- zusammenschlagend Fall weiblich Umarmung hüen -- treulos Geschlecht meiden -- Schmerz -- Neigung -- süß Wunsch Busen verschließen -- 
  Gewissenhaftigkeit -- womit Gelübde beobachten -- Wesen geheim Nahrung -- Herz Teilnehmung bleiben -- liebevoll Mitteilung Bedürfnis -- 
  Jugendnebel begleiten umher -- Auge faßt reizend Gegenstand Freude -- Urteil liebenswürdig Gestalt schonend -- 
  gefährlich Lage verwegen Mädchen müssen -- lassen einsehen -- 
  Haus finden Wilhelm Zimmer Empfang bereit -- Stuhl Vorlesung zurechen stellen -- Tisch Mitte setzen -- Punschnapf Platz nehmen -- 
  deutsch Ritterstücke neu -- Aufmerksamkeit Neigung Publikum ziehen -- 
  alt Polterer Art mitbringen -- Vorlesung beschließen -- 
  setzen nieder -- 
  Wilhelm bemächtigen Exemplar -- fing lesen -- 
  geharnischt Ritter -- alt Burge -- Treuherzigkeit -- Rechtlichkeit Redlichkeit -- Unabhängigkeit handelnd Person groß Beifall aufnehmen -- 
  Vorleser Möglichst -- Gesellschaft -- 
  Akt Punsch Napf -- Stück getrunken anstoßen -- natürlich -- Gesellschaft -- Fall -- lebhaft Platz Held versetzen -- gleichfalls anstieß -- Günstling handelnd Person leben lassen -- 
  Feuer edelst Nationalgeist entzünden -- 
  gefiel deutsch Gesellschaft -- -- Charakter gemäß -- eigen Grund Boden poetisch ergötzen -- 
  tun Gewölbe Keller -- verfallen Schlöss -- Moos hohl Baum -- nächtlich Zigeunerszen heimlich Gericht unglaublich Wirkung -- 
  Schauspieler -- Helm Harnisch -- Schauspielerin -- stehend Kragen Deutschheit Publikum produzieren -- 
  sogleich Name Stück deutsch Geschichte zueignen -- Madam Melina beteuern -- Sohn Tochter -- wozu Hoffnung -- Adelbert Mathilde taufen lassen -- 
  Akt Beifall lärmender laut -- zuletzt -- Held Unterdrücker entgehen -- Tyrann gestraft -- Entzück -- schworen -- glücklich Stunde -- 
  Melina -- Trank begeistern -- lautesen -- Punschnapf leeren -- Mitternacht herannahn -- schworen Laert teuer -- Mensch würdig -- Gläs jemals Lippe setzen -- werfen Beteuerung Glas Scheibe Gas hinaus -- 
  übrig folgen Beispiel -- unerachten Protestationen Wirt -- herbeilief -- Punschnapf -- Fest unheilig Getränk entweihen -- tausend Stück schlagen -- 
  Philin -- Rausch wenigster ansehen -- indes Mädchen anständigst Stellung Kanapee liegen -- reizen Schadenfreude Lärm -- 
  Madam Melina rezitieren erhaben Gedicht -- Mann -- Rausch liebenswürdig -- fing schlecht Bereitung Punsche schelten -- versichern -- fest einrichten verstehen -- zuletzt -- Laert Stillschweigen gebot -- Gröber laut -- -- Bedenken -- Scherbe Napfe Kopf werfen -- Lärm vermehrn -- 
  indessen Scharwache herbei kommen -- verlangt Haus einlassen -- 
  Wilhelm -- Lesen erhitzen -- trinken -- -- Beihilfe Wirt Leute Geld Wort befriedigen -- Glied Gesellschaft mißlich Umstand Haus schaffen -- 
  werfen -- -- Schlafe überwältigen -- voll Unmut -- unausgekleiden Bette -- glich unangenehm Empfindung -- morgens erwachen -- -- Auge aufschlagen -- düsterem Blick Verwüstung Tag -- Unrat böse Wirkung hinsehen -- geistreich -- lebhaft wohlgemeint Dichterwerk hervorbringen -- 
  Elftes Kapitel -- 
  kurz Bedenken rufen sogleich Wirt herbei -- lassen sowohl Schaden Zeche Rechnung schreiben -- 
  vernehmen Verdruß -- Pferd Laert gestern Hereinreiten dergestalt angreifen -- wahrscheinlich -- sagen pflegen -- verschlagen -- Schmidt Hoffnung Aufkomme geben -- 
  Gruß Philine -- Fenster zuwinken -- versetzt heit Zustand -- sogleich nächster Laden -- Geschenk -- Pudermesser schuldig -- kaufen -- bekennen -- halten Grenze proportionieren Gegengeschenk -- 
  kauft Paar niedlich Ohrring -- Hut Halstuch -- Kleinigkeit -- verschwenderisch wegwerfen sehen -- 
  Madam Melina -- Gabe überreichen -- beobachten -- suchen tisch Gelegenheit -- ernstlich Empfindung Mädchen Rede setzen -- erstaunt -- Vorwurf verdienen glauben -- 
  schworen teuer -- keineswegs eingefallen -- Person -- Wandel kennen -- wenden -- entschuldigt freundlich artig Betragen -- befriedigen Madam Melina Weise -- vielmehr verdrießlich -- bemerken müssen -- Schmeichelei -- wodurch Art Neigung unser Freund erwerben -- hinreich -- Besitz Angriff lebhafn -- jünger Natur glücklich begabt Person verteidigen -- 
  Mann finden gleichfalls -- Tisch kommen -- übl Humor -- fing -- Kleinigkeit auslassen -- Wirt hereintreten Harfenspieler anmelden -- 
  -- -- gewiß Vergnügen Musik Gesängen Mann finden -- -- hören -- enthalten -- bewundern -- mitteilen -- 
  Lassen weg -- versetzen Melina -- stimmen Leiermann hören -- allenfalls Sänger -- verdienen -- 
  begleitet Wort tückisch Seitenblick -- Philine werfen -- 
  verstehen -- bereit -- Verdruß -- angemeldet Sänger beschützen -- 
  wenden Wilhelm -- -- Mann hören -- -- erbärmlich Langenweil retten -- 
  Melina antworten -- Streit lebhaft -- Wilhelm Augenblick hereintretend Mann begrüßen herbeigewinkt -- 
  Gestalt seltsam Gast setzen Gesellschaft erstaunen -- stuhl Besitz nehmen -- ehe Frage vorzubring Herz -- 
  kahl Scheitel grau Haar umkränzen -- blau Auge blickt sanft lang weiß Augenbraun hervor -- 
  wohlgebildet Nase schließen lang weiß Bart -- gefällig Lippe bedecken -- lang dunkelbraun Gewand umhüllt schlank Körper Hals Füßen -- fing Harfe -- nehmen -- präludieren -- 
  angenehm Ton -- Instrument hervorlockt -- erheitert Gesellschaft -- 
  pflegen singen -- Alter -- Philin -- 
  geben -- Herz Geist Sinn ergötzen -- Wilhelm -- 
  Instrument Stimme begleiten -- Melodie -- Gang Läufe Worte Sinn -- scheinen Schmetterlinge schön bunt Vögel ähnlich -- Luft unser Auge herum schweben -- allenfalls Haschen Zueign möchten -- Gesang Genius gen Himmel heben -- gut begleiten anreizt -- 
  alt Wilhelm -- alsdann Höhe -- Griff Harfe -- beginnen Lied -- 
  enthalten Lob Gesang -- pries Glück Sänger -- ermahnt Mensch -- Ehre -- 
  tragen Lied Leben Wahrheit -- scheinen -- Augenblick Anlasse dichten -- 
  Wilhelm enthalten -- Hals fallen -- Furcht -- laut Gelächter erregen -- ziehen Stuhl -- übrig machen halb laut albern Anmerkung -- streiten -- Pfaff Jude -- 
  Verfasser Lied fragen -- bestimmt Antwort -- versichern -- reich Gesäng -- wünschen -- fallen möchten -- 
  groß Gesellschaft fröhlich freudig -- Melina Art -- schwatzen scherzt -- fing alt Lob gesellig Leben geistreich singen -- 
  Pries Einigkeit Gefälligkeit einschmeichelnd Ton -- 
  Gesang trocken -- rauh verworren -- gehässig Verschlossenheit -- kurzsinnig Feindschaft gefährlich Zwiespalt bedauern -- werfen Seele unbequem Fessel -- -- Fittiche vordringenden Melodie tragen -- Friedensstifter pries -- Glück Seele -- finden -- singen -- 
  endigen -- Wilhelm Zurief -- seist -- hülfreich Schutzgeist segnend belebend Stimme kommst -- nimm Verehrung -- fühlen -- bewundern -- vertrauen -- bedarfst -- 
  alte schweigen -- lassen Finger Sait schleichen -- greifen stark -- singen -- hören draußen Tor -- 
  Brücke schallen -- 
  lassen Gesang unser Ohr saal widerhallen -- 
  König sprach_es -- Page laufen -- Knabe -- König rufen -- 
  Bring herein alte -- 
  Gegrüßt hoch Herr -- Gegrüßt schön Dame -- 
  welch reich Himmel -- 
  Stern Stern -- 
  kennen Name -- 
  Saal voll Pracht Herrlichkeit Schließt Auge -- staunend ergötzen -- 
  Sänger drücken Auge -- schlagen voll Ton -- Ritter schaun mutig drein -- Schoß schön -- 
  König -- Lied gefallen -- Ließ -- Lohne Spiel -- golden Kette holen -- 
  golden Kette gib -- Kette gib Ritter -- kühn Angesicht feind Lanze splittern -- 
  Gib Kanzler -- -- laß golden Last Last tragen -- 
  Sing -- Vogel singen -- Zweig wohnen -- 
  Lied -- Kehl dringen -- Lohn -- reichlich lohnet -- bitten -- bitte eins -- lassen Trunk Wein rein Glase bringen -- 
  setzen -- trinken -- 
  O Trank süßen Labe -- 
  O -- dreimal hochbeglückt Haus Gabe -- 
  Ergeht_es -- denken -- danket Gott -- warm Trunk danken -- 
  Sänger geendigt Liede Glas Wein -- eingeschenken stehen -- ergriff -- freundlich Miene -- Wohltäter wendend -- austrank -- entstehen allgemein Freude Versammlung -- 
  klatschen -- rufen -- mögen Glas Gesundheit -- Stärkung alt Glied gereichen -- 
  singen Romanz -- erregen Munterkeit Gesellschaft -- 
  Melodie -- Alter -- rufen Philine -- Schäfer putzt Tanz -- 
  O -- versetzen -- Lied singen aufführen -- fehlen -- 
  Philine stehen -- halten fertig -- 
  alte beginnen Melodie -- singen Lied -- unser Leser mitteilen -- abschmacken unanständig finden können -- 
  inzwischen Gesellschaft -- heiter -- Flasche Wein ausgetrunken -- fing laut -- 
  unser Freund bös Folge Lust frisch Andenken schweben -- suchen abzubrechen -- steckt alt Bemühung reichlich Belohnung Hand -- tun -- lassen abtret Ruhe -- versprechen Abend wiederholen Freude Geschicklichkeit -- 
  hinweg -- Wilhelm Philine -- Leibgesange weder dichterisch sittlich Verdienst finden -- Naivität -- Eigenheit Zierlichkeit schicklich Theater jemals ausführen -- allgemein lebhaft Beifall gewiß -- 
  -- Philin -- müssen angenehm Empfindung -- eise wärmen -- 
  -- Wilhelm -- beschämt Mann Schauspieler -- 
  bemerken -- dramatisch Ausdruck Romanz -- 
  gewiß leben Darstellung Gesang -- unser steif Person Bühne -- Aufführung Stück eher Erzählung halten -- musikalisch Erzählung sinnlich Gegenwart zuschreiben -- 
  Ungerecht -- versetzt Laert -- geben weder Schauspieler Sänger -- wissen -- -- Musik Bewegung Körper leiten -- Leben -- Maß vorschreiben -- Deklamation Ausdruck Kompositeur übertragen -- 
  anderer Mensch -- prosaisch Drama erschaffen -- Takt Deklamation erfinden -- worin Mitspielende stören -- 
  wissen -- Melina -- Mann Punkt gewiß beschämt -- Hauptpunkt -- 
  Stärke Talent zeigen Nutzen -- ziehen -- -- Verlegenheit -- Mahlzeit hernehmen -- bewegen -- Mahlzeit teilen -- 
  wissen Geld -- anwenden können -- Verfassung setzen -- Liedche Tasche locken -- 
  scheinen angenehm -- Geld verschleudern -- womit Existenz verschaffen -- 
  Gespräch bekommen Bemerkung angenehmst Wendung -- 
  Wilhelm -- Vorwurf eigentlich richten -- antwortet Leidenschaft -- Melina -- groß Feinheit befliss -- bringen zuletzt Beschwerde ziemlich trocken Wort -- 
  vierzehn -- -- verpfänden Theater Garderobe besehen -- beider leidlich Summe -- 
  machen Hoffnung -- kreditier -- sehen -- Sache bedacht Entschluß nähern -- 
  Griffe -- sein Gange -- 
  Absicht verreisen ausführen -- Geld scheinen sparen -- Person -- Gelegenheit verschaffen wissen -- geschwinder weggehen -- 
  ungerecht Vorwurf treffen unser Freund -- 
  versetzt Lebhaftigkeit -- Heftigkeit -- ergriff -- Gesellschaft Aufstand zerstreuen -- Türe -- undeutlich erkennen -- unfreundlich undankbar Mensch aufhalten wollen -- 
  eilt verdrießlich Hinunter -- steinern Bank setzen -- Tore Gasthofs stehen -- bemerken -- halb Lust -- halb Verdruß gewöhnlich trinken -- 
  Zwölftes Kapitel -- 
  kurzen -- -- beunruhigen mancherlei Gedanke -- sitzend hinsehend zubrachen -- schlendert Philine singend Haustür heraus -- setzen -- dürfen beinahe sagen -- -- nahe rücken heran -- lehnen Schulter -- spielt Locke -- streichelt -- Wort Welt -- 
  bitten -- bleiben -- Gesellschaft lassen -- lang Weile sterben müssen -- können Melina Dache Ausdauer -- Herüber quartieren -- 
  vergebens suchen abzuweisen -- begreiflich -- lang weder bleiben können dürfen -- 
  lassen Bitte -- unvermutet Schlang Arm Hals -- küssen lebhaftesen Ausdrucke Verlangen -- 
  toll -- Philin -- rufen Wilhelm -- loszumachen suchen -- 
  öffentlich Straße Zeuge Liebkosung -- Weise verdienen -- 
  lassen -- bleiben -- 
  fest halten -- -- öffentlich Gaß küssen -- versprichst -- wünschen -- 
  lach Tod -- fahren fort -- Vertraulichkeit halten Leute gewiß Frau Woche -- Ehemänner -- anmutig Szene sehen -- Weiber Muster kindlich unbefangen Zärtlichkeit anpreisen -- 
  gehen Leute vorbei -- liebko anmutigsen -- -- Skandal geben -- zwingen -- Rolle geduldig Ehemann spielen -- 
  schneiden Leute Gesicht Rücken -- treiben voll Übermut allerhand Ungezogenheit -- zuletzt versprechen müssen -- übermorgen bleiben -- 
  Stock -- -- ablassen -- Törin -- Freundlichkeit verschwenden -- 
  stehen verdrießlich Schritt -- kehren lachend -- rufen -- 
  glauben -- vernarren -- Strickstrumpf holen -- -- 
  Bleibe -- steinern Mann steinern Bank finden -- 
  diesmal Unrecht -- enthalten streben -- Augenblick -- einsam Laube befinden -- Liebkosung wahrscheinlich unerwidert gelassen -- 
  -- leichtfertig Blick zugeworfen -- Haus -- 
  Beruf -- folgen -- vielmehr Betrag Widerwille erregen -- heben -- wissen -- Bank -- nachgehen -- 
  Begriff Türe treten -- Melina herbeikommen -- bescheiden anreden -- Wortwechsel hart ausgesprochen Ausdruck Verzeihung bitten -- 
  nehmen übel -- fahren fort -- Zustande -- befinden -- ängstlich bezeig -- Sorge Frau -- Kind -- verhindern -- ruhig leben -- Genuß angenehm Empfindung hinzubringen -- erlauben -- 
  Überdenk -- -- setzen Besitz theatralisch Gerätschaft -- vorfinden -- 
  Schuldner ewig dankbar bleiben -- 
  Wilhelm -- ungern Schwelle aufhalten -- unwiderstehlich Neigung Augenblicke Philine hinüberziehen -- überrascht Zerstreuung eilfertig Gutmütigkeit -- glücklich zufrieden -- lang bedenken -- 
  -- -- 
  bereit -- Abend früh Geld zahlen -- 
  hierauf Melina'n Hand Bestätigung Versprechen -- zufrieden -- eilig Straße weggehen -- Eindring Haus zweitenmal unangenehm Weise halten -- 
  jung Mensch Bündel Rücken eilig Straße -- treten Wilhelm -- Friedrich erkennen -- 
  -- rufen -- blau Auge freudig umh hinauf Fenster lassen -- mamsell -- 
  Henker lang Welt aushalten -- sehen -- 
  Wirt -- treten -- versetzen -- -- weniger Sprung Treppe hinauf -- Wilhelm bleiben Schwelle eingewurzeln stehen -- 
  Augenblick Junge Haar rückwärts Treppe herunterreißen -- hemmt heftig Kampf gewaltsam Eifersucht Lauf Lebensgeister Idee -- Erstarrung erholen -- überfiel Unruhe -- Unbehagen -- dergleich Leben empfinden -- 
  Stube -- finden Mignon schreiben beschäftigen -- 
  Kind groß Fleiße bemühen -- -- auswendig wissen -- schreiben -- Herr Freund Geschriebene korrigieren geben -- 
  unermüden -- fassen -- Buchstabe bleiben ungleich -- Linie krumm -- 
  scheinen Körper Geist widersprechen -- 
  Wilhelm -- Aufmerksamkeit Kind -- ruhig Sinn -- Freude -- achten diesmal -- zeigen -- fühlen -- betrüben Desto_mehr -- glauben -- diesmal Sache -- 
  Wilhelm Unruhe treiben Gäng Haus -- Haustür -- 
  Reiter sprengen -- ansehen -- gesetzt Munterkeit verraten -- 
  Wirt eilen entgegen -- reicht bekannt Freund Hand -- rufen -- ei -- Herr Stallmeister -- sehen -- 
  füttern -- versetzen Fremde -- hinüb -- Geschwindigkeit allerlei einrichten lassen -- 
  Graf Gemahlin -- Zeitlang drüben aufhalten -- Prinz * * * gute bewiren -- Gegend wahrscheinlich Hauptquartier aufschlagen -- 
  Schade -- bleiben -- versetzt Wirt -- Gesellschaft -- 
  Reitknecht -- nachsprengen -- Stallmeister Pferd -- Türe Wirt unterhalten -- Wilhelm Seite ansehen -- 
  -- merken -- Rede -- begeben weg -- Straße -- Dreizehntes Kapitel -- 
  verdrießlich Unruhe -- befinden -- fallen -- alte aufsuchen -- Harfe böse Geist verscheuchen hoffen -- 
  weisen -- Manne fragt -- schlecht Wirtshaus entfernt Winkel Städtchen -- Treppe hinauf Boden -- süß Harfenklang Kammer entgegen schallen -- 
  herzrührend -- klagend Ton -- traurig -- ängstlich Gesang begleiten -- 
  Wilhelm schlich Türe -- alt Art Phantasie vortragen -- strophen teils singend teils rezitierend wiederholen -- Horcher -- kurz Aufmerksamkeit -- ungefähr folgend verstehen -- 
  Brot Träne as -- kummervollen Nächte Bette weinend sitzen -- kennen -- himmlisch Mächt -- 
  führen Leben hinein -- lassen arme schuldig -- überlassen Pein -- schuld rächen Erde -- 
  wehmütig herzlich Klage Drang tief Seele Hörer -- 
  scheinen -- alt manchmal Träne hindern fortzufahren -- klang Sait -- Stimme leise gebrochen Lauten mischen -- 
  Wilhelm stehen Pfoste -- Seele tief rühren -- Trauer unbekannte schließen beklommen Herz -- widerstand Mitgefühl -- Träne halten -- alte herzlich Klage Auge hervorlocken -- 
  Schmerz -- Seele drücken -- lösen gleich -- überlassen -- stoßen Kammertüre -- stehen alte -- schlecht Bette -- einzig Hausrat armselig Wohnung -- Sitz nehmen nötigen -- 
  Empfindung regen -- Alter -- rufen -- -- Herzen stocken -- lösen -- laß stören -- Fahr fort -- leiden linderst -- Freund glücklich -- 
  alte aufstehen reden -- Wilhelm verhindern -- Mittage bemerken -- Mann ungern sprechen -- setzen vielmehr Strohsack nieder -- 
  alt trocknet Träne -- fragt freundlich Lächel -- hierher -- 
  Abend aufwarten -- 
  ruhig -- versetzen Wilhelm -- sing -- -- Lage passen -- tun -- -- 
  scheinen -- irr Könntest -- finden glücklich -- Einsamkeit angenehm beschäftigen unterhalten -- überall Fremdling -- Herzen angenehmen Bekanntschaft findest -- 
  alte blickt Sait -- sanft präludieren -- stimmen singen -- 
  Einsamkeit ergeben -- 
  -- leben -- lieben -- lassen Pein -- 
  -- lassen Qual -- 
  einsam -- -- 
  schleichen Liebender lauschend sachen -- Freundin -- 
  überschleichen Nacht Einsamen Pein -- Einsamen Qual -- 
  Einsam Grabe -- lassen -- 
  weitläufig -- Anmut seltsam Unterredung ausdrücken -- Freund abenteuerlich fremde halten -- 
  -- Jüngling -- antworten alt reinst Übereinstimmung Anklang -- verwandter Empfindung Rege machen -- Einbildungskraft weit Feld eröffnen -- 
  Versammlung fromm Mensch -- -- abgesondern Kirche -- rein -- herzlich Geistreicher erbau glauben -- beigewohnen -- Begriff gegenwärtig Szene -- erinnern -- Liturg Wort Ver Gesanges anpassen wissen -- Seele erheben -- wohin Redner wünschen -- Flug nehmen mögen -- anderer Gemeinde -- Melodie -- Ver Liedes hinzufügen -- anknüpfen -- wodurch verwandt Idee Lied -- entlehnen -- erregen -- Stelle Verbindung neu individuell -- Augenblick erfinden -- wodurch bekannt Kreis Idee -- bekannt Lied Sprüche -- besonderer Gesellschaft -- Augenblick entstehen -- Genuß beleben -- stärken erquicken -- 
  erbaut alt Gast -- -- bekennen unbekannt Lied Stelle -- nahe fern Gefühl -- wachend schlummernd -- angenehm schmerzlich Empfindung Zirkulation bringen -- gegenwärtig Zustande unser Freund gute hoffen -- 
  Vierzehntes Kapitel -- 
  fing Rückwege Lage lebhaft -- geschehen -- denken -- Vorsatze -- heraus reißen -- Haus gelangen -- Wirt sogleich Vertrauen eröffnen -- Mademoiselle Philine Stallmeister Graf Eroberung -- -- Auftrag ausrichten -- hoch Eile kommen -- Abendessen Zimmer verzehren -- 
  Augenblick treten Melina Notarius herein -- gehen Wilhelm Zimmer -- -- wiewohl einig zaudern -- Versprechen Genüge leisten -- dreihunderen Taler -- Wechsel -- Melina auszahlt -- sogleich Notarius übergeben -- Dokument geschlossen Kauf theatralisch Gerätschaft erhalten -- früh übergeben -- 
  auseinander gehen -- Wilhelm entsetzlich Geschrei Haus vernehmen -- 
  hört jugendlich Stimme -- -- zornig drohend -- unmäßig Weinen Heule -- Durchbrach -- 
  hört Wehklage herunter Stube vorbei Hausplatz eilen -- 
  Neugierd unser Freund herunter locken -- finden Friedrich Art Raserei -- 
  Knabe weinen -- knirschen -- stampfen -- drohen geballt Fäust -- stellen ungebärdig Zorn Verdruß -- 
  Mignon stehen Verwunderung -- Wirt erklären einigermaßen Erscheinung -- 
  Knabe Rückkunft -- Philin aufnehmen -- zufrieden -- lustig munt -- gesung gesprung -- Stallmeister Philine Bekanntschaft -- 
  Mittelding Kind Jüngling anfangen -- Verdruß zeigen -- Tür zuzuschlagen -- nieder rennen -- 
  Philin befohlen -- Abend Tisch aufwarten -- worüber mürrisch trotzig -- Schüssel Ragout -- anstatt Tisch setzen -- Mademoiselle Gast -- ziemlich nah gesessen -- hineingeworfen -- worauf Stallmeister paar tüchtig Ohrfeige geben -- Türe hinausgeschmissen -- 
  -- Wirt -- Person säubern helfen -- Kleid übel zugerichten -- 
  Knabe Wirkung Rache vernehmen -- fing laut lach -- Träne backen herunter laufen -- 
  Freute herzlich -- Schimpf -- Stärkere angetan -- Einfiel -- neu Heulen drohen Anfing -- 
  Wilhelm stehen nachdenklich beschämt Szene -- 
  Innerst -- stark übertrieben Zug darstellen -- unüberwindlich Eifersucht entzünden -- -- Wohlstand zurückhalten -- wild Laune befriedigen -- -- tückisch Schadenfreude -- geliebt Gegenstand verletzen -- Nebenbuhler ausgefordern -- Mensch -- Verdrusse scheinen -- vertilgen -- 
  Laert -- herbei kommen -- Geschichte vernehmen -- bestärken schelmisch aufgebracht Knabe -- beteuern schworen -- Stallmeister müssen Satisfaktion geben -- Beleidigung sitzen lassen -- weig Stallmeister -- rächen wissen -- 
  Laert Fache -- 
  ernsthaft hinauf -- Stallmeister Name Knabe heraus fordern -- 
  lustig -- -- Spaß Abend vorstellen -- 
  gehen Hinunter -- Philine folgen -- 
  Sohn -- Stallmeister Friedrich -- brav Junge -- weigern -- fechten -- Ungleichheit Kraft Sache ohnehin abenteuerlich -- Schlag anderer Waffe Paar Rapiere -- Knöpfe Kreide bestreichen -- -- meister Stöße Rock zeichnen -- Überwind halten -- Wein -- Stadt -- traktieren -- 
  Laert entscheiden -- Vorschlag annehmen -- friedrich gehorcht Lehrmeister -- 
  Rapiere kommen herbei -- 
  Philine setzen -- strickt -- Kämpfer Gemütsruh -- 
  Stallmeister -- fochen -- gefällig -- Gegner schonen -- Kreidenflecke Rock bringen lassen -- worauf umarmt -- Wein herbeigeschaffen -- 
  Stallmeister Friedrich Herkunft Geschichte wissen -- Märche erzählen -- wiederholen -- andermal Leser denken -- 
  Wilhelm Seele vollenden indessen Zweikampf Darstellung Gefühle -- leugnen -- Rapier -- Degen Stallmeister führen wünschen -- Einsah -- Fechtkunst überlegen -- 
  würdigen Philine Blicks -- hütet Äußerung -- Empfindung verraen -- eilt -- einigemal Gesundheit Kämpfer Bescheid tun -- Zimmer -- tausend unangenehm Gedanke drängten -- 
  erinnern -- Geist unbedingt hoffnungsreich Streben empor heben -- lebhaftesen Genusse Art -- Element schwamm -- 
  deutlich -- unbestimmt Schlender geraten -- schlürfend kosten -- voll Züg eingesogen -- deutlich sehen -- unüberwindlich Bedürfnis Natur Gesetz -- Bedürfnis Umstand reizen -- halb befriedigen Irre führen -- 
  wundern -- Betrachtung Zustand -- heraus denken arbeitet -- groß Verwirrung geraten -- 
  -- Freundschaft Laert -- Neigung Philine -- Anteil Mignon -- lang billig Ort Gesellschaft festhalten -- Lieblingsneigung hegen -- gleichsam verstohl Wunsch befriedigen -- Zweck vorzusetzen -- alt Träum nachschleichen -- 
  Verhältnis reißen -- scheiden -- glauben Kraft besitzen -- 
  weniger Augenblick Melina Geldgeschäft einlassen -- rätselhaften alte kennen lernen -- entziffern unbeschreiblich Begierde fühlen -- 
  halten lassen -- geworfen Gedanke entschließen -- glauben entschlossen -- 
  fort -- rufen -- fort -- 
  werfen Sessel -- bewegen -- 
  Mignon treten Herein fragt -- aufwickeln dürfen -- 
  still -- schmerzen tief -- abfertigen -- 
  rührend -- Liebe -- stille nähren -- Treue -- verborgener befestiget -- -- wert -- Stunde nahe -- offenbar -- 
  streng verschlossen Knospe reif -- Wilhelm Herz empfänglich -- 
  stehen -- Unruhe -- -- 
  Herr -- rufen -- unglücklich -- Mignon -- -- 
  Lieb Geschöpf -- -- Hand -- Schmerz -- 
  -- fort -- -- 
  Auge -- verhalten Träne blinkt -- kniet Heftigkeit nieder -- 
  behalten Hand -- legen Haupt Knie -- still -- 
  spielt Haar -- freundlich -- 
  bleiben ruhig -- 
  fühlt Art Zucken -- sacht Anfing -- Glied wachsend verbreiten -- 
  Mignon -- rufen -- -- -- 
  richtet Köpfchen -- -- fahren Herzen -- Gebärde -- Schmerz verbeißen -- 
  heben -- fallen Schoß -- drücken -- küßen -- 
  antworten Händedruck -- Bewegung -- 
  halten Herz fest -- Schrei -- krampfig Bewegung Körper begleiten -- 
  fahren -- fallen sogleich Gelenke brechen nieder -- 
  gräßlich Anblick -- -- 
  Kind -- rufen -- aufhieben fest umarmt -- Kind -- -- -- 
  Zuckung dauern fort -- Herz schlotternd Gliedern mitteilen -- hing arme -- 
  schließen Herz -- benetzen Träne -- 
  scheinen angespannen -- eins -- hoch körperlich Schmerz ertragen -- Heftigkeit Glied lebendig -- werfen -- Ressort -- zuschlägen -- Hals -- Innerst gewaltig Riß geschehen -- Augenblick fließen Strom Träne geschlossen Auge Busen -- 
  halten fest -- 
  weinen -- Zunge sprechen Gewalt Träne -- 
  lang Haar aufgehen -- hing Weinende nieder -- Wesen scheinen Bach Träne unaufhaltsam schmelzen -- 
  starr Glied gelind -- ergoß Innerst -- Verirrung Augenblickes fürchten Wilhelm -- arme zerschmelzen -- übrig behalten -- 
  halten fest Fester -- 
  -- Kind -- rufen -- Kind -- 
  -- 
  Wort trösten -- 
  -- 
  behalten -- verlassen -- -- 
  Träne fließen -- -- 
  richten -- 
  weich Heiterkeit glänzt Gesicht -- 
  -- Vater -- rufen -- verlassen -- Vater -- -- 
  Kind -- 
  sanft fing Türe Harfe klingen -- alte bringen herzlichsten Lied Freund Abendopfer -- -- Kind fest arme haltend -- reinsen unbeschreiblichst Glückes Genoß -- 