Wahlverwandtschaft -- 
  -- 
  Wahlverwandtschaft -- 
  Roman Goethe -- 
  -- 
  tübingen -- J. G. Cottaischen Buchhandlung -- 1809 -- 
  Kapitel -- 
  gemein Leben begegnen Epopöe Kunstgriff Dichter rühmen pflegen -- nämlich Hauptfigur entfernen -- verbergen -- Untätigkeit hingeben -- Sodann -- -- Bemerkter Platz füllen -- Tätigkeit äußern -- gleichfalls Aufmerksamkeit -- Teilnahme -- Lob Preis würdig erscheinen -- 
  zeigen Entfernung Hauptmann Eduard Architekt täglich bedeutend -- Anordnung Ausführung Unternehmen abhing -- wobei genau -- verständig tätig erweisen -- Dame mancherlei Art Beistand still langwierig Stunde unterhalten wissen -- 
  Äußeres Art -- zutrauen einflößt Neigung erwecken -- 
  Jüngling voll Sinn Wort -- wohlgebauen -- Schlank -- eher -- bescheiden ängstlich -- zutraulich zudringend -- 
  Freudig übernehmen Sorge Bemühung -- Leichtigkeit rechnen -- Hauswesen Geheimnis -- überall verbreiten günstig Einfluß -- 
  Fremden lassen gewöhnlich empfangen wissen unerwartet Besuch ablehnen -- Frau dergestalt vorbereiten -- Unbequemlichkeit entspringen -- 
  tags jung Rechtsgelehrter schaffen -- benachbart Edelmann senden Sache Sprache bringen -- sonderlich Bedeutung Charlotte dennoch innig berühren -- 
  vorfalls gedenken -- verschieden Ding Anstoß -- ruhen -- 
  erinnern Veränderung -- Charlotte Kirchhofe vornehmen -- 
  sämtlichen Monument Stelle rücken Mauer -- Sockel Kirche Platz finden -- 
  übrig Raum ebnen -- 
  breit Weg -- Kirche vorbei jenseitig Pförtche führen -- übrig verschieden Art Klee besäen -- schön grünt Blüht -- 
  gewiß Ordnung heran Grab bestellen -- Platz jederzeit vergleichen ebenfalls Besät -- 
  leugnen -- Anstalt sonn- festtägig Kirchgang heit würdig Ansicht gewähren -- 
  sogar betagt alt Gewohnheit haftend geistliche -- anfänglich Einrichtung sonderlich zufrieden -- nunmehr Freude -- alt Linden -- Philemon -- Baucis Hintertür ruhend -- holprig Grabstätt schön -- bunt Teppich -- überdies Haushalt -- Charlotte Nutzung Fleck Pfarre zusichern lassen -- 
  demungeachten Gemeindeglied mißbilligen -- Bezeichnung Stelle Vorfahre ruhen -- aufheben Andenken gleichsam auslöschen -- 
  wohlerhalten Monument zeigen -- begraben -- begraben -- kommen eigentlich -- behaupten -- 
  Gesinnung benachbart Familie -- Ihrig Raum Ruhestätte mehrere ausbedung Kirche Stiftung zugewenden -- 
  jung Rechtsgelehrte abgesenden -- Stiftung widerrufen Anzuzeig -- zahlen -- Bedingung geschehen -- einseitig aufheben Vorstellung Widerrede achten -- 
  Charlotte -- Urheberin Veränderung -- jung Mann sprechen -- lebhaft -- allzu vorlauen -- Prinzipal Grund darlegt Gesellschaft denken -- 
  sehen -- sprechen -- kurz Eingang -- Zudringlichkeit rechtfertigen wissen -- seh Geringst Höchsten liegen -- Ort bezeichnen Seinig aufbewahren -- 
  arm Landmann -- Kind begräbt -- Art Trost -- schwach hölzern Kreuz Grab stellen -- Kranz zieren -- Andenken erhalten Schmerz währen -- Merkzeiche -- Trauer -- aufheben -- 
  Wohlhabende verwandeln Kreuze eisern -- befestig schützen mancherlei Weise -- Dauer mehrere -- 
  sinken unscheinbar -- Begütert Angelegeneres -- Stein aufzuricht -- mehrere Generation dauern versprechen Nachkomme erneut aufgefrischen -- 
  Stein -- anziehen -- Enthaltene -- Erde vertraute -- 
  sowohl Andenken Rede -- Person -- Erinnerung -- Gegenwart -- 
  geliebt Abgeschieden umarmen eher innig Grabhügel Denkmal -- 
  eigentlich -- -- Markstein -- Gatte -- verwandte -- Freund -- hinscheiden versammeln -- Lebend behalten -- Fremd Misswollende Seite geliebt Ruhende abzuweisen entfernen -- 
  halten -- Prinzipal völlig -- Stiftung zurücknehmen -- billig -- Glied Familie Weise verletzen -- wofür Ersatz denken -- 
  schmerzlich süß Gefühl entbehren -- Geliebten Totenopfer bringen -- tröstlich Hoffnung dereinst unmittelbar ruhen -- 
  Sache Bedeutung -- versetzen Charlotte -- Rechtshandel beunruhigen -- 
  Anstalt reuen -- Kirche -- entgehen -- entschädigen -- 
  aufrichtig gestehen -- Argument überzeugen -- 
  rein Gefühl endlich Gleichheit -- Tod -- scheinen beruhigender eigensinnig Starre Fortsetz Persönlichkeit -- Anhänglichkeit Lebensverhältnis -- 
  sagen hierzu -- richten Frage Architekt -- 
  -- versetzen -- Sache weder streiten -- Ausschlag geben -- 
  Lasse -- Kunst -- Denkweise nächster liegen -- bescheidentlich äußeren -- 
  glücklich -- Rest geliebt Gegenstand eingeurnen Brust drücken -- weder reich heit -- unversehrt verziert Sarkophag verwahren -- Kirche Platz Unsrig finden -- hinaus frei weisen -- 
  Ursache -- Art Weise -- gnädig Frau -- einleiten -- billigen -- 
  Glied Gemeinde reihenweise liegen -- ruh Ihrig -- Erde aufnehmen -- finden natürlich reinlich -- zufällig entstanden zusammensinkend Hügel ungesäumt vergleich -- Decke -- tragen -- leicht -- 
  Zeichen Andenken -- Erinnerung entgegen kommen -- vorübergehen -- versetzt Ottilie -- 
  keineswegs -- fahren Architekt fort -- Andenken -- Platze lossagen -- 
  Baukünstler -- Bildhauer höchlich interessiert -- Mensch -- Kunst -- Hand Dauer Dasein erwarten -- wünscht Gedachte -- ausgeführt Monument -- einzeln zufällig ausgesäen -- Ort aufstellen -- Dauer versprechen -- 
  Fromme Hohen Vorrecht Verzicht -- Kirche persönlich ruhen -- stellen -- schön Halle Begräbnisplatz -- Denkzeich -- Denkschrift -- 
  tausenderlei Form vorschreiben -- tausenderlei Zierat womit ausschmücken -- 
  Künstler reich -- versetzt Charlotte -- sagen -- 
  niemals Form kleinlich Obeliske -- abgestutzt Säule Aschenkrug herausfinden -- 
  anstatt tausend Erfindung -- rühm -- tausend Wiederholung sehen -- 
  -- entgegnet Architekt -- überall -- 
  Erfindung schicklich Anwendung Sache -- 
  Fall Schwierigkeit -- ernst Gegenstand erheitern unerfreulich Unerfreulich geraten -- 
  Entwurf Monument Art betreffen -- sammeln zeigen gelegentlich -- bleiben schön Denkmal Mensch Bildnis -- 
  Begriff -- gut Text weniger Note -- 
  müssen -- gewöhnlich versäumen -- 
  denken lebend Form erhalten -- geschehen -- geschehen unzulänglich Weise -- 
  Toter geschwind abgegoss Maske Block setzen -- Büste -- 
  selten Künstler Stande völlig beleben -- 
  -- wissen -- versetzt Charlotte -- Gespräch Gunst lenken -- 
  Bild Mensch unabhängig -- überall stehen -- stehen verlangen -- eigentlich Grabstätt bezeichnen -- 
  wunderlich Empfindung bekennen -- Bildnis Art Abneigung -- 
  scheinen still Vorwurf -- deut Entfernt -- Abgeschiedenes erinnern -- schwer -- Gegenwart ehren -- 
  Gedenkt -- Mensch sehen -- -- gestehen -- -- -- Mut -- 
  begegnen Geistreiche unterhalten -- Gelehrt lernen -- gereister unterrichten -- Liebevolle Angenehme erzeigen -- 
  ereignen bloß vorübergehenden -- 
  Gesellschaft Familie betragen lieb Glied -- Stadt würdigst Bürger -- Volk trefflichst Fürst -- Nation vorzüglichst Mensch -- 
  hören fragen -- tote unbewunden sagen -- lebend gewiß Vorsicht -- 
  antworten -- 
  befürchten -- irgendwo Weg können -- 
  unrein Sorge Andenken -- meist selbstisch Scherz -- heilig Ernst -- Verhältnis Überblieben lebendig tätig erhalten -- 
  Kapitel -- 
  Aufgeregt Vorfall knüpfend Gespräch -- begeben Tag Begräbnisplatz -- Verzierung Erheiterung Architekt glücklich Vorschlag -- 
  Kirche Sorgfalt erstrecken -- Gebäude anfänglich Aufmerksamkeit ziehen -- 
  Kirche stehen mehrere Jahrhundert -- deutsch Art Kunst -- gut Maße errichten glücklich Weise verziern -- 
  nachkommen -- Baumeister benachbart Kloster Einsicht Neigung klein Gebäude bewähren -- wirken ernst angenehm Betrachter -- obgleich innerer Einrichtung protestantisch Gottesdienst Ruhe Majestät nehmen -- 
  Architekt fallen schwer -- Charlotte mäßig Summe erbitten -- wovon Äußere sowohl innerer altertümlich Sinn herstellen liegend Auferstehungsfelde Übereinstimmung bringen gedachten -- 
  Handgeschick -- Arbeiter -- Hausbau beschäftigen -- beibehalten fromm Werk vollenden -- 
  nunmehr Fall -- Gebäude Umgebung Angebäude untersuchen -- zeigen groß erstaun Vergnügen Architekt bemerken Seitenkapelle geistreicher leicht Maße -- gefälliger fleißiger Zierat -- 
  enthalten geschnitzt gemalt Rest alt Gottesdienst -- mancherlei Gebilde Gerätschaft verschieden Fest bezeichnen jeder Weise feiern wissen -- 
  Architekt unterlassen -- Kapelle sogleich Plan hereinzuzieh eng Raum Denkmal vorig Zeit Geschmack herstellen -- 
  leer Fläche Neigung verziern denken -- freut malerisch Talent üben -- Hausgenossen für Geheimnis -- 
  zeigen versprochenermaß Frau verschieden Nachbildung Entwurf alt Grabmonument -- Gefäßen nähernd Ding -- Gespräch einfacheren Grabhügel nordisch Volk reden -- bringen Sammlung mancherlei Waffe Gerätschaft finden -- Ansicht -- 
  reinlich tragbar schublad Fach eingeschnitten Tuch überzogen Brett -- alt ernst Ding Behandlung Putzhaftes annehmen Vergnügen -- Kästchen Modehändler hinblicken -- 
  Vorzeig -- Einsamkeit Unterhaltung fordern -- pflegen Abend Schatz hervorzutreten -- 
  meistenteils deutsch Ursprung -- Brakteate -- Dickmünze -- Siegel anschließen -- 
  Ding richten Einbildungskraft alt -- zuletzt Anfängen Druck -- Holzschnitt alt Kupfer Unterhaltung ziern -- Kirche täglich -- Sinn gemäß -- Farbe sonstig Auszierung gleichsam Vergangenheit Entgegenwuch -- müssen beinahe fragen -- neueren leben -- Traum -- nunmehr Sitte -- Gewohnheit -- Lebensweise Überzeugung verweilen -- 
  Art vorbereiten größeres Portefeuille -- zuletzt herbeibracht -- gut Wirkung -- 
  enthalten meist umrißen Figur -- -- Bild durchgezeichnen -- altertümlich Charakter vollkommen erhalten -- -- einnehmend finden Beschauende -- 
  Gestalt blicken Reinste hervor -- müssen -- Edel -- ansprechen -- 
  heiter Sammlung -- willig Anerkennung Ehrwürdig -- still Hingebung lieb Erwartung Gesicht -- Gebärde ausdrücken -- 
  Greis kahl Scheitel -- reichlockig Knabe -- munter Jüngling -- ernst Mann -- verklärt heilig -- schwebend Engel -- scheinen selig unschuldig Genüg -- fromm Erwart -- 
  gemein geschehen Zug himmlisch Leben -- gottesdienstlich Handlung scheinen Natur angemessen -- 
  Region blicken meister verschwunden golden Zeitalter -- verloren Paradiese -- 
  Ottilie Fall Gleichen fühlen -- 
  widersteh Architekt erbieten -- Anlaß urbild -- Raum Spitzbog Kapelle auszumal Andenke entscheiden Ort stiften -- gehen -- 
  erklären hierüber Wehmut -- 
  Lage Sache einsehen -- Aufenthalt vollkommen Gesellschaft dauern können -- abgebrochen müssen -- 
  reich Begebenheite -- voll Anläs ernsthaft Unterhaltung -- 
  nehmen Gelegenheit demjenigen Ottilie Heft anmerken -- mitteilen -- wozu schicklicher Übergang finden Gleichnis -- Betrachte liebenswürdig Blatt aufdringt -- 
  hören besonderer Einrichtung englisch Marine -- 
  sämtlicher Tauwerk königlich Flotte -- stärksen schwächst -- dergestalt gesponn -- rot Faden durchgehen -- herauswinden auflösen -- woran klein Stück kenntlich -- Krone gehören -- 
  ziehen Ottilies Tagebuch Fade Neigung Anhänglichkeit -- verbinden bezeichnen -- 
  Bemerkung -- Betrachtung -- ausgezogen Sinnsprüche vorkommen -- schreibend Bedeutung -- 
  einzeln ausgewählt mitgeteilt Stelle entschiedenste Zeugnis -- 
  Ottilies Tagebuche -- 
  -- dereinst ruhen lieben -- angenehmst Vorstellung Mensch -- Leben hinausdenken -- 
  Seinig versammeln -- herzlich Ausdruck -- -- 
  -- mancherlei denkmal Merkzeiche -- Entfernt Abgeschiedene nah bringen -- 
  Kein Bedeutung Bild -- 
  Unterhaltung geliebt Bild -- unähnlich -- Reizend -- manchmal Reizend -- Freund streiten -- 
  fühlen angenehm Weise -- zweien auseinander -- -- 
  -- unterhalten manchmal gegenwärtig Mensch Bild -- 
  brauchen sprechen -- ansehen -- beschäftigen -- 
  sehen -- fühl Verhältnis -- sogar Verhältnis wachsen -- tun -- empfinden -- bloß Bild verhalten -- -- 
  -- niemals Porträt zufried Person kennen -- 
  Porträtmaler bedauern -- 
  verlangen selten Leute unmögliche -- fordern man_es -- 
  Verhältnis Person -- Neigung Abneigung Bild aufnehmen -- bloß darstellen -- Mensch fassen -- fassen -- 
  nehmen Wunder -- Künstler verstocken -- gleichgültig eigensinnig -- 
  entstehen -- Abbildung lieben teuer Mensch entbehren müssen -- -- 
  -- -- Sammlung Architekt Waffe alt Gerätschaft -- nebst Körper hoch Erdhügel Felsenstück zudecken -- bezeugen -- unnütz Vorsorge Mensch Erhaltung Persönlichkeit Tod -- 
  widersprechend -- 
  Architekt gestehen -- Grabhügel Vorfahren öffnen fahren dennoch fort Denkmälern Nachkomme beschäftigen -- -- 
  -- streng nehmen -- 
  Ewigkeit tun -- 
  Ziehe morgens -- Abends auszuziehen -- 
  Verreise -- wiederzukehren -- 
  wünschen -- Unsrig ruhen -- Jahrhundert -- -- 
  -- versunken -- Kirchgänger abgetreten Grabstein -- Grabmäl zusammengestürzt Kirche erblicken -- Leben Tod Leben vorkommen -- Bild -- Überschrift eintreten lang verweilen eigentlich lebendig Leben -- 
  Bild -- verlischen -- 
  Mensch Denkmäler lassen nehmen -- -- 
  Kapitel -- 
  angenehm Empfindung beschäftigen halb -- Dilettant schelten -- Kunst abgeben -- lernen -- Künstler tadeln dürfen -- Grenze Kunst hinaus -- benachbart Feld ergeh Lust -- 
  billig Gesinnung betrachten Anstalt Architekt Ausmal Kapelle -- 
  Farbe bereiten -- Maß nehmen -- Karton zeichnen -- Anspruch Erfindung aufgeben -- halten Umris -- sitzend schwebend Figur geschickt auszuteilen -- Raum geschmackvoll auszuzieren -- Sorge -- 
  Gerüste stehen -- Arbeit vorwärts -- Auge fallen erreichen -- Zuwider -- Charlotte Ottilie besuchen -- 
  lebendig Engelsgesichter -- lebhaft Gewänder blau Himmelsgrund erfreut Auge -- still fromm Wesen Gemüt Sammlung berufen zart Wirkung hervorbracht -- 
  Frau auf Gerüst steigen -- Ottilie bemerken -- Abgemesse Bequem zugehen -- früh Unterricht empfangene entwickeln scheinen -- Farbe Pinsel greifen erhalten Anweisung faltenreich Gewand soviel Reinlichkeit Geschicklichkeit anlegen -- 
  Charlotte -- Ottilie Weise beschäftigen zerstreute -- lassen gewähren -- Gedanke nachzuhäng -- Betrachtung Sorge -- mitteilen -- durchzuarbeien -- 
  gewöhnlich Mensch -- gemein Verlegenheite Tags leidenschaftlich ängstlich Betrag aufgeregen -- mitleidig lächeln abnötigen -- betrachten Ehrfurcht Gemüt -- Saat Schicksals ausgesäen -- Entwicklung Empfängnis abwarten -- weder böse -- weder Glückliche Unglückliche entspringen -- beschleunigen -- 
  Eduard Charlottes Boten -- Einsamkeit senden -- freundlich teilnehmend -- eher gefaßt ernst zutraulich liebevoll -- antworten -- 
  Eduard verschwinden -- Gattin Nachricht gelangen -- ungefähr Name Zeitung finden -- -- bedeutend Kriegsgelegenheit hervorgetan -- Auszeichnung nennen -- 
  wissen -- Weg nehmen -- erfahren Gefahr entronnen -- überzeugt -- groß aufsuchen -- allzusehr deuten -- Sinn schwerlich Äußerst zurückhalten -- 
  tragen Sorge Gedanke -- legen -- Ansicht Beruhigung finden -- 
  Ottilie -- ahnend -- indessen Arbeit groß Neigung fassen -- Charlotte Erlaubnis erhalten -- regelmäßig fortfahren -- 
  rasch azurn Himmel würdig Bewohner bevölkeren -- 
  anhaltend Übung gewann Ottilie Architekt letzter Bild Freiheit -- zusehends -- 
  Gesicht -- Architekt malen überlassen -- zeigen besonderer Eigenschaft -- fangen sämtlich Ottilie gleichen -- 
  Nähe schön Kind müssen Seele jung Mann -- natürlich künstlerisch Physiognomie vorgefassen -- lebhaft Eindruck -- -- Weg Auge Hand -- verlieren -- zuletzt gleichstimmig arbeiten -- 
  -- eins letzter Gesichtchen glücken vollkommen -- scheinen Ottilie himmlisch Raum heruntersähen -- 
  gewölbe fertig -- Wand vornehmen einfach lassen heller bräunlich Farbe überziehen -- zart Säule künstlich bildhauerisch Zierat dunklere Auszeichn -- 
  Ding einer führen -- Blume Fruchtgehänge beschließen -- Himmel Erde gleichsam zusammenknüpfen -- 
  Ottilie Feld -- 
  Garten liefern schön Muster -- obschon Kranz reich ausstatten -- denken -- Stande -- 
  wüs roh -- 
  Gerüste schieben -- Brett werfen -- ungleich Fußboden mancherlei vergossen Farbe verunstalten -- 
  Architekt erbat nunmehr -- Frauenzimmer lassen Kapelle betreten möchten -- 
  ersucht schön Abend -- beiderseits verfügen -- wünscht begleiten empfehlen sogleich -- 
  Überraschung zugedenken -- Charlotte weggehen -- gegenwärtig Lust hinunter -- 
  nimmst gibst Nachricht -- 
  gewiß Angenehmes stand bringen -- 
  Beschreibung Wirklichkeit genießen -- 
  Ottilie -- wissen -- Charlotte Stück -- Gemütsbewegung vermeiden -- überraschen -- begeben sogleich Weg unwillkürlich Architekt -- nirgends erscheinen verbergen -- 
  treten Kirche -- finden -- 
  fertig -- reinigen einweihen -- 
  treten Türe Kapelle -- schwer Erz beschlagen Last Auftat bekannt Raume unerwartet Anblick überraschen -- 
  einzig hoch Fenster fallen ernst bunt Licht herein -- 
  farbig Gläser anmutig zusammengesetzt -- 
  erhalten fremd Ton bereitet Stimmung -- 
  Schönheit Gewölbe Wand Zierde Fußboden erhöhen -- geformt -- schön Must gelegt -- gegossen Gipsfläch verbunden Ziegelsteine bestehen -- 
  sowohl farbig Scheibe Architekt heimlich bereiten lassen -- kurz Zusammenfüg -- 
  Ruheplatz sorgen -- 
  kirchlich Altertümer schöngeschnitzt Chorstühle vorgefunden -- schicklich Wand angebracht umherstanden -- 
  Ottilie freut bekannt unbekannt entgegentretend Teil -- 
  stehen -- -- besehen -- setzt Stühl scheinen -- umherblickt -- -- empfänd empfänd -- -- verschwinden -- Sonne lebhaft beschienen Fenster verlassen -- erwacht Ottilie eilt Schlos -- 
  verbergen sonderbar Epoche Überraschung fallen -- 
  Abend Eduard Geburtstage -- 
  freilich feiern hoffen -- 
  Fest schmücken -- 
  nunmehr stehen herbstlich Blumenreichtum unpflücken -- 
  Sonnenblume wendet Angesicht gen Himmel -- aster sehen still bescheiden -- allenfalls Kränze binden -- Muster dienen Ort auszuschmücken -- bloß Künstler-Grille bleiben -- nutzen -- gemeinsam Grabstätt geeignet scheinen -- 
  müssen geräuschvoll Geschäftigkeit erinnern -- Eduard Geburtsfest feiern -- müssen neugerichtet Haus gedenken -- Decke soviel Freundliches versprechen -- 
  Feuerwerk rauschen Auge Ohr -- einsam -- desto Einbildungskraft -- fühlen desto -- 
  lehnen Arm -- Hoffnung -- jemals Stütze zu_finden -- 
  Ottilies Tagebuch -- 
  -- Bemerkung jung Künstler aufzeichn -- Handwerker bildend Künstler deutlichst gewahr -- Mensch wenigster zuzueignen vermögen eigens anhören -- 
  Werk verlassen -- Vögel Nest worin ausgebrüten -- -- 
  -- Baukünstler hierin wunderlich Schicksal -- 
  wenden Geist -- Neigung -- Raum hervorzubringen -- ausschließen -- 
  königlich Säle Pracht schuldig -- groß Wirkung mitgenießen -- 
  tempeln ziehen Grenze Allerheiligst -- Stufe betreten -- Herz erhebend Feierlichkeit gründen -- Goldschmied Monstranz fern anbeten -- Schmelz Edelsteine zusammengeordnen -- 
  Reichen übergiben Baumeister Schlüssel Palastes Bequemlichkeit Behäbigkeit -- mitzugenießen -- 
  allgemach Weise Kunst Künstler entfernen -- Werk -- ausgestattet Kind -- Vater zurückwirkt -- müssen Kunst befördern -- fast Öffentlich -- Künstler gehören -- beschäftigen bestimmen -- -- 
  -- Vorstellung alt Volk ernst furchtbar scheinen -- 
  dachen Vorfahre Höhle rings umh Thron sitzend stumm Unterhaltung -- 
  Hereintrat -- würdig -- stehen neigt Willkommen -- 
  gestern Kapelle sitzen geschnitzt Stuhle mehrere umhergestellen -- erscheinen Gedanke freundlich anmutig -- 
  sitzen bleiben -- denken -- still kehren sitzen bleiben -- -- Freund kommen -- aufstündest Platz freundlich Neig anwiesesen -- 
  farbig Scheibe ernst Dämmerung müssen ewig Lampe stiften -- Nacht finst bleiben -- -- 
  -- stellen -- denken sehend -- 
  glaub Mensch träumen -- aufhöre sehen -- 
  -- innerer Licht herausträn -- keiner bedürften -- -- 
  -- klingen -- 
  Wind Stoppel finden bewegen -- rot Beere schlanken Baum scheinen Muntere erinnern -- Taktschlag Drescher Gedanke erwecken -- abgesichelt Ähr soviel Nährend Lebendig verbergen liegen -- -- 
  Kapitel -- 
  seltsam müssen -- Ereignissen -- aufgedrungen Gefühl Vergänglichkeit Hinschwinden -- Ottilie Nachricht treffen -- lang verbergen bleiben -- Eduard wechselnd Kriegsglück überliefern -- 
  entging Betrachtung -- Ursache -- 
  glücklicherweise Mensch gewiß Grad Unglück fassen -- hinausgehen vernichten lassen gleichgültig -- 
  Lag -- Furcht Hoffnung Eins -- wechselseitig aufheben dunkl Fühllosigkeit verlieren -- 
  können entfernt Geliebtest stündlich Gefahr wissen dennoch täglich gewöhnlich Leben forttreiben -- 
  Geist Ottilie sorgen -- Stille -- einsam unbeschäftigen Versink scheinen -- wild Heer hereinbrachen -- -- außen schaffen führen -- Gefühl Kraft anregen -- 
  Charlottes Tochter -- Lucian -- Pension Welt treten -- Haus Tante zahlreich Gesellschaft umgeben sehen -- Gefallenwolle Gefallen erregen -- jung -- reich Mann heftig Neigung empfinden -- besitzen -- 
  ansehnlich Vermögen -- gute Art nennen -- scheinen abgehen vollkommen Frau -- Welt übrig beneiden -- 
  Familienangelegenheit -- Charlotte -- Überlegung -- Korrespondenz widmen -- insofern richten -- Eduard nah Nachricht erhalten -- Ottilie letzter bleiben -- 
  wissen Ankunft Luciane -- Haus nötigsten Vorkehrung treffen -- nahe stellen Besuch -- 
  vorher schreiben -- abreden -- nah bestimmen -- Sturm Schloß Ottilie hereinbrach -- 
  Angefahr kommen Kammerjungfer Bedient -- Brancard Koffer Kist -- glauben doppelt dreifach Herrschaft Haus -- erscheinen Gast -- 
  Großtant Luciane Freundin -- Bräutigam gleichfalls unbegleiten -- 
  liegen Vorhaus voll Vach -- Mantelsäck anderer ledern Gehäuse -- 
  Mühe sondert Kästchen Futterale auseinander -- 
  Gepäck Geschleppes -- 
  regnet Gewalt -- woraus Unbequemlichkeit entstehen -- 
  ungestüm treiben begegnen Ottilie gleichmütig Tätigkeit -- heiter Geschick erscheinen schön Glanze -- 
  kurz Untergebracht anordnen -- 
  logieren -- Art bequem -- glauben Bedient -- hindern bedienen -- 
  -- höchst beschwerlich Reise -- Ruhe nossen -- Bräutigam Schwiegermutter nähern -- Liebe -- gut Wille beteuern -- Luciane rasen -- 
  Glück gelangen -- Pferd besteigen -- 
  Bräutigam schön Pferd -- sogleich müssen aufsitzen -- 
  Wetter Wind -- Regen Sturm kommen Anschlag -- leben naß trocken -- 
  Fiel -- Fuß ausgehen -- fragen -- Kleid anhatter beschuhen -- müssen Anlage besichtigen viele gehören -- 
  Pferd geschehen -- Fuß durchrannen -- 
  sehen aburteilen -- 
  Schnelligkeit Wesen widersprechen -- 
  Gesellschaft leiden -- meister Kammermädch -- Wasch bügeln -- Auftrenne Annähen -- fertig -- 
  Haus Gegend erschöpfen -- verpflichten fühlen -- ring Nachbarschaft Besuch ablegen -- 
  schnell riten fahren -- reichen Nachbarschaft ziemlich fern umh -- 
  Schloß Gegenbesuche überschwemmen -- Verfehl -- bestimmen ansetzen -- 
  indessen Charlotte Tante Geschäftsträger Bräutigam innerer Verhältnis feststellen bemühen -- Ottilie untergebene sorgen wissen -- -- groß Zudrang -- fehlen -- Jäger Gärtner -- Fischer Krämer Bewegung setzen -- zeigen Luciane brennend Kometenker -- lang Schweif ziehen -- 
  gewöhnlich Besuchsunterhaltung dünkten unschmackhaft -- 
  alt Person Ruhe Spieltisch gönnen -- einigermaßen beweglich -- lassen reizend Zudringlichkeit Bewegung setzen -- -- müssen herbei -- Tanze -- lebhafen Pfand-Straf- Vexierspiel -- 
  obgleich -- hernach Pfänderlösung -- berechnen -- Seite -- Mann -- Art -- leer -- glücken -- alt Person Bedeutung gewinnen -- einfallend Geburt Namenstage ausgeforscht feiern -- 
  Geschick Statten -- -- begünstigen sehen -- meister begünstigt halten -- Schwachheit sogar Älteste Gesellschaft allermerklichsen schuldig -- 
  Scheinen Plan -- Mann vorstellt -- Rang -- ansehen -- Ruhm Bedeutend -- gewinnen -- Weisheit Besonnenheit Schande -- wild wunderlich Wesen Bedächtigkeit Gunst erwerben -- Jugend -- 
  -- -- Stunde -- entzück Fessel wissen -- 
  Architekt Auge fassen -- schwarz langlockig Haar unbefangen heraussehen -- ruhig Entfernung stehen -- Frage verständig antworten -- einlassen neigen scheinen -- -- halb unwillig halb listig -- entschließen Held Tag Hof gewinnen -- 
  umsonst vieler Gepäcke mitbringen -- folgen -- 
  unendlich Abwechslung Kleidern vorsehen -- 
  Vergnügen -- tags viermal umzuzieh gewöhnlich -- Gesellschaft üblich Kleid Nacht wechseln -- erscheinen wirklich Maskenkleid -- Bäuerin Fischerin -- Fee Blumenmädche -- 
  verschmähen -- alt Frau verkleiden -- desto frisch jung Gesicht Kutte hervorzuzeigen -- verwirrt gegenwärtig Eingebildete dergestalt -- Saalnixe verwandt verschwägert glauben -- 
  wozu Verkleidung hauptsächlich benutzt -- pantomimisch Stellung Tänze -- verschieden Charakter ausdrücken wenden -- 
  kavalier Gefolge einrichten -- Flügel Gebärden weniger nötig Musik begleiten -- bedürfen kurz Abred sogleich Einstimmung -- 
  Tag -- Pause lebhaft Ball -- heimlich Antrieb -- gleichsam Stegereif -- Darstellung auffordern -- scheinen verlegen überraschen lassen wider Gewohnheit bitten -- 
  zeigen unentschlossen -- lassen Wahl -- bitten Improvisator Gegenstand -- Klavier spielend Gehilfe -- abgereden -- Flügel setzen -- Trauermarsch spielen Anfing auffordert -- Artemisia geben -- vortrefflich einstudiern -- 
  lassen erbitten -- kurz Abwesenheit erscheinen -- zärtlich traurig Ton Totenmarsche -- Gestalt königlich Witwe -- gemessen Schritt -- Aschenkrug hertragend -- 
  bringen schwarz Tafel golden Reißfeder zugeschnitzt Stück Kreide -- 
  Verehrer Adjutant -- Ohr -- sogleich Architekt auffordern -- nötigen gewissermaßen herbeizuschieben -- Baumeister Grab Mausolus zeichnen -- keineswegs Statist -- ernstlich Mitspielende vorstellen -- 
  verleg Architekt äußerlich erscheinen -- 
  schwarz knapp modern Zivilgestalt wunderlich Kontrast Flör -- Kreppe -- Franse -- Schmelze -- Quast Krone -- fassen innerlich -- wunderlich ansehen -- 
  groß Ernst stellen Tafel -- paar Pag halten -- zeichnen Bedacht Genauigkeit Grabmal -- eher langobardisch karisch König gemäß -- schön Verhältnis -- ernst Teil -- geistreich Zierat -- Vergnügen entstehen fertig bewunderten -- 
  Zeitraum fast Königin wenden -- Geschäft Aufmerksamkeit widmen -- 
  neigen andeuten -- Befehl vollziehen glauben -- halten Urne -- bezeichnen verlangen -- Gipfel abbilden sehen -- 
  -- obgleich ungern -- Charakter übrig Entwurf passen -- 
  Luciane betreffen -- Ungeduld erlösen -- 
  Absicht keineswegs gewissenhaft Zeichnung -- 
  weniger Striche hinskizziern -- Monument ähnlich sehen -- übrige abgeben -- Endzweck Wunsch gemäßer -- 
  Benehme groß Verlegenheit -- 
  Schmerz -- Anordnung Andeutung -- Beifall Entstehende -- ziemlich abzuwechseln suchen einigemal beinahe herumzerren -- Art Verhältnis -- erweisen Steif -- dergestalt allzuoft Zuflucht Urne nehmen -- Herz drücken Himmel schauen müssen -- zuletzt -- dergleich Situation steigern -- Witwe Ephesus Königin Karien ähnlich -- 
  Vorstellung ziehen Länge -- Klavierspieler -- Geduld -- wissen Ton ausweichen -- 
  danken Gott Urne Pyramide stehen fallen unwillkürlich -- Königin ausdrücken -- lustig Thema -- wodurch Vorstellung Charakter verlieren -- Gesellschaft völlig aufgeheiteren -- sogleich teilen -- Dame vortrefflich Ausdruck -- Architekt künstlich zierlich Zeichnung freudig Bewunderung beweisen -- 
  Bräutigam unterhalten Architekt -- 
  tun leid -- -- Zeichnung vergänglich -- 
  erlauben -- Zimmer bringen lassen unterhalten -- 
  Vergnügen -- Architekt -- sorgfältig Zeichnung dergleich Gebäude Monument vorlegen -- wovon zufällig flüchtig Entwurf -- 
  Ottilie stehen fern treten -- 
  Versäume -- Architekt -- Herr Baron gelegentlich Sammlung sehen lassen -- 
  Freund Kunst Altertum -- wünschen nah kennen lernen -- 
  Luciane herbeigefahren fragen -- 
  wovon Rede -- 
  Sammlung Kunstwerk -- antworten Baron -- Herr besitzen gelegentlich zeigen -- 
  bringen -- rufen Luciane -- 
  -- bringen -- setzen schmeichelnd hinzu -- Hand freundlich anfaßte -- 
  Zeitpunkt -- versetzt Architekt -- 
  -- rufen Luciane gebieterisch -- Befehl Königin gehorch -- 
  legen neckisch Bitte -- 
  eigensinnig -- Ottilie halb leise -- 
  Architekt entfernt Beugung -- weder bejahend verneinend -- 
  fort -- Luciane Windspiel Saale herumjagen -- 
  -- rufen -- zufällig Mutter stoßen -- unglücklich -- 
  Affe mitnehmen -- abgeraten -- Bequemlichkeit Leute -- Vergnügen bringen -- 
  nachkommen lassen -- holen -- 
  Bildnis sehen -- vergnügen -- 
  gewiß malen lassen Seite -- 
  tröst -- versetzt Charlotte -- Bibliothek Band wunderlichsen Affenbild lassen -- 
  Luciane schreien Freude laut -- Folioband bringen -- 
  Anblick menschenähnlich Künstler vermenschlicht abscheulich Geschöpf Luciane groß Freude -- 
  glücklich fühlen -- Tier Ähnlichkeit bekannt Mensch finden -- 
  Sieht Onkel -- rufen unbarmherzig -- Galanteriehändler M-- -- Pfarrer S-- Ding -- -- leibhaftig -- 
  Grund Affe eigentlich Incroyabl unbegreiflich -- Gesellschaft ausschließen -- 
  Gesellschaft -- übel -- 
  gewohnen Anmut viele erlauben -- zuletzt Unart erlauben -- 
  Ottilie unterhalten indessen Bräutigam -- 
  hoffen Rückkunft Architekt -- ernster -- geschmackvoller Sammlung Gesellschaft Affenwese befreien -- 
  Erwartung Baron besprechen aufmerksam -- 
  Architekt bleiben -- wiederkommen -- verlieren Gesellschaft -- bringen -- Frage -- 
  Ottilie Augenblick -- man_es nennen -- 
  -- verdrießlich -- ungehaln -- betreffen -- Wort wenden -- gönnt Bräutigam vergnügt Stunde Sinn -- unendlich Liebe lucian Betrag leiden scheinen -- 
  Affe müssen Kollation Platz -- 
  Gesellige Spiel -- sogar Tänze -- zuletzt freudelos Herumsitzen Wiederaufjage gesunken Lust dauern diesmal -- -- Mitternacht -- 
  Luciane gewöhnen -- Morgen Bette Abends Bett gelangen -- 
  finden Ottilie Tagebuch Ereignis selten anmerken -- häufig Leben bezüglich Leben abgezogen Maxime Sentenze -- 
  meister Reflexion entstehen -- wahrscheinlich -- Heft mitteilen -- gemütlich -- ausschreiben -- 
  inniger Bezug rot Fade erkennen -- 
  Ottilies Tagebuche -- 
  -- blicken Zukunft -- ungefähre bewegen -- still Wunsch unser Gunst heranleiten möchten -- -- 
  -- befinden Gesellschaft -- denken -- Zufall -- zusammenbringen -- sollen Freund herbeiführen -- -- 
  -- eingezogen leben -- ehe sich_es versiehen -- Schuldner Gläubiger -- -- 
  -- Begegnet schuldig -- fallen -- 
  begegnen -- schuldig -- denken -- -- 
  -- mitteilen Natur -- Mitgeteiltes aufnehmen geben -- Bildung -- -- 
  -- Gesellschaft sprechen -- bewußt -- mißverstehen -- -- 
  -- verändern fremd Rede wiederholen -- verstehen -- -- 
  -- sprechen -- Zuhörer schmeicheln -- erregen Widerwillen -- -- 
  -- jeder ausgesprochen Wort erregen Gegensinn -- -- 
  -- Widerspruch Schmeichelei schlecht Gespräch -- -- 
  -- angenehmst Gesellschaft -- heit Ehrerbietung Glied obwalten -- -- 
  -- bezeichnen Mensch Charakter lächerlich finden -- -- 
  -- lächerliche entspringen sittlich Kontrast -- -- unschädlich Weise -- Sinn Verbindung bringen -- -- 
  -- sinnlich Mensch lachen lachen -- 
  anregen -- innerer Behag Vorschein -- -- 
  -- Verständige finden fast lächerlich -- Vernünftig fast -- -- 
  -- bejahrt Manne verdacht -- jung Frauenzimmer bemühen -- 
  einzig -- versetzen -- verjüngen -- -- 
  -- lassen Mangel vorhalten -- lassen strafen -- leiden Wille Geduld -- ungeduldig -- ablegen -- -- 
  -- Gewiß Mangel notwendig Einzeln -- 
  unangenehm -- alt Freund gewiß Eigenheit ablegten -- -- 
  -- -- 
  sterben -- Art Weise tun -- -- 
  -- Mangel behalten -- kultivieren -- 
  eher schmeicheln verletzen -- -- 
  -- Leidenschaft Mangel Tugende -- gesteigeren -- -- 
  -- Leidenschaft wahr Phönix -- 
  alt verbrennt -- steigen sogleich Asche hervor -- -- 
  -- Leidenschaft Krankheit Hoffnung -- 
  heil -- gefährlich -- -- 
  -- Leidenschaft erhöhen mildern durch Bekennen -- 
  Mittelstraß wünschenswert Vertrauen Verschweige lieben -- -- 
  Kapitel -- 
  peitscht Luciane Lebensrausch gesellig Strudel -- 
  Hofstaat vermehren täglich -- teils treiben anregen Anzog -- teils Gefälligkeit wohltun verbinden wissen -- 
  Mitteilend hoch Grade -- 
  Neigung Tante Bräutigam Schön Köstliches zufließen -- scheinen besitzen -- Wert Ding kennen -- häufen -- 
  zaudert Augenblick kostbaren Schal abzunehm Frauenzimmer umzuhängen -- übrig ärmlich kleiden scheinen -- neckisch -- geschickt Weise -- Gabe ablehnen -- 
  Hofstaat stets Börse Auftrag -- Ort einkehrten -- Ältesten Kränkst erkundigen -- Zustand Augenblick erleichtern -- 
  entstehen Gegend Name Vortrefflichkeit -- manchmal unbequem -- allzuviel lästig Notleidend heranziehen -- 
  vermehrt Ruf -- auffallend beharrlich Benehmen unglücklich jung Mann -- Gesellschaft fliehen -- -- schön wohlgebilden -- Hand -- obgleich rühmlich -- Schlacht verlieren -- 
  Verstümmlung erregt Mißmut -- verdrießlich -- Bekanntschaft Unfall -- verstecken -- Lesen Studie ergeben allemal Gesellschaft schaffen -- 
  jung Mann bleiben verbergen -- 
  müssen herbei -- Gesellschaft -- groß -- groß -- 
  benehmen anmutig -- wissen zudringlich Dienstfertigkeit Verlust wert -- geschäftig ersetzen -- 
  Tafel müssen Platz nehmen -- schneiden -- Gabel gebrauchen -- 
  Name alte -- Vornehmere Nachbarschaft weg -- erstreckt Aufmerksamkeit Tafel -- eilend Bedienten müssen ersetzen Entfernung rauben drohen -- 
  zuletzt muntert -- linker Hand schreiben -- 
  müssen Versuch richten -- stehen -- entfernt nah -- Verhältnis -- 
  jung Mann wissen -- fing Augenblick neu Leben -- 
  denken -- Betragen Bräutigam mißfällig -- finden Gegenteil -- 
  rechnet Bemühung groß Verdienst -- ruhig -- fast übertrieben Eigenheit kennen -- wodurch mindest verfänglich scheinen -- ablehnen wissen -- 
  Belieben umspringen -- Gefahr -- anstoßen -- zerren necken -- gleich erlauben -- Willkür berühren -- entferntest Sinn -- Freiheit -- erwidern -- halten streng Grenze Sittlichkeit -- Augenblick übertreten scheinen -- 
  glauben -- Maxime -- Lobe Tadel -- Neigung Abneigung gleichmäßig aussetzen -- 
  Mensch mancherlei Weise gewinnen suchen -- verdarb gewöhnlich bös Zunge -- schonen -- 
  Besuch Nachbarschaft ablegen -- nirgends Gesellschaft Schlössern Wohnung freundlich aufnehmen -- Rückkehr ausgelassenste merken lassen -- menschlich Verhältnis lächerlich Seite nehmen neigen -- 
  Bruder -- lauter Kompliment -- heiraten -- Alter übereilen -- jung Frau alt Manne -- umgekehrt munter Mann unbehilflich Riesin -- 
  Haus stolpert Schritt Kind -- groß Gesellschaft voll erscheinen -- Kind gegenwärtig -- 
  alt Gatten schnell begraben lassen -- Haus lachen kommen -- Noterben geben -- 
  jung Eheleute reisen -- Haushalt kleide -- 
  Person -- Sache -- Gebäude -- Haus- Tischgerät -- 
  Wandverzierung reizten lustig Bemerkung -- 
  alt Hautelißteppich neust Papiertapete -- ehrwürdigst Familienbilde frivolsn Kupferstich -- eins müssen leiden -- eins spöttisch Bemerkung gleichsam aufzehren -- verwundern -- Meile umher existieren -- 
  eigentlich Bosheit verneinend Bestrebe -- selbstisch Mutwille gewöhnlich anreizen -- 
  wahrhaft Bitterkeit Verhältnis Ottilie erzeugen -- 
  ruhig ununterbrochen Tätigkeit lieb Kind -- bemerken preisen -- Verachtung herab -- Sprache -- Ottilie Garten Treibhäuser annehmen -- spotten -- -- uneingedenk tief Winter leben -- verwundern scheinen -- weder Blume Frucht gewahr -- lassen Grüne -- Zweig keimt -- herbeihol täglich Zierde Zimmer Tisch verschwenden -- Ottilie Gärtner kränken -- Hoffnung nächster lang zerstören sehen -- 
  gönnt Ottilie Ruhe häuslich Gang -- worin Bequemlichkeit fortbewegen -- 
  Ottilie Lust Schlittenfahrten -- bälle Nachbarschaft veranstalten -- weder Schnee Kälte gewaltsam Nachtstürme scheuen -- soviel stürben -- 
  zart Kind leiden -- Luciane gewinnen -- 
  obgleich Ottilie einfach kleiden -- -- scheinen Mann schön -- 
  sanft anziehen versammelt Mann -- Raum letzter Platz befinden -- Bräutigam Lucianes unterhalten -- -- Angelegenheit beschäftigen -- Rat -- Mitwirkung verlangen -- 
  Architekt nah kennen lernen -- Gelegenheit Kunstsammlung Geschichtlich sprechen -- Fall -- Betrachtung Kapelle -- Talent schätzen lernen -- 
  Baron jung -- reich -- sammelt -- bauen -- Liebhaberei lebhaft -- Kenntnis schwach -- glauben Architekt Mann finden -- Zweck erreichen -- 
  Braut Absicht sprechen -- loben höchlich Vorschlag zufrieden -- -- jung Mann Ottilie entziehen -- 
  glaubt Neigung bemerken -- denken -- Talent Absicht benutzen -- 
  extemporiert Fest tätig erweisen Ressource Anstalt dargeboten -- glauben verstehen -- Erfindung gewöhnlich gemein -- reichen -- auszuführ -- Geschicklichkeit gewandt Kammerdiener -- vorzüglichst Künstler -- 
  Altar -- worauf opfern -- Bekränzung -- gypfern lebend Haupt -- Einbildungskraft versteigen -- Geburt Ehrentage festlich Kompliment gedachen -- 
  Ottilie Bräutigam -- Verhältnis Architekt Haus erkundigen -- gut Auskunft geben -- 
  wissen Charlotte Stelle umgetan -- 
  Gesellschaft kommen -- jung Mann Vollendung Kapelle entfernen -- Bau Winter stillstehen müssen -- erwünscht -- geschickt Künstler Gönner nutzen befördern -- 
  persönlich Verhältnis Ottilies Architekt rein unbefangen -- 
  angenehm tätig Gegenwart -- Nähe alt Bruder -- unterhalten erfreut -- 
  Empfindung bleiben ruhig Leidenschaftslose oberfläch Blutsverwandtschaft -- 
  Herz Raum -- Liebe Eduard drängen ausgefüllt -- Gottheit -- durchdringen -- Herz besitzen -- 
  indessen tief Winter senken -- wilder Wetter -- unzugänglich Weg -- desto anziehend scheinen -- Gesellschaft abnehmenden zuzubringen -- 
  kurz Ebb überflutet Menge Haus -- 
  Offizier entfernter Garnisone -- gebildet Vorteil -- roheren Unbequemlichkeit Gesellschaft -- ziehen herbei -- Zivilstand fehlen -- unerwartet kommen Tag Graf Baronesse anfahren -- 
  Gegenwart scheinen wahr Hof bilden -- 
  Mann Stand Sitte umgaben Grafe -- Frau lassen Baronesse Gerechtigkeit widerfahren -- 
  verwunderen -- heit sehen -- 
  vernehmen -- Grafe Gemahlin sterben -- Verbindung schließen sobald Schicklichkeit erlauben -- 
  Ottilie erinnern Besuch -- jeder Wort Ehestand Scheidung -- Verbindung Trennung -- Hoffnung -- Erwartung -- Entbehr Entsag sprechen -- 
  Person -- Aussicht -- stehen -- gehofft Glück nahe -- unwillkürlich Seufzer drang Herz -- 
  Luciane hören -- Graf Liebhaber Musik -- wissen Konzert veranstalten -- Gesang Gitarre hören lassen -- 
  geschehen -- 
  Instrument spielen ungeschickt -- Stimme angenehm -- Wort betreffen -- verstehen deutsch schön Gitarre singen -- 
  Indes versichern -- Ausdruck singen -- lauten Beifall zufrieden -- 
  wunderlich Unglück begegnen Gelegenheit -- 
  Gesellschaft befinden Dichter -- verbinden hoffen -- Lied richten wünschen -- Abend meist Lieder vortragen -- 
  -- -- höflich -- erwarten -- 
  legen einigemal nahe -- vernehmen -- Ungeduld Hofleute schicken sondieren lassen -- entzücken -- vortrefflich Gedicht vortrefflich vortragen hören -- 
  Gedicht -- versetzt erstaunen -- 
  verzeihen -- Herr -- fügen hinzu -- 
  vokale gehören -- 
  unterdessen Schuldigkeit liebenswürdig Intention dankbar erweisen -- 
  Hofmann schweigen verschweigen -- 
  suchen wohltönend Komplimente Sache ziehen -- 
  lassen Absicht undeutlich merken -- eigens gedichtetes besitzen -- 
  allzu unfreundlich -- Alphabet überreich -- beliebig Lobgedicht vorkommend Melodie einzubilden -- 
  Kränkung Begebenheit scheiden -- 
  kurze erfahren -- 
  selbigen Abend Ottilies Lieblingsmelodien allerliebst Gedicht untergelegen -- verbindlich -- 
  Luciane -- Mensch Art -- durcheinander misch Vorteilhaft nachteilig -- Glück Rezitieren versuchen -- 
  Gedächtnis -- aufrichtig reden -- Vortrag geistlos heftig leidenschaftlich -- 
  rezitiert Balladen -- Erzählung Deklamatorin vorzukommen pflegen -- 
  unglücklich Gewohnheit annehmen -- vortrug Geste begleiten -- wodurch eigentlich episch lyrisch -- unangenehm Weise Dramatischen verwirrt verbinden -- 
  Graf -- einsichtsvoll Mann -- Gesellschaft -- Neigung -- Leidenschaft Unterhaltung übersehen -- bringen Luciane -- glücklich unglücklich Weise -- Art Darstellung -- Persönlichkeit gemäß -- 
  finden -- -- wohlgestaltet Person -- gewiß fehlen -- malerisch Bewegung Stellung nachzuahmen -- 
  versuchen -- wirklich bekannt Gemäld vorstellen -- 
  Nachbildung -- mühsam Anordnung erfordern -- bringen unglaublich Reiz hervor -- 
  schnell Luciane gewahr -- Fach -- 
  schön Wuch -- voll Gestalt -- regelmäßig bedeutend Gesicht -- lichtbraun Haarflecht -- schlank Hals -- auf Gemälde berechnen -- wissen -- schön Aussah still Stand bewegt -- letzter Fall manchmal störend Ungraziöses entschlüpft -- mehrer Eifer natürlich Bildnerei ergeben -- 
  suchen Kupferstiche berühmt Gemälde -- wählen Belisar van Dyk -- 
  wohlgebaut Mann gewiß sitzend blind General -- Architekt teilnehmend traurig stehend Krieger nachbild -- ähnlich -- 
  Luciane -- halb bescheiden -- jung Weibch Hintergrunde wählen -- reichlich Almose Beutel flach Hand zählen -- indes alt abzumahn vorstellen scheinen -- tun -- 
  Almosen reichend Frauensperson vergessen -- 
  Bild beschäftigen ernstlich -- 
  Graf Architekt Art Einrichtung Winke -- sogleich Theater aufstellt Beleuchtung nötig Sorge tragen -- 
  tief Anstalt verwickeln -- bemerken -- Unternehmen ansehnlich Aufwand verlangen -- Land mitten Winter Erfordernis abgehen -- 
  lassen -- stocken mögen -- Lucian beinahe sämtlicher Garderobe zerschneiden -- verschieden Kostüm liefern -- Künstler willkürlich angeben -- 
  Abend herbei Darstellung Gesellschaft allgemein Beifall ausführen -- 
  bedeutend Musik spannt Erwartung -- 
  Belisar eröffnen Bühne -- 
  Gestalt passend -- Farbe glücklich ausgeteilt -- Beleuchtung kunstreich -- fürwahr Welt glauben -- Gegenwart Wirklich Schein Art ängstlich Empfindung hervorbrachen -- 
  Vorhang fallen -- verlangen aufziehen -- 
  musikalisch Zwischenspiel unterhalten Gesellschaft -- Bild hoch Art überraschen -- 
  bekannt Vorstellung Poussin -- Ahasverus Esther -- 
  diesmal Luciane bedenken -- 
  entwickelt ohnmächtig hingesunken Königin Reiz -- klug Weise umgebend unterstützend Mädchen laut hübsch wohlgebildet Figur aussuchen -- worunter mindest messen -- 
  Ottilie bleiben Bild übrig ausschließen -- 
  golden Thron -- Zeus gleich König vorstellen -- rüstig schön Mann Gesellschaft wählen -- Bild unvergleichlich Vollkommenheit gewinnen -- 
  sogenannter väterlich Ermahnung Terburg wählen -- kennen herrlichen Kupferstich unseres Wille Gemälde -- 
  Fuß schlagen -- sitzen edl ritterlich Vater scheinen stehend Tochter Gewissen reden -- 
  -- herrlich Gestalt -- faltenreich weiß Atlaskleide -- hinten sehen -- Wesen scheinen Anzudeut -- zusammennimmen -- 
  Ermahnung heftig beschämend -- sehen Miene Gebärde Vater -- Mutter betreffen -- scheinen Verlegenheit verbergen -- Glas Wein blicken -- auszuschlürf Begriff -- 
  Gelegenheit Luciane hoch Glanze erscheinen -- 
  Zöpfe -- Form Kopfe -- Hals Nacken -- Begriff schön -- Taille -- modern antikisierend Bekleidung Frauenzimmer sichtbar -- höchst zierlich -- Schlank zeigen alt Kostüm äußerst vorteilhaft -- Architekt sorgen -- reich Falte weiß Atlass künstlichst Natur legen -- Frage lebendig Nachbildung Originalbildnis hinausreicht allgemein Entzück erregen -- 
  Wiedererlang endigen -- natürlich Wunsch -- schön Wesen -- genügsam Rückseite sehen -- Angesicht schauen -- dergestalt überhand -- lustig ungeduldig Vogel Wort -- manchmal Seite schreiben pflegen -- tournez S' il vous Plait laut ausrief allgemein Beistimmung erregen -- 
  Darstellende kennen Vorteil -- Sinn Kunststücke fassen -- Ruf nachgeben -- 
  beschämt scheinend Tochter bleiben ruhig stehen -- Zuschauer Ausdruck angesichts gönnen -- Vater bleiben ermahnend Stellung sitzen -- Mutter bringen Nase Auge durchsichtigen Glase -- worin -- trinken scheinen -- Wein verminderen -- 
  -- Nachstück sagen -- wozu niederländisch Wirthshaus Jahrmarktsscene wählen -- 
  Graf Baronesse reisen versprach glücklich Woche nah Verbindung wiederzukehren -- Charlotte hoffen nunmehr -- mühsam überstanden Monat -- übrig Gesellschaft gleichfalls -- 
  Glück Tochter gewiß -- Braut- Jugendtaumel legen -- 
  Bräutigam halten glücklichst Mensch Welt -- 
  groß Vermögen gemäßigt Sinnesart scheinen wunderbar Weise vorzuge schmeicheln -- Frauenzimmer besitzen -- Welt fallen müssen -- 
  Sinn -- beziehen -- unangenehm Empfindung -- Neuankommend Aufmerksamkeit richten -- -- gut Eigenschaft alt Person geschehen -- nah Verbindung suchen sonderlich bekümmern -- 
  Architekt Richtigkeit -- 
  auf Neujahr folgen Karneval Stadt zubringen -- Luciane Wiederholung schön eingerichtet Gemälde -- hundert Ding -- groß Glückseligkeit versprechen -- Tante Bräutigam Aufwand gering scheinen -- Vergnügen erfordern -- 
  scheid -- gewöhnlich Weise geschehen -- 
  scherzen ziemlich laut -- Charlotte Wintervorrat aufzehren -- Ehrenmann -- Belisar vorstellen -- freilich reich -- Lucian Vorzüg hingerissen -- huldigen -- unbedachtsam ausrufen -- 
  lassen polnisch Art halten -- 
  zehren -- Runde herum -- 
  -- tun -- 
  Luciane schlagen -- 
  gepacken Schwarm werfen anderer Besitztum -- 
  Raum -- Bequemlichkeit Einrichtung -- 
  entstehen Unschickliche -- Luciane glücklich -- 
  Leben wüster wild -- 
  Treibjag tiefst Schnee -- unbequem auffinden -- veranstalten -- 
  Frau Mann ausschließen -- ziehen -- jagend reitend -- schlittenfahrend lärmend -- -- Residenz nähern -- Nachricht Erzählung -- Hof Stadt vergnügen -- Einbildungskraft Wendung geben -- Luciane sämtlichen Begleitung -- Tant vorausgehen -- unaufhaltsam Lebenskreis hineinzogen -- 
  Ottilies Tagebuche -- 
  -- nehmen Welt wofür -- geben -- 
  ertragen Unbequemen Unbedeutende dulden -- -- 
  -- Gesellschaft aufdringen -- Folge -- -- 
  -- lernen Mensch kennen -- -- -- erfahren stehen -- -- 
  -- finden beinahe -- Besuchende mancherlei aussetzen -- sogleich weg -- liebevollsen urteilen -- 
  sagen -- unser Maßstabe messen -- 
  verständig billig Mensch enthalt Fall scharf Zensur -- -- 
  -- Umgebung -- Gewohnheit -- notwendig unausweichlich Zustand sehen -- wirken -- fügen -- gehören Unverstand bös Wille -- lächerlich finden -- Sinn ehrwürdig scheinen müssen -- -- 
  -- Betrag Sitte nennen -- erreichen -- Gewalt -- Gewalt erreichen -- -- 
  -- Umgang Frau Element Sitte -- -- 
  -- Charakter -- Eigentümlichkeit Mensch -- Lebensart bestehen -- 
  -- Eigentümliche müssen Lebensart hervorheben -- 
  Bedeutende -- unbequem -- -- 
  -- groß Vorteil Leben Gesellschaft gebildet Soldat -- -- 
  -- Rohe Kriegsleute Charakter -- meist Stärke Gutmütigkeit verbergen liegen -- Notfall auskommen -- -- 
  -- lästig täppisch Mensch Zivilstand -- 
  Feinheit fordern -- Rohem beschäftigen -- -- 
  -- Mensch leben -- zart Gefühl Schicklich -- Angst ihretwillen -- Ungeschicktes begegnen -- 
  fühlen Charlotte -- Stuhle schaukelen -- Tod leiden -- -- 
  -- kommen Brille Nase vertraulich Gemach -- wissen -- Frau sogleich Lust vergehen ansehen unterhalten -- -- 
  -- Zutraulichkeit Stelle Ehrfurcht lächerlich -- 
  Hut ablegen -- Kompliment -- wissen -- komisch aussehen -- -- 
  -- äußere Zeichen Höflichkeit tief sittlich Grund -- 
  Erziehung -- Zeichen Grund überlieferen -- -- 
  -- Betrag Spiegel -- Bild zeigen -- -- 
  -- Höflichkeit Herzens -- Liebe verwanden -- 
  entspringen bequem Höflichkeit äußerer Betragen -- -- 
  -- Freiwillige Abhängigkeit schön Zustand Liebe -- -- 
  -- entfernt unser Wunsch -- einbild Gewünscht besitzen -- -- 
  -- Sklave frei halten -- -- 
  -- frei erklären -- fühlen Augenblick bedingt -- 
  Wagt bedingt erklären -- fühlen frei -- -- 
  -- Vorzug Rettungsmittel Liebe -- -- 
  -- schrecklich vorzüglich Mann -- Dummen -- -- 
  -- -- -- Kammerdiener Held -- 
  bloß -- Held Held anerkennen -- 
  Kammerdiener wahrscheinlich Gleichen schätzen wissen -- -- 
  -- groß Trost Mittelmäßigkeit Genie unsterblich -- -- 
  -- groß Mensch hängen Jahrhundert Schwachheit -- -- 
  -- halten Mensch gewöhnlich gefährlich -- -- 
  -- Toren gescheit Leute unschädlich -- 
  Halbnarre Halbweise -- gefährlichsen -- -- 
  -- weichen Welt sicher Kunst -- verknüpfen sicher Kunst -- -- 
  -- Augenblick hoch Glück hoch Not bedürfen Künstler -- -- 
  -- Kunst beschäftigen Schwer Gute -- -- 
  -- schwierige behandeln sehen anschauen Unmöglich -- -- 
  -- Schwierigkeit wachsen nah Ziel -- -- 
  -- Säen beschwerlich ernten -- -- 
  Kapitel -- 
  Unruhe Charlotte Besuch erwuchs -- vergüten -- Tochter völlig begreifen lernen -- worin Bekanntschaft Welt Hilfe -- 
  erstenmal -- seltsam Charakter begegnen -- niemals Höhe erscheinen -- 
  Erfahrung -- Person durch Leben -- mancherlei Ereignis -- elterlich Verhältnis bilden angenehm liebenswürdig reife erlangen -- Selbstigkeit gemildern schwärmend Tätigkeit entschieden Richtung erhalten -- 
  Charlotte lassen Mutter desto eher unangenehm Erscheinung fallen -- Eltern geziemt hoffen -- Fremd genießen wünschen -- belästigen -- 
  unerwartet Weise Charlotte Tochter Abreise treffen -- sowohl Tadelnswert Betrag -- lobenswürdig finden -- übel Nachrede lassen -- 
  Luciane scheinen Gesetz -- Fröhliche fröhlich -- Traurig traurig -- Geist Widerspruchs üben -- manchmal Fröhliche verdrießlich Traurig heit -- 
  Familie hinkommen -- erkundigt kranke schwache -- Gesellschaft erscheinen -- 
  besucht Zimmer -- Arzt drang Reiseapotheke -- beständig Wagen führen -- energischen -- Kur -- vermuten lassen -- gelingen Misslang -- Zufall herbeiführen -- 
  Art Wohltätigkeit grausam lassen einreden -- fest überzeugen -- vortrefflich handeln -- 
  Mißriet Versuch sittlich Seite -- -- Charlotte schaffen -- Folge -- sprechen -- 
  Lucian Abreise hören -- Ottilie -- Partie mitmachen -- müssen umständlich Rechenschaft geben -- 
  Tochter angesehen Haus Unglück -- Tod jung geschwister schuld -- Beruhige finden -- 
  lebt Zimmer beschäftigen still -- ertrug Anblick Ihrig einzeln kommen -- 
  argwohnen sogleich -- mehrere Beisamm -- untereinand Zustand reflektieren -- 
  jeder äußern vernünftig unterhalten stundenlang -- 
  Luciane gehören sogleich stille vornehmen -- Haus kommen -- gleichsam Wunder Frauenzimmer Gesellschaft wiedergeben -- 
  betragen Vorsichtiger -- wissen Seelenkranke einführen -- soviel merken -- Musik Vertrauen gewinnen -- 
  zuletzt versehen -- 
  Aufsehen erregen -- bringen schön Blasse Kind -- vorbereiten wähnen -- Abends plötzlich bunt glänzend Gesellschaft -- gelingen -- Sozietät -- Neugierde Apprehension -- ungeschickt benommen -- kranke versammeln -- gemied -- Flüster -- Kopf zusammenstecken Irre aufgeregt -- 
  zart Empfindende ertragen -- 
  entwich fürchterlich Schreie -- gleichsam entsetzen eindringend Ungeheure ausdrücken scheinen -- 
  Erschreckt fahren Gesellschaft Seite auseinander -- Ottilie -- völlig Ohnmächtige Zimmer begleiten -- 
  indessen Luciane stark Strafrede Weise Gesellschaft halten -- mindest denken -- Schuld -- anderer Mißling treiben abhalten lassen -- 
  Zustand Deck kranke bedenklich -- Übel steigern -- Eltern arm Kind Haus behalten -- öffentlich Anstalt überantworten müssen -- 
  Charlotte bleiben übrig besonderer zart Benehmen Familie Tochter verursacht Schmerz einigermaßen lindern -- 
  Ottilie Sache tief Eindruck -- bedauern arm Mädchen überzeugen -- Charlotte leugnen -- konsequent Behandlung kranke gewiß herstellen -- 
  -- gewöhnlich unangenehmen angenehmen unterhalten -- Mißverständnis Sprache -- Ottilie Architekt irr -- Abend Sammlung vorzeigen -- freundlich ersuchen -- 
  abschlägig Betrag Seele bleiben wissen -- 
  Empfindung -- 
  Mädchen Ottilie verlangen -- Jüngling Architekt versagen -- 
  bringen gelegentlich leise Vorwurf ziemlich gültig Entschuldigung Sprache -- 
  wüßten -- -- roh gebildet Mensch schätzbarst Kunstwerk verhalten -- verzeih -- meinig Menge bringen -- 
  wissen Medaille Rand anzufassen -- betasten schön Geprag -- reinsten Grund -- lassen köstlich Stück Daumen Zeigefinger hergehen -- Kunstformen Weise prüfen -- 
  denken -- Blatt Hand anfassen müssen -- greifen Hand unschätzbar Kupferstich -- unersetzlich Zeichnung -- anmaßlich Politiker Zeitung fassen Zerknittern Papier Voraus Urteil Weltbegebenheite erkennen -- 
  denken -- Mensch Kunstwerk hintereinander verführen -- Einundzwanzigste sehen -- 
  manchmal -- fragt Ottilie -- Verlegenheit setzen -- etwan Schatz -- ahnden -- gelegentlich beschädigen -- 
  niemals -- versetzt Architekt -- niemals -- 
  unmöglich -- Schicklich gebären -- 
  Fall -- versetzen Ottilie -- übel -- künftig Büchlein gut Sitte -- Kapitel -- Gesellschaft essen Trinke benehmen -- umständlich Einschöbe -- Kunstsammlung Museum betragen -- 
  gewiß -- versetzt Architekt -- alsdann Kustode Liebhaber Seltenheit fröhlich mitteilen -- 
  Ottilie verzeihen -- Vorwurf Herz nehmen scheinen auf beteuert -- gewiß gerne mitteil -- Freund tätig -- Empfand -- zart Gemüt verletzen -- fühlt Schuldnerin -- 
  bitte abschlagen -- Gefolge Gespräch -- -- schnell Gefühl Rate ziehen -- einsah Wunsch gewähren können -- 
  Sache verhieln -- 
  Ottilie Luciane Eifersucht Gemäldedarstellunge ausschließen -- höchst empfindlich -- Charlotte glänzend gesellig Unterhaltung unterbrechen beiwohnen -- befinden -- gleichfalls bedauern bemerken -- 
  entfernen -- Dankbarkeit beweisen -- Ehre Unterhaltung -- schönere Darstellung veranstalten Bisherig -- 
  hierzu -- unbewußt -- anderer geheim Antrieb -- 
  schwer -- Haus -- Familie verlassen -- scheinen unmöglich ottilies Auge scheiden -- ruhig freundlich gewogen Blick letzter fast leben -- 
  Weihnachtsfeiertage nahn klar -- eigentlich Gemäldedarstellunge rund Figur sogenannter Praesepe ausgehen -- fromm Vorstellung -- heilig göttlich Mutter Kind widmen -- scheinbaren Niedrigkeit Hirt Könige verehren -- 
  Möglichkeit Bild vollkommen vergegenwärtigen -- 
  schön frisch Knabe finden -- Hirt Hirtinn fehlen -- Ottilie Sache ausführen -- 
  jung Mann Sinn Mutter Gott erheben -- abschlagen -- Frage -- Unternehmen fallen müssen -- 
  Ottilie halb verleg Antrag weisen Bitte Charlotte -- 
  erteilt Erlaubnis -- Scheu Ottilies -- heilig Gestalt anzumaßen -- freundlich Weise überwinden -- 
  Architekt arbeitet Nacht -- Weihnachtsabend fehlen mögen -- 
  Nacht eigentlich Sinn -- 
  ohnehin Bedürfnis -- Ottilies Gegenwart scheinen Labsals -- ihretwillen arbeiten -- kein schlafs -- beschäftigen -- Speis bedürfen -- 
  feierlich Abendstunde fertig bereit -- 
  wohltönend Blasinstrumente versammeln -- Einleitung machen gewünscht Stimmung hervorzubringen wissen -- 
  Vorhang heben -- Charlotte überraschen -- 
  Bild vorstellen -- Welt wiederholen -- Eindruck erwarten -- 
  Wirklichkeit Bild besonderer Vorzug -- 
  Raum eher nächtlich dämmernd -- undeutlich einzeln Umgebung -- 
  unübertrefflich Gedanke -- Licht Kind ausgehen -- Künstler klug Mechanismus Beleuchtung ausführen wissen -- beschattet -- streiflichtern erleuchtet Figur Vordergrunde zudecken -- 
  froh Mädchen Knabe stehen umher -- frisch Gesicht scharf unten beleuchten -- 
  Engel fehlen -- Schein göttlichen verdunkeln -- ätherisch Leib göttlich-menschlichen verdichten lichtsbedürftig scheinen -- 
  glücklicherweise Kind anmutigst Stellung eingeschlafen -- Betrachtung stören -- Blick scheinbaren Mutter verweilen -- unendlich Anmut Schleier aufheben -- verborgen Schatz offenbaren -- 
  Augenblick scheinen Bild festhalten erstarren -- 
  physisch blenden -- geistig überraschen -- scheinen umgebend Volk bewegen -- getroffen Auge wegzuwenden -- neugierig erfreut hinzublinz Verwunderung Lust -- Bewunderung Verehrung anzeigen -- obgleich vergessen alt Figur Ausdruck übertragen -- 
  Ottilies Gestalt -- Gebärde -- Miene -- Blick übertreffen Maler darstellen -- 
  gefühlvoll Kenner -- Erscheinung sehen -- Furcht geraten -- mögen bewegen -- Sorge gestehen -- jemals gefallen können -- 
  Unglücklicherweise -- Wirkung aufzufassen vermocht -- 
  Architekt -- lang schlank Hirte Seite Knieende hereinsehen -- -- obgleich genauest Standpunkt -- groß Genuß -- 
  beschreiben Mien neugeschaffen Himmelskönigin -- 
  rein Demut -- liebenswürdigste Gefühl Bescheidenheit unverdient erhalten Ehre -- unbegreiflich unermeßlich Glück -- bilden Züg -- sowohl Empfindung -- Vorstellung ausdrücken -- spielen -- 
  Charlotte erfreute schön Gebilde -- wirken hauptsächlich Kind -- 
  Auge strömt Träne stellen lebhaftester -- ähnlich lieb Geschöpf Schoße hoffen -- 
  Vorhang niederlassen -- teils Vorstellend Erleichterung geben -- teils Veränderung Dargestellt anzubringen -- 
  Künstler vornehmen -- Nacht Niedrigkeitsbild Tag- Glorienbild verwandeln -- Seite unmäßig Erleuchtung vorbereiten -- Zwischenzeit anzünden -- 
  Ottilie halb theatralisch Lage groß Beruhigung -- Charlotte weniger Hausgenoss fromm Kunstmummerei zusehen -- 
  einigermaßen betreffen -- Zwischenzeit vernehmen -- Fremder ankommen -- saal Charlotte freundlich begrüßen -- 
  -- sagen -- 
  ergeben darein -- Störung verursachen -- 
  Licht Lampe brannen unendlich Hellung umgeben -- 
  Vorhang -- Zuschauend überraschend Anblick -- Bild Licht -- völlig aufgehoben Schatten bleiben Farbe übrig -- klug Auswahl lieblich Mäßigung hervorbrachten -- 
  lang Augenwimper hervorblickend bemerken Ottilie Mannsperson Charlotte sitzend -- 
  erkennen -- glauben Stimme Gehilfe Pension hören -- 
  wunderbar Empfindung ergreifen -- 
  viele begegnen -- Stimme treu Lehrer vernehmen -- 
  zackig Blitz fahren Reihe Freude Leid schnell Seele vorbei regt Frage -- bekennen gestehen -- 
  wert heilig Gestalt erscheinen -- seltsam vorkommen -- sehen -- Maske erblicken -- 
  Schnelligkeit kein gleich -- wirken Gefühl Betrachtung gegeneinander -- 
  Herz befangen -- Auge füllt Träne -- zwingen Immerfort starres Bild erscheinen -- froh -- Knabe regen Anfing -- Künstler nötigen Zeichen geben -- Vorhang fallen -- 
  peinlich Gefühl -- werten Freund entgegeneilen -- letzter Augenblick übrig Empfindung Ottilies gesellt -- groß Verlegenheit -- 
  fremd Anzug Schmuck entgegengehen -- umkleid -- 
  wählen -- letzter sucht Zwischenzeit zusammennehmen -- beruhigen -- Einstimmung gewohnt Kleide Angekommen begrüßen -- 
  Kapitel -- 
  insofern Architekt Gönnerinn gute wünschen -- angenehm -- scheiden müssen -- gut Gesellschaft schätzbaren Gehilfe wissen -- Gunst beziehen -- Empfand einigermaßen schmerzhaft -- sobald -- Bescheidenheit dünken -- -- vollkommen -- ersetzen sehen -- 
  zaudern -- drängen hinweg -- 
  Entfernung müssen gefallen lassen -- gegenwärtig erleben -- 
  Erheiterung halb traurig Gefühl machen Dame Abschiede Geschenk Weste -- stricken sehen -- still Neid unbekannt Glückliche dereinst -- 
  Gabe angenehmsen liebend -- verehrend Mann erhalten -- 
  unermüdet Spiel schön Finger gedenken -- umhin schmeicheln -- Herz anhaltend Arbeit Teilnahme bleiben -- 
  Frau Mann bewiren -- wohlwollten -- 
  weiblich Geschlecht hegen innerer unwandelbar Interesse -- Welt abtrünnig -- äußerer gesellig Verhältnis hingegen lassen Mann bestimmen beschäftigen -- Abweisen Empfänglichkeit -- Beharr Nachgiebigkeit fahren eigentlich Regiment -- gesittet Welt Mann entziehen wagen -- 
  Architekt -- gleichsam Lust Belieben -- Talent Freundin vergnügen Zweck üben beweisen -- Beschäftigung Unterhaltung Sinn Absicht einrichten -- 
  kurz Gegenwart gehilf Lebensweise -- 
  Gabe -- sprechen menschlich Verhältnis -- Bezug Bildung Jugend -- Unterredung behandeln -- 
  entstehen bisherig Art leben ziemlich fühlbar Gegensatz -- Gehilfe dasjenig billigen -- womit ausschließlich beschäftigen -- 
  lebendig Gemälde Ankunft empfangen -- sprechen -- 
  hingegen Kirche -- Kapelle beziehen -- Zufriedenheit sehen lassen -- Meinung -- Gesinnung zurückhalten -- 
  betreffen -- -- Annäherung -- Vermischung heilig Sinnliche keineswegs fallen -- fallen -- gewiß besonderer Raum widmen -- Weihet aufschmückt -- Gefühl Frömmigkeit hegen unterhalten -- 
  Umgebung -- gemein -- Gefühl Göttlichen stören -- überall begleiten Stätte Tempel einweihen -- 
  Hausgottesdienst saale halten sehen -- speisen -- gesellig versammeln -- Spiel Tanz ergötzen pflegen -- 
  Höchste -- Vorzüglichste Mensch gestaltlos -- Hüten Edler gestalten -- 
  Charlotte -- Gesinnung kennen kurz erforschen -- bringen Fache Tätigkeit -- Gartenknabe -- Architekt Abreise mustern -- Saal aufmarschieren lassen -- heiter reinlich Uniform -- gesetzlich Bewegung natürlichen lebhaft Wesen -- ausnahmen -- 
  Gehilfe prüfen Weise -- mancherlei Frage Wendung gemütsarter Fähigkeit Kind bringen -- scheinen -- Stunde -- bedeutend unterrichten fördern -- 
  -- Charlotte -- Knabe wegzogen -- 
  aufmerksam zuhören -- bekannt Ding vorkommen -- wissen -- anfangen -- kurz -- Hin- Widerreden -- Folge Sprache bringen -- 
  -- versetzt Gehilfe -- Vorteilen Handwerk Geheimnis -- 
  einfach Maxime verbergen -- leisten vermögen -- 
  Fassen Gegenstand -- Materie -- Begriff -- nennen -- halten fest -- Teil deutlich -- -- Gesprächsweis -- Maß Kind erfahren entwickeln -- anzuregen -- überliefern -- 
  Antwort Frage ungehörig -- Weite -- sodann Gegenfrage Geist Sinn hereinwärts ziehen -- Standpunkt verrücken lassen -- Kind zuletzt denken -- begreifen -- überzeugen -- Lehrende -- 
  groß Fehler -- Lernende Weite reißen lassen -- Punkt festhalten wissen behandeln -- 
  nächstens Versuch Unterhaltung dienen -- 
  artig -- Charlotte -- Pädagogik umgekehrt gut Lebensart -- 
  Gesellschaft verweilen -- Unterricht hoch Gebot -- Zerstreuung arbeiten -- 
  Abwechslung Zerstreuung Lehre Leben schön Wahlspruch -- löblich Gleichgewicht erhalten -- Gehilfe -- fortfahr Charlotte aufrufen -- Knabe nochmals betrachten -- munter Zug Hof bewegen -- 
  bezeigt Zufriedenheit -- Kind Uniform anhalten -- 
  Mann -- -- Jugend Uniform tragen -- gewöhnen handeln -- Gleich verlieren -- Maß gehorch arbeiten -- 
  befördern Art Uniform militärisch Sinn -- knapper stracker Betragen -- Knabe ohnehin geboren Soldat -- 
  sehen Kampf Streitspiel -- Erstürmen Erkletter -- 
  tadeln -- versetzen Ottilie -- Mädchen überein Kleide -- 
  vorführen -- hoff bunt Gemisch ergötzen -- 
  billigen -- versetzen -- 
  Frau mannigfaltig kleiden -- Art Weise -- fühlen lernen -- eigentlich stehen zieme -- 
  wichtig Ursache -- 
  bestimmen -- Leben stehen handeln -- 
  scheinen paradox -- versetzen Charlotte -- fast niemals -- O -- versetzt Gehilfe -- Absicht Frau gewiß -- 
  betrachten Frauenzimmer Liebende -- Braut -- Frau -- Hausfrau Mutter -- stehen isolieren -- -- -- 
  Eitle Falle -- 
  Frau schließen -- Natur -- 
  fordern -- Geschlecht leisten obliegen -- 
  verhalten Mann -- 
  Mann verlangen Mann -- erschaffen -- geben -- Frau Ewigkeit leben -- denken -- Gleich hervorzubringen -- 
  -- Charlotte -- wahr wunderlich sagen -- scheinen zuletzt Wunderliche -- 
  Bemerkung gute herausnehmen Frau Frau zusammenhaln -- gemeinsam wirken -- Mann allzu Vorzug einräumen -- 
  Schadenfreude übel nehmen -- künftig desto lebhaft empfinden -- Herr untereinander sonderlich vertragen -- 
  vieler Sorgfalt untersuchen verständig Mann nunmehr Art -- Ottilie Zöglinge behandeln -- bezeigen entschieden Beifall -- 
  heben -- -- untergebene nächster Brauchbarkeit heran -- 
  Reinlichkeit veranlassen Kind Freude halten -- gewinnen -- -- Munterkeit Selbstgefühl leisten anregen -- 
  finden Befriedigung Schein außen tun -- innen unerläßlich Bedürfnis -- 
  Wort -- rufen -- lassen Erziehungsgeschäft aussprechen -- Ohr hören -- 
  versuchen -- freundlich Ottilie -- 
  -- versetzen -- verraten -- 
  erziehen Knabe Diener Mädchen Mütter -- überall stehen -- 
  Mütter -- versetzen Ottilie -- können Frau hingehen lassen -- -- Mutter -- einrichten -- Wärterinne -- freilich Dienern jung Mann halten -- ansehen -- Gebiet fähig dünken -- 
  verschweigen -- Gehilfe -- 
  schmeicheln Leben hinein -- Leben schmeicheln -- 
  Mensch freiwillig zugestehen -- -- 
  Lasse Betrachtung -- berühren -- 
  Preis glücklich -- Zögling richtig Verfahren anwenden -- 
  klein Mädchen Puppe herumtrag Läppch zusammenflicken -- alt Geschwister Alsdann jung sorgen -- Haus bedienen aufhilfen -- 
  Schritt Leben -- Mädchen finden Gatten -- Eltern verlassen -- 
  gebildet Ständen Aufgabe verwickeln -- 
  hoch -- zart -- fein -- gesellschaftlich Verhältnis Rücksicht nehmen -- 
  Zöglinge außen bilden -- notwendig -- unerläßlich -- Maß überschriten -- 
  Kind Kreis bilden gedenken -- treiben Grenzenlose -- Auge behalten eigentlich innerer Natur fordern -- 
  liegen Aufgabe -- Erzieher lösen verfehlen -- 
  womit Schülerin Pension ausstatten -- bang -- Erfahrung -- gering Gebrauch künftig -- 
  abgestreifen -- Vergessenheit überantworten sobald Frauenzimmer stand Hausfrau -- Mutter befinden -- 
  indessen fromm Wunsch versagen -- Geschäft widmen -- dereinst Gesellschaft treu Gehilfin gelingen mögen -- Zögling dasjenig rein ausbilden bedürfen -- Feld Tätigkeit Selbständigkeit hinüberschreiten -- sagen -- 
  Sinn Erziehung vollenden -- 
  freilich schließen -- beinahe unser Leben -- -- Umstand veranlassen -- 
  finden Ottilie Bemerkung -- 
  ungeahnt Leidenschaft erziehen -- 
  Prüfung schweben -- auf nächster -- auf nächst künftig hinblickte -- 
  jung Mann Vorbedacht -- Gehilfin -- Gattin erwähnen -- Bescheidenheit unterlassen -- Absicht entfernt Weise andeuten -- mancherlei Umstand Vorfall aufgeregen -- Besuch Schritt Ziel nah -- 
  Vorsteherin Pension -- Mitarbeiter Mitarbeiterinn Person umgesehen -- eigentlich Gesellschaft träten -- zuletzt Gehilfe -- vertrauen höchlich Ursache -- Antrag tun -- 
  sollen Lehranstalt fortführen -- Seinig mitwirken -- Tod Erbe einzig Besitzer eintreten -- 
  Hauptsache scheinen hierbei -- einstimmend Gattin finden müssen -- 
  still Ottilie Auge Herz -- regten mancherlei Zweifel -- günstig Ereignis Gegengewicht erhalten -- 
  Luciane Pension verlassen -- 
  Ottilie frei zurückkehren -- Verhältnis Eduard verlauten -- Sache -- ähnlich Vorfall -- gleichgültig -- Ereignis Ottilies Rückkehr beitragen -- 
  Entschluß kommen -- Schritt geschehen -- unvermutet Besuch besonderer Anregung geben -- 
  Erscheinung bedeutend Mensch Kreis niemals Folge bleiben -- 
  Graf Baronesse -- Fall kommen -- Wert verschieden Pension befragen -- fast Erziehung Kind verlegen -- vornehmen -- kennen lernen -- -- nunmehr Verhältnis Untersuchung anstellen -- 
  Baronesse beabsichtigen anderer -- 
  letzter Aufenthalt Charlotte umständlich durchgesproch Eduard Ottilie beziehen -- 
  bestehen abermals -- 
  Ottilie müssen entfernt -- 
  suchen Charlotte hierzu Mut einsprechen -- Eduard Drohung fürchten -- 
  sprechen verschieden Ausweg -- Gelegenheit Pension Neigung Gehilfe Rede -- Baronesse entschließen gedacht Besuch -- 
  -- lernen Gehilfe kennen -- beobachten Anstalt sprechen Ottilie -- 
  Graf unterhalten -- neulich Besuch genau kennen lernen -- 
  nähern -- anziehen -- gehaltvoll Gespräch dasjenig sehen kennen glauben -- unbekannt bleiben -- 
  Umgang Eduard Welt vergessen -- scheinen Gegenwart graf Welt wünschenswert -- 
  Anziehung wechselseitig -- 
  Graf empfinden Neigung Ottilie -- Tochter betrachten -- 
  Baronesse zweitenmal erstemal Weg -- 
  wissen -- Zeit lebhafter Leidenschaft -- angestiftet -- -- Verheiratung Ehefrau unschädlich -- 
  regen Gehilfe leise wirksam Art klüglich -- Exkursion Schloß einrichten Plan Wunsch -- Dame Geheimnis -- ungesäumt nähern sollen -- 
  vollkommen Beistimmung Vorsteherin treten Reise -- hegen Gemüt Hoffnung -- 
  wissen -- Ottilie ungünstig -- Mißverhältni Stand -- glich Denkart -- 
  Baronesse fühlen lassen -- Ottilie arm Mädchen bleiben -- 
  reich Haus verwanden -- heißen -- helfen -- 
  -- groß Vermögen -- Gewissen -- denjenig ansehnlich Summe entziehen -- nah Grade vollkommener Besitztum scheinen -- 
  gewiß bleiben wunderbar -- Mensch Vorrecht -- Tod disponieren -- selten Gunst Lieblinge brauchen -- scheinen -- Achtung Herkommen -- begünstigen -- Vermögen besitzen -- Wille -- 
  Gefühl setzen Reise Ottilie völlig -- 
  Aufnahme erhöht Hoffnung -- 
  finden Ottilie -- erwachsen -- gebildet -- Mitteilender -- 
  Vertraulich lassen Einsicht nehmen -- Fach beziehen -- 
  Zweck nähern -- halten gewiß innerer Scheu -- 
  einst Charlotte hierzu Gelegenheit -- Beisein ottilies -- -- 
  -- Kreis heranwächst -- ziemlich prüfen -- finden Ottilie -- 
  Gegenwart aussprechen -- 
  Gehilfe bezeichnen hierauf -- Einsicht ruhig Ausdruck -- Ottilie Absicht freieren Betragen -- bequemeren Mitteilung -- hoch Blick weltlich Ding -- Handlung Wort betätigen -- Vorteil verändern finden -- glauben -- können Nutzen gereichen -- Pension zurückkehr -- gewiß Folge gründlich zuzueignen -- Welt stückweise eher Verwirrung Befriedigung -- manchmal allzuspät überlieferen -- 
  wollen weitläufig -- Ottilie wissen zusammenhängend Lehrvorträgen herausgerissen -- 
  Ottilie leugnen -- gestehen -- Wort empfinden -- auszulegen wissen -- 
  scheinen Welt unzusammenhängend -- geliebt Mann denken -- begreifen -- zusammenhängen können -- 
  Charlotte beantwortet Antrag klug Freundlichkeit -- 
  -- sowohl Ottilie Rückkehr Pension längst wünschen -- 
  Gegenwart lieben Freundin Helferin unentbehrlich -- wollen Folge hinderlich -- Ottilies Wunsch bleiben -- dorthin zurückkehren -- Angefangene enden Unterbrochene vollständig zueignen -- 
  Gehilfe Anerbietung freudig -- Ottilie dürfen sagen -- Gedanke schauderen -- 
  Charlotte hingegen dachen gewinnen -- hoffen Eduard glücklich Vater finden einfinden -- -- überzeugen -- geben Ottilie Weise sorgen -- 
  bedeutend Gespräch -- Teilnehmende nachdenken -- pflegen gewiß Stillstand eintreten -- Verlegenheit ähnlich sehen -- 
  saal -- Gehilfe blättert Bücher Folioband -- Luciane Zeit liegen bleiben -- 
  -- Affe enthalten -- schlagen -- 
  Vorfall Gespräch Anlaß geben -- wovon Spur Ottilies Tagebuch finden -- 
  Ottilies Tagebuche -- 
  -- Herz bringen -- garstig Affen sorgfältig abzubilden -- 
  erniedrigen -- Tier betrachten -- bösartig -- Reiz folgen -- bekannt Mensch Maske aufsuchen -- -- 
  -- gehören gewiß Verschrobenheit -- Karikatur Zerrbilder abgeben -- 
  Unserem gut Gehilfe danken ich_es -- Naturgeschicht quälen -- 
  Würm Kaf niemals befreunden -- -- 
  -- diesmal gestehen -- gehen -- 
  Natur -- -- kennen -- unmittelbar lebendig umgiben -- 
  Bäumen blühen -- grün -- Frucht tragen -- Staude vorbeigehen -- Grashalm hinwandeln -- wahres Verhältnis -- echt Kompatriot -- 
  Vogel unser Zweig hüpfen -- unser Laube singen -- gehören -- sprechen -- Jugend -- lernen Sprache verstehen -- 
  Frage -- jeder fremd -- Umgebung gerissen Geschöpf gewiß ängstlich Eindruck -- Gewohnheit abstumpfen -- 
  gehören buntes geräuschvoll Leben -- Affe -- Papagei Mohr ertragen -- -- 
  -- manchmal neugierig verlangen abenteuerlich Ding anwandeln -- reisend beneiden -- Wunder Wunder lebendig alltäglich Verbindung sehen -- 
  anderer Mensch -- 
  wandeln ungestraft Palme -- Gesinnung ändern gewiß Land Elefant Tiger Haus -- -- 
  -- naturforscher verehrungswern -- Fremdest -- Seltsamst -- Lokalität -- Nachbarschaft -- jedesmal eigenst Element schildern darzustellen wissen -- 
  Humboldt erzählen hören -- -- 
  -- Naturalien-Kabinett vorkommen ägyptisch Grabstätt -- verschieden Thier Pflanzengötz balsamieren umherstehen -- 
  Priester-Kaste geziemt -- geheimnisvoll Halbdunkel abgeben -- Unterricht dergleichen einfließen -- -- Näheres Würdigeres verdrängen sehen -- -- 
  -- Lehrer -- Gefühl einzig gut -- einzig gut Gedicht erwecken -- leisten Reihe untergeordnet Naturbildungen Gestalt Name überliefern -- 
  Resultat -- ohnedies wissen -- Menschengebild vorzüglichsn einzigst Gleichnis Gottheit tragen -- -- 
  -- einzeln bleiben Freiheit beschäftigen -- anziehen -- Freude -- nützlich deuchen -- eigentlich Studium Menschheit Mensch -- -- 
  Kapitel -- 
  Mensch -- Nächstvergangen beschäftigen wissen -- 
  gegenwärtig halten Gewalt -- verlier Vergangenheit suchen völlig verlorener -- -- Hervorzurufen herstellen -- 
  reich Familie -- Vorfahr viele schuldig -- pflegen -- Großvater Vater gedenken -- 
  Betrachtung Gehilfe auffordern -- schön -- scheidend Winter Frühling lügen pflegen -- alt Schloßgarten gehen hoch Lindenallee -- regelmäßig Anlage -- Eduard Vater herschrieben -- bewundern -- 
  vortrefflich gedeihen -- Sinn desjenigen pflanzen -- -- anerkennen nossen -- sprechen -- besucht Liebhaberei Aufwand Seite frei Weite richten -- 
  Rückkehr Charlotte Bemerkung -- ungünstig aufnehmen -- 
  Leben fortziehen -- versetzen -- glauben handeln -- Tätigkeit -- Vergnügungen wählen -- freilich -- genau ansehen -- Plan -- Neigung -- auszuführ nötigen -- 
  gewiß -- Gehilfe -- widerstehen Strome Umgebung -- 
  rücken fort Gesinnung -- Meinung -- Vorurteil Liebhabereien -- 
  fallen Jugend Sohn Umwendung -- versichern -- Vater gemein -- 
  Periode leben -- Lust zuzueignen -- Eigentum sicheren -- beschränken -- einzueng Absonderung Welt Genuß befestigen -- Sodann Auszudehn suchen -- mitteil -- verbreit Verschlossene eröffnen -- 
  Zeitraum -- versetzen Charlotte -- gleich Vater Sohn -- schildern -- 
  Zuständen -- Stadt Mauer Gräben müssen -- Edelhof Sumpf baut -- gering Schlöss Zugbrücke zugänglich -- Begriff -- 
  sogar groß Stadt tragen Wäll -- Gräben fürstlich Schlösser ausgefüllt -- Stadt bilden Flecken -- Reise ansehen -- glauben -- allgemein Friede befestigen golden Zeitalter Türe -- 
  glauben Garten behaglich -- frei Land ähnlich sehen -- Kunst -- Zwang erinnern -- völlig frei unbedingt Atem schöpfen -- 
  Begriff -- Freund -- -- vorig Zustand zurückkehren können -- 
  -- versetzt Gehilfe -- Zustand Beschwerlichkeit -- beschränken sowohl Losgebundene -- 
  letzterer setzen Überfluß voraus führen Verschwendung -- 
  Lasse bleiben -- auffallend -- 
  sobald Mangel eintreten -- sogleich Selbstbeschränkung wiedergeben -- 
  Mensch Grund Boden nutzen nötigen -- führen Mauer Garten -- Erzeugnis sicher -- 
  entstehen Ansicht Ding -- 
  nützliche erhalten Oberhand Vielbesitzende meinen zuletzt nutzen -- 
  Glaube -- 
  -- Sohn sämtlichen Parkanlag vernachlässigen ernst Mauer hoch Linden Großvater zurückziehen -- 
  Charlotte stille erfreuen -- Sohn verkündigen hören -- verzieh Gehilfe unfreundlich Prophezeiung -- dereinst lieb schön Park ergehen können -- 
  versetzen freundlich -- 
  alt dergleich Widerspruch mehrmals erleben -- früh Jugend zurückdenken -- erinnern worüber alt Person klagen gehören -- Land Stadt Betrachtung aufnimmen -- 
  Bemerkung einwenden -- 
  Naturgang entgegensetzen -- Vater Sohn -- Eltern Kind Übereinstimmung bringen -- 
  freundlich Knabe weissagen -- müssen Vater Widerspruch stehen -- zerstören Eltern erbauen -- anstatt vollend erheben Sinn fortfährt -- 
  vernünftig -- versetzt Gehilfe -- Mensch selten anwenden -- 
  Vater erheben Sohn Mitbesitzer -- lassen mitbauen -- Pflanze -- erlauben -- -- unschädlich Willkür -- 
  Tätigkeit lassen verweben -- anstückeln -- 
  jung Zweig verbinden alt Stamm -- erwachsen Ast anzufügen -- 
  freut Gehilfe -- Augenblick Abschied nehmen nötigen -- Charlotte zufälligerweise angenehme Gunst auf befestigen -- 
  allzulang Haus weg -- Rückreise eher entschließen -- völlig Überzeugung -- müssen herannahend Epoche Charlotte Niederkunft vorbeigehen lassen -- bevor Ottilies Entscheidung hoffen können -- 
  fügen Umstand kehrt Aussicht Hoffnung Vorsteherin -- 
  Charlottes Niederkunft nahten heran -- 
  halten Zimmer -- 
  Frau -- versammeln -- geschlossen Gesellschaft -- 
  Ottilie besorgt Hauswese denken -- 
  völlig ergeben -- wünschen Charlotte -- Kind -- Eduard -- ferner dienstlich bemühen -- -- -- 
  völlig Verworrenheit retten -- Pflicht -- 
  Sohn glücklich Welt kommen -- Frau versicheren sämtlich -- leibhaft Vater -- 
  Ottilie stille finden -- Wöchnerin Glück wünscht Kind herzlichster begrüßen -- 
  Anstalt Verheiratung Tochter Charlotte Abwesenheit Gemahl höchst fühlbar -- Vater Geburt Sohnes gegenwärtig -- Name bestimmen -- künftig rufen -- 
  Freund glückwünschend sehen lassen -- Mittler -- Kundschafter ausstellen Ereignis sogleich Nachricht erhalten -- 
  finden behaglich -- 
  Triumph Gegenwart Ottilies verbergen -- sprechen Charlotte laut -- Mann Sorge heben augenblicklich Hindernis Seite bringen -- 
  Taufe aufschieben -- 
  alt geistliche -- Fuß Grabe -- Segen Zukünftig zusammenknüpfen -- Otto Kind heißen -- 
  Name führen Name Vater Freund -- 
  bedurft entschieden Zudringlichkeit Mann -- hunderterlei Bedenklichkeit -- Widerrede -- Zaudern -- Stocken -- Besser- Anderswissen -- Schwank -- -- Um Wiedermein beseitigen -- gewöhnlich Gelegenheit gehoben Bedenklichkeit entstehen -- Verhältnis schonen -- Fall eintreten -- verletzen -- 
  meldungsschreiben Gevatterbrief übernehmen Mittler -- ausgefertigt -- 
  höchlich liegen -- Glück Familie bedeutend halten -- übrig mißwollend mißredend Welt -- 
  freilich bisherig leidenschaftlich Vorfall Publikum entgehen -- ohnehin Überzeugung stehen -- geschehen -- geschehen -- reden -- 
  Feier Taufaktes würdig beschränken -- 
  -- Ottilie Mittler Kind Taufzeug halten -- 
  alt geistliche -- unterstützen Kirchdiener -- treten langsam Schritt heran -- 
  Gebet verrichten -- Ottilie Kind arme legen -- Neigung heruntersehen -- erschrak offen Auge -- 
  glauben sehen -- Übereinstimmung überraschen -- 
  Mittler -- Kind empfangen -- stutzen gleichfalls -- Bildung auffallend Ähnlichkeit -- Hauptmann erblicken -- dergleichen vorkommen -- 
  Schwäche gut alt geistliche hindern -- Taufhandlung mehrerem gewöhnlich Liturgie begleiten -- 
  Mittler indessen -- voll Gegenstand -- gedacht früh Amtsverrichtung Art -- sogleich Fall denken -- reden -- äußeren -- 
  diesmal zurückhalten -- Gesellschaft laut Freund -- umgeben -- 
  fing -- Akt -- Behaglichkeit Stelle geistliche versetzen -- munter Rede Patenpflicht Hoffnung äußeren verweilen -- Charlotte Beifall zufrieden Miene erkennen glauben -- 
  alt Mann setzen -- Entging rüstig Redner -- denken -- größ Übel hervorzubring Weg -- 
  Verhältnis anwesend kind Nachdruck geschildern Ottilies Fassung ziemlich Probe stellen -- wenden zuletzt Greis Wort -- 
  -- würdiger Altvater -- nunmehr Simeon sprechen -- 
  Herr laß dein Diener Frieden fahren -- Auge Heiland Haus sehen -- 
  Zug glänzend schließen -- bemerken -- alt -- Kind hinhieln -- neigen scheinen -- nachher schnell Zurücksank -- 
  Fall abhalten Sessel bringen müssen -- ungeachtet augenblicklich Beihilfe -- tot ansprechen -- 
  unmittelbar Geburt Tod -- Sarg Wieg sehen denken -- bloß Einbildungskraft -- Auge ungeheur Gegensatz zusammenzufassen -- Umstehenden schwer Aufgabe -- überraschender vorlegen -- 
  Ottilie betrachtet Eingeschlummert -- freundlich einnehmend Miene behalten -- Art Neid -- 
  Leben Seele töten -- Körper erhalten -- 
  führen Weise manchmal unerfreulich Begebenheit Tag Betrachtung Vergänglichkeit -- Scheiden -- Verlieren -- wundersam nächtlich Erscheinung Trost geben -- geliebter versicheren Befestigt belebten -- 
  Abends Ruhe legen -- süß Gefühl Schlaf Wachen schweben -- scheinen -- hell Mild erleuchtet Raum hineinblicken -- 
  Eduard deutlich kleiden sehen -- kriegerisch Anzug -- jedesmal Stellung -- vollkommen Phantastisch -- stehend -- gehend -- liegend -- reitend -- 
  Gestalt auf klein Ausgemalt bewegen willig -- minde -- Einbildungskraft anstrengen -- 
  manchmal umgeben -- Beweglich -- dunkel hell Grund -- unterschied Schattenbilder -- zuweilen Mensch -- Pferd -- Baum Gebirg vorkommen -- 
  gewöhnlich schliefr Erscheinung -- ruhig Nacht morgens erwachen -- erquicken -- trösten -- fühlen überzeugen -- 
  Eduard leben -- stehen innigst Verhältnis -- 
  Kapitel -- 
  Frühling kommen -- rasch freudig gewöhnlich -- 
  Ottilie finden Garten Frucht Vorsehen -- keimt -- grünt blüht -- angelegt Glashäuser Beete vorbereiten -- treten sogleich außen wirkend Natur entgegen -- besorgen -- bleiben bloß hoffnungsvoll Mühe -- heiter Genusse -- 
  Gärtner tröst Lucian Wildheit entstanden Lücke Topfgewächsen -- zerstören Symmetrie Baumkrone -- 
  Mut -- herstellen -- tief Gefühl -- rein Begriff Handwerk -- Trostgründe fruchn -- 
  Gärtner Liebhabereien Neigung zerstreuen -- ruhig Gang unterbrechen -- Pflanze dauernd vorübergehend Vollendung nehmen -- 
  Pflanze gleichen eigensinnig Mensch -- erhalten -- Art behandeln -- 
  ruhig Blick -- still Konsequenz -- Jahrszeit -- Stunde Gehörig -- Gärtner verlangen -- 
  Eigenschaft besitzen Mann hoch Grade -- Ottilie wirken -- eigentlich Talent Behaglichkeit ausüben -- 
  Baum- Küchengärtnerei betreffen -- Erfordernis alt Ziergarten -- vollkommen leisten verstehen -- gelingen -- Behandlung Orangerie -- Blumenzwiebel -- Nelke Aurikelenstöcke -- Natur herausfordern -- 
  Zierbaum Modeblume einigermaßen fremd bleiben -- unendlich Feld Botanik -- Auftat -- herumsummend fremd Name -- Art Scheu -- verdrießlich -- 
  Herrschaft vorig verschreiben anfangen -- halten unnütz Aufwand Verschwendung -- kostbar Pflanze ausgehen -- Handelsgärtner -- glauben -- redlich bedient -- sonderlich Verhältnis stehen -- 
  -- mancherlei Versuch -- Art Plan -- Ottilie bestärken -- Wiederkehr Eduard eigentlich gründen -- Abwesenheit Fall täglich nachteilig empfinden müssen -- 
  Pflanze Wurzel schlagen Zweig treiben -- fühlen Ottilie Raum fesseln -- 
  treten Fremdling -- unbedeutend Wesen -- erwerben -- 
  verlieren -- 
  reich arm -- 
  Gefühl beid wechseln augenblicklich -- durchkreuzen auf innig -- helfen wissen -- Nächste Anteil -- Leidenschaft ergreifen -- 
  Eduard leiben -- Sorgfalt stärksen ziehen -- lassen denken -- hoffen -- wiederkommen -- vorsorglich Dienstlichkeit -- Abwesende leisten -- dankbar gegenwärtig bemerken -- 
  Weise veranlassen wirken -- 
  vorzüglich Sorge Kind übernehmen -- unmittelbar Pflegerin -- Amme übergeben -- Milch Wasser aufzuziehen entscheiden -- 
  schön frei Luft genießen -- tragen liebsn heraus -- tragen schlafend unbewußt Blume Blüte -- dereinst Kindheit freundlich entgegen lach -- jung Sträucher Pflanze -- Höhe wachsen Jugend bestimmt scheinen -- 
  -- verbergen -- reichen Zustande Kind gebären -- 
  fast wohin Auge blicken -- dereinst gehören -- 
  wünschenswert -- Auge Vater -- Mutter -- aufwüchse erneut froh Verbindung bestätigen -- 
  Ottilie fühlen rein -- sich_es entscheiden denken Empfand -- 
  klar Himmel -- hell Sonnenschein -- klar -- Liebe -- vollenden -- völlig uneigennützig müssen -- Augenblick glaubt Höhe erreichen -- 
  wünschen Freund -- glauben fähig entsagen -- sogar niemals sehen -- glücklich wissen -- 
  entscheiden -- niemals anzugehören -- 
  Herbst herrlich Frühling -- sorgen -- 
  sogenannter Sommergewachs -- Herbst Blühen enden Kälte Keck entgegen entwickeln -- aster -- groß Mannigfaltigkeit gesäen überallhin verpflanzen -- Sternhimmel Erde bilden -- 
  Ottilies Tagebuche -- 
  -- gut Gedanke lesen -- Auffallende gehören -- tragen Tagebuch -- 
  Nähmen Mühe -- Brief Freund eigentümlich Bemerkung -- originell Ansicht -- flüchtig geistreich Wort auszuzeichnen -- reich -- 
  Brief heben -- lesen -- zerstören zuletzt Diskretion -- verschwinden schön unmittelbar Lebenshauch unwiederbringlich -- 
  nehmen -- Versäumnis -- -- 
  -- wiederholt abermals Jahresmärchen vorn -- 
  -- Gott -- artigst Kapitel -- 
  Veilchen Maiblumen Überschrift vignetten -- 
  angenehm Eindruck -- Buch Leben aufschlagen -- -- 
  -- schelt arme -- Unmündig -- Straße herumlegen betteln -- 
  Bemerke -- tätig -- sobald -- 
  entfalten Natur freundlich Schatz -- Kind da_hinterh Gewerbe eröffnen -- keiner betteln -- jeder reichen Strauß -- pflücken ehe Schlaf erwachtest -- Bittend sehen freundlich Gabe -- 
  sehen erbärmlich -- fühlen -- fordern -- -- 
  -- manchmal -- manchmal -- scheinen Erinnerung -- 
  -- nirgends auffallend Garten -- vergänglich dauernd greifen -- 
  flüchtig Spur -- Gleichen zurücklassen -- -- 
  -- lassen Winter fallen -- 
  glauben frei ausbreiten -- Baum geisterhaft -- durchsichtig stehen -- 
  -- decken -- 
  Knospe Blüte -- ungeduldig voll Laub hervortritt -- Landschaft verkörpern Baum Gestalt entgegen drängen -- -- 
  -- vollkommen Art Art hinausgehen -- anderer unvergleichbarer -- 
  Tönen Nachtigall Vogel -- steigen Klasse hinüber scheinen Gefiedert andeut -- eigentlich singen heißen -- -- 
  -- Leben Liebe -- Nähe geliebter -- Comédie -- Tiroir -- schlecht Schubladenstück -- 
  schieben heraus hinein eilen folgenden -- 
  bedeutendes vorkommen -- hängen kümmerlich -- 
  überall vorn anfangen überall enden -- -- 
  Kapitel -- 
  Charlotte Seite befinden Munter -- 
  freuen tüchtigen Knabe -- versprechend Gestalt Auge Gemüt stündlich beschäftigen -- 
  erhalten Bezug Welt Besitz -- 
  alt Tätigkeit regen -- erblicken -- hinsiehen -- viele tun empfinden Freude getaner -- 
  Gefühl beleben steigen Mooshütte Ottilie Kind -- Tisch -- häuslich Altar niederlegt -- Platz leer sehen -- gedenken vorig Zeit Hoffnung Ottilie dringen hervor -- 
  jung Frauenzimmer sehen bescheiden Jüngling -- still Prüfung -- Gatte wünschen -- Tochter weiblich Zögling sorgen -- schauen Kreis umher -- 
  Augenblick Charlotte -- Verbindung Hauptmann Ottilie unmöglich scheinen -- ehemals Hütte sitzen -- 
  unbekannt bleiben -- Aussicht vorteilhaft Heirat verschwinden -- 
  Charlotte steigen Ottilie tragen Kind -- 
  überlassen mancherlei Betrachtung -- 
  fest Land Schiffbruch -- schnellste erholen Herzustelle -- schön preiswürdig -- 
  Leben Gewinn Verlust berechnen -- 
  Anlage stören -- 
  schlagen Weg ableiten -- 
  scharf Auge gefaßt Ziel ablenken -- hoch erreichen -- 
  reisend brechen unterwegs hoch Verdruß Rad gelangen unangenehm Zufall erfreulichst Bekanntschaft Verbindung -- Leben Einfluß -- 
  Schicksal gewähren Wunsch -- Weise -- Wunsch geben -- 
  ähnlich Betrachtung -- Charlotte Gebäude Höhe gelangen -- vollkommen bestätigen -- 
  Umgebung schön denken -- 
  störend Kleinliche ring umh entfernen -- Landschaft -- Natur -- tun -- treten reinlich hervor fallen Auge -- grünt jung Pflanzung -- bestimmen -- Lücke ausfüllen abgesondert Teil angenehm verbinden -- 
  Haus nahezu bewohnbar -- Aussicht -- oberer Zimmer -- höchst mannigfaltig -- 
  lang umsehen -- desto Schönes entdecken -- 
  müssen verschieden Tagszeit -- Mond Sonne Wirkung hervorbringen -- 
  Verweil höchst wünschenswert -- schnell Lust bauen schaff Charlotte erwecken -- grob Arbeit tun finden -- 
  Tisch -- Tapezierer -- Maler -- Patron leicht Vergoldung helfen wissen -- bedürfen -- kurz Gebäude Stande -- 
  Keller Küche schnell einrichten -- 
  Entfernung Schlos müssen Bedürfnis versammeln -- 
  wohnen Frauenzimmer Kind -- Aufenthalt -- Mittelpunkt -- eröffnen unerwartet Spaziergäng -- 
  genießen vergnüglich hoch Region frei frisch Luft schönsn Wetter -- 
  Ottilies liebst Weg -- teils -- teils Kind -- herunter Platane bequem Fußsteig -- sodann Punkt leiten -- Kahn anbinden -- überzufahren pflegen -- 
  erfreute manchmal Wasserfahrt -- Kind -- Charlotte Besorgnis zeigen -- 
  verfehlen -- täglich Gärtner Schloßgarten besuchen Sorgfalt Pflanzenzögling -- frei Luft nossen -- freundlich nehmen -- 
  schön Charlotte Besuch Engländer liegen -- Eduard Reisen kennen lernen -- einigemal treffen nunmehr neugierig -- schön Anlage sehen -- erzählen hören -- 
  bringen Empfehlungsschreibe Grafe stellen still gefällig Mann Begleiter -- 
  Charlotte Ottilie -- Gärtnern Jäger -- öfter Begleiter -- manchmal Gegend durchstrich -- Bemerkung ansehen -- Liebhaber Kenner Anlage -- dergleichen ausführen -- 
  obgleich heit Weise -- Leben Zierde gereichen bedeutend -- 
  Gegenwart nossen Frauenzimmer vollkommen Umgebung -- 
  geübt Auge empfangen Effekt frisch -- so_mehr Freude Entstandene -- Gegend vorher -- tun -- Natur liefern -- unterscheiden wissen -- 
  sagen -- Bemerkung Park wachsen bereicheren -- 
  voraus erkennen -- heranstrebend Pflanzung versprechen -- 
  Stelle bleiben unbemerkt -- Schönheit hervorzuheben anzubringen -- 
  deutet Quelle -- reinigen -- Zierde Buschpartie versprechen -- Höhle -- ausräumen erweitern -- erwünscht Ruheplatz geben -- indessen Baum fällen braucht -- herrlich Felsenmasse aufgetürmt erblicken -- 
  wünschen Bewohner Glück -- nachzuarbeien übrig bleiben -- ersucht -- eilen -- folgend Vergnügen Schaffen Einrichten vorbehalten -- 
  gesellig Stunde keineswegs lästig -- 
  beschäftigen groß Tags -- malerisch Aussicht Park tragbar dunkel Kammer auffangen zeichnen -- Reise schön Frucht gewinnen -- 
  -- mehrere -- bedeutend Gegende tun angenehmst interessantest Sammlung verschaffen -- 
  Portefeuille führen -- zeigen Dame unterhieln -- teils Bild -- teils Auslegung -- 
  freuen -- Einsamkeit Welt bequem durchreis -- Ufer Hafen -- Berg -- See Fluß -- Stadt -- Kastelle Lokal -- Geschichte Name -- vorbeiziehen sehen -- 
  Frau besonderer Interesse -- Charlotte allgemeineren -- -- historisch merkwürdig finden -- Ottilie vorzüglich Gegenden aufhieln -- wovon Eduard erzählen pflegen -- verweilen -- wohin öfters zurückkehren -- 
  Mensch Nähe Ferne gewiß örtlich Einzelheit anziehen -- -- Charakter -- Eindruck -- gewiß Umstand -- Gewohnheit Wille -- leiben aufregend -- 
  fragt Lord -- gefalle -- Wohnung aufschlagen -- wählen -- 
  wissen schön Gegend vorzeigen -- widerfahren -- Lieb wert -- eigens akzentuiert französische behaglich mitteilen -- 
  Frage hingegen -- gewöhnlich aufhalen -- wohin lieb zurückkehren -- lassen unbewunden -- Frau unerwartet -- vernehmen -- 
  angewöhnen überall Haus finden zuletzt Bequemer -- bauen -- Pflanze häuslich bemühen -- 
  Besitzung sehn -- teils politisch Ursache -- vorzüglich Sohn -- eigentlich tun einrichten -- übergeben -- genießen hoffen -- nehmen -- Indien gehen -- Leben -- -- hoch nutzen -- vergeuden -- 
  gewiß vorarbeitend Aufwand auf Leben -- 
  anstatt anfinge mäßigen Zustand behaglich finden -- Breite -- unbequem -- 
  genießen Gebäude -- Park -- Garten -- 
  -- Meinig -- fremd Gast -- neugierige -- unruhig reisend -- 
  Mittel halb halb Haus -- Land -- Gewohnte Stadt fehlen -- 
  Buch eifrigsen wünschen -- Hand -- meister bedürften -- vergessen -- 
  richten häuslich -- auszuzieh -- Wille Willkür -- wirken Verhältnis -- Leidenschaft -- Zufall -- Notwendigkeit -- 
  Lord ahnden -- tief Betrachtung Freundin treffen -- 
  Gefahr -- allgemein Betrachtung Gesellschaft Verhältnis -- aussprechen -- 
  Charlotte zufällig Verletzung Wohlwollende Gutmeinende neue -- Welt liegen ohnehin deutlich Auge -- besonderer Schmerz empfinden -- unbedachtsam unvorsichtig nötigen -- Blick dorthin unerfreulich Stelle richten -- 
  Ottilie hingegen -- halbbewußt Jugend ahnden -- Blick wegwenden müssen sehen -- Ottilie traulich Rede schrecklichst Zustand versetzen -- 
  zerreißen Gewalt anmutig Schleier -- scheinen -- Haus Hof -- Garten -- Park Umgebung geschehen -- eigentlich umsonst -- gehören -- genössen -- -- gegenwärtig Gast -- herumschweifen Welt gefährlichsen -- Liebs Nächste drängen -- 
  hören schweigen gewöhnen -- sitzen diesmal peinlichst Lage -- Fremden Gespräch eher vermehrt vermindern -- heiter Eigenheit Bedächtigkeit fortsetzen -- 
  glauben -- -- Weg -- Immerfort reisend betrachten -- entsagen -- viele genießen -- 
  Wechsel gewöhnen -- Bedürfnis -- Oper Dekoration warten -- -- 
  schlechtesen Wirtshause versprechen -- -- schlimm -- nirgends find Gewohnte -- laufen Eins hinaus -- notwendig Gewohnheit -- willkürlichst Zufälligkeit abzuhangen -- 
  Verdruß -- verlegen verlieren -- täglich Wohnzimmer unbrauchbar -- reparieren lassen -- lieb Tasse zerbrichen schmecken -- 
  überhoben -- Haus Kopf brennen anfängen -- pack Leute lassen -- fahren Hofraum Stadt hinaus -- 
  Vorteil -- genau berechnen -- Jahr ausgeben -- Haus kosten -- 
  Schilderung Ottilie Eduard -- -- Entbehr Beschwerde -- ungebahnt Straße hinziehen -- Gefahr Not Felde liegen -- Unbestand Wagnis gewöhnen heimatlos freundlos -- wegzuwerfen verlieren -- 
  glücklicherweise trennt Gesellschaft -- 
  Ottilie finden Raum Einsamkeit auszuweinen -- 
  Gewaltsamer dumpf Schmerz ergreifen -- Klarheit -- klar streben -- pflegen -- peinigen -- Weg peinigen -- 
  Zustand Eduard kümmerlich -- jämmerlich -- entschließen -- kosten wollen -- Wiedervereinigung Charlotte beitragen -- Schmerz Liebe still Ort verbergen Art Tätigkeit betrügen -- 
  indessen Begleiter Lords -- verständig -- ruhig Mann Beobachter -- Mißgriff Unterhaltung bemerken Ähnlichkeit Zustand Freund offenbaren -- 
  wissen Verhältnissen Familie -- -- eigentlich Reise interessiert sonderbar Ereignis -- natürlich künstlich Verhältnis -- Konflikt gesetzlich Ungebändigt -- Verstand Vernunft -- Leidenschaft Vorurteil hervorbringen -- -- Haus -- vorgehen vorging -- 
  Lord leid -- verlegen -- 
  müssen Gesellschaft schweigen -- manchmal Fall -- 
  bedeutend Bemerkung -- trivialst Äußerung mißklingend Weise Interesse Gegenwärtig zusammentreffen -- 
  Abend -- Lord -- Gespräch enthalten -- 
  geb Gesellschaft angenehm bedeutend Anekdote Geschichte hören -- womit Portefeuille Gedächtni Reise bereichern -- 
  vorsatz gelingen Fremd -- Freund diesmal unverfänglich Unterhaltung erfreuen -- 
  Begleiter sonderbar -- bedeutend -- heit -- rührend -- furchtbar Geschichte Aufmerksamkeit erregen Teilnahme auf hoch gespannt -- denken sonderbaren -- sanft Begebenheit schließen -- ahndet -- nah Zuhörern verwanden -- 
  wunderlich Nachbarskinder -- 
  Novelle -- 
  Nachbarskinder bedeutend Haus -- Knabe Mädchen -- verhältnismäßig Alter -- dereinst Gatte -- lassen angenehmen Aussicht aufwachsen -- beiderseitig Eltern freuen künftig Verbindung -- 
  bemerken -- Absicht misslingen scheinen -- trefflich Natur sonderbar Widerwille hervortaen -- 
  ähnlich -- 
  gewenden -- deutlich -- fest Vorsätz -- jeder einzeln geliebt ehren Gespiel -- Widersacher -- aufbauend -- wechselsweise zerstörend begegnen -- wetteifernd Ziel -- kämpfend Zweck -- gutartig liebenswürdig -- Hassend -- bösartig -- beziehen -- 
  wunderlich Verhältnis zeigen kindisch Spiel -- zeigen zunehmenden -- 
  Knabe Krieg spielen -- Partei -- Schlacht liefern pflegen -- stellen trotzig mutig Mädchen einst Spitze Heer -- fochen Gewalt Erbitterung -- schimpflich Flucht schlagen -- einzeln Widersacher brav gehalt Gegnerin zuletzt entwaffnen Gefang nehmen -- 
  wehren gewaltsam -- -- Auge erhalten -- Feindin beschädigen -- seiden Halstuch abreißen Hand Rücken binden müssen -- 
  verzieh -- heimlich Anstalt Versuch beschädigen -- Eltern -- seltsam Leidenschaft längst -- verständigen beschließen -- feindlich Wesen trennen lieblich Hoffnung aufgeben -- 
  Knabe Verhältnissen hervor -- 
  Art Unterricht schlagen -- 
  Gönner Neigung bestimmt Soldatenstand -- 
  überall finden -- lieben ehren -- 
  tüchtig Natur scheinen Wohlsein -- Behag anderer wirken -- -- deutlich Bewußtsein -- glücklich -- einzig Widersacher verlieren -- Natur zugedenken -- 
  Mädchen treten verändert Zustand -- 
  -- zunehmend Bildung -- gewiß innerer Gefühl ziehen heftig Spiel hinweg -- Gesellschaft Knabe ausüben pflegen -- 
  scheinen fehlen -- herum -- wert -- Haß erregen -- 
  Liebenswürdig finden -- 
  jung Mann -- alt ehemalig nachbarlich Widersacher -- Stand -- Vermögen Bedeutung -- belieben Gesellschaft -- suchen Frau -- wendet Neigung -- 
  erstemal -- Freund -- Liebhaber -- Diener bemühen -- 
  Vorzug -- alt -- gebildet -- glänzend Anspruchsreicher -- -- 
  fortgesetzt Aufmerksamkeit -- zudringlich -- treu Beistand verschieden unangenehm Zufälle -- Eltern ausgesprochen -- ruhig hoffnungsvoll Werben -- freilich jung -- 
  -- wozu Gewohnheit -- äußerer Welt angenommen Verhältnis -- ihrig beitragen -- 
  Braut nennen -- halten -- weder denken -- Prüfung nötig -- Ring demjenigen wechseln -- Bräutigam gelten -- 
  ruhig Gang Sache nehmen -- Verlöbnis beschleunigen -- 
  lassen Seite fortgewähren -- freut Zusammenleben Jahreszeit Frühling künftig ernster Leben genießen -- 
  indessen entfernen schön ausbilden -- verdient Stufe Lebensbestimmung erstiegen -- Urlaub seinigen besuchen -- 
  natürlich sonderbar Weise stehen schön Nachbarin abermals entgegen -- 
  letzter freundlich -- bräutlich Familienempfindungen nähren -- umgeben Übereinstimmung -- glauben glücklich gewiß Weise -- 
  stehen erstenmal lang entgegen -- 
  hassenswern -- Hasses unfähig -- kindisch Haß -- eigentlich dunkl Anerkenn innerer Wert -- äußern froh erstaunen -- erfreulich Betrachte -- gefällig Eingesteh -- halb willig halb unwillig notwendig nahe -- wechselseitig -- 
  Entfernung lang Unterhaltung Anlaß -- 
  kindisch Unvernunft dienen aufgeklärteren scherzhaft Erinnerung -- neckisch Haß freundschaftlich aufmerksam Behandlung vergüten müssen -- gewaltsam Verkenn nunmehr ausgesprochen Anerkenn bleiben dürfen -- 
  Seite bleiben verständigen -- wünschensweren Maß -- 
  Stand -- Verhältnis -- Streben -- Ehrgeiz beschäftigen reichlich -- Freundlichkeit schön Braut dankenswert Zugabe Behaglichkeit aufnehmen -- Bezug betrachten -- Bräutigam mißgönnen -- Verhältnissen stehen -- 
  hingegen -- 
  scheinen Traum erwachen -- 
  Kampf jung Nachbar Leidenschaft -- heftig Kampf -- Form Widerstreben -- heftig gleichsam angeboren Neigung -- 
  Erinnerung -- gelieben -- 
  lächelen feindlich Such Waffe Hand -- angenehmst Gefühl erinnern -- entwaffnen -- bildet groß Seligkeit empfinden -- behen -- Schaden Verdruß unternehmen -- unschuldig -- Aufmerksamkeit ziehen -- 
  verwünscht Trennung -- bejammert Schlaf verfallen -- verfluchen schleppend -- träumerisch Gewohnheit -- unbedeutend Bräutigam -- verwandeln -- doppelt verwandeln -- vorwärts rückwärts nehmen -- 
  Empfindung -- geheim halten -- entwickeln teilen -- gescholten -- 
  freilich Bräutigam Vergleichung Nachbar aushalten -- sobald -- 
  gewisses zutrauen versagen -- erregt vollst Vertrauen -- Gesellschaft -- wünschen Gefährte -- denken hoch Teilnahme -- außerordentlich Fall -- 
  zweifeln -- vollkommen Gewißheit -- 
  Verhältnis Weiber besonderer Takt angeboren Ursache Gelegenheit ausbilden -- 
  Jemehr schön Braut Gesinnung heimlich nähren -- dasjenig auszusprech Fall -- Gunst Bräutigam gelten -- Verhältnis -- Pflicht anzurat gebiet -- unabänderlich Notwendigkeit unwiderruflich fordern scheinen -- desto begünstigt schön Herz Einseitigkeit -- Seite Welt Familie -- Bräutigam Zusage unauflöslich binden -- emporstrebend Jüngling Geheimnis Gesinnung -- Planen Aussicht -- treu zärtlich Bruder beweisen -- unmittelbar Abreise Rede -- scheinen kindisch Geist Tück Gewaltsamkeiten erwachen -- hoch Lebensstufe Unwille rüsten -- bedeutend verderblich wirken -- 
  beschloß sterben -- ehemals Gehaßt heftig geliebter Anteilnahme strafen -- besitzen -- Einbildungskraft -- Reue ewig vermählen -- 
  tot Bild loswerden -- aufhören Vorwurf -- Gesinnung erkennen -- erforschen -- schätzen -- 
  seltsam Wahnsinn begleiten überall -- 
  verbergen allerlei Form -- Mensch wunderlich vorkommen -- aufmerksam klug -- innerer wahr Ursache entdecken -- 
  indessen Freund -- verwandte -- bekannte Anordnung mancherlei Fest erschöpfen -- 
  verging -- neu unerwartetes anstellen -- 
  schön Platz Landschaft -- ausgeschmücken Empfang vieler froh Gast bereiten -- 
  jung Ankömmling Abreise Seinige -- laden jung Paar engeren Familienkreise Wasserlustfahrt -- 
  Bestieg schön wohlausgeschmückt Schiff -- Jacht Saal Zimmer anbiet Wasser Bequemlichkeit Land überzutragen suchen -- 
  fahren strom Musik -- Gesellschaft heiß Tageszeit unterer Raum versammeln -- Geistes- glücksspielen ergötzen -- 
  jung Wirt -- niemals untätig bleiben -- an Steuer setzen -- alt Schiffsmeister ablösen -- Seite eingeschlafen -- brauchte wachend Vorsicht -- Stelle nahen -- Insel Flußbette verengt flach Kiesufer -- Seite hereinstreckt -- gefährlich Fahrwasser zubereiteten -- 
  fast sorgsam scharfblickend Steurer Versuchung Meister wecken -- getraute fahren Enge -- 
  Augenblick erscheinen Verdeck schön Feindin Blumenkranz Haaren -- 
  werfen Steuernde -- 
  Nimm Andenken -- rufen -- 
  Störe -- rufen entgegen -- Kranz auffehen -- 
  bedürfen Kraft Aufmerksamkeit -- 
  stören -- rufen -- 
  siehst -- 
  sprach_es eilt Vorderteil Schiff -- Wasser springen -- 
  Stimme rufen -- retten -- retten -- ertrinkt -- 
  entsetzlichst Verlegenheit -- 
  Lärm erwachen alt Schiffsmeister -- Ruder ergreifen -- jung übergeben -- Herrschaft wechseln -- Schiff stranden -- Augenblick -- lästigsn Kleidungsstücke wegwerfend -- stürzt Wasser -- schwamm schön Feindin -- 
  Wasser freundlich Element behandeln wissen -- 
  tragen -- geschickt Schwimmer beherrschen -- 
  fortgerissen schön erreichen -- fassen -- wissen heben tragen -- Strom gewaltsam fortgeriss Insel -- Werder -- Fluß breit gemächlich fließen Anfing -- 
  ermannt -- erholt zudringend Not -- Besinnung mechanisch handeln -- blicken emporstrebendem Haupt umh rudert Vermögen flach buschig Stelle -- angenehm geleg Fluß verlaufen -- 
  bringen schön Beute auf Trockene -- Lebenshauch spüren -- 
  Verzweiflung -- betreten Pfad durch Gebüsch laufen -- Auge leuchten -- 
  Belud auf teuer Last -- erblicken einsam Wohnung erreichen -- 
  finden Leute -- jung Ehepaar -- 
  Unglück -- Not sprechen geschwind -- 
  Besinnung fordern -- leisten -- 
  lichtes Feuer brennen -- wollen Decke Lager breiten -- Pelz -- Fell Erwärmend vorrätig -- schnell herbeigetragen -- 
  Überwand Begierde rett Betrachtung -- 
  versäumen -- schön halbstarr nackt Körper Leben rufen -- 
  gelingen -- 
  schlagen Auge -- erblicken Freund -- umschlang Hals himmlisch arme -- 
  bleiben -- Tränenstrom stürzen Auge vollendet Genesung -- 
  verlassen -- rufen -- 
  wiederfinden -- 
  niemals -- rufen -- niemals -- wissen -- 
  Schone -- rufen hinzu -- Schone -- denken deinet- meinetwillen -- 
  denken bemerkt Zustand -- 
  Liebling -- Retter schämen -- entlassen -- sorgen mögen -- 
  umgeben -- naß triefend -- 
  jung Eheleute beredeten -- bieten Jüngling -- schöne Hochzeitkleid -- vollständig hing -- Paar Kopf Fuß innen heraus bekleiden -- 
  kurz Abenteurer angezogen putzen -- 
  sehen allerliebst -- staunen -- zusammentrat -- fallen unmäßig Leidenschaft -- halb lächelnd Vermummung -- gewaltsam Arm -- 
  Kraft Jugend Regsamkeit Liebe stellen weniger Augenblick völlig -- fehlt Musik Tanz auffordern -- 
  Wasser Erde -- Tod Leben -- Familienkreise Wildnis -- Verzweiflung Entzück -- Gleichgültigkeit Neigung -- Leidenschaft finden -- Augenblick -- Kopf hinreichend fassen -- zerspringen verwirren -- 
  hierbei Herz gut -- Überraschung ertragen -- 
  verlieren eins -- Angst -- Sorge Zurückgelassen denken -- fast Angst -- Sorge denken -- begegnen -- 
  fliehen -- verbergen -- Jüngling -- 
  bleiben -- -- Hals hing -- 
  Landmann -- Geschichte gestrandet Schiff vernehmen -- eilt Frage Ufer -- 
  Fahrzeug glücklich einhergeschwommen -- vieler Mühe losgebrachen -- 
  fahren auf Ungewisse fort -- Hoffnung Verloren finden -- 
  Landmann Rufen winken Schiffende aufmerksam -- Stelle laufen -- vorteilhaft Landungsplatz zeigen -- winken Rufen aufhören -- wandt Schiff Ufer -- welch Schauspiel -- landen -- 
  Eltern verlobten drängen an Ufer -- liebend Bräutigam fast Besinnung verlassen -- 
  vernehmen -- lieben Kind retten -- treten sonderbaren Verkleidung Busch hervor -- 
  erkennen eher -- herangetreten -- 
  sehen -- rief Mutter -- sehen -- rief Vater -- 
  Gerettete werfen nieder -- 
  euer Kind -- rufen -- Paar -- 
  Verzeiht -- rufen Mädchen -- 
  Gebt euren Segen -- rufen Jüngling -- 
  geben euren Segen -- rufen -- Welt staunend verstummen -- euer Segen -- ertönen drittenmal -- versagen -- 
  Elftes Kapitel -- 
  erzählend Pause -- vielmehr geendigen bemerken müssen -- Charlotte höchst bewegen -- stehen verlassen stumm Entschuldigung Zimmer -- 
  Geschichte -- 
  Begebenheit Hauptmann Nachbarin zugetragen -- Engländer erzählen -- hauptzügen entstellen -- Einzeln ausgebildet ausgeschmücken -- dergleich Geschichte pflegen -- Mund Menge Sodann Phantasie geist- geschmackreich Erzähler durchgehen -- 
  bleiben zuletzt meist -- 
  Ottilie folgen Charlotte -- fremd verlangen -- Lord Reihe bemerken -- abermals Fehler begehen -- Haus Bekannt Verwandt erzählen -- 
  hüten -- fahren fort -- Üble stiften -- 
  Angenehme -- nossen -- scheinen Bewohnerinne Glück bringen -- schicklich Weise empfehlen suchen -- 
  gestehen -- versetzen Begleiter -- anderer festhalten -- Aufklärung näh Kenntnis Haus verlassen -- 
  gestern -- Mylord -- tragbar dunkel Kammer Park ziehen -- beschäftigen -- wahrhaft malerisch Standpunkt auswählen -- bemerken nebenher vorging -- 
  lenkt Hauptwege -- besuchen Platz See gelangen -- reizend Anbot -- 
  Ottilie begleiten -- stehen folgen -- bitten -- Kahne dorthin begeben -- 
  setzen Freude Gewandtheit schön Schifferin -- 
  versichern -- Schweiz -- reizendst Mädchen Stelle Fuhrmann vertreten -- angenehm Welle schaukeln -- enthalten fragen -- eigentlich ablehnen Seitenweg -- 
  ausweichen Art ängstlich Verlegenheit -- 
  auslachen -- versetzen freundlich -- Auskunft geben -- obgleich Geheimnis obwalten -- 
  Nebenweg niemals betreten -- Schauder überfallen -- nirgends empfind erklären wissen -- 
  vermeiden -- Empfindung aussetzen -- so_mehr Kopfweh linker Seite einstellen -- woran manchmal leiden -- 
  landen -- Ottilie unterhalten -- untersuchen indes Stelle -- Ferne deutlich angeben -- 
  Verwunderung -- deutlich Spur steinkohlen entdecken -- überzeugen -- einiger nachgraben ergiebig Lager Tiefe finden -- 
  verzeihen -- Mylord -- 
  sehen lächeln wissen -- leidenschaftlich Aufmerksamkeit Ding -- Glaube -- weiser Mann Freund nachsehen -- unmöglich scheid -- schön Kind Pendelschwingunge versuchen lassen -- 
  niemals fehlen -- Sache Sprache -- Lord Grund abermals wiederholen -- Begleiter bescheiden geduldig aufnehmen -- zuletzt Meinung -- Wunsch verharren -- 
  wiederholt erkennen -- -- Versuch gelängen -- Sache aufgeben -- vielmehr desto ernsthaft gründlich untersuchen müssen -- gewiß Bezug Verwandtschaft unorganisch Wesen untereinander -- organisch abermals untereinander -- offenbaren -- gegenwärtig verbergen -- 
  Apparat golden Ring -- Markasit metallisch Substanz -- schön Kästchen führen -- ausbreiten lassen Metall -- Faden schwebend -- liegenden Metall Versuch nieder -- 
  gönnen Schadenfreude -- Mylord -- -- Gesicht lesen -- bewegen -- 
  Operation Vorwand -- 
  Dame zurückkehren -- neugierig wunderlich beginnen -- 
  Frauenzimmer kommen -- 
  Charlotte verstehen sogleich vorging -- 
  Ding gehören -- -- niemals Wirkung sehen -- 
  hübsch bereit -- lassen versuchen -- anschlagen -- 
  Faden Hand -- Ernst -- halten sten Gemütsbewegung -- mindeste schwanken bemerken -- 
  Ottilie veranlassen -- 
  halten Pendel ruhig -- unbefangen -- unbewußt unterliegend Metall -- 
  Augenblick schwebend entschieden Wirbel fortgerissen drehen -- Unterlage wechseln -- -- Seite -- Kreis -- Ellipsen -- Schwung gerade Linie -- Begleiter erwarten -- Erwartung -- 
  Lord stutzen einigermaßen -- Lust Begierde enden bitten Wiederholung Vermannigfaltigung Versuch -- 
  Ottilie gefällig verlangen finden -- zuletzt freundlich ersuchten -- mögen entlassen -- Kopfweh einstellen -- 
  verwundern -- entzücken -- versichern Enthusiasmus -- Übel völlig heilen wollen -- Kurart anvertrauen -- 
  Augenblick ungewiß -- Charlotte geschwind Begriff wovon Rede -- lehnen wohlgesinnt Antrag -- meinen -- Umgebung zulassen -- wovor Immerfort stark Apprehension fühlen -- 
  fremde entfernt -- ungeachtet sonderbar Weise berühren -- Wunsch zurückgelassen -- irgendwo antreffen -- 
  Charlotte benutzen nunmehr schön -- Nachbarschaft Gegenbesuch enden -- womit fertig -- Landschaft umh -- wahrhaft teilnehmend -- bloß Gewohnheit -- fleißig bekümmern -- 
  Haus beleben Anblick Kind -- gewiß Liebe -- Sorgfalt wert -- 
  wunderbar -- Wunderkind -- höchst erfreulich Anblick -- Größe -- Ebenmaß -- Stärke Gesundheit -- Verwunderung setzen -- doppelt Ähnlichkeit entwickeln -- 
  Gesichtszüg Form glich Kind Hauptmann -- Auge lassen Ottilies Auge unterscheiden -- 
  sonderbar Verwandtschaft schön Gefühl Frau leiten -- Kind geliebt Mann zärtlich Neigung umfangen -- Ottilie heranwachsend Geschöpf Mutter -- vielmehr Art Mutter -- 
  entfernt Charlotte -- bleiben Ottilie Kind Wärterin -- 
  Nanny -- eifersüchtig Knabe -- Herrin Neigung zuwenden scheinen -- trotzig entfernt Eltern zurückkehren -- 
  Ottilie fahren fort -- Kind frei Luft tragen -- gewöhnt Spaziergäng -- 
  Milchfläschch -- Kind -- nötig -- Nahrung reichen -- 
  selten unterließ Buch mitzunehmen -- bilden -- Kind Arm -- lesend wandelnd -- anmutig Penserosa -- 
  Zwölftes Kapitel -- 
  Hauptzweck Feldzug erreichen -- Eduard Ehrenzeichen schmücken -- rühmlich entlassen -- 
  begeben sogleich -- genau Nachricht Seinig finden -- -- bemerken wissen -- scharf beobachten lassen -- 
  still Aufenthalt blicken auf freundlichste entgegen -- 
  indessen Anordnung einrichten -- bessern fördern -- Anlage Umgebung -- weit Breite fehlen -- innerer Genießbar ersetzen -- 
  Eduard -- rasch Lebensgang entschieden Schritt gewöhnen -- nunmehr dasjenig ausführen -- überdenken -- 
  Ding berufen Major -- 
  Freude Wiedersehen -- 
  Jugendfreundschafte -- Blutsverwandtschaft -- bedeutend Vorteil -- Irrung Mißverständniß -- Art -- niemals Grund schaden -- alt Verhältnis herstellen -- 
  froh Empfang erkundigen Eduard Zustande Freundes -- vernehmen -- vollkommen wünschen Glück begünstigen -- 
  halb scherzend vertraulich fragt Eduard sodann -- schön Verbindung Werk -- 
  Freund verneinen -- bedeutendem Ernst -- 
  hinterhältig -- fahren Eduard fort -- 
  Gesinnung Vorsatz sogleich entdecken -- 
  kennst Leidenschaft Ottilie längst begreifen -- -- Feldzug stürzen -- 
  leugnen -- wünschen -- Leben -- nütze -- gestehen -- gewinnen -- vollkommen verzweifeln -- 
  Glück schön -- wünschenswert -- unmöglich bleiben -- völlig Verzicht -- 
  tröstlich Ahnung -- heit Zeichen Glaube -- Wahn bestärken -- Ottilie können -- 
  Glas unser Namenszug bezeichnen -- Grundsteinlegung Lüfte werfen -- Trümmer -- aufgefang Hand -- 
  -- rufen -- einsam Ort zweifelhaft Stunde verleben -- 
  Stelle Glases Zeichen -- Verbindung -- 
  gehen such Tod -- Rasend -- leben hoffen -- 
  Ottilie Preis -- Kampf -- -- feindlich Schlachtordnung -- Verschanzung -- belagert Festung gewinnen -- erobern hoffen -- 
  Wunder -- Wunsch verschonen bleiben -- Sinn Ottilie gewinnen -- verlieren -- 
  Gefühl leiten -- Gefahr beigestanden -- find Ziel gelangen -- Hindernis überwinden -- Weg stehen -- 
  Ottilie -- Gedanke Ausführung liegen -- bedeutend ansehen -- 
  löschest -- versetzen Major -- Zügen -- entgegensetzen -- wiederholen -- 
  Verhältnis Frau Wert zurückzurufen -- überlassen -- -- schuldig -- hierüber verdunkeln -- 
  gedenken -- Sohn geben -- auszusprech -- angehören -- Wesen Wille schuldig -- vereinen leben -- vereinen Erziehung künftig sorgen möget -- 
  bloß Dünkel Eltern -- versetzen Eduard -- einbilden -- Kind nötig -- 
  leben finden Nahrung Beihilfe -- Sohn -- früh Tod Vater -- bequem -- begünstigt Jugend -- gewinnen schnellerer Bildung Welt -- zeitig anerkennen -- schicken -- lernen -- 
  hiervon Rede -- reich -- mehrere Kind versorgen -- keineswegs Pflicht Wohltat -- Haupt Gut häufen -- 
  Major Zügen Charlotte Wert Eduard bestanden Verhältnis anzudeut gedingen -- fallen Eduard hastig Rede -- Torheit begehen -- allzuwohl einsehen -- 
  gewiß Alter früh Jugendwünsche Hoffnung realisieren -- betrügen -- 
  jeder Jahrzehnt Mensch Glück -- Hoffnung Aussicht -- 
  weh Mensch vorwärts rückwärts greifen -- Umstand Wahn veranlassen -- 
  Torheit begehen -- für Leben -- 
  -- Art Bedenklichkeit -- dasjenig versagen -- Sitte absprechen -- 
  Ding nehmen Mensch Vorsatz -- -- geschehen -- Einzeln -- Bedingung Leben -- Komplex Leben Rede -- 
  Major verfehlen geschickt nachdrücklich Weise Eduard verschieden Bezug Gemahlin -- Familie -- Welt -- Besitzung vorstellen -- gelingen -- Teilnahme erregen -- 
  -- Freund -- erwidern Eduard -- Seele vorbeigehen -- mitten Gewühl Schlacht -- Erde anhaltend Donner bebt -- Kugel sausen pfiffen -- rechts links Gefährt niederfielen -- Pferd treffen -- Hut durchlöcheren -- vorgeschwebt still nächtlich Feuer gestirnt Gewölbe Himmel -- 
  treten Verbindung Seele -- durchdachen -- durchgefühlen -- zueignen -- abgefund -- wiederholt Male -- -- 
  Augenblick -- dir_es verschweigen -- warst gegenwärtig -- gehörtest Kreis -- gehören zueinand -- 
  schuldig -- kommen Fall Zins abzutragen -- schuldig -- siehst Stande -- vergelten -- 
  wissen liebst Charlotte -- verdienen -- wissen gleichgültig -- deinen Wert erkennen -- 
  Nimm Hand -- führ Ottilie -- glücklichst Mensch Erde -- 
  hoch Gabe bestechen -- versetzen Major -- desto vorsichtig -- desto streng -- 
  anstatt Vorschlag -- still verehr -- Sache erleichtern -- erschweren vielmehr -- 
  -- -- Rede -- Schicksal -- gut Name -- Ehre zwei Mann -- unbescholt -- wunderlich Handlung -- nennen -- Gefahr -- Welt höchst seltsam Licht erscheinen -- 
  unbescholn -- versetzt Eduard -- schelten lassen -- 
  Leben zuverlässigen Mann beweisen -- Handlung zuverlässig -- zweideutig erscheinen -- 
  betreffen -- fühlen letzter Prüfung auferlegen -- schwierig gefahrvoll Tat tun -- berechtigen -- 
  Charlotte betreffen -- Zukunft Anheim geben -- -- vorsatz zurückhalten -- 
  Hand bieten -- erbötig -- überlassen -- entgegen -- 
  Extrem entstehen -- wollen -- 
  Major halten Pflicht -- Vorsatz Eduard Widerstand leisten -- bedient Freund klug Wendung -- nachzugeben scheinen Form -- Geschäftsgang Sprache bringen -- Trennung -- Verbindung erreichen -- 
  treten unerfreuliche -- Beschwerlich -- Unschickliche hervor -- Eduard schlimm Laune versetzen fühlen -- 
  sehen -- rufen -- Feind -- Freund wünschen -- erstürmen -- 
  -- unentbehrlich -- halten fest Auge -- ergreifen gewiß behend -- 
  dergleicher Verhältnis -- wissen -- heben bilden -- fall stehen -- weich beharr Lust -- 
  Überlegung enden -- verstand -- steigend Waagschale lassen Gegengewicht legen -- 
  Entschließ -- Freund -- -- handeln -- -- Zustand entwirren -- auflösen -- verknüpfen -- 
  Laß Betrachtung abhalten -- Welt ohnehin reden -- reden -- Sodann -- übrig aufhören neu -- vergessen gewähren lassen -- nehmen -- 
  Major Ausweg müssen zugeben -- Eduard allemal Sache Bekannt Vorausgesetzt behandeln -- anzustellen -- Einzeln durchsprach Zukunft heiterst -- sogar scherzen ergehen -- 
  ernsthaft nachdenklich fahren fort -- Hoffnung -- Erwartung überlassen -- finden -- Zufall leiten begünstigen sollen -- sträflich Selbstbetrug -- 
  Weise unmöglich retten -- allseitig Ruhe wiederherstellen -- tröst -- unschuldig Schuld -- 
  Zudringlichkeit Charlotte vermocht -- Haus nehmen -- Ottilie Gefolge Veränderung eintreten -- 
  Herr entsprung -- Herr -- unschädlich -- Verhältnis unser Glück leiten -- 
  Auge schön freundlich Aussicht abwenden -- eröffnen -- -- traurig Entsagen gebieten -- insofern dir_es denken -- insofern -- 
  Alsdann -- vornehm alt Zustand zurückkehren -- Unschicklich -- Unbequem -- verdrießliche übertragen -- -- Heitere entsprängen -- 
  glücklich Zustand befindesen -- Freude -- hindern Wärst -- besuchen -- leben -- 
  vorgehen -- peinlich -- 
  Charlotte unser Vermögen traurig Lage befinden -- 
  Weltmenschen glauben -- -- Entfernung Empfindung abstumpfen -- tief eingegraben Zug auslöschen -- Rede -- Schmerz Entbehren Freude Behag zubringen -- 
  zuletzt Wichtigste aussprechen -- 
  -- unser äußerer innerer Zustande -- allenfalls abwarten können -- Ottilie -- Haus verlassen -- Gesellschaft Vorsorge entbehr verrucht kalt Welt jämmerlich herumdrücken müssen -- 
  Mal Zustand worin Ottilie -- -- -- glücklich -- sollst Argument aussprechen -- stark jeder -- -- zugeben -- ergeben -- dennoch auf Betrachtung Überlegung ziehen -- 
  Aufgabe lösen -- fallen Freund hierauf hinlänglich Antwort -- bleiben übrig -- wiederholt einzuschärfen -- wichtig -- bedenklich Sinn gefährlich Unternehmen -- angreifen -- ernstlich Bedenken -- 
  Eduard lassen gefallen -- Bedingung -- Freund eher verlassen wollen -- Sache völlig einig -- Schritt tun -- 
  Dreizehntes Kapitel -- 
  völlig fremd gleichgültig Mensch -- leben -- kehren Innere wechselseitig heraus -- gewiß Vertraulichkeit entstehen -- 
  lassen erwarten -- unser Freund -- wohnt -- täglich stündlich umging -- gegenseitig verbergen bleiben -- 
  wiederholt Andenken früh Zustand -- Major verhehlen -- Charlotte Eduard -- Reise zurückgekommen -- Ottilie zugedenken -- schön Kind Folge vermählen meinen -- 
  Eduard Verwirrung entzücken Entdeckung -- sprechen Rückhalt gegenseitig Neigung Charlottes Major -- -- bequem günstig -- lebhaft Farbe ausmalen -- 
  leugnen Major eingestehen -- Eduard befestigen -- bestimmen -- 
  denken -- geschehen -- 
  Teil brauchen willigen wünschen -- Scheidung gewiß erlangen -- baldig Verbindung folgen -- Eduard Ottilie reisen -- 
  Einbildungskraft angenehme ausmalen -- Reizenderes -- Liebende -- jung Gatte -- neu frisch Verhältnis frisch Welt genießen -- dauernd Bund wechselnd Zustand prüfen Bestätig hoffen -- 
  Major Charlotte unterdessen unbeschränkt Vollmacht -- Besitz -- Vermögen irdisch wünschenswert Einrichtung beziehen -- dergestalt ordn Billigkeit einleiten -- Teil zufrieden können -- 
  worauf Eduard allermeisten fußen -- wovon groß Vorteil versprechen scheinen -- -- 
  Kind Mutter bleiben -- Major Knabe erziehen -- Einsicht leiten -- Fähigkeit entwickeln -- 
  umsonst Taufe beiderseitig Name Otto geben -- 
  Eduard fertig -- lang anstehen -- Ausführung nah treten -- 
  gelangt Weg Stadt -- Eduard Haus besitzen -- verweil Rückkunft Major abwarten -- 
  überwind -- sogleich absteigen -- begleiten Freund Ort -- 
  Pferd -- bedeutend Gespräch verwickeln ritten -- 
  erblickt Ferne Haus Höhe -- rot Ziegeln erstenmal blinken sehen -- 
  Eduard ergreifen unwiderstehlich Sehnsucht -- Abend abtun -- 
  nah Dorfe verbergen halten -- Major Sache Charlotte dringend vorstellen -- Vorsicht überraschen unerwartet Antrag frei Eröffnung Gesinnung nötigen -- 
  Eduard -- Wunsch übergetragen -- glauben entschieden Wunsch entgegen kommen -- hoffen schnell Einwilligung -- Wille -- 
  glücklich Ausgang freudig Auge -- Lauernden schnell verkündigen -- Kanonenschlag losgebrannen -- Nacht -- Rakete steigen -- 
  Major riten Schlos -- 
  finden Charlotte -- erfahren vielmehr -- gegenwärtig Gebäude wohnen -- Besuch Nachbarschaft ablegen -- wahrscheinlich sobald Haus kommen -- 
  Wirtshaus -- wohin Pferd stellen -- 
  Eduard indessen unüberwindlich Ungeduld treiben -- schlich Hinterhalt einsam Pfade -- Jäger Fischer -- Park -- finden Abend Gebüsch Nachbarschaft Sees -- Spiegel erstenmal vollkommen rein erblicken -- 
  Ottilie Nachmittag Spaziergang See -- 
  tragen Kind las Gewohnheit -- 
  gelangt Eiche Überfahren -- 
  Knabe eingeschlafen -- setzen -- legen nieder Fuhr fort lesen -- 
  Buch eins zart Gemüt ziehen lassen -- 
  vergessen Stunde -- denken -- Land weit Rückweg Gebäude -- sitzen versenken Buch -- -- liebenswürdig ansehen -- Baum -- Sträucher rings umh beleben -- Auge begabt -- Bewunder erfreuen -- 
  fallen rötlich Streiflicht sinkenden Sonne vergoldet Wange Schulter -- 
  Eduard -- gelingen -- unbemerkt vorzudring -- Park leer -- Gegend einsam finden -- wagen -- 
  brechen Gebüsch Eiche -- sehen Ottilie -- -- fliegen liegen Fuß -- 
  lang stumm Pause -- Fasse suchen -- erklären Wort -- hierher kommen -- 
  Major Charlotte abgesenden -- gemeinsam Schicksal Augenblick entscheiden -- 
  Liebe zweifeln -- gewiß seinigen -- 
  bitte Einwilligung -- 
  zauderen -- beschwören -- alt geltend Arm schließen -- deutet Kind -- 
  Eduard erblicken staunt -- 
  Gott -- rufen -- Ursache Frau -- Freund zweifeln -- Gestalt fürchterlich zeugen -- 
  Bildung Major -- 
  solch Gleichen sehen -- 
  -- 
  versetzt Ottilie -- 
  Welt -- gleichen -- 
  -- versetzen Eduard -- Augenblick schlagen Kind Auge -- -- schwarz -- durchdringend Auge -- tief freundlich -- 
  Knabe Welt verständig -- scheinen kennen -- stehen -- 
  Eduard werfen Kind nieder -- knien zweimal Ottilie -- 
  bist_es -- rufen -- Auge sind_es -- 
  -- Laß deinig Schaun -- 
  Laß Schleier werfen unselig Stunde -- Wesen -- 
  rein Seele unglücklich Gedanke erschrecken -- Mann Frau entfremden an Herz drücken gesetzlich Bund lebhaft Wunsch entheiligen -- 
  -- -- Verhältnis Charlotte trennen -- meinig -- sagen -- 
  hart Wort aussprechen -- Kind doppelt Ehebruch erzeugen -- 
  trennen Gattin Gattin -- verbinden -- 
  Zeuge -- herrlich Auge deinig sagen -- arme gehören -- mögest fühlen -- Ottilie -- fühlen -- Fehler -- Verbrechen deinen arme abbüßen -- 
  Horch -- rufen -- Aufsprang Schuß hören glauben -- Zeichen Major geben -- 
  Jäger -- benachbart Gebirg schießen -- 
  erfolgen -- Eduard ungeduldig -- 
  Ottilie -- Sonne Berg senken -- 
  zuletzt blinkt Fenster oberer Gebäude -- 
  Entferne -- Eduard -- rufen Ottilie -- 
  entbehren -- dulden -- 
  Bedenke Charlotte schuldig -- 
  Schicksal entscheiden -- Laß vorgreifen -- 
  -- vergönnen -- -- entsagen -- 
  Entscheidung nah glaubst -- laß erwarten -- 
  Gehen Dorf -- Major vermuten -- 
  vorkommen -- Erklärung fordern -- 
  wahrscheinlich -- roh Kanonenschlag Erfolg Unterhandlung verkünd -- 
  suchen Augenblick -- 
  Charlotte treffen -- wissen -- 
  entgegen gehen -- wissen -- 
  vielerlei Fall -- 
  Laß -- 
  -- 
  erwarten Kind -- 
  Ottilie sprechen -- 
  rufen Möglichkeit -- 
  glücklich Eduard Nähe fühlen -- entfernen müssen -- 
  bitte -- beschwören -- Geliebter -- rufen -- 
  Kehr erwarten Major -- 
  Gehorch dein Befehl -- rufen Eduard -- leidenschaftlich anblicken fest Arm schließen -- 
  Umschlang ihrigen drückt zärtlichste Brust -- 
  Hoffnung fahren Stern -- Himmel fallen -- Häupter weg -- 
  wähnn -- glauben anzugehören -- wechseln erstenmal entschieden -- frei Küs trennen gewaltsam schmerzlich -- 
  Sonne untergegangen dämmert duftet feucht See -- 
  Ottilie stehen verwirrt bewegen -- Berghause hinüber glauben Charlottes weiß Kleid Altan sehen -- 
  Umweg See -- kennen Charlott ungeduldig Harren Kind -- 
  Platane sehen -- Wasserraum trennen Pfade -- sogleich Gebäude hinaufführt -- 
  Gedanke drüben -- Auge -- 
  Bedenklichkeit -- Kind auf Wasser wagen -- verschwinden Drange -- 
  eilen Kahn -- fühlen Herz pochen -- Fuß schwanken -- Sinn vergehen drohn -- 
  springen Kahn -- ergreifen Ruder stoßen -- 
  Gewalt brauchen -- wiederholen Stoß -- Kahn schwanken gleiten Strecke Seewärt -- 
  linker Arm Kind -- linker Hand Buch -- Ruder -- schwanken fallen Kahn -- 
  Ruder entfahren -- Seite -- erhalten -- Kind Buch -- -- Wasser -- 
  ergreifen Kind Gewand -- unbequem Lage hindern aufstehen -- 
  frei Hand hinreichend umzuwenden -- Aufzuricht -- gelingt_es -- ziehen Kind Wasser -- Auge schließen -- aufgehört atmen -- 
  Augenblick kehren Besonnenheit -- desto groß Schmerz -- 
  Kahn treiben fast Mitte See -- Ruder schwimmen fern -- erblicken Ufer helfen -- sehen -- 
  abgesondert schweben Treulose unzugänglich Element -- 
  suchen Hilfe -- 
  Rettung Ertrunken gehören -- 
  Abend Geburtstag erleben -- 
  entkleidet Kind -- trocknen Musselingewand -- 
  reißen Busen zeigen erstenmal frei Himmel -- erstenmal drücken Lebendig rein nackt Brust -- -- Lebendig -- 
  kalt Glied unglücklich Geschöpf erkält Busen innerst Herz -- 
  Unendliche Träne entquell Auge erteilen Oberfläche erstarrter Schein Wärme -- Leben -- 
  lassen -- überhüllen Schal -- Streichel -- Andrücke -- anhauchen -- Küsse -- Träne glauben Hilfsmittel ersetzen -- Abgeschnittenheit versagen -- 
  vergebens -- 
  Bewegung liegen Kind arme -- Bewegung stehen Kahn Wasserfläche -- lassen schön Gemüt hülflos -- 
  wenden -- 
  Kniend sinken Kahne nieder heben erstarrt Kind arme unschuldig Brust -- weiß Kälte Marmor gleichen -- 
  feucht Blick sehen empor rufen Hilfe -- zart Herz groß Fülle finden hoffen -- überall mangeln -- 
  wenden vergebens Stern -- Einzel hervorzublinken anfangen -- 
  sanft Wind erheben treiben Kahn Platane -- 
  Vierzehntes Kapitel -- 
  eilen Gebäude -- rufen Chirurg hervor -- übergeben Kind -- 
  gefaßt Mann behandeln zart Leichnam stufenweise gewohnt Art -- 
  Ottilie stehen -- schaffen -- bringen -- sorgen -- Welt wandelnd -- 
  hoch Unglück hoch Glück verändern Ansicht Gegenstand -- -- durchgegangen Versuch wack Mann Kopf schütteln -- hoffnungsvoll Frage schweigend -- leisen antworten -- verlassen Schlafzimmer Charlotte -- worin geschehen -- Wohnzimmer betreten -- fallen -- Sofa erreichen -- erschöpfen auf Angesicht Teppich -- 
  hören Charlotte vorfahren -- 
  Chirurg bitten Umstehenden dringend bleiben -- entgegen -- vorbereiten -- betreten Zimmer -- 
  finden Ottilie Erde -- Mädchen Haus stürzen Geschrei Weine entgegen -- 
  Chirurg treten Herein erfahren -- 
  Hoffnung aufgeben -- 
  erfahren -- kunstreich -- klug Mann bitten Kind sehen -- entfernt -- Anstalt täuschen -- 
  Sofa setzen -- Ottilie liegen Erde -- Freundin Knie herangehoben -- schön Haupt hingesenken -- 
  ärztlich Freund -- scheinen Kind bemühen -- bemühen Frau -- 
  Mitternacht herbei -- Totenstille tief -- 
  Charlotte verbergen -- Kind Leben zurückkehren -- verlangen sehen -- 
  warm wollen Tücher reinlich einhüllen -- Korb legen -- Sofa setzen -- Gesichtchen frei -- ruhig schön liegen -- 
  Unfall Dorf erregen Kunde sogleich Gasthof erschollen -- 
  Major bekannt Weg hinaufbegeben -- Haus herum -- Bedienten anhieln -- Angebäude hohlen laufen -- verschaffen nah Nachricht lassen Chirurg herausrufen -- 
  -- erstaunt Erscheinung alt Gönner -- berichten gegenwärtig Lage übernehmen -- Charlotte Anblick vorbereiten -- 
  hinein -- fing ableitende Gespräch führen Einbildungskraft Gegenstand -- Freund Charlotte vergegenwärtigen -- gewiß Teilnahme -- Nähe Geist -- Gesinnung -- Wirklich übergehen lassen -- 
  erfahren -- Freund stehen Tür -- wissen wünsche einlassen -- 
  Major treten herein -- begrüßen Charlotte schmerzlich Lächel -- 
  stehen -- 
  heben grünseiden Decke -- Leichnam verbergen -- dunkel Schein Kerze erblicken -- geheim Grausen -- erstarrt Ebenbild -- 
  Charlotte deutet Stuhl -- sitzen -- schweigend -- Nacht hindurch -- 
  Ottilie liegen ruhig Knien Charlott -- atmen Sanft -- Schlief -- scheinen schlafen -- 
  dämmeren -- Licht verlosch -- Freund scheinen dumpf Traum erwachen -- 
  Charlotte blicken Major fassen -- erklären -- Freund -- Schickung hierher -- Trauerszene nehmen -- 
  -- antworten Major leise fragen -- -- Ottilie aufwecken -- Ort -- zurückhalten -- Einleitung sachen heran treten -- 
  Fall -- finden -- ungeheuer -- Bedeutende weshalb kommen -- Wert verlieren -- 
  gestehen -- ruhig einfach -- Zweck Sendung -- fern Eduard abgeschicken -- Zweck Kommen -- fern frei Wille -- Interesse -- 
  tragen beide zaren -- aufrichtig -- Charlotte hören gelassen -- scheinen weder Staune -- unwillig -- 
  Major geendigen -- antworten Charlotte leise Stimme -- nötigen Stuhl heranzurücken -- 
  Fall -- befinden -- ähnlich -- 
  -- 
  fühlen -- mehrere Hand liegen -- Zweifel aussprechen -- 
  willig Scheidung -- 
  entschließen -- Zaudern -- Widerstrebe Kind töten -- 
  gewiß Ding -- Schicksal hartnäckig vornimmen -- 
  vergebens -- Vernunft Tugend -- Pflicht heilig Weg stellen -- geschehen -- scheinen -- greifen zuletzt -- gebärden -- 
  sagen -- 
  eigentlich Schicksal Wunsch -- Vorsatz -- unbedachtsam handeln -- Weg bringen -- Ottilie Eduard schicklichsen Paar zusammengedachen -- nähern suchen -- 
  -- Freund -- Mitwisser Plan -- 
  Eigensinn Mann wahr Liebe unterscheiden -- 
  Hand -- 
  Freundin Gattin glücklich -- 
  betrachten unglücklich Schlummernd -- 
  zitter Augenblick -- halb Totenschlafe Bewußtsein erwachen -- 
  leben -- tröst -- hoffen -- Liebe Eduard ersetzen -- Werkzeug wunderbarst Zufall rauben -- 
  wiedergeber Neigung -- Leidenschaft lieben -- 
  Vermag Lieb dulden -- vermögen vielmehr ersetzen -- 
  Augenblick denken -- 
  Entfern Stille -- Major -- 
  sagen Eduard -- Scheidung willig -- -- -- mittler Sache einzuleit überlasse -- künftig Lage unbekümmert Sinn -- 
  jeder Papier unterschreiben -- bringen -- verlangen -- mitwirk -- Bedenke -- beraten -- 
  Major stehen -- 
  reichen Hand Ottilie weg -- 
  drücken Lippe lieb Hand -- 
  -- hoffen -- lispelen leise -- 
  Lassen Antwort schuldig bleiben -- versetzen Charlotte -- 
  verschulden unglücklich -- verdienen glücklich -- 
  Major entfernen -- Charlotte tief Herz beklagend -- arm abgeschieden Kind bedauern -- 
  Opfer scheinen nötig allseitig Glück -- 
  denken Ottilie Kind Arm -- vollkommenst Ersatz -- Eduard rauben -- dachen Sohn Schoß -- mehrer Ebenbild trügen -- abgeschiedenen -- 
  schmeichelnd Hoffnung Bild gehen Seele -- Rückwege Gasthofe Eduard finden -- Nacht Freien Major erwarten -- Feuerzeiche -- Donnerlaut glücklich gelingen verkünden -- 
  wissen Unglück -- anstatt arm Geschöpf bedauern -- Fall -- gestehen -- Fügung -- wodurch jeder Hindernis Glück beseitigen -- 
  lassen Major bewegen -- schnell Entschluß Gattin verkündigen -- Dorfe -- sodann Stadt zurückkehren -- Nächste überlegen einleiten -- 
  Charlotte sitzen -- Major verlassen -- Minute Betrachtung versenken -- 
  sogleich richten Ottilie -- Freundin Auge anblickend -- 
  erheben Schoß -- Erde stehen Charlotte -- 
  zweitenmal -- beginnen herrlich Kind unüberwindlich anmutig Ernst -- zweitenmal widerfähren -- 
  sagtest einst -- 
  begegnen Mensch Leben Ähnlich ähnlich Weise -- bedeutend Augenblick -- 
  find Bemerkung -- gedrung Bekenntnis -- 
  Mutter Tod -- Kind -- Schemel rücken -- saßest Sofa -- haupt liegen deinen Knie -- Schlief -- wacht -- schlummern -- 
  vernehmen vorging -- Rede -- deutlich -- regen -- äußeren -- -- andeuen -- bewußt fühlen -- 
  sprachst Freundin -- bedauertest Schicksal -- arm Waise Welt bleiben -- schildertest abhängig Lage mißlich stehen können -- besonderer Glücksst walen -- 
  fassen genau -- streng -- wünschen -- fordern schienst -- 
  beschränkt Einsicht hierüber Gesetz -- leben -- Las einrichten -- liebtest -- Sorgtest -- Haus aufnahmst -- Hernach -- 
  Bahn geschriten -- Gesetz brechen -- sogar Gefühl verlieren -- schrecklich Ereignis klärst Zustand -- jammervoller -- 
  Schoß ruhend -- halb erstarren -- fremd Welt vernehmen abermals leis Stimme Ohr -- vernehmen -- aussehen -- schauderen -- diesmal halb Totenschlaf Bahn vorgezeichnen -- 
  entschließen -- ich_es -- wozu entschließen -- mußt erfahren -- 
  Eduard -- 
  schrecklich Weise Gott Auge öffnen -- Verbrechen befangen -- 
  büßen -- gedenken Vorsatz abzubringen -- 
  -- Liebe -- gute -- nimm Maßregel -- 
  Laß Major zurückkommen -- schreiben -- Schritt geschehen -- 
  ängstlich -- rühren Regen -- -- 
  auffahren -- Aufschreie -- 
  solltest frevelhaft Hoffnung entlassen -- 
  Charlotte Ottilies Zustand -- empfinden -- hofft Vorstellung gewinnen -- 
  Wort aussprechen -- Zukunft -- Milderung Schmerzes -- Hoffnung deuten -- 
  -- rufen Ottilie Erhebung -- suchen bewegen -- hintergeh -- 
  Augenblick -- erfahren -- 
  habest Scheidung willigen -- büßen demselbig See Vergehen -- Verbrechen -- 
  Fünfzehntes Kapitel -- 
  glücklich friedlich Zusammenlebe verwandte -- Freund -- Hausgenossen -- nötig billig -- unterhalten geschehen geschehen -- Vorsätz -- Unternehmung -- Beschäftigung wiederholt mitteil -- wechselseitig Rat annehmen -- Leben gleichsam ratschlagend behandeln -- 
  finden -- wichtig Moment -- scheinen -- Mensch bedürf fremd Beistand -- fremd Bestätigung allermeisten -- einzeln zurückziehen -- jeder handeln -- jeder Weise wirken streben -- einzelner verbergen -- Ausgang -- Zweck -- Erreichte Gemeingut -- 
  soviel wundervoll unglücklich Ereignis gewiss still Ernst Freundin kommen -- liebenswürdig Schonung äußern -- 
  Stille Charlotte Kind Kapelle senden -- 
  ruht Opfer ahnungsvoll Verhängnis -- 
  Charlotte kehren -- -- Leben -- finden Ottilie -- Beistand bedürfen -- 
  beschäftigen vorzüglich -- merken lassen -- 
  wissen himmlisch Kind Eduard lieben -- szen Unglück vorher gehen -- Herausgeforscht -- Umstand -- teils Ottilie -- teils Brief Major erfahren -- 
  Ottilie Seite erleichtert Charlotte augenblicklich Leben -- 
  -- gesprächig -- niemals Gegenwärtig Rede -- 
  stets aufgemerken -- stets beobachten -- wissen -- Vorschein -- 
  unterhalten -- zerstreut Charlotte -- still Hoffnung nähren -- wert Paar verbinden sehen -- 
  Ottilie hing -- 
  Geheimnis Lebensgange Freundin entdecken -- früh Einschränkung -- Dienstbarkeit entbinden -- 
  Reue -- Entschluß fühlen befreien Last Vergehen -- Mißgeschick -- 
  bedürfen Gewalt -- tief Herzen Bedingung völlig Entsagen verzeihen -- Bedingung Zukunft unerläßlich -- 
  verfließen -- Charlotte fühlen -- Haus Park -- See -- Felse Baumgruppe -- traurig Empfindung täglich erneuerten -- 
  Ort verändern müssen -- allzu deutlich -- geschehen sollen -- entscheiden -- 
  Frau zusammenbleiben -- 
  Eduard früh Wille scheinen gebiet -- Erklärung -- Drohung nötig -- verkennen -- Frau -- gut Wille -- Vernunft -- Anstrengung -- peinlich Lage befinden -- 
  Unterhaltung vermeidend -- 
  manchmal halb verstehen -- öfter Ausdruck -- Verstand Empfindung -- mißdeuten -- 
  fürchtete verletzen -- Furcht verletzbar verletzen -- 
  Ort verändern -- -- trennen -- treten alt Frage hervor -- Ottilie hinbegeben sollen -- 
  reich Haus vergeblich Versuch -- hoffnungsvoll Erbtochter unterhaltend wetteifernd Gespielinn verschaffen -- 
  letzter Anwesenheit Baronesse -- neuerlich Brief -- Charlotte auffordern -- Ottilie dorthin senden -- bringen abermals Sprache -- 
  Ottilie verweigern ausdrücklich -- dasjenig finden -- Welt nennen pflegen -- 
  Lasse -- lieb Tante -- -- einschränken eigensinnig erschein -- dasjenig Aussprech verschweigen -- verbergen Fall Pflicht -- 
  seltsam unglücklich Mensch -- schuldlos -- fürchterlich Weise zeichnen -- 
  Gegenwart erregen sehen -- gewahr -- Art entsetzen -- 
  ungeheure ansehen auferlegen -- neugierig ängstlich -- 
  bleiben Haus -- Stadt -- worin ungeheuer geschehen -- furchtbar betreten -- 
  leuchten Licht Tag hell -- Stern scheinen Glanz verlieren -- 
  -- entschuldigen -- Unglückliche Indiskretion Mensch -- albern Zudringlichkeit ungeschickt Gutmütigkeit -- 
  verzeihen -- reden -- unglaublich arm Mädchen gelitt -- Luciane verborgen Zimmer Haus hervorziehen -- freundlich beschäftigen -- Absicht Spiel Tanz nötigen -- 
  arm Kind bange bang zuletzt Floh Ohnmacht sinken -- arme fassen -- Gesellschaft erschrecken aufgeregt neugierig unglückselige -- 
  denken -- gleich Schicksal bevorstehen -- Mitgefühl -- lebhaft -- lebendig -- 
  mitleiden wenden hüt -- ähnlich Auftritt Anlaß geben -- 
  -- lieb Kind -- versetzen Charlotte -- Anblick Mensch nirgends entziehen -- 
  Kloster -- Freistatt Gefühl finden -- 
  Einsamkeit Freistatt -- lieb Tante -- versetzen Ottilie -- 
  schätzenswertest Freistatt suchen -- tätig -- 
  Büßung -- Entbehrung keineswegs geeignet ahnungsvoll Geschick entziehen -- verfolgen entscheiden -- 
  -- müßigen Zustande Welt Schau dienen -- widerwärtig ängstigen -- 
  Finden freudig Arbeit -- unermüden Pflicht -- Blick aushalten -- göttlich Scheue brauchen -- 
  müssen irren -- versetzt Charlotte -- Neigung Pension zurückzögen -- 
  -- versetzen Ottilie -- leugnen -- 
  denken glücklich Bestimmung -- gewöhnlich Weg erziehen -- sonderbar Erzog -- 
  sehen Geschichte -- Mensch -- sittlich Unfall Wüsst zurückzogen -- keineswegs -- hoffen -- verbergen decken -- 
  zurückrufen Welt -- verirrter Weg führen -- Irrgängen Leben Eingeweiht -- 
  berufen Unglücklichen beizusteh -- vermögen eher -- irdisch Unheil begegnen -- 
  wählst sonderbar Bestimmung -- versetzen Charlotte -- 
  widersterben -- -- -- hoffen -- kurzen -- 
  danken -- Ottilie -- Versuch -- Erfahrung gönnen -- 
  Schmeichle -- glücken -- 
  Ort erinnern -- Prüfung ausgestanden -- klein -- nichtig -- nachher erfahren müssen -- 
  heit verlegenheiter jung Aufschößlinge betrachten -- kindlich Schmerz lächeln leiser Hand Verirrung herausführen -- 
  Glücklich geeignet Glückliche vorzustehen -- 
  liegen menschlich Natur -- fordern empfangen -- 
  Unglückliche erholen -- wissen Gefühl nähren -- mäßig Entzück nossen -- 
  Laß dein Vorsatz -- Charlotte zuletzt einig Bedenken -- Einwurf anführen -- Wichtigste scheinen -- 
  -- Rede -- 
  Gesinnung gut vernünftig fromm Gehilfe -- Weg gehst -- Werter unentbehrlich -- 
  -- Gefühl -- leben -- künftig -- Mitwirkung gewohnen -- Geschäft verwalten -- 
  anfangs beistehen -- hernach verleiden -- 
  Geschick sanft verfahren -- versetzen Ottilie -- lieben besseres erwarten -- 
  verständig Freund -- -- hoffen -- Empfindung rein Verhältnis entwickeln -- geweiht Person erblicken -- ungeheur Übel aufzuwiegen vermögen -- heilige widmen -- unsichtbar umgebend ungeheur zudringend Mächt beschirmen -- 
  Charlotte lieb Kind herzlich äußern -- still Überlegung -- 
  verschiedentlich -- obgleich leisest -- angeforscht -- Annäherung Ottilies Eduard denkbar -- leise Erwähnung -- minde Hoffnung -- klein Verdacht scheinen Ottilie auf tief rühren -- sprechen einst -- umgehen -- hierüber deutlich -- 
  Entschluß -- entgegnet Charlotte -- Eduard entsagen -- fest unveränderlich -- hüt Gefahr Wiedersehen -- 
  Entfernung geliebt Gegenstand scheinen -- lebhaft Neigung -- desto Herr -- Gewalt Leidenschaft -- außen erstrecken -- innen wenden -- -- geschwind Irrtum gerissen -- dasjenig entbehren glauben -- unentbehrlich unser Auge stehen -- 
  Tue dein Zustand gemäßesen Hältst -- prüfen -- verändre deinen gegenwärtig Entschluß -- 
  -- frei -- wollend Herz -- 
  Laß zufällig -- Überraschung -- vorig Verhältnis hineinziehen -- Zwiespalt Gemüt unerträglich -- 
  -- ehe Schritt tusen -- ehe entfernst neu Leben anfängst -- wissen Weg leiten -- bedenke -- Zukunft Eduard entsagen -- 
  hierzu bestimmen -- schließen Bund -- einlassen -- Unterredung -- aufsuchen -- drängen -- 
  Ottilie besann Augenblick -- Charlotte Wort -- geben -- 
  schweben Charlotte Drohung Eduard Seele -- Ottilie entsagen können -- Charlotte trennen -- 
  Umstand verändern -- mancherlei vorgefallen -- Augenblick abgedrungen Wort folgend Ereignis aufheben -- dennoch entferntest Sinn weder wagen -- Vornehmen verletzen -- Mittler Fall Eduard Gesinnung erforschen -- 
  Mittler Tod Kind Charlotte öfters -- obgleich Augenblick -- besuchen -- 
  Unfall -- Wiedervereinigung beide Gatte höchst unwahrscheinlich -- wirken gewaltsam -- Sinnesweise hoffend strebend -- freut still Entschluß Ottilies -- 
  vertraut lindernd vorüberziehend -- dacht Gatte zusammenzuhalten leidenschaftlich Bewegung Prüfung ehelich Liebe Treue -- 
  Charlotte anfangs Major Ottilies Erklärung schriftlich unterrichten -- inständig bitten -- Eduard vermögen -- Schritt geschähen -- ruhig verhalt -- abwart -- Gemüt schön Kind herstellen -- 
  spät Ereignis Gesinnung Nötige mitteilen -- freilich Mittlerum schwierig Aufgabe übertragen -- Veränderung Zustand Eduard vorbereiten -- 
  Mittler -- wohlwissend -- Geschehen eher gefallen lassen -- Geschehender einwilligen -- überredet Charlotte -- 
  gut -- Ottilie Pension schicken -- 
  -- sobald weg -- Anstalten Reise -- 
  Ottilie packen -- Charlotte -- weder schön Köfferche -- mitzunehmen Anschickt -- 
  Freundin schweigen lassen schweigend Kind gewähren -- 
  Abreise herbei -- Charlottes Wagen Ottilie bekannt Nachtquartier -- Pension bringen -- Nanny begleiten Dienerin bleiben -- 
  leidenschaftlich Mädchen Tod Kinde Ottilie zurückgefund hing Natur Neigung -- scheinen -- unterhaltend Redseligkeit -- Versäumt nachbringen geliebt Herrin völlig widmen -- 
  Glück mitzureisen -- fremd Gegende sehen -- niemals Geburtsort -- rannen Schlos Dorf -- Eltern -- verwandter -- Glück verkündigen Abschied nehmen -- 
  Unglücklicherweise treffen Zimmer Maserkranken empfinden sogleich Folge Ansteckung -- 
  Reise aufschieben -- Ottilie drang -- Weg -- kennen Wirtsleute einkehren -- Kutscher Schloß führen -- besorgen -- 
  Charlotte widersetzen -- eilt Gedanke Umgebung weg -- Zimmer Ottilie Schloß bewohnen -- Eduard einrichten -- Ankunft Hauptmann -- 
  Hoffnung alt Glück wiederherzustellen flammen Mensch -- Charlotte Hoffnung abermals berechtigen -- nötigen -- 
  Sechzehntes Kapitel -- 
  Mittler kommen -- Eduard Sache unterhalten -- finden -- Kopf Hand gelehnen -- Arm Tisch stemmen -- 
  scheinen leiden -- 
  Plagen Kopfweh -- fragen Mittler -- 
  plagen -- versetzen -- hassen -- 
  erinnern Ottilie -- 
  leiden -- denken -- linker Arm stützen -- leiden -- 
  tragen -- -- 
  Schmerz heilsam -- -- beinahe sagen -- wünschenswert -- 
  mächtig -- deutlich -- lebhaft schweben Bild Geduld -- übrig Vorzüg begleiten -- Seele -- leiden empfinden vollkommen Eigenschaft -- nötig ertragen -- 
  Mittler Freund Grade resignieren finden -- halten Anbring -- stufenweise -- Gedanke Frau entsprungen -- Vorsatz reifen -- historisch vortragen -- 
  Eduard äußern -- 
  weniger -- scheinen hervorzugehen -- überlassen -- gegenwärtig Schmerz scheinen gleichgültig -- 
  -- stehen Zimmer -- 
  fühlen Schmerz -- beschäftigen -- 
  Mittler Erzählung Einbildungskraft Liebenden lebhaft ergehen -- 
  Ottilie -- -- wohlbekannt Weg -- gewohnt Wirtshause -- Zimmer betreten -- denken -- überlegen -- vielmehr -- denken -- überlegen -- wünschen -- -- 
  müssen sehen -- sprechen -- 
  wozu -- -- entstehen -- Rede -- 
  Widerstand -- müssen -- 
  Kammerdiener vertrauen ziehen -- erforschen sogleich Stunde -- Ottilie reisen -- 
  brechen -- Eduard säumen -- unbegleiten Pferd begeben -- Ottilie übernachten -- 
  allzuzeitig -- überrascht Wirtin empfangen Freude -- Familienglück schuldig -- 
  Sohn -- Soldat brav halten -- Ehrenzeich verschaffen -- -- wobei gegenwärtig -- herausheben -- Eifer Feldherrn bringen Hindernis Mißwollende überwinden -- 
  wissen -- Liebe -- 
  räumen schnell Putzstube -- freilich Garderobe Vorratskammer -- möglichst -- kündigen Ankunft Frauenzimmer -- hereinziehen -- lassen Kammer hinten Gange notdürftig einrichten -- 
  Wirtin erscheinen Sache geheimnisvoll -- angenehm -- Gönner -- interessiert tätig zeigen -- Gefällige erweisen -- 
  -- Empfindung bringen Abend -- 
  betrachtet Zimmer rings umher -- sehen -- scheinen häuslich Seltsamkeit himmlisch Aufenthalt -- 
  denken -- Ottilie überraschen -- vorbereiten -- 
  gewinnen letzterer Meinung Oberhand -- setzen schreiben -- 
  Blatt empfangen -- 
  Eduard Ottilie -- 
  Brief lesen -- Geliebtest -- Nähe -- 
  Mußt erschrecken -- entsetzen -- befürchten -- 
  drängen -- 
  siehst eher erlaubst -- 
  Bedenke vorher Lage -- meinigen -- 
  danken -- entscheidend Schritt vorhast -- bedeutend -- tun -- 
  -- Art Scheideweg -- überlegen nochmals -- -- -- 
  O erzeigst Wohltat überschwenglichen -- 
  Laß wiedersehen -- Freude wiedersehen -- 
  Laß schön Frage mündlich -- beantworten Schöne -- 
  Brust -- Ottilie -- hierher -- manchmal ruhen Hingehörst -- -- 
  schreiben -- ergriff Gefühl -- Höchstersehnt nahe -- gegenwärtig -- 
  Tür hereintreen -- Brief lesen -- dastehen -- Erscheinung herbeisehnten -- 
  -- 
  Gestalt -- Gesinnung verändern -- 
  halten Feder Hand -- schreiben denken -- Wagen rolln Hof -- 
  flüchtig Feder setzen hinzu -- 
  hören -- 
  Augenblick leben -- 
  faltet Brief -- überschrieb -- Siegel spät -- 
  springen Kammer -- nachh Gang gelangen wissen -- Augenblick fallen -- Petschaft Tisch lassen -- 
  sehen -- springen holen glücklich weg -- 
  Vorsaal vernehmen Wirtin -- Zimmer losging -- Gast anzuweisen -- 
  eilt Kammertür -- zugefahren -- 
  Schlüssel Hineinspring herunter werfen -- liegen inwendig -- Schloß zugeschnappen Stand bannen -- 
  heftig drängt Türe -- -- 
  O wünschen Geist Spalte schlüpfen -- 
  vergebens -- 
  verbergen Gesicht Türpfosten -- 
  Ottilie treten herein -- Wirtin -- erblicken -- -- 
  Ottilie Augenblick verbergen bleiben -- 
  wenden -- stehen Liebenden abermals seltsamst Weise -- 
  ruhig ernsthaft -- zurückzugeh -- Bewegung -- nähern -- treten Schritt Tisch -- 
  treten -- 
  Ottilie -- rufen -- laß furchtbar schweigen brechen -- 
  Schatten -- stehen -- 
  Ding hören -- Zufall -- Findest -- 
  liegen Brief -- vorbereiten -- 
  Lies -- bitte -- lies -- beschließe -- 
  blicken herab Brief einig besinner -- Erbrach lesen -- 
  Miene verändern -- lesen legen leise weg -- drückt flach -- Höhe gehoben Hand -- führen Brust -- vorwärts neigen -- dringend Fordernde Blick -- abzustehen nötigen -- verlangen wünschen -- 
  Bewegung zerreißen Herz -- 
  Anblick -- Stellung Ottilies ertragen -- 
  völlig -- Knie sinken -- beharren -- 
  eilt verzweifelnd Tür hinaus schicken Wirtin Einsamen -- 
  Vorsaal -- 
  Nacht -- Zimmer bleiben Still -- 
  treten Wirtin heraus -- ziehen Schlüssel -- 
  Frau rühren -- verlegen -- wissen -- 
  zuletzt weggehen bieten Schlüssel Eduard -- ablehnen -- 
  lassen Licht stehen entfernen -- 
  Eduard tief Kummer werfen Ottilies Schwelle -- Träne benetzen -- 
  Jammervoller bringen jemals Nähe Liebende Nacht -- 
  brechen -- Kutscher treiben -- Wirtin Schloß treten Zimmer -- 
  finden Ottilie ankleiden eingeschlafen -- winken Eduard teilnehmend Lächel -- 
  treten Schlafende -- Anblick vermögen Eduard auszuhaln -- 
  Wirtin wagt ruhend Kind wecken -- setzen -- 
  schlagen Ottilie schön Auge richten Fuß -- 
  lehnen Frühstück -- treten Eduard -- 
  bitten inständig -- Wort reden -- Wille erklären -- 
  wollen Wille -- schwören -- schweigen -- 
  nochmals fragen liebevoll dringend -- angehören wollen -- 
  lieblich bewegen -- niedergeschlagen Auge -- Haupt sanfen -- 
  fragen -- Pension wollen -- 
  gleichgültig verneinen -- 
  fragen -- Charlotte zurückführen dürfen -- bejahen getrost Neig Haupt -- 
  eilen an Fenster Kutscher Befehl geben -- weg -- Blitz Stube hinaus -- Treppe hinab Wagen -- 
  Kutscher nehmen Weg Schloß -- Eduard folgen Pferd Entfernung -- 
  Siebzehntes Kapitel -- 
  höchst überraschen Charlotte Ottilie vorfahren Eduard Pferde sogleich Schloßhof hereinsprengen -- 
  eilt Türschwelle -- 
  Ottilie steigen nähern Eduard -- 
  Eifer Gewalt fassen Hand beide ehegatter -- drücken eilen Zimmer -- 
  Eduard werfen Charlotte Hals zerfließen Träne -- erklären -- bitten Geduld -- Ottilie beizustehen -- helfen -- 
  Charlotte eilen Ottilies Zimmer schaudern Hineintritt -- 
  ausräumen -- leer Wand stehen -- 
  erscheinen weitläufig unerfreulich -- 
  weggetragen -- Köfferche -- unschlüssig hinstell -- Mitte Zimmer stehen gelassen -- 
  Ottilie liegen Boden -- Arm Haupt Koffer strecken -- Charlotte bemühen -- fragen vorgehen -- erhalten Antwort -- 
  lassen Mädchen -- Erquickung -- Ottilie eilen Eduard -- 
  finden Saal -- belehren -- 
  werfen nieder -- baden Hand Träne -- fliehen Zimmer -- nachfolgen -- begegnen Kammerdiener -- aufklären soweit vermögen -- 
  Übrige denken -- sogleich Entschlossenheit Augenblick fordern -- 
  Ottilies Zimmer auf baldig einrichten -- 
  Eduard seinigen antreffen -- letzter Papier -- verlassen -- 
  scheinen gegeneinander finden -- Ottilie fahren fort schweigen -- Eduard vermögen Gattin Geduld bitten -- fehlen scheinen -- 
  Charlotte senden Bote mittler Major -- 
  antreffen -- -- 
  schütten Eduard Herz -- gestehen klein Umstand -- erfahren Charlotte begegnen -- Lage sonderbar verändern -- Gemüt aufgeregen -- 
  sprechen auf liebevollster Gemahl -- 
  wissen Bitte -- Kind gegenwärtig bestürmen mögen -- 
  Eduard fühlen Wert -- Liebe -- Vernunft Gattin -- Neigung beherrschen ausschließlich -- 
  Charlotte Hoffnung -- versprechen Scheidung willigen -- 
  trauen -- krank -- Hoffnung Glaube abwechselnd verlassen -- dringen Charlotte -- Major Hand zusagen -- Art wahnsinnig Unmut ergreifen -- 
  Charlotte -- besänftigen -- erhalten -- tun fordern -- 
  Major Hand -- Fall -- Ottilie Eduard verbinden wollen -- ausdrücklich Bedingung -- Mann Augenblick Reise -- 
  Major Hof auswärtig Geschäft -- Eduard versprechen begleiten -- 
  Anstalt beruhigen einigermaßen -- geschehen -- 
  unterdessen bemerken -- Ottilie Speise Trank nehmen -- Immerfort schweigen verharren -- 
  reden -- ängstlich -- unterlassen -- 
  meistenteils Schwäche -- quälen -- 
  Charlotte Sann -- geraten Gedanke -- Gehilfe Pension lassen -- Ottilie vermochen -- unvermuten Außenbleiben freundlich äußern -- Antwort erhalten -- 
  sprechen -- Ottilie überraschen -- Vorsatz Gegenwart -- 
  scheinen einstimmen -- bedenken -- scheinen Entschluß reifen -- eilen Zimmer senden Abend versammelte folgend Schreiben -- 
  Ottilie Freund -- 
  ausdrücklich sagen -- Geliebten -- verstehen -- 
  Bahn geschriten hinein -- 
  feindselig Dämon -- gewinnen -- scheinen außen hindern -- Einigkeit finden -- 
  rein Vorsatz -- Eduard entsagen -- entfernen -- 
  hoffen begegnen -- 
  -- stehen Wille -- 
  Versprechen Unterredung einlassen -- buchstäblich nehmen deuten -- 
  Gefühl Gewissen Augenblick schweigen -- verstummen Freund -- sagen -- 
  streng Ordensgelübde -- Überlegung eingehen -- unbequem ängstiget -- zufällig -- Gefühl dringen -- nehmen -- 
  lassen beharren -- Herz gebieten -- 
  Beruft Mittelsperson -- 
  Dringt -- reden -- Speis Trank genießen -- höchstens Bedarf -- 
  helft Nachsicht Geduld hinweg -- 
  jung -- Jugend stellen unversehens -- 
  Duldet eurer Gegenwart -- erfreut eure Liebe -- belehren eur Unterhaltung -- Inneres überlassen -- 
  längst vorbereitet Abreise Mann unterbleiben -- auswärtig Geschäft Major verzögeren -- 
  erwünschen Eduard -- 
  Ottilies Blatt auf anregen -- trostvoll hoffnunggebend Wort ermutigen standhaft ausharren berechtigen -- erklären -- 
  entfernen -- 
  töricht -- rufen -- Unentbehrlichst -- Notwendigste vorsätzlich -- voreilig wegzuwerfen -- -- Verlust bedrohen -- erhalten -- 
  heißen -- 
  -- Mensch scheinen -- wählen -- 
  -- beherrschen albern Dünkel -- Stunde früh -- Freund losgerissen -- letzter unausweichlich Termin entschieden zwingen -- 
  diesmal bleiben -- 
  entfernen -- 
  entfernen -- 
  fallen -- Hand fassen -- Herz drücken -- sogar denken -- schaudern -- 
  weg -- weggehoben -- 
  bleiben -- -- müssen -- 
  Behag glich -- Zusammenfand -- 
  Empfindung bleiben -- selig Notwendigkeit entziehen -- 
  üben unbeschreiblich -- fast magisch Anziehungskraft -- 
  wohnen Dache -- denken -- Ding beschäftigen -- Gesellschaft ziehen -- nähern -- 
  Fande saal -- dauern stehen -- sitzen -- 
  nächster Nähe beruhigen -- völlig beruhigen -- Nähe -- Blick -- Wort -- Gebärde -- Berührung bedürfen -- rein Zusammensein -- 
  Mensch -- Mensch bewußtlos vollkommen Behag -- zufried Welt -- 
  -- eins letzter Wohnung festhalten -- -- Vorsatz -- hinbewegen -- 
  Leben Rätsel -- Auflösung finden -- 
  Ottilie heit lassen -- völlig beruhigen -- 
  entfernt Gesellschaft -- erlangen -- speisen -- 
  Nanny bedienen -- 
  Mensch gewöhnlich begegnen -- wiederholt glauben -- Natur hierzu nächster Bestimmung -- 
  Charakter -- Individualität -- Neigung -- Richtung -- Örtlichkeit -- Umgebung Gewohnheit bilden -- Mensch -- Element -- Atmosphäre -- schwimmen -- worin bequem behaglich -- 
  finden Mensch -- Veränderlichkeit Klage führen -- unser erstaunen unverändert -- äußerer innerer unendlich Anregung unveränderlich -- 
  bewegt täglich zusammenleben Freund fast alt Gleis -- 
  äußern Ottilie stillschweigend Gefälligkeit zuvorkommend Wesen -- jeder Art -- 
  Weise zeigen häuslich Zirkel Scheinbild vorig Leben -- Wahn -- alt -- verzeihlich -- 
  herbstlich -- Länge Frühlingstagen -- rufen Gesellschaft Stunde frei Haus -- 
  Schmuck Früchte Blume -- -- lassen glauben Herbst Frühling -- Zwischenzeit vergessen fallen -- 
  blüht Blume -- dergleichen säen -- reift Frucht Baum -- blühen sehen -- 
  Major -- Mittler lassen öfter sehen -- 
  Abendsitzung meistens regelmäßig -- 
  Eduard lesen gewöhnlich -- lebhaft -- gefühlvoll -- -- sogar Heiterer -- -- jemals -- 
  -- Fröhlichkeit Gefühl -- Ottilies erstarren beleben -- schweigen auflösen -- 
  setzen vormals -- Buch sehen -- unruhig -- zerstreuen -- hineinsehen -- gewiß -- Wort Auge folgen -- 
  jeder unerfreulich unbequem Gefühl mittlerer auslöschen -- 
  Keines tragen -- Art Bitterkeit verschwinden -- 
  Major begleiten Violine Klavierspiel Charlottes -- Eduard Flöte Ottilies Behandlung Saiteninstrument vormals zusammentreffen -- 
  rücken Geburtstage Eduard nah -- Feier erreichen -- 
  Festlichkeit still freundlich Behag diesmal feiern -- 
  -- halb stillschweigend halb ausdrücklich -- übereingekommen -- 
  nah Epoche heranrücken -- vermehrt Feierlich Ottilies Wesen -- empfinden bemerken -- 
  scheinen Garten Blume mustern -- Gärtner andeuten -- Sommergewachs Art schon -- Aster aufhalten -- unmäßig Menge blühten -- 
  achtzehnt Kapitel -- 
  Bedeutendste Freund still Aufmerksamkeit beobachteten -- -- Ottilie Koffer erstenmal auspacken verschieden wählen abschneiden -- einzig voll Anzug hinreichen -- 
  Übrige Beihilfe Nannys einpacken -- Stande -- Raum übervoll -- obgleich herausnehmen -- 
  jung habgierig Mädchen sehen -- klein Stück Anzug sorgen finden -- 
  Schuh -- Strümpf -- Strumpfbänd Devise -- Handschuhe übrig -- 
  bitten Ottilie -- schenken -- 
  verweigern -- ziehen sogleich Schublade Commode heraus lassen Kind wählen -- hastig ungeschickt zugriffr Beute laufen -- übrig Hausgenoss Glück verkünden vorzeigen -- 
  zuletzt gelingen Ottilie sorgfältig einzuschichn -- öffnet hierauf verborgen Fach Deckel anbringen -- 
  Zettelch Brief Eduard -- mancherlei aufgetrocknet Blumenerinnerung früh Spaziergäng -- lock geliebter -- verbergen -- 
  einer fügen hinzu -- Porträt Vater -- verschließen -- worauf zart Schlüssel golden Kettchen Hals Brust hing -- 
  Mancherlei Hoffnung indes Herzen Freund regen -- 
  Charlotte überzeugen -- Ottilie sprechen anfangen -- 
  heimlich Geschäftigkeit beweisen -- Art heiter Selbstzufriedenheit -- lächeln demjenig Gesicht schweben -- geliebter Erfreuliches verbergen -- 
  wissen -- Ottilie Stunde Schwachheit hinbrachen -- Zeit -- erscheinen -- Geisteskraft emporhieln -- 
  Mittler öfter sehen lassen lang bleiben gewöhnlich -- 
  hartnäckig Mann wissen -- gewiß Moment Eisen schmieden -- 
  Ottilies schweigen Weigerung legen Gunst -- 
  Schritt Scheidung Gatte geschehen -- hofft Schicksal gut Mädchen günstig Weise bestimmen -- horchen -- -- verstehen führt Weise klug -- 
  überwältigen stets sobald Anlaß finden -- Räsonnement Materien äußeren -- Wichtigkeit beilegen -- 
  leben -- -- verhieln gewöhnlich handelnd -- 
  Brach Freund Rede -- öfter sehen -- rollt Rücksicht fort -- verletzen heilen -- nutzen schaden -- fügen -- 
  Abend Eduard Geburtstag sitzen Charlotte Major -- Eduard ausgeriten -- erwartend beisammen -- Mittler Zimmer -- Ottilie ihrigen bleiben -- morgend Schmuck auseinander legend Mädchen andeutend -- vollkommen verstehen stumm Anordnung geschickt befolgen -- 
  Mittler Lieblingsmaterien kommen -- 
  pflegen behaupten -- sowohl Erziehung Kind Leitung Volk -- ungeschickt barbarisch Verbot -- verbietend Gesetz Anordnung -- 
  Mensch Haus tätig -- -- Gebiet verstehen -- fahren -- handeln richten -- 
  Person Kreis Fehler Gebrechen dulden -- entgegengesetzt Tugend gebieten -- Fehler Stelle sehen -- 
  Mensch tun -- Zweckmäßig -- -- tun -- -- sinnen -- albern Streich -- Müßiggang lang Weile vornehmen -- 
  verdrießlich -- anhören -- Zehngebot Kinderlehr wiederholen lassen -- 
  hübsch vernünftig gebietend Gebot -- sollst Vater Mutter ehren -- 
  Kind Sinn schreiben -- ausüben -- 
  -- sagen -- 
  Sollst töten -- 
  Mensch mindest Lust tot schlagen -- 
  hassen -- erzürnen -- übereilen Gefolge -- gelegentlich tot schlagen -- 
  barbarisch Anstalt -- Kind Mord Totschlag verbieten -- 
  hieße -- Sorge Leben -- entferne schädlich -- rett Gefahr -- beschädigst -- denken beschädigst -- 
  Gebot gebildet vernünftig Volk Stadt -- Katechismuslehre kümmerlich Wasistder nachschleppen -- 
  -- finden abscheulich -- 
  -- neugierd vorahnend Kind gefährlich Mysteri reizen -- Einbildungskraft wunderlich Bild Vorstellung aufregen -- entfernen -- Gewalt heranbringen -- 
  -- dergleich heimlich Gericht willkürlich bestrafen -- Kirche Gemeinde plappern lassen -- 
  Augenblick treten Ottilie herein -- sollst ehebrechen -- fahren Mittler fort -- grob -- unanständig -- 
  Klang heißen -- sollst Ehrfurcht ehelich Verbindung -- Gatten siehst lieben -- sollst freuen nehmen Glück heiteren Tag -- 
  Verhältnis trüben -- sollst such aufklären -- Sollst suchen Begütig -- besänftig -- wechselseitig Vorteil deutlich -- schön Uneigennützigkeit fördern -- fühlbar machen Glück Pflicht entspringen -- Mann Weib unauflöslich verbinden -- 
  Charlotte sitzen Kohle -- Zustand ängstlich überzeugen -- Mittler wissen er_es -- ehe unterbrechen -- Ottilie -- Gestalt verwandeln -- Zimmer -- 
  erlass Gebot -- Charlotte erzwungen lächeln -- 
  übrig -- versetzen Mittler -- retten -- worauf beruhen -- 
  entsetzlich Schrei hereinstürzend rufen Nanny -- sterben -- 
  Fräulein sterben -- 
  -- -- 
  Ottilie Zimmer schwankend zurückgekommen -- liegen morgend Schmuck mehrere Stuhl völlig ausbreiten -- Mädchen -- betrachtend bewundernd Herging -- rufen jubelnd -- sehen -- lieb Fräulein -- Brautschmuck wert -- 
  Ottilie vernehmen Wort sinken Sofa -- 
  Nanny sehen Herrin erblassen -- erstarren -- laufen Charlotte -- -- 
  ärztlich Hausfreund eilen herbei -- scheinen Erschöpfung -- 
  lassen Kraftbrüh bringen -- Ottilie weisen Abscheu weg -- fallen fast Zuckung Taß Mund nähern -- 
  fragen Ernst -- Umstand eingeben -- 
  Ottilie nossen -- 
  Mädchen stocken -- wiederholt Frage -- Mädchen bekennen -- Ottilie nossen -- 
  Nanny erscheinen ängstlicher billig -- 
  reißen Nebenzimmer -- Charlotte folgen -- Mädchen werfen Knie -- gestehen -- Ottilie genieße -- 
  Andring ottilies speis Stadt nossen -- verschwiegen bittend drohend Gebärde Gebieterin -- -- setzen unschuldig hinzu -- 
  schmecken -- 
  Major Mittler kommen heran -- finden Charlotte tätig Gesellschaft Arzt -- 
  bleich himmlisch Kind sitzen -- bewußt scheinen -- Ecke Sofas -- 
  bitten niederlegen -- verweigern -- winken Köfferche herbeibringen -- 
  setzen Füße finden halb liegend bequem Stellung -- 
  scheinen Abschied nehmen -- Gebärde drücken umstehende zartest Anhänglichkeit -- Liebe -- Dankbarkeit -- Abbitte herzlichster Lebewohl -- 
  Eduard Pferde steigen -- vernimmen Zustand -- stürzen Zimmer -- werfen Seite nieder -- fassen Hand überschwemmen stumm Träne -- 
  bleiben -- 
  rufen -- Stimme wiederhören -- Wort Leben zurückkehren -- 
  -- -- 
  Folge hinüber -- 
  Sprache reden -- 
  drücken kräftig Hand -- blicken lebevoll liebevoll -- tief Atemzug -- himmlisch -- stumm Bewegung Lippe -- versprich leben -- rufen -- hold zärtlich Anstrengung -- sinken -- 
  versprechen -- rufen entgegen -- rufen -- abgeschieden -- 
  tränenvoll Nacht fallen Sorge -- geliebt Rest bestatt -- Charlotte Anheim -- 
  Major Mittler stehen -- 
  Eduard Zustand bejammern -- 
  Verzweiflung hervorheben einigermaßen besinnen -- bestehen -- 
  Ottilie Schlos bringen -- warten -- pflegen -- lebende behandeln -- tot -- können tot -- 
  Wille -- insofern unterließ verbieten -- 
  verlangen sehen -- 
  anderer Schreck ergreifen -- Sorge beschäftigter Freund -- 
  Nanny Arzt heftig gescholten -- Drohung Bekenntnis nötigen -- Bekenntnis Vorwurf überhäufen -- entflohen -- 
  lang suchen finden -- scheinen -- 
  Eltern nehmen -- 
  gut Begegnung scheinen anschlagen -- müssen einsperren -- entfliehen drohen -- 
  Stufenweise gelingen -- Eduard heftigsen Verzweiflung entreißen -- Unglück -- 
  deutlich -- gewiß -- Glück Leben verlieren -- 
  wagen vorstellen -- Ottilie Kapelle beisetzen -- Lebendig bleiben freundlich still Wohnung entbehren -- 
  fallen schwer Einwilligung erhalten -- Bedingung -- offen Sarge hinausgetragen -- Gewölbe allenfalls Glasdeckel zudecken immerbrennend Lampe stiften -- lassen sich_es zuletzt fallen scheinen ergeben -- 
  kleiden hold Körper Schmuck vorbereiten -- setzen Kranz Asterblumen Haupt -- traurig Gestirn ahnungsvoll glänzen -- 
  Bahr -- Kirche -- Kapelle schmücken -- Garten Schmuck berauben -- 
  liegen veröden Winter Freude Beete weggetilgen -- 
  frühst offen Sarge Schloß tragen aufgehend Sonne rötet nochmals himmlisch Gesicht -- 
  Begleitende drängen Träger -- vorausgeh -- folgen -- umgeben -- letztenmal Gegenwart genießen -- 
  Knabe -- Mann Frau -- keins bleiben ungerühren -- 
  untröstlich Mädchen -- Verlust unmittelbarsten empfinden -- 
  Nanny fehlen -- 
  zurückhalten vielmehr Stunde Begräbnisses verheimlichen -- 
  bewacht Eltern Kammer -- Garten -- 
  Glocke läuten hören -- allzubald inne vorging -- Wächterin -- Neugierd Zug sehen -- verlassen -- entkommen Fenster hinaus Gang -- Tür verschlossen finden -- Oberboden -- 
  schwanken Zug reinlich Blätter bestreuen Weg durch Dorf -- 
  Nanny Gebieterin deutlich -- deutlich -- vollständig -- schön Zug folgen -- 
  überirdisch -- Wolke Woge tragen -- scheinen Dienerin winken -- verworren schwankend taumelnd stürzen Hinab -- 
  auseinander fahren Menge entsetzlich Schrei Seite -- 
  drängen Getümmel Träger nötigen Bahr niederzusetzen -- 
  Kind liegen nahe -- scheinen Gliedern zerschmettern -- 
  heben -- zufällig besonderer Fügung lehnt Leiche -- scheinen letzter Lebensrest geliebt Herrin erreichen -- 
  schlotternd Glied Ottilies Gewand -- kraftlosen Finger Ottilies gefaltet Hand berühren -- Mädchen Aufsprang -- arm Auge gen Himmel erheben -- Knie Sarge niederstürzen andächtig entzücken Herrin hinauf staunen -- 
  springen begeistert rufen heilig Freude -- 
  -- vergeben -- 
  Mensch -- vergeben -- vergeben Gott Blick -- Gebärde -- Mund -- 
  ruhen still sanft -- sehen aufrichtet entfaltet Hand segnen -- freundlich anblicken -- 
  gehören -- Zeuge -- vergeben -- -- 
  Mörderin -- verzeihen -- Gott verzeihen -- anhaben -- 
  umhergedrängt stehen Menge -- erstaunt -- horchten sehen -- wissen beginnen -- 
  Tragt Ruhe -- Mädchen -- Ihrig tun gelitt -- wohnen -- 
  Bahre bewegen -- Nanny folgen gelangt Kirche -- Kapelle -- 
  stehen Sarg Ottilies -- Häupten Sarg Kind -- Fuß Köfferche -- stark eichen Behältni einschließen -- 
  Wächterin sorgen -- Leichnam wahrnehmen -- Glasdecke liebenswürdig dalag -- 
  Nanny Amt nehmen lassen -- -- Gesellin bleiben erstenmal angezündet Lampe fleißig warten -- 
  verlangen eifrig hartnäckig -- nachgeben -- größeres Gemütsübel befürchten lassen -- verhüten -- 
  bleiben -- 
  sinkend Nacht -- schwebend Licht voll ausübend heller Schein verbreiten -- öffnet Türe treten Architekt Kapelle -- fromm verziert Wand -- mild Schimmer -- altertümlich Ahnungsvoller -- glauben -- entgegen dringen -- 
  Nanny sitzen Seite Sarges -- 
  erkennen -- schweigend deutet verblichen Herrin -- 
  stehen Seite -- jugendlich Kraft Anmut -- zurückweisen -- starr -- kehren -- niedergesenkt arme -- falteten -- mitleidig gerungen Hand -- Haupt Blick Entseelt hingeneigen -- 
  Belisar gestehen -- 
  unwillkürlich geraten gleich Stellung -- diesmal -- 
  unschätzbar Würdig Höhe herabgestürzen -- Tapferkeit -- Klugheit -- -- Rang Vermögen Manne unwiederbringlich verlieren bedauern -- Eigenschaft -- Nation -- Fürst -- entscheidend Moment unentbehrlich -- schätzen -- vielmehr verwerfen ausgestoß -- 
  still Tugende -- Natur gehaltreich Tiefe hervorrufen -- gleichgültig Hand schnell ausgetilgt -- selten -- schön -- liebenswürdig Tugende -- friedlich Einwirkung bedürftig Welt wonnevoll Genügen umfängen sehnsüchtig Trauer vermissen -- 
  Jüngling schweigen -- Mädchen -- Träne häufig Auge quellen -- Schmerz auflösen scheinen -- sprechen Wahrheit Kraft -- Wohlwollen Sicherheit -- -- Fluß Rede erstaunt -- fassen vermögen -- schön Freundin hoch Region lebend wirkend vorschweben -- 
  Träne trocknen -- Schmerz linderten -- kniend Ottilie -- herzlich Händedruck Nanny Abschied -- Nacht riten Ort weg sehen -- 
  Wundarzt Nacht -- Mädchen Wissen -- Kirche bleiben -- finden morgens besucht -- heit getrost Mut -- 
  mancherlei Verirrung fassen -- denken -- nächtlich Unterredung Ottilie Erscheinung sprechen -- 
  -- ruhig völlig selbstbewußt -- 
  erinnern vollkommen früh Zeit -- Zustand Genauigkeit -- Rede schreiten gewöhnlich Gang Wahren Wirkliche heraus -- Begebenheit Leichenbegängnis -- Freudigkeit wiederholen -- Ottilie aufrichten -- segnen -- Verzieh -- beruhigen -- 
  fortdauernd schön -- schlaf todähnlich Zustand Ottilies ziehen mehrere Mensch herbei -- 
  Bewohner Anwohner sehen -- Nanny's Mund Unglaublich hören -- spotten -- meister zweifeln -- glaubend verhalten -- 
  jeder Bedürfnis wirklich Befriedigung versagen -- nötigen Glaube -- 
  Auge Welt zerschmettert Nanny Berührung frommen Körper gesund -- ähnlich Glück bereiten -- 
  Zärtlich Mutter bringen heimlich Kind -- Übel behafteen -- glauben plötzlich Besserung spüren -- 
  zutrauen vermehrn -- zuletzt alt schwach -- Stelle Erquickung Erleichterung suchen -- 
  Zudrang wachsen nötigen Kapelle -- Stunde Gottesdienst -- Kirche verschließen -- 
  Eduard wagen Abgeschieden -- 
  leben -- scheinen Tran -- kein Schmerz fähig -- 
  Teilnahme Unterhaltung -- Genuß Speis -- Trank vermindern -- 
  Erquickung scheinen Glase schlürfen -- freilich wahrhafter Prophet -- 
  betrachten verschlungen Namenszug ernst-heiter Blick scheinen anzudeut -- Vereinigung hoffen -- 
  Glücklich Nebenumstand begünstigen -- jeder Ungefähr emporzuheben scheinen -- klein Vorfall Kränkung -- verderben Unglücklichen vereinigen -- 
  Tag -- Eduard -- geliebt Glas Mund bringen -- entfernt entsetzen -- 
  -- vermißt Kennzeichen -- 
  dringen Kammerdiener gestehen -- 
  echt Glas unlängst zerbroch -- gleich -- Eduard Jugendzeit -- unterschieben -- 
  Eduard zürnen -- Schicksal aussprechen -- 
  Gleichnis rühren -- 
  drücken tief -- 
  Trank scheinen widerstehen -- scheinen Vorsatz Speise -- Gespräch enthalten -- 
  überfällen Unruhe -- 
  verlangen genießen -- fangen sprechen -- 
  -- Major -- Seite -- unglücklich -- Bestreben Nachahmung -- falsch bemühen bleiben -- 
  Seligkeit -- Pein -- -- Seligkeit Wille -- genötigen Pein übernehmen -- 
  -- Weg -- Natur halten Versprechen -- 
  schrecklich Aufgabe -- Unnachahmliche nachzuahmen -- 
  fühlen -- Bester -- gehören Genie -- Märtyrertum -- 
  -- hoffnungslosen Zustande -- ehegattlich -- freundschaftlich -- ärztlich Bemühung gedenken -- Eduard angehörige herwogten -- 
  finden tot -- 
  Mittler traurig Entdeckung -- 
  berufen Arzt beobachten -- gewöhnlich Fassung -- genau Umstand verblichener antreffen -- 
  Charlotte stürzen herbei -- Verdacht Selbstmordes regen -- -- unverzeihlich Unvorsichtigkeit anklagen -- 
  Arzt natürlichen -- Mittler sittlich Grund -- wissen Gegenteil überzeugen -- 
  deutlich Eduard überraschen -- 
  -- sorgfältig verbergen pflegen -- Ottilie übrig geblieben -- still Augenblick -- Kästche -- Brieftasch ausbreiten -- Lock -- Blume glücklich Stunde pflücken -- Blättche schreiben -- Gattin zufällig ahnungsreich übergeben -- 
  ungefähren Entdeckung Wille preisgeben -- 
  liegen kurz unendlich Bewegung aufgeregt Herz unstörbar Ruhe -- Gedanke Heilige eingeschlafen -- selig nennen -- 
  Charlotte Platz Ottilie verordnet -- Gewölbe beisetzen -- 
  Bedingung Kirche Schule -- geistlich Schullehrer ansehnlich Stiftung -- 
  ruh Liebende -- 
  Friede schweben Stätte -- heit verwandte Engelsbilder schauen Gewölbe herab -- welch freundlich Augenblick -- dereinst erwachen -- 