Wilhelm Meister Lehrjahre -- 
  Roman -- 
  Herausgegebe Goethe -- 
  Band -- 
  Frankfurt Leipzig -- 1795 -- 
  Wilhelm Meister Lehrjahre -- 
  Buch -- 
  Kapitel -- 
  Wilhelm geheilt Wunde abermals frisch -- unbequem -- 
  Aurelie zugeben -- Wundarzt bedienen -- verbinden allerlei wunderlich Rede -- Zeremonie Sprüche -- setzen peinlich Lage -- 
  -- Person Nähe befinden -- leiden Unruhe Sonderbarkeit -- Felix -- 
  lebhaft Kind Druck höchst ungeduldig zeigen unartig -- tadelen zurecht weisen -- 
  Knabe gefiel gewiß Eigenheit -- Unarte nennen pflegen -- keineswegs nachzuseh Gedachte -- 
  trinken -- -- Flasche Glase -- offenbar schmeckt Speise Schüssel Teller -- 
  Unschicklichkeit übersehen -- Türe aufließ Zuschlug -- -- befohlen -- Stelle weichen ungestüm rannen -- 
  müssen Lektion anhören -- Besserung spüren lassen -- 
  vielmehr scheinen Neigung Aurelie täglich verlieren -- Tone zärtlich Mutter nennen -- Hing vielmehr leidenschaftlich alt Amme -- freilich Wille lassen -- 
  krank -- Haus still Quartier bringen müssen -- Felix sehen -- Mignon liebevoll Schutzgeist erscheinen -- 
  artig unterhielt Kind -- lehrt Lied -- Gedächtnis -- rezitiert Verwunderung Zuhörer -- 
  Landkarte erklären -- abgeben -- wobei Methode verfuhr -- 
  eigentlich scheinen Land anderer Interesse -- kalt warm -- 
  weltpolen -- schrecklich Eise -- zunehmend Wärme -- entfernen -- wissen Rechenschaft geben -- 
  reisen -- fragen -- Norden Süden gehen -- bemühen Weg Karte aufzufinden -- 
  Wilhelm Reise sprechen aufmerksam -- scheinen betrüben Gespräch Materie überging -- 
  bereden -- Rolle übernehmen -- spielen -- Theater -- fleißig lernt Oden Lied auswendig erregen -- Gedicht -- gewöhnlich ernst feierlich Art -- unvermuten Stegreif deklamieren -- erstaunen -- 
  Serlo -- Spur aufkeimend Talent gewohnen -- suchen aufmuntern -- meister Empfahl artigen -- mannigfaltig manchmal munter Gesang -- Weg Harfenspieler Gunst erwerben -- 
  Serlo -- Genie Musik -- Instrument spielen -- wissen hoch Wert schätzen -- suchen Genuß -- vergleichen -- verschaffen -- 
  wöchentlich Konzert -- Mignon -- Harfenspieler Laert -- Violine ungeschickt -- wunderlich Hauskapelle bilden -- 
  pflegen sagen -- Mensch neigen Gemeinst abgeben -- Geist Sinn stumpfen Eindruck schöne Vollkommene -- Fähigkeit empfinden -- Weise erhalten -- 
  Genuß entbehren -- Ungewohntheit genieß Ursache -- Mensch Albern Abgeschmackte -- neu -- Vergnügen finden -- 
  -- -- Lied hören -- Gedicht lesen -- trefflich Gemälde sehen -- -- -- vernünftig Wort sprechen -- 
  Gesinnung -- Serlo gewissermaßen -- Person -- umgaben -- angenehm Unterhaltung fehlen -- 
  mitten vergnüglich Zustande bringen Wilhelm Tags schwarzgesiegelt Brief -- 
  Werner Petschaft deuten traurig Nachricht -- erschrak -- Tod Vater Wort anzeigen finden -- 
  unerwartet kurz Krankheit Welt gehen -- häuslich Angelegenheit Ordnung hinterlassen -- 
  unvermutet Nachricht treffen Wilhelm Innersten -- 
  fühlen tief -- unempfindlich Freund verwandte -- irdisch Aufenthalt erfreuen -- vernachlässigen -- Versäumnis bereuen -- schön Verhältnis diesmal aufheben -- 
  Schmerz zeitig Absterbe brav Mann Gefühl lindern -- Welt lieben -- Überzeugung -- nossen -- 
  Wilhelm Gedanke wandt Verhältnis -- fühlen beunruhigt -- 
  Mensch gefährlich Lage versetzen -- äußerer Umstand Veränderung Zustand bewirken -- Art empfind denken vorbereiten -- 
  alsdann Epoche Epoche -- entstehen desto groß Widerspruch -- Mensch bemerken -- Zustande ausbilden -- 
  Wilhelm Augenblicke frei -- einig -- 
  Gesinnung Edel -- Absicht lauter Vorsatz scheinen verwerflich -- 
  einigem zutrauen bekennen -- Gelegenheit bemerken -- Erfahrung fehlen -- legen Erfahrung anderer Resultat -- Überzeugung ableiteen -- übermäßigen Wert -- Irre -- 
  fehlen -- glauben erwerben -- denkwürdig -- Buch Gespräch vorkommen -- erhalten sammeln Unternähme -- 
  schreiben fremd Meinung Idee -- Gespräch interessant -- -- halten Weise falsch Wahr fest -- bleiben Idee -- sagen Sentenz hängen -- verlies natürlich Denk Handelsweis -- fremd Lichter Leitstern folgen -- 
  Aurelie Bitterkeit Freund Laert kalt Verachtung Mensch bestachen öfter billig Urteil -- gefährlich Jarno -- Mann -- hell Verstand gegenwärtig Ding richtig -- streng Urteil fällen -- Fehler -- einzeln Urteil Art Allgemeinheit aussprechen -- aussprücher Verstand eigentlich bestimmtest Fall gelten -- unrichtig -- nächster anwenden -- 
  entfernen Wilhelm -- einig streben -- heilsamen Einheit -- Verwirrung Leidenschaft leicht Zurüstung Vorteil gebrauchen -- verwirren -- Serlo benutzt Todespost Vorteil -- täglich Ursache Einrichtung Schauspiel denken -- 
  müssen alt Kontrakt erneuern -- wozu Lust -- mehrere Mitglied -- unentbehrlich halten -- täglich unleidlich -- müssen -- wohin Wunsch -- Gesellschaft Gestalt geben -- 
  Wilhelm dringen -- regen Aurelie Philine -- übrig Geselle -- Engagement sehnen -- lassen unser Freund gleichfalls Ruhe -- ziemlich Verlegenheit Scheideweg stehen -- 
  denken -- Brief Werner -- entgegen gesetzt Sinn schreiben -- Entschließung hindrängen -- 
  lassen Eingang weg geben schreiben Veränderung -- 
  Kapitel -- -- -- 
  -- Gelegenheit Gewerbe nachgehen Tätigkeit zeigen -- 
  alte verschieden -- nächster Viertelstund Sinn Haus geschehen -- 
  Freund -- bekannte verwandte drängen -- Menschenart -- Gelegenheit gewinnen -- 
  bringen -- tragen -- zahlen -- schreiben rechnen -- holt Wein Kuchen -- tranken aßen -- ernsthaft beschäftigen -- Weiber -- Trauer aussuchten -- 
  verzeihen -- -- Gelegenheit Vorteil denken -- Schwester hülfreich tätig zeigen -- einigermaßen schicklich -- begreiflich -- nunmehr Sache -- Verbindung beschleunigen -- Vater allzugroß Umständlichkeit verzögern -- 
  Mußt denken -- eingefall -- leer Haus Besitz nehmen -- 
  Bescheidener Vernünftiger -- unser Plan sollst hören -- 
  Schwester ziehen Heirat Haus herüber -- sogar Mutter -- 
  -- sagen -- Neste Platz -- 
  Kunst -- Freund -- 
  geschickt Einrichtung -- glaubst wieviel Platz finden -- Raum brauchen -- 
  Haus verkaufen -- wozu sogleich Gelegenheit darbieten -- gelöst Geld hundertfältig Zins tragen -- 
  hoffen einverstanden -- wünschen unfruchtbar Liebhabereien dein Vater Großvater erben mögest -- 
  setzen hoch Glückseligkeit Anzahl unscheinbar Kunstwerk -- -- sagen genießen -- lebt kostbar Einrichtung -- genießen lassen -- 
  -- hoffen Beistimmung -- 
  -- behalten unser Haus Platz Schreibpulte -- sehen -- künftig Wieg hinsetzen -- Raum Haus desto groß -- 
  Kaffeehäuser Klub Mann -- spaziergäng Spazierfahrt Frau -- schön Lustörter Land -- 
  groß Vorteil -- rund Tisch besetzen Vater unmöglich Freund sehen -- desto leichtfertig aufhalten -- Mühe geben bewirten -- 
  überflüssig Haus -- Möbel -- Gerätschaft -- Kutsche Pferd -- 
  Geld -- vernünftig Weise tun beliebt -- Garderobe -- neu gut Leib -- Mann Rock abtrag Frau ihrig vertrödeln -- einigermaßen Mode -- 
  unerträglich -- alt Kram Besitztum -- 
  kostbarst Edelstein schenken -- Bedingung täglich Finger tragen -- annehmen -- lassen tot Kapital Freude denken -- 
  lustig Glaubensbekenntnis -- Geschäft verrichten -- Geld schaffen -- Seinig lustig übrig Welt bekümmern -- fern nutzen -- 
  sagen -- 
  eur sauber Plan denken -- 
  unterkommen -- väterlich Haus verkaufen -- eurig mind Raum übrig bleiben -- 
  freilich Hauptpunkt -- Brüderchen -- dienen -- vorher gebührend Lob vortrefflich angewenden entrichten -- 
  Sage -- anfangen -- weniger Woche Kenner nützlich interessant Gegenstand -- 
  Fähigkeit kennen -- Aufmerksamkeit Fleiß zutrauen -- 
  Tagebuch überzeugen -- Nutzen Reise -- Beschreibung Eis Kupferhämmer vortrefflich zeigen vieler Einsicht Sache -- 
  ehemals besuchen -- Relation -- halten -- sehen stümpermäßig -- 
  Brief Leinwandfabrikation lehrreich Anmerkung Konkurrenz treffend -- 
  Ort Fehler Addition -- verzeihlich -- 
  Vater meister hoch freuen -- gründlich Einsicht Bewirtschaftung Verbesserung Feldgüter -- 
  Hoffnung -- -- Sequestration liegen -- fruchtbaren Gegend erkaufen -- 
  wend Geld -- väterlich Haus lösen -- -- borgen -- stehen bleiben -- rechnen -- ziehst -- Verbesserung vorstehst -- -- sagen -- Drittel Wert steigen -- verkaufen -- suchen größeres -- verbessern handeln -- Mann -- 
  Feder indes Haus müßig -- beneidenswern Zustand versetzen -- 
  leben -- 
  Genieß Leben Reise -- ziehen -- vergnüglich nützlich findest -- 
  halb bedürfen -- Belieben Welt umsehen -- gut Bildung finden gescheit Mensch Reise -- 
  Leb -- freu -- nahe verbinden -- nunmehr Geist Tätigkeit vereinen -- -- 
  Brief schreiben -- ökonomisch Wahrheit enthalten -- mißfiel Wilhelm Weise -- 
  Lob -- fingiert statistisch -- technologisch rural Kenntnis erhalten -- still Vorwurf -- Ideal -- Schwager Glück bürgerlich Leben vorzeichnen -- reizen keineswegs -- vielmehr heimlich Geist Widerspruchs Heftigkeit entgegen gesetzt Seite treiben -- 
  überzeugen -- Theater Bildung -- geben wünschen -- vollenden können -- scheinen Entschluss desto_mehr bestärken -- lebhaft Werner -- wissen -- Gegner -- 
  fassen Argument bestätigt Meinung desto_mehr -- Ursache glauben klug Werner günstig Licht darstellen -- Weise entstehen Antwort -- gleichfalls einrücken -- 
  Kapitel -- 
  Brief schreiben -- scheuen klug denken -- setzen lassen -- 
  verzeihen -- sagen -- Gegenteil -- behaupten -- 
  Art denken unbeschränkt Besitz leicht lustig Art genießen hinaus -- brauchen sagen -- reizen finden -- 
  bekennen -- Tagebuch Not -- Vater gefällig -- Hilfe Freund mehrere Buch schreiben -- enthalten Sache mehrere Art wissen -- keineswegs verstehen -- abgeben -- 
  helfen -- Eisen fabrizieren -- innerer voll Schlack -- -- Landgut Ordnung bringen -- selber uneins -- 
  dir_es Wort sagen -- -- -- ausbilden -- dunkel Jugend Wunsch Absicht -- 
  heg Gesinnung -- -- -- deutlich -- 
  Welt sehen -- glaubst -- benutzen -- denken -- 
  Schenke -- sagen -- Aufmerksamkeit -- Sinn -- 
  Edelmann -- Streit abgetan -- Bürger -- Weg nehmen -- Wünsch verstehen mögest -- 
  wissen fremd Land -- Deutschland Edelmann gewiß allgemein -- sagen personell Ausbildung -- 
  Bürger Verdienst erwerben hoch Not Geist ausbilden -- Persönlichkeit verlieren -- stellen -- 
  Edelmann -- Vornehmste umgehen -- Pflicht -- vornehm Anstand geben -- Anstand -- weder Tür Tor verschließen -- frei Anstand -- Figur -- Person -- Hof Armee -- bezahlen -- Ursache halten -- zeigen -- halten -- 
  gewiß feierlich Grazie gewöhnlich Ding -- Art leichtsinnig Zierlichkeit ernsthaft wichtig kleiden -- sehen lassen -- überall Gleichgewicht stehen -- 
  öffentlich Person -- ausgebildet Bewegung -- sonor Stimme -- gehalten gemessen Wesen -- desto vollkommen -- hoch nied -- Freund verwandte bleiben -- aussetzen -- wünschen -- 
  kalt -- verständig -- verstellen -- klug -- 
  äußerlich Moment Leben beherrschen wissen -- Forderung -- übrig -- Fähigkeit -- Talent -- Reichtum -- scheinen Zugabe -- 
  denken Bürger -- Vorzug Anspruch gedingen -- mißlingen -- müssen desto unglücklich -- Naturell Art Fähigkeit Trieb geben -- 
  Edelmann gemein Leben Grenze kennen -- König königähnlich Figur erschaffen -- überall still Bewußtsein gleichen treten -- überall vorwärts dringen -- anstatt Bürger anstehen -- rein still Gefühl Grenzlinie ziehen -- 
  fragen -- 
  -- -- 
  -- 
  Einsicht -- Kenntnis -- Fähigkeit -- wieviel Vermögen -- 
  Edelmann Darstellung Person -- Bürger Persönlichkeit geben -- 
  scheinen -- -- scheinen lächerlich abschmacken -- 
  wirken -- leisten schaffen -- einzeln Fähigkeit ausbilden -- brauchbar -- voraus setzen -- Wesen Harmonie -- dürfen -- -- Weise brauchbar -- übrig vernachlässigen -- 
  Unterschied Anmaßung Edelleute Nachgiebigkeit Bürger -- Verfassung Gesellschaft Schuld -- ändern ändern -- bekümmern -- -- -- Sache stehen -- denken -- unerläßlich Bedürfnis -- rett erreichen -- 
  harmonisch Ausbildung Natur -- Geburt versagen -- unwiderstehlich Neigung -- 
  -- verlassen -- Leibesübung gewinnen -- gewöhnlich Verlegenheit ablegen stellen ziemlich dar -- 
  sprach Stimme ausbilden -- Eitelkeit sagen -- Gesellschaft mißfallen -- 
  leugnen -- Trieb täglich unüberwindlich -- öffentlich Person -- Kreis fallen wirken -- 
  Neigung Dichtkunst -- Verbindung stehen -- Bedürfnis Geist Geschmack ausbilden -- Genuß -- entbehren -- schön schön halten -- 
  siehst -- Theater finden -- einzig Element Wunsch rühren ausbilden -- 
  Brett erscheinen gebildet Mensch persönlich Glanz oberer Klasse -- Geist Körper Bemühung gleich Schritt -- scheinen -- anderswo -- 
  Suche Beschäftigung -- mechanisch Quälereia -- Geduld täglich Übung verschaffen -- 
  Disputiere -- ehe schreibst -- Schritt geschehen -- 
  herrschend Vorurteil Name verändern -- ohnehin schäm Meister auftreten -- 
  Leb -- 
  Vermögen Hand -- bekümmeren -- brauchen -- verlangen gelegentlich -- -- hoff Kunst nähren -- -- 
  Brief abgeschicken -- Wilhelm Stelle Wort halten Serlo's übrig Verwunderung erklären -- Schauspieler widme Kontrakt billig Bedingung eingehen wollen -- 
  hierüber einig -- Serlo erklären -- Wilhelm übrigen zufrieden -- 
  verunglückt Gesellschaft -- unterhalten -- annehmen -- -- Laert -- Wilhelm dankbar erzeigen -- 
  zutrauen fordern -- empfingen -- 
  meister Anstellung Einflus Philines zuschreiben -- richten Danksagung -- 
  indessen ausgefertigt Kontrakt unterschreiben -- unerklärlich Verknüpfung Idee entstehen Wilhelm Einbildungskraft -- Augenblick fingiert Name unterzeichnen -- Bild Waldplatz -- verwunden Philines Schoß liegen -- 
  Schimmel liebenswürdig Amazone Büschen -- nahte steigen -- 
  menschenfreundlich bemühen heißen -- stehen -- 
  Kleid fallen Schulter -- Gesicht -- Gestalt fangen glänz Verschwand -- 
  schreiben Name mechanisch -- wissen -- fühlen -- unterzeichnen -- Mignon Seite stehen -- Arm halten Hand leise wegzuziehen versuchen -- 
  Kapitel -- 
  Bedingung -- Wilhelm auf Theater begeben -- Serlo Einschränkung zugestehen -- 
  verlangen -- Hamlet unzerstücken aufführen -- lassen wunderlich begehren fern fallen -- -- 
  hierüber Streit -- -- Stück weglassen können -- zerstücken -- verschieden Meinung -- 
  Wilhelm befinden glücklich Zeit -- begreifen -- geliebt Mädchen -- verehren Schriftsteller mangelhaft können -- 
  Empfindung -- übereinstimmend -- vollkommen Harmonie denken -- 
  Serlo hingegen sonderen beinahe -- scharf Verstand Kunstwerk gewöhnlich unvollkommen erkennen -- 
  glauben -- Stück finden -- Ursache bedächtig umgehen -- müssen Shakespeare -- müssen Hamlet viele leiden -- 
  Wilhelm hören -- Absonderung Spreu Weizen sprechen -- 
  Spreu Weizen durcheinander -- rufen -- Stamm -- Ast -- Zweig -- Blatt -- Knospe -- Blüte Frucht -- 
  einer -- 
  behaupten -- bringen Stamm Tisch -- Künstler müssen golden Äpfel silbern Schalen Gast reichen -- 
  erschöpft Gleichnisse -- Meinung scheinen entfernen -- 
  verzweifeln Freund -- Serlo einst lang Streit einfach Anriet -- resolvier -- Feder ergreifen Trauerspiele -- wollen können -- abzustreich -- mehrere Person drängen -- Art -- Herz -- sollen Arbeit überlassen -- wollen fertig -- 
  Abred gemäß -- versetzen Wilhelm -- 
  Geschmack leichtsinnig -- 
  Freund -- rufen Serlo -- -- 
  kenn abscheulich Manier -- Theater Welt finden -- 
  einer verwahrlost -- 
  ekelhaft Verstümmelung zwing Autor -- Publikum erlauben -- 
  Stück -- Maß Personal -- Dekoration Theatermechanik -- -- Dialog physisch Kraft Akteurs hinausschritten -- Spiele spielen neu spielen -- 
  unser Vorteil bedienen -- zerstückelt Werk ausrichten -- 
  setzen Publikum Vorteil -- 
  deutsche -- Mensch neu Nation -- Gefühl ästhetisch -- Loben tadeln stellenweise -- entzücken stellenweise -- 
  größ Glück Schauspieler -- Theater gestoppelt gestückelt Wesen bleiben -- 
  -- versetzen Wilhelm -- bleiben -- bleiben -- 
  Überzeug -- -- Welt bewegen -- Kontrakt halten -- gröbsten Irrtum schließen -- 
  Serlo Sache lustig Wendung ersuchen Wilhelm -- öfteren Gespräch Hamlet nochmals bedenk -- glücklich Bearbeitung ersinnen -- 
  -- Einsamkeit zubrachen -- Wilhelm froh Blick -- 
  müssen irren -- rufen -- finden -- helfen -- überzeugen -- Shakespeare -- Genie Hauptsache richten -- Novelle -- arbeiten -- verführen -- 
  Lasse hören -- Serlo -- gravitätisch auf Kanapee setzen -- ruhig aufhorchen -- desto streng richten -- 
  Wilhelm versetzen -- bange -- hören -- 
  unterscheide -- genauest Untersuchung -- reiflichsen Überlegung -- Komposition Stück -- zweierlei -- 
  innerer Verhältnis Person Begebenheite -- mächtig Wirkung -- Charakter Handlung Hauptfigur entstehen -- einzeln vortrefflich -- Folge -- aufstellen -- unverbesserlich -- 
  Art Behandlung zerstören -- verunstalten -- 
  sind_es -- sehen verlangen -- anzutasten wagen -- tief Seele eindrücken -- hören -- beinahe deutsch Theater bringen -- 
  -- glauben -- fehlen -- -- Stück bemerken -- äußerer Verhältnis Person -- wodurch Ort bringen -- Weise gewiß zufällig Begebenheite verbinden -- allzu_unbedeutend ansehen -- vorbeigehen sprechen -- weggelassen -- 
  freilich Faden dünn lose -- durch Stück -- halten -- auseinander fiele -- auseinander fallen -- wegschneiden -- übrig tun glauben -- Ende stehen lassen -- 
  äußerer Verhältnis zähl Unruhe Norwegen -- Krieg jung Fortinbra -- Gesandtschaft alt Oheim -- geschlichtet Zwist -- Zug jung Fortinbra Polen Rückkehr -- 
  ingleich Rückkehr Horatio Wittenberg -- Lust Hamlet -- Reise Laert Frankreich -- Rückkunft -- Verschickung Hamlet England -- Gefangenschaft Seeräuber -- Tod Hofleute Uriasbrief -- Umstand Begebenheite -- Roman breit -- Einheit Stück -- Held Plan -- äußerste schaden höchst fehlerhaft -- 
  hören gerne -- rufen Serlo -- 
  Falle -- versetzen Wilhelm -- möchten loben -- 
  Fehler flüchtig Stütze Gebäude -- wegnehmen -- vorher fest Mauer unterzuziehen -- Vorschlag -- Situation rühren -- sowohl einzeln möglichst schon -- äußerer -- einzeln -- zerstreut zerstreuend Motiv weg werfen Einzig substituieren -- 
  -- fragt Serlo -- ruhig Stellung aufhieben -- 
  liegen Stück -- erwidern Wilhelm -- machen Gebrauch -- 
  Unruhe Norwegen -- 
  Plan Prüfung -- 
  Tod alt Hamlet ersterobert Norweger unruhig -- 
  dortig Statthalter schicken Sohn Horatio -- alt Schulfreund Hamlet -- Tapferkeit Lebensklugheit vorgelaufen -- Dänemark -- Ausrüstung Flotte dringen -- Schwelgerei ergeben König saumselig Statten -- 
  Horatio kennen alt König -- letzter Schlacht beigewohnen -- Gunst gestehen -- Geisterszene verlieren -- 
  König sodann Horatio Audienz schicken Laert Norwegen Nachricht -- Flott anlanden -- indes Horatio Auftrag erhalten -- Rüstung beschleunigen -- Mutter einwilligen -- Hamlet -- wünschen -- Horatio See gehen -- 
  Gott -- rufen Serlo -- Wittenberg hoch Schule -- leidig Anstoß -- 
  find Gedanke -- einzig fern Bild -- Norwegen Flotte -- brauchen Zuschauer denken -- übrige sehen -- übrig -- anstatt Einbildungskraft Welt herum jagen -- 
  sehen -- versetzen Wilhelm -- nunmehr übrig halten -- 
  Hamlet Horatio Missetat Stiefvater entdecken -- raten Norwegen -- Armee versichern gewaffnet Hand kehren -- 
  Hamlet König Königin gefährlich -- näher -- Flotte schick Rosenkranz Güldenster Beobachter mitzugeben -- indes Laert -- Meuchelmord erhitzt Jüngling nachgeschicken -- 
  Flotte bleiben ungünstig Wind liegen -- Hamlet kehren nochmals -- Wanderung Kirchhof glücklich motivieren -- zusammentreffen Laert Ophelia Grabe unentbehrlich Moment -- 
  hierauf König bedenken -- Hamlet Stelle -- fest Abreise -- scheinbaren Versöhnung Laert feierlich begehen -- wobei Ritterspiel halten Hamlet Laert fechten -- 
  Leiche Stück schließen -- übrig bleiben -- 
  Hamlet -- Wahlrecht Volks eintreten -- Stimme sterbend Horatio -- 
  geschwind -- versetzen Serlo -- setzen arbeiten Stück -- Idee völlig Beifall -- Lust verrauchen -- 
  Kapitel -- 
  Wilhelm Übersetzung Hamlet abgeben -- geistvollen Wielandsche Arbeit bedienen -- Shakespearn kennen lernen -- 
  auslassen -- fügen hinzu -- Besitz vollständig Exemplar Augenblick -- Serlo Behandlung ziemlich einig -- 
  fing Plan auszuheben einzuschieben -- trennen verbinden -- verändern herstellen -- zufried Idee -- scheinen Ausführung -- Original verdorben -- 
  sobald fertig -- lesen Serlo übrig Gesellschaft -- 
  bezeugt zufrieden -- Serlo günstig Bemerkung -- 
  -- -- empfinden -- äußerer Umstand Stück begleiten -- einfach -- Dichter geben -- 
  Theater vorgehen -- Zuschauer sehen -- vorstellen -- Hintergrund -- spielend Figur bewegen -- 
  einfach Aussicht Flotte Norwegen Stück -- Nähme Weg -- Familienszen -- Begriff -- königlich Haus innerer Verbrechen Ungeschicklichkeit Grund -- darstellen -- 
  Blieb Hintergrund mannigfaltig -- beweglich -- Konfus -- täte Eindrucke Figur Schaden -- 
  Wilhelm Partie Shakespear -- zeigen -- Insulaner schreiben -- Engländer -- Hintergrunde Schiff Seereis -- Küste Frankreich Kaper sehen gewohnen -- -- gewöhnlich -- zerstreu verwirren -- 
  Serlo müssen nachgeben -- stimmen überein -- -- Stück deutsch Theater sollen -- ernstern einfacher Hintergrund Vorstellungsart passen -- 
  Rolle ausgeteilt -- Polonius übernehmen Serlo -- Aurelie -- Ophelia -- Laert Name bezeichnen -- jung -- Untersetzter -- Munterer -- neuangekommen Jüngling erhalten Rolle Horatio -- Königs Geist Verlegenheit -- 
  Rolle alt Polterer -- 
  Serlo schlagen Pedante König -- wogegen Wilhelm auf äußerer protestieren -- 
  entschließen -- 
  ferner Wilhelm Stücke Rolle Rosenkranz Güldenster stehen lassen -- 
  verbinden -- fragt Serlo -- Abbreviatur -- 
  Gott bewahr Verkürzunge -- Sinn Wirkung aufheben -- versetzen Wilhelm -- 
  Mensch -- vorstellen -- 
  Kleinigkeit zeigen Shakespear Größe -- 
  leis auftreten -- schmieg Biegen -- sagen -- Streichel schmeicheln -- Behendigkeit -- Schwänzel -- Allheit Leerheit -- rechtlich Schurkerei -- Unfähigkeit -- Mensch ausdrücken -- 
  Dutzend -- -- bloß Gesellschaft -- Gesellschaft -- Shakespeare bescheiden Weise -- Repräsentant auftreten lassen -- 
  überdies brauch Bearbeitung Paar -- -- gut -- trefflich Horatio kontrastieren -- 
  verstehen -- Serlo -- helfen -- 
  geben Elmir -- nennen alt Tochter Polterer -- -- schaden -- aussehen -- Puppe putzen dressieren -- Lust -- 
  Philine freuen außerordentlich -- Herzogin Komödie spielen -- 
  -- rufen -- Geschwindigkeit heiraten -- außerordentlich lieben -- 
  hoffen groß Beifall erwerben -- Mann wünschen -- 
  Aurelie verdrießlich Gesicht Äußerung -- Widerwille Philine -- 
  schade -- Serlo -- Ballett -- Manne Pas de deux tanzen -- alt Takt einschlafen -- Füßch wadchen hinten Kindertheater allerliebst ausnehmen -- 
  Wadch wissen -- versetzen schnippisch -- Füßch betreffen -- rufen schnell Tisch reichen -- Pantöffelchen herauf holen Serlo hinstelln -- Stelzchen -- geben niedlichere finden -- 
  Ernst -- -- zierlich Halbschuh betrachten -- 
  gewiß -- Artiger sehen -- 
  Pariser Arbeit -- Philine Gräfin Geschenk erhalten -- Dame -- schön Fuß berühmt -- 
  reizend Gegenstand -- rufen Serlo -- Herz hüpfen ansehen -- 
  Verzuckung -- Philine -- 
  paar Pantöffelch fein schön Arbeit -- rufen Serlo -- Klang reizend -- Anblick -- 
  heben lassen einigemal wechselsweise Tisch fallen -- 
  heißen -- 
  -- rufen Philine -- 
  sagen -- versetzen verstellt Bescheidenheit schalkhaft Ernst -- Junggeselle -- nachts meist -- Mensch fürchten -- Dunkel Gesellschaft sehnen -- Wirtshäuser fremd Ort geheuer -- finden tröstlich -- gutherzig Kind Gesellschaft Beistand leisten -- 
  Nacht -- liegen Bette -- rascheln -- schaudern -- Türe tun -- erkennen lieb pispernd Stimmchen -- schleichen herbei -- Vorhang rauschen -- Klipp -- klapp -- Pantoffel fallen -- husch -- -- 
  lieben -- einzig Klang -- absätzch Boden aufschlagen -- 
  zierlich -- Feiner klingen -- 
  sprech Philomelen -- rauschend Bächen -- Säusel Wind -- orgeln pfiffen -- halten Klipp -- 
  Klapp -- -- 
  Klipp -- 
  Klapp -- schön Thema Rondeau -- vorne hören wünschen -- 
  Philine Pantoffel Hand -- krumm treten -- -- 
  spielen Rieb Sohle -- 
  heiß -- rufen -- Sohle flach Wange halten -- rieb Serlo hinreichen -- 
  gutmütig Wärme fühlen -- Klipp -- 
  Klapp -- rufen -- derben Schlag Absatz versetzen -- schreiend Hand ziehen -- 
  lehr Pantoffel denken -- Philin lachend -- 
  lehren alt Leute Kind anführen -- rufen Serlo -- springen -- fassen Heftigkeit raubt Kuß -- ernstlich Widerstrebe künstlich abzwingen lassen -- 
  Balg fallen lang Haar herunter wickelten Gruppe -- Stuhl schlagen Boden -- Aurelie -- Unwesen innerlich beleidigen -- stehen Verdruß -- 
  Kapitel -- 
  obgleich Bearbeitung Hamlet Person weggefallen -- bleiben Anzahl -- fast Gesellschaft hinreichen -- 
  fort -- Serlo -- Souffleur Loche hervorsteig -- wandeln -- Person -- 
  Stelle bewundern -- versetzen Wilhelm -- 
  glauben -- vollkommeneren Einhelfer -- Serlo -- 
  Zuschauer jemals hören -- Theater verstehen Silbe -- 
  gleichsam Organ -- Genius -- Not vernehmlich zulispeln -- 
  fühlen Rolle Schauspieler vollkommen inne -- ahnden weit Gedächtnis verlassen -- 
  Fall -- Rolle überlesen -- Wort Wort vorsagen -- spielt Glück -- Sonderbarkeit -- unbrauchbar -- 
  nehmen herzlich Anteil Stück -- pathetisch Stelle deklamieren -- affektvoll rezitieren -- 
  Unart irren -- 
  -- Aurelie -- Sonderbarkeit einst gefährlich Stelle stecken lassen -- 
  Aufmerksamkeit -- fragen Wilhelm -- 
  -- versetzt Aurelie -- gewiß Stelle rühren -- heiß Träne weinen -- Augenblick Fassung -- eigentlich sogenannter rührend Stelle -- Zustand versetzen -- -- deutlich ausdrücken -- schön Stelle -- rein Geist Dichter gleichsam hell offen Auge hervorsiehen -- Stelle -- höchstens freuen -- Tausend wegsehen -- 
  erscheinen zart Seele Theater -- 
  heisch Organ steif Betragen schließen Bühne -- hypochondrisch Natur Gesellschaft -- versetzen Serlo -- 
  wieviel Mühe geben -- gewöhnen -- vergebens -- 
  lesen vortrefflich -- lesen hören -- halten zart Grenzlinie Deklamation affektvoll Rezitation -- 
  Gefunden -- rufen Wilhelm -- finden -- 
  welch glücklich Entdeckung -- 
  Schauspieler -- Stelle rauh Pyrrhus rezitieren -- 
  Leidenschaft -- versetzen Serlo -- Endzwecke nutzen -- 
  gewiß groß Sorge -- rufen Wilhelm -- Stelle wegbleiben müssen -- Stück lähmen -- 
  einsehen -- versetzt Aurelie -- 
  hoff Meinung -- Wilhelm -- 
  Shakespeare führen ankommend Schauspieler doppelt Endzweck herein -- 
  Mann -- Tod Priamus Rührung deklamieren -- tief Eindruck Prinz -- schärfen Gewissen jung schwankend Mann -- szen Präludium -- Schauspiel Wirkung König tun -- 
  Hamlet fühlen Schauspieler beschämt -- fremd -- fingiert leiden nehmen -- Gedanke Weise Versuch Gewissen Stiefvater -- sogleich erregen -- 
  welch herrlich Monolog ist_es -- Akt schließen -- 
  freu -- rezitieren -- -- O -- welcher Schurk -- welch niedrig Sklave -- -- 
  ungeheuer -- Schauspieler -- Erdichtung -- Traum Leidenschaft -- Seele Wille zwingen -- Wirkung Gesicht entfärben -- 
  -- Träne Auge -- 
  Verwirrung Betragen -- 
  Gebrochene Stimme -- 
  Wesen Gefühl durchdrungen -- -- Hekuba -- - 
  Hekuba Hekuba -- weinen -- 
  unser Mann Theater bringen -- Aurelie -- 
  -- versetzen Serlo -- hinein führen -- 
  Probe Stelle lesen -- sagen Schauspieler -- spielen -- erwarten -- sehen -- nah -- 
  einig -- wenden Gespräch Geist -- 
  Wilhelm entschließen -- Rolle lebend König Pedante überlassen -- Polterer Geist spielen können -- glauben eher -- warten -- Schauspieler melden -- Mann finden -- 
  denken verwundern Wilhelm -- -- Adresse Theaternamen -- Abends folgend Billet wunderbar Züg versiegeln Tisch finden -- 
  -- -- o Sonderbarer Jüngling -- wissen -- Verlegenheit -- 
  Findest Mensch Hamlet -- Geist -- 
  Eifer verdienen Wunder -- Wunder -- Wunderbares geschehen -- 
  vertrauen -- Stunde Geist erscheinen -- Mut bleiben fassen -- 
  bedürfen Antwort -- Entschluß -- -- 
  seltsam Blatt eilt Serlo -- lesen Las -- bedenklich Miene versichern -- Sache Wichtigkeit -- müssen überlegen wagen dürfen können -- 
  sprechen viele -- Aurelie still lächelen -- Rede -- undeutlich verstehen -- Scherz Serlo halten -- 
  bitten Wilhelm völlig Sorge -- Geist geduldig erwarten -- 
  Serlo Humor -- abgehend Schauspieler geben möglich Mühe spielen -- vermissen -- Neugierd Gesellschaft gut Einnahme erwarten -- 
  sogar Umgang Wilhelm Einfluß -- 
  fing Kunst sprechen -- deutsch -- Nation Rechenschaft tun -- 
  Wilhelm schreiben Unterredung -- -- Erzählung unterbrechen -- derjenige Leser interessieren -- dramaturgisch Versuch Gelegenheit vorlegen -- 
  Serlo Abends lustig -- Rolle Polonius sprechen -- Fasse gedachen -- 
  versprech -- -- diesmal würdig Mann geben -- gehörig Ruhe Sicherheit -- Leerheit Bedeutsamkeit -- Annehmlichkeit geschmacklos Wesen -- Freiheit Aufpassen -- treuherzig Schalkheit erlogen Wahrheit -- gehören -- zierlich aufstellen -- 
  grau -- redlich -- ausdauernd -- dienend Halbschelme auf Allerhöflichste vorstellen vortragen -- roh grob Pinselstrich unser Autor Dienst leisten -- 
  reden Buch -- vorbereiten -- Tor -- Laune -- 
  abschmacken Maule reden -- fein -- merken Leute -- 
  Rolle Lust Schalkheit übernehmen -- 
  Meinig hoffen -- Aurelie -- 
  weder Jugend Weichheit -- Charakter finden -- 
  einer wissen -- Gefühl -- Ophelia Kopf verrückt -- verlassen -- 
  genau nehmen -- Wilhelm -- 
  eigentlich Wunsch Hamlet spielen -- Studium Stück -- auf äußerste Irre führen -- 
  Rolle studiern -- desto sehen -- Gestalt Zug Physiognomie -- Shakespeare Hamlet aufstellen -- 
  überlegen -- genau Rolle hängen -- getrau leidlich Wirkung hervor bringen -- 
  treten Gewissenhaftigkeit Laufbahn -- versetzen Serlo -- Schauspieler schicken Rolle -- Rolle richten -- 
  Shakespeare Hamlet vorgezeichnen -- 
  unähnlich -- 
  Zuvörderst Hamlet blond -- erwidern Wilhelm -- 
  heiß suchen -- Aurelie -- 
  woher schließen -- 
  Dän -- Nordland -- blond Haus -- blau Auge -- 
  -- Shakespeare denken -- -- 
  Bestimmt finden ausdrücken -- Verbindung Stelle scheinen unwidersprechlich -- 
  Fechten sauer -- Schweiß laufen Gesicht -- Königin sprechen -- 
  Fett -- lassen Atem -- 
  blond wohlbehaglich vorstellen -- braun Leute Jugend selten Fall -- 
  Passen schwankend Melancholie -- weich Trauer -- tätig Unentschlossenheit -- Gestalt -- schlank -- braunlockig Jüngling denken -- Entschlossenheit Behendigkeit erwarten -- 
  verderben Imagination -- rufen Aurelie -- weg fett Hamlet -- Stelle wohlbeleibt Prinz -- 
  Geben Quiproquo -- reizen -- rühren -- 
  Intention Autor liegen nah Vergnügen -- verlangen Reiz -- homogen -- 
  Kapitel -- 
  Abend striten Gesellschaft Roman Drama Vorzug verdienen -- 
  Serlo versichern -- vergeblich -- mißverstanden Streit -- können Art vortrefflich -- müssen Grenze Gattung halten -- 
  Klar -- versetzen Wilhelm -- 
  -- Serlo -- Mühe wert -- Sache nah kommen -- 
  sprechen Herüber hinüber -- folgend ungefähr Resultat Unterhaltung -- 
  Roman Drama sehen menschlich Natur Handlung -- 
  Unterschied beide Dichtungsart liegen bloß äußerer Form -- -- Person sprechen -- gewöhnlich erzählen -- 
  Dramas dialogiert Roman -- unmöglich Drama Brief schreiben -- 
  Roman vorzüglich Gesinnung Begebenheite vorstellen -- Drama Charaktere Tat -- 
  Roman langsam -- Gesinnung Hauptfigur -- Weise wollen -- Vordringen Entwicklung aufhalten -- 
  Drama eilen -- Charakter Hauptfigur drängen -- aufhalten -- 
  Romanheld leidend -- hoch Grade wirkend -- dramatisch verlangen Wirkung -- 
  Grandison -- Clarisse -- Pamela -- Landpriester Wakefield -- Tom Jones -- leidend -- retardierend Person -- Begebenheite gewissermaßen Gesinnung modeln -- 
  Drama modeln Held -- widerstehen -- räumen rücken Hindernis Weg -- unterliegen -- 
  vereinigen -- Zufall Roman Spiel erlauben können -- Gesinnung Person lenken leiten müssen -- hingegen Schicksal -- Mensch -- Zutun -- unzusammenhängend äußerer Umstand unvorgesehen Katastrophe hindrängen -- Drama -- Zufall pathetisch -- niemals tragisch -- Situation hervorbringen dürfen -- Schicksal hingegen müssen fürchterlich -- hoch Sinn tragisch -- schuldig unschuldig unabhängig Tat unglücklich Verknüpfung bringen -- 
  Betrachtung führen wunderlich Hamlet -- Eigenheit Stück -- 
  Held -- -- eigentlich Gesinnung -- Begebenheite stoßen -- Stück gedehnt Roman -- 
  Schicksal Plan zeichnen -- Stück fürchterlichen ausgehen -- Held vorwärts fürchterlichen drängen -- hoch Sinn tragisch -- leiden tragisch Ausgang -- 
  Leseprobe halten -- Wilhelm eigentlich fest ansehen -- 
  Rolle vorher kollationieren -- Seite Anstoß -- 
  sämtlichen Schauspieler Stück -- suchen -- ehe anfingen -- Wichtigkeit Leseprobe überzeugen -- 
  Musikus verlangen -- -- gewiß Grad -- Blatt spielen können -- sollen Schauspieler -- wohlerzogen Mensch -- üben Blatt lesen -- Drama -- Gedicht -- Erzählung sogleich Charakter abgewinnen -- Fertigkeit vorzutragen -- 
  Memorieren helfen -- Schauspieler vorher Geist Sinn gut Schriftsteller eindringen -- Buchstab können wirken -- 
  Serlo versichern -- Probe -- Hauptprobe nachsehen wollen -- sobald Leseprobe widerfahren -- 
  gewöhnlich -- -- lustig -- Schauspieler Studier sprechen -- -- Freimaurer Arbeit reden -- 
  Probe laufen Wunsch -- sagen -- Ruhm Einnahme Gesellschaft weniger wohlangewandt Stunde gründen -- 
  tun -- Freund -- Serlo -- -- unser Mitarbeiter ernstlich zusprachen -- fürcht -- Wunsch schwerlich erfüllen -- 
  -- versetzen Wilhelm -- 
  finden -- Serlo -- Mensch Imagination Bewegung setzen -- Märche erzählen lassen -- selten -- Art produktiv Imagination finden -- 
  Schauspieler auffallend -- 
  zufrieden schön lobenswürdige brillant Rolle übernehmen -- selten tun -- Selbstgefälligkeit Stelle Held setzen -- mindest bekümmern -- halten -- 
  Lebhaftigkeit umfassen Autor Stück denken -- Individualität hingeben müssen Rolle -- Überzeugung -- anderer Mensch -- Zuschauer gleichfalls Überzeugung hinreißen -- -- innerer Wahrheit Darstellungskraft -- Brett Tempel -- Pappen Wald verwandeln -- wenige geben -- 
  innerer Stärke Geist -- wodurch Zuschauer täuschen -- erlogen Wahrheit -- Wirkung hervorbringen -- wodurch Illusion erzielen -- Begriff -- 
  Lassen Geist Empfindung dringen -- 
  sicher -- unser Freund Gelassenheit Sinn Buchstaben erklären -- Verstand eröffnen -- 
  Anlage -- eilen Alsdann geistreichen empfindungsvoll Ausdrucke entgegen -- -- niemals falsch spielen rezitieren -- 
  Schauspieler -- -- schlimmer Anmaßung finden -- Anspruch Geist -- Buchstab deutlich geläufig -- 
  Kapitel -- 
  Wilhelm Theaterprobe zeitig finden Brett -- Lokal überraschen -- wunderbar Erinnerung -- 
  Wald- Dorfdekoration stehen genau -- Bühne Vaterstadt -- Probe -- Mariane lebhaft Liebe bekannt -- glücklich Nacht zusagen -- 
  Bauernhäuser gleichen Theater Land -- wahr Morgensonne beschien -- halb offen Fensterlad hereinfallend -- Bank Türe befestigen -- scheinen Mariane Schoß Busen -- 
  setzen nieder -- denken wunderbar Übereinstimmung -- glauben ahnden -- Platz sehen -- 
  -- -- Nachspiel -- Dekoration gehören -- deutsch Theater geben -- 
  Betrachtung stören übrig ankommend Schauspieler -- Theater- Garderobenfreunde herein treten -- Wilhelm Enthusiasmus begrüßen -- 
  gewissermaßen Madam Melina attachiert -- rein Freund Schauspielkunst -- Art -- Gesellschaft Freund wünschen -- 
  wissen sagen -- Theater kannen lieben -- 
  lieben kennen -- kennen schätzen Schlecht verbannen -- 
  Neigung Mittelmäßige unerträglich -- herrlich Genuß -- kosten -- Ausdruck -- 
  mechanisch Freude -- geistige entzücken -- Neigung -- zerstückelt Probe Art Illusion versetzen -- 
  Mangel scheinen jederzeit Ferne treten -- berühren nah Gegenstand -- 
  Liebhaber -- Künstler Fache wünschen -- 
  lieb Wanderung Kulisse Parterre -- Parterre Kulissen -- angenehmst Aufenthalt Garderobe -- emsigste Beschäftigung Stellung -- Kleidung -- Rezitation Deklamation Schauspieler zuzustutzen -- lebhaftest Gespräch Effekt -- hervorbringen -- beständig Bemühung -- Schauspieler aufmerksam -- tätig genau erhalten -- leiben -- -- Verschwendung -- Gesellschaft Genuß verschaffen -- 
  ausschließlich verschaffen -- Probe Aufführung Theater erscheinen -- 
  -- Aufführung Hamlet betreffen -- Wilhelm Stelle einig -- hie -- meistens behauptet Meinung -- dienen Unterhaltung Bildung Geschmack -- 
  lassen Freund sehen Schätz -- weissagten vereint Bemühung -- Epoche für deutsch Theater -- 
  Gegenwart Mann Probe nützlich -- 
  überzeugen Schauspieler -- Probe Stellung Aktion -- Aufführung zeigen gedenken -- immerfort Rede verbind Gewohnheit mechanisch vereinigen müssen -- 
  Hand sollen Probe Tragödie gemein Bewegung vornehmen -- tragisch Schauspieler -- Probe Tabak schnupfen -- machen bange -- höchst wahrscheinlich Stelle -- Aufführung -- Prise vermissen -- 
  halten -- Stiefel probieren sollen -- Rolle Schuhe spielen -- 
  -- versicheren -- schmerz -- Frauenzimmer Probe Hand Rockfalt versteckn -- 
  zureden Mann bewirken -- nämlich Mannsperson exerzieren lernen -- 
  Militärrolle vorkommen -- sagen -- sehen betrübt Mensch -- minde Dressur zeigen -- Hauptmann Majors-Uniform Theater herum schwanken sehen -- 
  Wilhelm Laert -- Pädagogik Unteroffizier unterwarfen -- setzen Fechtübunge Anstrengung fort -- 
  Mühe geben Mann Ausbildung Gesellschaft -- glücklich finden -- 
  sorgen künftig Zufriedenheit Publikum -- indes entschieden Liebhaberei gelegentlich aufhieln -- 
  wissen wieviel Ursache dankbar -- versäumen Schauspieler Hauptpunkt einzuschärfen -- nämlich Pflicht laut vernehmlich sprechen -- 
  finden hierbei Widerstand Unwille -- anfangs denken -- 
  meister gehören Sprache -- bemüht sprechen -- hören -- 
  schoben Fehler auf Gebäude -- sagen -- können schreien -- -- heimlich zärtlich sprechen -- 
  Theaterfreunde -- unsäglich Geduld -- suchen Weise Verwirrung lösen -- Eigensinne beizukommen -- 
  sparten weder Grund Schmeicheleie -- erreichen zuletzt Endzweck -- wobei Wilhelm -- 
  bitten -- Probe entferntst Ecke setzen -- sobald vollkommen verstünd Schlüssel Bank pochen möchten -- 
  artikulieren -- sprechen gemäßigt -- steigern Ton stufenweise -- überschrie heftig Stelle -- 
  pochend Schlüssel hört Probe -- lassen Operation fallen -- hoffen -- Stück Winkel Haus verstehen -- 
  sehen Mensch Zweck Weise erreichen möchten -- wieviel Not -- begreiflich eigentlich verstehen -- schwer -- derjenige -- leisten wünschen -- Erkenntnis Bedingung bringen -- Vorhaben -- 
  Kapitel -- 
  fahren fort -- nötig Anstalt Dekoration Kleid erforderlich -- 
  Szene Stelle Wilhelm besonderer Grill -- Serlo nachgeben -- teils Rücksicht Kontrakt -- teils Überzeugung -- hoffen -- Wilhelm Gefälligkeit gewinnen -- Folge desto_mehr Absicht lenken -- 
  König Königin Audienz Throne sitzend erscheinen -- Hofleute Seite Hamlet unbedeutend stehen -- 
  Hamlet -- -- ruhig verhalten -- schwarz Kleidung unterscheiden -- 
  eher verberg Vorschein -- 
  -- Audienz geendigen -- König Sohn sprechen -- herbei treten Szene Gang -- 
  Hauptschwierigkeit machen Gemälde -- Hamlet Szene Mutter heftig beziehen -- 
  -- Wilhelm -- Lebensgröße Grund Zimmer Haupttüre sichtbar -- alt König völlig Rüstung -- Geist -- Seite hängen hervortritt -- 
  wünsch Figur Hand befehlend Stellung annehmen -- gewandt gleichsam Schulter sehen -- Geist völlig gleich -- Augenblick Türe hinaus -- 
  Wirkung -- Augenblick Hamlet Geiste Königin Bilde sehen -- 
  Stiefvater königlich Ornat -- Unscheinbarer vorstellen -- 
  verschieden Punkt -- sprechen Gelegenheit -- 
  unerbittlich -- Hamlet sterben -- fragt Serlo -- 
  Leben erhalten -- Wilhelm -- Stück Tod drücken -- 
  weitläufig sprechen -- 
  Publikum wünschen lebendig -- 
  Gefallen -- diesmal ist_es unmöglich -- 
  wünschen -- brav nützlich Mann -- chronisch Krankheit sterben -- lang leben mögen -- 
  Familie weinen beschwören Arzt -- halten -- Natur-Notwendigkeit widerstehen vermögen -- anerkannt Kunstnotwendigkeit gebieten -- 
  falsch Nachgiebigkeit Menge -- Empfindung erregen -- -- -- 
  -- Geld bringen -- Ware Sinn verlangen -- -- gewissermaßen -- Publikum verdienen -- Kind -- Geld abnehmen -- behandle -- 
  bringen -- Gefühl Geschmack -- Geld doppelt Vergnügen einlegen -- Verstand -- Vernunft Ausgabe vorwerfen -- 
  schmeicheln geliebt Kind -- schmeicheln gut -- künftig aufklären -- Vornehmen reiche -- Irrtum -- nutzen -- Verewig -- 
  handelt -- Frage beziehen -- Stück verändern dürfen -- unberührt lassen müssen -- 
  lassen hierauf -- legen künftig Bearbeitung Hamlet demjenigen Teil Leser -- interessieren -- 
  Kapitel -- 
  Hauptprobe vorbei -- 
  übermäßig dauern -- 
  Serlo Wilhelm finden besorgen -- ungeachtet -- Vorbereitung verwenden -- notwendig Anstalt letzter Augenblick verschieben -- 
  -- -- Gemälde König fertig -- Szene Hamlet Mutter -- Effekt hoffen -- mager -- weder Geist gemalt Ebenbild gegenwärtig -- 
  Serlo scherzt Gelegenheit -- 
  sein Grund übel anführen -- Geist ausblieben -- Wache Luft fechten -- Souffleur Kulisse Vortrag Geist supplieren müssen -- 
  wunderbar Freund unser Unglaube verscheuchen -- versetzen Wilhelm -- gewiß -- Zuschauer überraschen -- 
  gewiß -- rufen Serlo -- froh -- Stück geben -- Umstand glauben -- 
  Welt froh -- Stück spielen -- versetzen Philin -- Rolle drücken -- 
  ewig Sache reden hören -- wobei heraus Repräsentation -- -- hundert -- vergessen -- Geduld hinreichen -- 
  Gottesnam Umstand -- 
  Gast Tisch aufstehen -- nachh Gericht aussetzen -- Haus reden hören -- begreiflich -- Not ausstehen -- 
  Lassen Gleichnis Vorteil brauchen -- schön Kind -- versetzen Wilhelm -- 
  Bedenken Natur Kunst -- Handel -- Gewerk Gewerbe schaffen -- Gastmahl geben -- 
  Hirsch Walde -- Fisch Fluß Meer zubringen -- Tafel besetzen würdig -- Hausfrau -- Köchin Küche -- 
  Nachlässigkeit schlürfen Sorge entferntest Winzer -- Schiffer -- Kellermeister -- Nachtische hinunter -- müssen -- 
  Mensch arbeiten -- schaffen bereiten -- Hausherr sorgfältig zusammenbringen halten -- Genuß vorübergehend -- 
  Genuß vorübergehend -- Eindruck zurücklassen bleibend -- Fleiß Anstrengung tun -- teilen Zuschauer verborgen Kraft -- wissen wirken -- 
  einerlei -- versetzen Philin -- diesmal erfahren -- Mann Widerspruch -- 
  all eurer Gewissenhaftigkeit -- Autor verstümmeln -- lassen schön Gedanke Stück -- 
  schönsn -- rufen Wilhelm -- 
  -- gewiß schönsn -- Hamlet tun -- -- 
  -- rufen Serlo -- 
  Perücke -- versetzen Philin -- säuberlich abnehmen -- scheinen nötig -- Verständnis eröffnen -- 
  dachn -- Unterhaltung stocken -- 
  aufstehen -- spät -- scheinen auseinander -- 
  unentschlossen stehen -- fing Philin Liedche -- zierlich gefällig Melodie -- singen -- 
  Singet Trauertön Einsamkeit Nacht -- -- -- o hold schöne -- Geselligkeit -- 
  weib Mann geben schön Hälfte -- Nacht halb Leben -- schön Hälfte -- 
  tages freuen Freude unterbrichen -- 
  zerstreuen -- taugen -- 
  nächtig Stunde süß Lampe Dämmerung fließen -- Mund nahen Mund Scherz Liebe ergießen -- rasch los Knabe -- wild feurig eilen -- -- Gabe -- leicht Spiel weilen -- Nachtigall Verliebte Liebevoll Liedchen singen -- gefangener Betrübt Wehe klingen -- 
  leicht Herzensregen Horchet Glocke -- zwölf bedächtig Schlagen Ruhe Sicherheit versprechen -- 
  lang Merk -- lieb Brust -- 
  Plage Nacht Lust -- 
  leicht Verbeugung endigen -- Serlo rufen laut Bravo -- 
  springen Tür hinaus eilt Gelächter fort -- 
  hört Treppe hinunt sing Absätz klappern -- 
  Serlo Seitenzimmer -- Aurelie bleiben Wilhelm -- Nacht wünschen -- Augenblick stehen -- 
  zuwider -- innerer Wesen zuwider -- klein Zufälligkeit -- 
  braun Augenwimper blond Haar -- Bruder reizend finden -- ansehen -- Schramm Stirn widriges -- niedrig -- Schritt treten -- 
  erzählen neulich Scherz -- Vater Kindheit Teller Kopf werfen -- Zeichen tragen -- 
  Auge Stirn zeichnen -- hüten mögen -- 
  Wilhelm antworten -- Aurelie scheinen Unwille fortzufahren -- 
  beinahe unmöglich freundlich höflich Wort reden -- hassen -- anschmiegend -- 
  sein -- 
  -- Freund -- gewiß Gefälligkeit Geschöpf -- Betrag -- Seele kränken -- Aufmerksamkeit -- Achtung grenzen -- Gott verdienen -- 
  -- schuldig -- versetzen Wilhelm -- Aufführung tadeln -- Charakter Gerechtigkeit widerfahren lassen -- 
  Charakter -- rufen Aurelie -- glauben -- Kreatur Charakter -- 
  O Mann -- erkennen -- 
  Frau wert -- 
  Verdacht -- Freundin -- versetzen Wilhelm -- 
  Minute Rechenschaft geben -- zubringen -- 
  -- -- Aurelie -- spät -- streiten -- 
  -- -- 
  Nacht Freund -- Nacht fein Paradiesvogel -- 
  Wilhelm fragen -- Ehrentitel kommen -- 
  andermal -- versetzt Aurelie -- andermal -- 
  -- Fuß -- schweben Luft -- nähren Äther -- 
  märchen -- fahren fort -- poetisch Fiktion -- 
  Nacht -- lassen schön träum Glück -- 
  Zimmer lassen -- eilt Seinige -- 
  halb unwillig nieder -- 
  scherzend entschieden Ton Aurelie beleidigen -- fühlen tief Unrecht -- 
  Philin widrig -- unhold begegnen -- verbroch -- fühlen fern Neigung -- stolz standhaft bestehen -- 
  Begriff auszuziehen -- Lager Vorhang aufzuschlagen -- groß Verwunderung Paar Frauenpantoffeln Bett erblicken -- stehen -- liegen -- 
  -- Philines Pantoffel -- erkennen -- glaubt Unordnung Vorhäng sehen -- scheinen bewegt -- stehen unverwandt Auge -- 
  Gemütsbewegung -- Verdruß halten -- versetzt Atem -- kurz Pause -- erholen -- rufen fassen -- Stehen -- Philin -- heißen -- 
  Klugheit -- Betrag -- 
  märch Haus -- 
  rühren -- 
  Scherz -- fahren fort -- Neckereie übel anwenden -- 
  laut -- 
  Bewegung -- 
  entschlossen unmutig Bette -- reißen Vorhang -- 
  Stehen -- -- Zimmer Nacht überlassen -- 
  groß erstaunen finden Bette leer -- Kissen Deck schönst Ruhe -- 
  -- suchen -- suchen -- finden Spur Schalk -- 
  Bette -- Ofen -- schränken sehen -- suchen emsig emsig -- Boshafter Zuschauer glauben -- suche finden -- 
  Schlaf stellen -- setzen Pantoffel Tisch -- nieder -- bleiben manchmal Tisch stehen -- schelmisch Genius -- belauschen -- versichern -- 
  Nacht allerliebsten stelzch beschäftigen -- gewiß Interesse ansehen -- behandeln -- spielen -- Kleid auf Bette werfen -- seltsamst Phantasie einschlummerten -- 
  Schlief -- Serlo herein treten rufen -- -- 
  Bette -- 
  Unmöglich -- 
  suchen Theater -- mancherlei -- 
  Elftes Kapitel -- 
  Nachmittag verflossen eilig -- 
  Haus voll Wilhelm eilt anzuziehen -- 
  Behaglichkeit -- Maske erstenmal anprobieren -- gegenwärtig anlegen -- ziehen fertig -- 
  Frau Versammlungszimmer -- beriefen einstimmig sitzen -- schön Federbusch verschieben -- Schnall passen -- fing aufzutrennen -- nähen -- stecken -- 
  Symphonie -- Philin Krause einwenden -- Aurelie Mantel aussetzen -- 
  lassen -- Kind -- rufen -- Nachlässigkeit Hamlet -- 
  Frau lassen fuhren fort putzen -- 
  Symphonie aufgehört Stück angehen -- 
  besehen Spiegel -- drücken Hut tief Gesicht erneuert Schminke -- 
  Augenblick stürzen Herein rufen -- Geist -- Geist -- 
  Wilhelm -- Hauptsorge denken -- Geist -- 
  weggenomm -- wunderlich Gastrolle erwarten -- 
  Theatermeister fragen -- Wilhelm Gespenst umzuseh -- eilt Throne einzufinden -- König Königin Hofe umgeben Herrlichkeit glänzen -- hört letzter Wort Horatio -- Erscheinung Geist verwirrt sprechen -- fast Rolle vergessen scheinen -- 
  Zwischenvorhang Höhe voll Haus -- 
  Horatio Rede halten König abfertigen -- drängen Hamlet -- -- Prinz präsentieren -- -- Teufel stecken Harnisch -- 
  Furcht jagen -- 
  Zwischenzeit Mann weiß Mänteln Kapuz Kulisse stehen -- Wilhelm -- Zerstreuung -- Unruhe Verlegenheit Monolog -- glauben -- mißglücken -- treten -- lebhaft Beifall Abgehen begleiten -- kalt Winternacht unbehaglich -- 
  -- sprechen zweckmäßig angebracht Stelle -- Schmause Trinken Nordländer -- gehörig Gleichgültigkeit -- vergessen -- Zuschauer -- Geist -- erschrak -- Horatio ausraufen -- sehen -- -- 
  fahren Heftigkeit herum -- edel Gestalt -- leise -- unhörbar Tritt -- leicht Bewegung schwer scheinend Rüstung -- machen stark Eindruck -- versteineren stehen -- halb Stimme -- Engel himmlisch Geist beschützen -- ausrufen -- 
  starren -- holen einigemal Atem -- bringen Anrede Geist verwirren -- zerstücken zwingen -- groß Kunst trefflich ausdrücken -- 
  Übersetzung Stelle -- 
  nah Original halten -- Wortstellung Verfassung überraschen -- erschreckn -- entsetzen ergriffen Gemüt einzig ausdrücken scheinen -- 
  -- Geist -- verdammt Kobold -- bringen Düfte Himmel dämpf Hölle -- Böses Beginnen -- kommst würdig Gestalt -- reden -- nenn Hamlet -- König -- Vater -- o antworte -- -- 
  -- spürt Publikum groß Wirkung -- 
  Geist winken -- Prinz folgen lautest Beifall -- 
  Theater verwandeln -- entfernt Platz kommen -- halten Geist unvermutet inne wenden -- Hamlet nah stehen -- 
  verlangen Neugierde Wilhelm sogleich niedergelassen Visier hinein -- tiefliegend Auge wohlgebildet Nase erblicken -- 
  Furchtsam ausspähend stehen -- Ton Helm hervordrangen -- wohlklingend -- rauh Stimme Wort hören lassen -- 
  Geist dein Vater -- treten Wilhelm Schritt schaudernd -- Publikum schauderen -- 
  Stimme scheinen -- Wilhelm glauben Ähnlichkeit Stimme Vater bemerken -- 
  wunderbar Empfindung Erinnerung -- Neugierd seltsam Freund entdecken Sorge beleidigen -- Unschicklichkeit Schauspieler Situation nahe treten -- bewegt Wilhelm entgegengesetzt Seite -- 
  verändert lang Erzählung Geist Stellung -- scheinen unbestimmt verlegen -- aufmerksam zerstreuen -- Spiel allgemein Bewunderung -- Geist allgemein entsetzen erregen -- 
  sprechen tief Gefühl Verdruss Jammer -- geistig -- langsam unübersehlich Verdruß -- 
  Mißmut Seele -- Irdische trennen -- unendlich leiden unterliegen -- 
  zuletzt versank Geist -- sonderbar Art -- leicht -- grau -- durchsichtiger Flor -- Dampf Versenkung steigen scheinen -- legen Weg ziehen Hinunter -- 
  kommen Hamlet Freund schwuren Schwert -- 
  alt Maulwurf geschäftig Erde -- -- stehen -- Füßen rufen -- schwören -- -- Boden brennen -- schnell Ort eilen -- 
  erscheinen -- stehen -- jedesmal Flamm Boden -- vermehrt Wirkung -- hinterlassen Zuschauer tief Eindruck -- 
  Stück unaufhaltsam Gang fort -- mißglücken -- geraten -- Publikum bezeigt Zufriedenheit -- Lust Mut Schauspieler scheinen Szene zuzunehmen -- 
  Zwölftes Kapitel -- 
  Vorhang fallen lebhafte Beifall erscholl Eck Enden -- 
  fürstlich Leiche springen behend Höhe umarmt Freude -- 
  Polonius Ophelia kommen Gräber hervor hört lebhaft Vergnügen -- Horatio -- Ankündig Heraustrat -- heftigste beklatschen -- 
  Anzeige Stück lassen -- begehrn Ungestüm Wiederholung heutigen -- 
  gewinnen -- rufen Serlo -- Abend vernünftig Wort -- 
  Eindruck -- 
  Schauspieler übel nehmen -- Debüt vorsichtig eigensinnig -- 
  Kassier überreichen schwer Kasse -- 
  debütieren -- rufen -- Vorurteil -- 
  versprochen Abendessen -- 
  schmecken lassen -- 
  ausgemacht -- Theaterkleider beisammen bleiben Fest feiern -- 
  Wilhelm unternehmen Lokal -- Madam Melina Essen besorgen -- 
  Zimmer -- worin malen pflegen -- auf gut säubern -- allerlei Dekoration umstellen herausputzen -- halb Garten -- halb Säulengange ähnlich -- 
  Hereintreten Gesellschaft Glanz vieler Licht blenden -- feierlich Schein Dampf süßest Räucherwerk -- sparen -- geschmückt bestellt Tafel verbreiten -- 
  Ausrufung lobt Anstalt Anstand Platz -- scheinen -- königlich Familie Geisterreiche kommen -- 
  Wilhelm sitzen Aurelie Madam Melina -- Serlo Philine Elmiren -- Platze unzufrieden -- 
  Theaterfreunden -- gleichfalls eingefunden -- vermehrt Glück Gesellschaft -- 
  einigemal Vorstellung Bühne kommen -- Publikum Zufriedenheit sprechen -- nunmehr an besondere -- jeder reichlich belohnen -- 
  unglaublich Lebhaftigkeit Verdienst -- Stelle herausgehoben -- 
  Souffleur -- bescheiden Tafel sitzen -- Lob rauh Pyrrhus -- Fechtübung Hamlet Laert erheben -- Ophelia Trauer Ausdruck schön erhaben -- Polonius Spiel sprechen -- Gegenwärtige hört Lob -- 
  abwesend Geist Lob Bewunderung hinweg -- 
  Rolle glücklich Organ Sinn sprechen -- wunderen meisten -- -- Gesellschaft vorgehen -- unterrichten scheinen -- 
  glich völlig gemalt Bild Künstler gestehen -- Theaterfreund rühmen -- schauerlich ausgeseh -- Unfer Gemälde hervortreten Ebenbilde vorbei geschriten -- 
  Wahrheit Irrtum sonderbar vermischen -- überzeugen -- Königin Gestalt sehen -- 
  Madam Melina Gelegenheit loben -- Stelle Höhe Bilde starren -- indes Hamlet nieder Geist weisen -- 
  erkundigt Gespenst hereinschleichen -- erfahren Theatermeister -- hinterer Tür -- Dekoration verstellen -- Abend -- gotisch Saal brauchen -- frei -- Figur weiß Mänteln Kapuz hereingekommen -- unterscheid -- geendigt Akt wahrscheinlich hinausgehen -- 
  Serlo loben -- schneidermäßig jammern sogar Stelle -- Held ziem Sohn befeuern -- anbringen -- 
  Wilhelm Gedächtnis behalten versprechen Manuskript nachtragen -- 
  Freude Gastmahl bemerken -- Kind Harfenspieler fehlen -- machen angenehm Erscheinung -- 
  treten Herein -- abenteuerlich ausgeputzt -- Felix schlagen Triangel -- Mignon Tamburin alt schwer Harfe umgehangen spielen -- tragen -- 
  ziehen Tisch singen allerlei Lied -- 
  ess Gast glauben Kind Wohltat erzeig -- süß Wein gäben -- trinken -- 
  Gesellschaft köstlich Flasche schonen -- Abend -- Geschenk Theaterfreunde -- Körbe ankommen -- 
  Kind springen singen fort Mignon auslassen -- niemals sehen -- 
  schlagen Tamburin möglich Zierlichkeit Lebhaftigkeit -- druckender Finger Fell schnell schnurren -- Rücken Hand Knöchel drauf pocht -- abwechselnd Rhythm Pergament wider Knie wider Kopf schlagen -- schüttelnd Schelle klingen lassen -- einfach Instrument verschieden Ton hervorlocken -- 
  gelärmen -- setzen Lehnsessel -- Wilhelm Tische leer bleiben -- 
  Bleiben Sessel weg -- rufen Serlo -- stehen vermutlich Geist -- -- kann_es übel -- 
  fürchten -- rufen Mignon -- -- stehen -- 
  Oheim -- tun leiden -- 
  Rede verstehen -- wissen -- vermeintlich Vater Teufel nennen -- 
  Gesellschaft -- Verdacht bestärken -- Serlo Erscheinung Geist wissen -- 
  schwatzen trank Mädchen sehen furchtsam Türe -- 
  Kind -- Sessel sitzend Pulcinellpuppe Kasten Tisch hervorragt -- Fing -- Weise Stück aufführen -- 
  Mignon schnarrenden Ton artig -- stoßen zuletzt Kopf dergestalt Tischkante -- eigentlich Holzpupp aushalten -- 
  Mignon Wut lustig -- Gesellschaft -- Anfangs Scherz lachen -- müssen zuletzt Einhalt -- 
  helfen Zureden -- springen rast -- Schellentrommel Hand -- Tisch herum -- 
  Haar fliegen -- Kopf Glied gleichsam Luft werfen -- scheinen Mänade ähnlich -- wilden beinahe unmöglich Stellung alt Monument erstaunen setzen -- 
  Talent Kind Lärm aufgereizen -- suchen Unterhaltung Gesellschaft beitragen -- 
  Frauenzimmer singen Kanon -- Laert lassen Nachtigall hören -- Pedant Konzert pianissimo Maultrommel -- 
  indessen spielen Nachbar Nachbarinn allerlei Spiel -- wobei Hand begegnen vermischen -- fehlen Paar Ausdruck hoffnungsvoll Zärtlichkeit -- 
  Madam Melina scheinen lebhaft Neigung Wilhelm verhehlen -- 
  spät Nacht -- Aurelie -- fast Herrschaft behalten -- ermahnt übrig -- Aufstand -- auseinander -- 
  Serlo Abschied Feuerwerk -- Mund -- fast unbegreiflich Weise -- Ton Rakete -- Schwärmer Feuerräd nachzuahmen wissen -- 
  Auge zumachen -- Täuschung vollkommen -- 
  indessen aufstehen -- reichen Frauenzimmer Arm Haus führen -- 
  Wilhelm zuletzt Aurelie -- 
  Treppe begegnen Theatermeister -- -- Schleier -- worin Geist verschwinden -- 
  Versenkung hängen bleiben finden -- 
  wunderbar Reliquie -- rufen Wilhelm -- -- 
  Augenblick fühlen linker Arm ergriffen heftig Schmerz -- 
  Mignon verstecken -- angefassen Arm gebissen -- 
  fahren Treppe hinunt Verschwand -- 
  Gesellschaft frei Luft -- merken fast jeder -- Abend gute nossen -- 
  Abschied nehmen verlieren auseinander -- 
  Wilhelm Stube erreichen -- Kleid abwarf ausgelöscht Licht Bette eilen -- 
  Schlaf sogleich bemeistern -- Geräusch Stube ofen entstehen scheinen -- aufmerksam -- 
  schweben erhitzt Phantasie Bild geharnischt König -- richten -- Gespenst anzureden -- zart arme umschlung -- Mund lebhaft Küsse verschließen -- Brust seinigen fühlen -- wegzustoß Mut -- 
  Dreizehntes Kapitel -- 
  Wilhelm fahren morgens unbehaglichen Empfindung Höhe -- finden Bette leer -- 
  völlig ausgeschlafen Rausch Kopf düster -- Erinnerung unbekannt nächtlich Besuch unruhig -- 
  Verdacht fallen Phililinen -- scheinen lieblich Körper -- Arm schließen -- ihrigen -- 
  lebhaft Liebkosung Freund Seite seltsamen -- stumm Besuch eingeschlaf Spur entdecken -- 
  springen -- Anzog finden Türe -- verriegeln pflegen -- anlehnen -- wissen erinnern -- gestern Abend zugeschlossen -- 
  wunderbar erscheinen Schleier Geist -- Bette finden -- 
  herauf bringen wahrscheinlich werfen -- 
  grau Flor -- Saum Schrift schwarz Buchstabe sticken -- 
  entfalten las Wort -- 
  letztenmal -- 
  fliehe -- 
  Jüngling -- fliehen -- 
  betreffen wissen sagen -- 
  Augenblick treten Mignon herein bringen Frühstück -- 
  Wilhelm erstaunen Anblick Kind -- sagen erschrak -- 
  scheinen Nacht groß -- treten hoch edl Anstand ernsthaft Auge -- Blick ertragen -- 
  rühren -- gewöhnlich Hand drücken -- Wange -- Mund -- Arm -- Schulter küßen -- -- Sache Ordnung bringen -- stillschweigend fort -- 
  angesetzt Leseprobe herbei -- versammelt gestrig Fest verstimmen -- 
  Wilhelm -- anfangs lebhaft gepredigt Grundsatz verstoßen -- 
  Übung helfen -- Übung Gewohnheit Kunst Lücke ausfüllen -- Genie Laune lassen -- 
  eigentlich Gelegenheit Bemerkung finden -- Zustand -- lang dauern -- eigentlich Beruf -- Lebensweise -- Feierlichkeit anfangen dürfen -- 
  feiern glücklich vollenden -- Zeremonie Anfang erschöpfen Lust Kraft -- Streben hervor bringen fortgesetzt Mühe beistehen -- 
  Fest Hochzeitsfest unschicklichsen -- kein Stille -- Demut Hoffnung begehen -- 
  schlich -- Wilhelm jemals alltäglich vorkommen -- 
  Stadt gewöhnlich Unterhaltung Abends fing gähnen -- Interesse Hamlet erschöpfen finden eher unbequem folgend Tag zweitenmal vorstellen -- 
  Wilhelm zeigen Schleier Geist -- müssen schließen -- -- 
  Serlo Meinung -- scheinen Ratschläge wunderbar Gestalt vertraut -- lassen Wort -- 
  fliehe Jüngling -- fliehen -- erklären -- 
  Serlo einstimmen -- vorzüglichst Schauspieler Gesellschaft entfern Absicht scheinen -- 
  notwendig nunmehr -- Rolle Geist Polterer Rolle König Pedante geben -- 
  erklären -- einstudieren -- Wunder -- Probe weitläufigen Behandlung Stück -- sämtlich Rolle wechseln -- 
  probiert Geschwindigkeit spät auseinander -- flüstern Philine Abschiede Wilhelm leise -- 
  Pantoffel holen -- schiebst Riegel -- 
  Wort setzen Stube -- ziemlich Verlegenheit -- Vermutung -- Gast vorig Nacht Philine -- bestärken -- nötigen Meinung schlagen -- Ursache -- hierüber zweifelhaft machen sonderbar Argwohn einflößen müssen -- entdecken -- 
  unruhig einigemal Zimmer -- Riegel vorschieben -- 
  stürzen Mignon Zimmer -- fassen rufen -- Meister -- rette Haus -- brennt -- 
  Wilhelm springen Türe gewaltig Rauch drängen ob Treppe herunter entgegen -- 
  Gasse hören Feuergeschrei -- Harfenspieler -- Instrument Hand -- Rauch atemlos Treppe herunter -- 
  Aurelie stürzen Zimmer werfen Felix Wilhelm arme -- 
  Rett Kind -- rufen -- übrig greifen -- 
  Wilhelm -- Gefahr halten -- gedacht Ursprung Brandes hinzudringen -- Anfange ersticken -- 
  alt Kind -- befehlen steinern Wendeltreppe hinunter -- Gartengewölber Garten führen -- eilen -- Kind Freie bleiben -- 
  Mignon Licht leuchten -- 
  Wilhelm bitten Aurelie Sache Weg retten -- 
  Drang Rauch hinauf -- vergebens setzen Gefahr -- 
  Flamme scheinen benachbart Haus herüber dringen Holzwerk Boden leicht Treppe fassen -- Rettung herbei eilen -- leiden -- Qualm Feuer -- 
  sprechen Mut rufen Wasser -- beschwören -- Flamm Schritt Schritt weichen -- versprechen bleiben -- 
  Augenblick springen Mignon herauf rufen -- Meister -- rette deinen Felix -- alt rasend -- alte bringen -- 
  Wilhelm springen besinn Treppe hinab Mignon folgen Ferse -- 
  letzter Stufe Gartengewölbe führen -- bleiben entsetzen stehen -- 
  Bündel Stroh Reisholz -- aufhäufen -- brannen hell Flamm -- Felix liegen Boden schreien -- alte stehen niedergesenkt Haupt seitwärts Wand -- 
  machen Unglücklicher -- rufen Wilhelm -- 
  alte schweigen -- Mignon Felix aufheben -- schleppt Mühe Knabe Garten -- indes Wilhelm Feuer auseinander zerren dämpfen streben -- Gewalt Lebhaftigkeit Flamme vermehrn -- 
  müssen verbrannt Augenwimper Haar Garten fliehen -- alt Flamm reißen -- versengt Bart unwillig folgen -- 
  Wilhelm eilen sogleich Kind Garten suchen -- 
  Schwelle entfernt Lusthäuschen finden -- Mignon möglichster beruhigen -- 
  Wilhelm Schoß -- fragen -- befühln zusammenhängend Kind herausbringen -- 
  indessen Feuer gewaltsam mehrere Haus ergriffen erhellt Gegend -- 
  Wilhelm besehen Kind rot Schein Flamm -- Wunde -- Blut -- Beule wahrnehmen -- 
  betasten überall -- Zeichen Schmerz -- beruhigen vielmehr fing Flamm verwundern -- schön -- Ordnung -- Illumination -- brennend Sparr Gebälk erfreuen -- 
  Wilhelm denken Kleid verlieren -- fühlen stark wert menschlich Geschöpf -- Gefahr entronnen -- 
  drücken Empfindung Herz -- Mignon freudig Zärtlichkeit umarmen -- sanft ablehnen -- Hand fest halten -- 
  Meister -- -- niemals -- Abend -- Name geben -- Anfangs pflegen Herr -- nachh Vater nennen -- -- 
  Meister -- Gefahr entronnen -- Felix Tod -- 
  Frage erfahren Wilhelm -- Harfenspieler -- Gewölbe kommen -- Licht Hand gerissen Stroh sogleich anzünden -- 
  Felix niedergesetzen -- wunderlich Gebärden Hände Kind Kopf legen Messer ziehen -- opfern wollen -- 
  zugesprung Messer Hand gerissen -- geschrien -- Haus -- Sache Garten retten -- Hilfe kommen -- müssen -- Verwirrung weggehen -- alt Kind lassen -- 
  Haus stehen voll Flamme -- 
  Garten retten -- Brandes Gartengewölbe -- 
  Wilhelm verlegen Freund -- Sache -- 
  getraut Kind verlassen -- Unglück vergrößern -- 
  bringen Stunde bänglich Lage -- 
  Felix Schoß eingeschlafen -- Mignon liegen halten Hand fest -- 
  getroffen Anstalt Feuer Einhalt tun -- 
  ausgebrannt Gebäude stürzen -- herbei -- Kind fangen frier leicht Kleidung fallend Tau fast unerträglich -- 
  führen Trümmer gestürzt Gebäude -- finden Kohlen- Aschenhaufe behaglich Wärme -- 
  anbrechend bringen Freund Bekannte -- 
  retten -- verlieren -- 
  Wilhelm Koffer finden Serlo treiben -- -- Probe Hamlet -- Szene -- Schauspieler besetzen -- 
  Debatte Polizei -- 
  Geistlichkeit verlangen -- Strafgericht Gott Schauspielhaus schließen bleiben -- Serlo behaupten -- teils Ersatz -- Nacht verlieren -- teils Aufheiterung erschreckt Gemüt -- Aufführung interessant Stück jemals Platz -- 
  letzter Meinung drang Haus füllen -- 
  Schauspieler spielen selten Feuer leidenschaftlich Freiheit erstemal -- 
  Zuschauer -- Gefühl schrecklich nächtlich Szene erhöhen -- Langeweile zerstreut verdorben Tag interessant Unterhaltung spannen -- Empfänglichkeit Außerordentliche -- 
  groß -- Ruf Stück herbeigezogen Zuschauer -- Vergleichung Abend anstellen -- 
  Polterer spielt Sinn unbekannt Geist -- Pedant Vorgänger gleichfalls aufgepassen -- Erbärmlichkeit -- Hamlet Unrecht -- -- trotz Purpurmantel Hermelinkragen -- geflickt Lumpen-König Schalt -- 
  Sonderbarer Throne gelangen -- obgleich Übrig -- Philin -- äußerst lustig machen -- lassen merken -- Graf -- Kenner -- Anblick voraus -- ermahnt Philine Demut versichern -- gelegentlich Rockärmel pudern -- unglücklich Nacht Schlos erinnern -- Krone Bescheidenheit tragen mögen -- 
  Vierzehntes Kapitel -- 
  Geschwindigkeit Quartier umgesehen -- Gesellschaft zerstreuen -- 
  Wilhelm Lusthaus Garten -- Nacht zubringen -- liebgewonnen -- erhalten Schlüssel richten -- Aurelie Wohnung eng -- müssen Felix behalten Mignon Knabe verlassen -- 
  Kind artig Zimmer Stock einnehmen -- Wilhelm unteren Saal einrichten -- 
  Kind schlafen -- Ruhe finden -- 
  anmutig Garten -- aufgegangen Vollmond herrlich erleuchten -- stehen traurig Ruine -- Dampf aufstieg -- Luft angenehm Nacht außerordentlich schön -- 
  Philin -- herausgehen Theater -- Ellenbogen angestrichen Wort zugelispeln -- verstehen -- 
  verwirren verdrießlich -- wissen erwarten -- 
  Philin gemied Abend Zeichen geben -- 
  Türe verbrennen -- zuschließen -- Pantöffelch Rauch aufgehen -- 
  schön Garten -- Absicht -- wissen -- 
  wünschen sehen -- erklären -- 
  schwer Herz liegen -- Schicksal Harfenspieler -- sehen -- 
  Wilhelm fürchten -- Aufräume tot Schutt finden -- 
  Wilhelm Verdacht verbergen hegen -- alt Schuld Brand -- 
  brennend rauchend Boden entgegen -- Verzweiflung Gartengewölbe scheinen Folge unglücklich Ereignis -- 
  Untersuchung -- Polizei sogleich anstellen -- wahrscheinlich -- Haus wohnen -- Brand entstehen -- sogleich Dach weggeschlichen -- 
  Wilhelm überlegt Laube sitzend -- nah Gange schleichen hören -- 
  traurig Gesang -- sogleich anstimmen -- erkennen Harfenspieler -- 
  Lied -- verstehen -- enthalten Trost Unglücklichen -- Wahnsinne nahe fühlen -- 
  Wilhelm letzter Strophe behalten -- 
  Tür schleichen -- Still sittsam stehen -- Frommer Hand Nahrung reichen -- 
  glücklich scheinen Bild erscheinen -- Tran weinen -- wissen weinen -- 
  Wort Gartentür kommen -- entlegenen Straße -- -- verschließen finden -- Spalier übersteigen -- Wilhelm halten reden freundlich -- 
  alte bitten aufzuschließen -- fliehen wollen müssen -- 
  Wilhelm stellen -- Garten Stadt können -- zeigen -- Schritt verdächtig machen -- vergebens -- 
  alte bestand Sinn -- 
  Wilhelm drängen halb Gewalt Gartenhaus -- schließen führen wunderbar Gespräch -- -- Leser unzusammenhängend Idee bänglich Empfindung quälen -- verschweigen ausführlich mitteilen -- 
  Fünfzehntes Kapitel -- 
  Verlegenheit -- worin Wilhelm befinden -- unglücklich alte beginnen -- deutlich Spur Wahnsinn zeigen -- reißen Laert selbigen -- 
  -- alt Gewohnheit überall pflegen -- Kaffeehaus Mann sehen -- heftigsen Anfälle Melancholie erdulden -- 
  Landgeistlichen anvertrauen -- besonderer Geschäft dergleichen Leute behandeln -- 
  diesmal gelingen -- Stadt Familie Wiederhergestellten erzeigen Ehre -- 
  Wilhelm eilen sogleich Mann aufsuchen -- vertraut Fall einig -- 
  wissen gewisser Vorwand alte übergeben -- 
  Scheidung schmerzen Wilhelm tief -- Hoffnung -- wiederherstellen sehen -- einigermaßen erträglich -- gewohnen Mann sehen geistreich herzlich Ton vernehmen -- 
  harfe verbrennen -- suchen -- Reise mitgeben -- 
  Feuer Garderobe Mignon verzehren -- neu schaffen -- Aurelie Vorschlag -- Mädchen kleiden -- 
  -- rufen Mignon bestehen Lebhaftigkeit alt Tracht -- worin willfahren müssen -- 
  Gesellschaft -- besinnen -- Vorstellung gehen Gang -- 
  Wilhelm horchen Publikum -- selten Stimme entgegen -- hören wünschen -- öfters vernehmen betrübt Verdroß -- 
  erzählen -- Aufführung Hamlet -- jung Mensch Lebhaftigkeit -- zufrieden Abend Schauspielhause -- 
  Wilhelm lauschen hören -- Beschämung -- jung Mann Verdruß Hintermann -- Hut aufbehalten hartnäckig Stück hindurch abtun -- Heldentat groß Vergnügen erinnern -- 
  anderer versichern -- 
  Wilhelm Rolle Laert spielen -- hingegen Schauspieler -- Hamlet unternehmen -- können zufrieden -- 
  Verwechslung unnatürlich -- Wilhelm Laert gleichen -- wiewohl entfernt Sinn -- 
  loben Spiel -- Szene Mutter auf lebhaftester -- bedauern -- feurig Augenblick weiß Band Weste hervorgesehen -- wodurch Illusion äußerst stören -- 
  innerer Gesellschaft gehen indessen allerlei Veränderung -- 
  Philin Abend Brand Wilhelm gering Zeichen Annäherung geben -- 
  -- scheinen vorsätzlich -- entfernter Quartier mieten -- vertragen elmiren selten Serlo -- womit Aurelie zufrieden -- 
  Serlo -- gewogen bleiben -- besuchen manchmal -- Elmir finden hoffen -- Abends Wilhelm -- 
  hereintreen verwundern -- Philin Zimmer -- arme jung Offizier sehen -- rot Uniform weiß Unterkleider -- abgewendet Gesicht sehen -- 
  Philin besuchend Freund Vorzimmer entgegen verschließen -- 
  überraschen wunderbar Abenteuer -- rufen -- 
  wunderbar -- Serlo -- lassen hübsch -- jung -- beneidenswert Freund sehen -- ohnedem zugestutzen -- eifersüchtig -- 
  Verdacht Zeitlang lassen -- Philine scherzend -- versichern -- Freundin -- unbekannt aufhalten -- 
  Schicksal künftig erfahren -- interessant Mädchen kennen lernen -- wahrscheinlich alsdann Ursache -- Bescheidenheit Nachsicht üben -- fürcht -- Herr Bekanntschaft alt Freundin vergessen -- 
  Wilhelm stehen versteinern -- Anblick rot Uniform geliebt Rock Mariane erinnern -- Gestalt -- blond Haar -- scheinen gegenwärtig Offizier groß -- 
  Himmel Wille -- rufen -- lassen Freundin wissen -- lassen verkleidet Mädchen sehen -- 
  Teilnehmer Geheimnisses -- versprechen -- Schwöre -- lassen Mädchen sehen -- 
  O Feuer -- rufen Philin -- lassen -- geduldig -- draus -- 
  lassen Name wissen -- rufen Wilhelm -- 
  alsdann schön Geheimnis -- versetzen Philin -- 
  Vorname -- 
  raten -- meinetwegen -- 
  dreimal raten -- öfter -- können Kalend durchführen -- 
  -- Wilhelm -- Cecilie -- 
  Cecilie -- 
  Henriett -- 
  keineswegs -- 
  nehmen -- 
  Neugierd ausschlafen -- 
  Wilhelm zaudern zitteren -- Mund auftun -- Sprache versagen -- 
  Mariane -- stammeln -- Mariane -- 
  bravor -- rufen Philin -- treffen -- Gewohnheit Absatz herum drehen -- 
  Wilhelm Wort hervorbringen -- Serlo -- Gemütsbewegung bemerken -- fahren fort Philine dringen -- Türe öffnen -- 
  verwundern -- Wilhelm heftig Neckerei unterbrechen -- Philin Füßen werfen lebhaftest Ausdrucke Leidenschaft bitten beschwören -- 
  Lassen Mädchen sehen -- rufen -- -- Mariane -- 
  -- Leben sehnen -- -- Weiber Welt -- 
  hinein -- sagen -- Mensch -- Liebe Glück Jugend knüpfen -- 
  rechtfertigen -- unfreundlich verlassen -- Verzeihung bitten -- vergeben -- fehlen -- sogar Anspruch -- sehen -- sehen leben glücklich -- 
  Philine schüttelt Kopf -- 
  Freund -- reden leise -- 
  Betrüge -- Frauenzimmer Freundin -- schonen -- vermuten keineswegs sehen -- 
  Angelegenheit fahren hierher -- wissen -- Gespenst alt Liebhaber unrecht Auge sehen -- 
  fragen -- vorbereit überlegen -- -- 
  schreiben Billet -- Stunde -- -- gehorch pünktlich -- schwören -- Freundin Wille liebenswürdig Geschöpf Auge sehen -- 
  Tür verschlossen halten -- Axt Beil besuchen -- 
  Wilhelm beschwören -- Serlo reden -- vergebens -- Freund müssen zuletzt nachgeben -- Zimmer Haus räumen -- 
  unruhig Nacht Wilhelm zubrachten -- denken -- 
  langsam Stunde Tag dahinzogen -- Philines Billet erwarten -- lassen begreifen -- 
  Unglücklicherweise müssen selbigen Abend spielen -- niemals groß Pein ausgestanden -- 
  geendigtem Stück eilt Philin -- fragen -- einladen -- 
  finden Türe verschließen Hausleut sagen -- 
  mademoiselle früh jung Offizier weggefahren -- -- wiederkommen -- glauben -- bezahlen Sache mitnehmen -- 
  Wilhelm Nachricht -- 
  eilt Laert -- schlagen -- nachzusetzen -- -- kosten wollen -- Begleiter Gewißheit erlangen -- 
  Laert verweisen Freund Leidenschaft Leichtgläubigkeit -- 
  wetten -- -- Friedrich -- 
  Junge gut Haus -- wissen -- unsinnig Mädchen verlieben -- wahrscheinlich verwandte Geld abgelocken -- Zeitlang leben -- 
  Einwendung Wilhelm überzeugen -- zweifelhaft -- 
  Laert stellen -- unwahrscheinlich Märchen -- Philin vorgespiegeln -- Figur Haar Friedrich passen -- zwölf Stunde Vorsprung einholen -- hauptsächlich Serlo Schauspiele entbehren können -- 
  Grund Wilhelm bringen -- Verzicht -- nachzusetzen -- 
  Laert wissen selbig Nacht tüchtig Mann schaffen -- Auftrag geben -- 
  gesetzt Mann -- mehrere Herrschaft Reise Kurier Führer dienen -- Beschäftigung stillen liegen -- 
  Geld -- unterrichtet Sache -- Auftrag -- Flüchtling aufsuchen einholen -- alsdann Auge lassen Freund sogleich fänd benachrichtigen sollen -- 
  setzen derselbig Stunde Pferd reiden zweideutig Paar -- Wilhelm Anstalt einigermaßen beruhigen -- 
  Sechzehntes Kapitel -- 
  Entfernung Philines auffallend Sensation weder Theater Publikum -- 
  Ernst -- Frau haßen durchgängig -- Mann Auge Theater sehen -- schön -- Bühne glücklich Talent verlieren -- 
  übrig Glied Gesellschaft geben desto Mühe -- Madam Melina Fleiß Aufmerksamkeit hervor -- 
  merken -- -- Wilhelm Grundsatz -- richtet Theorie -- zeith wissen Wesen -- interessant -- 
  erlangt richtig Spiel gewinnen natürlich Ton Unterhaltung vollkommen -- Empfindung gewiß Grad -- 
  wissen Serlo Laun schicken Befliss Singens fallen -- worin -- gesellig Unterhaltung bedürfen -- 
  neu angenommen Schauspieler Gesellschaft vollständig -- Wilhelm Serlo Art wirken -- Stück Sinn Ton drang -- einzeln Teil gewissenhaft durcharbeiten -- beleben lobenswürdig Eifer Schauspieler -- Publikum lebhaft Anteil -- 
  gut Weg -- Serlo einst -- fortfahr -- Publikum -- 
  Mensch toll unschicklich Darstellung irre -- leg vernünftig Schicklich interessant Weise -- gewiß greifen -- 
  unser Theater hauptsächlich fehlen -- weder Schauspieler Zuschauer Besinnung -- -- bunt aussehen -- nirgends Grenze -- woran Urteil anlehnen -- 
  scheinen Vorteil -- Theater gleichsam unendlich Naturschauplatz ausweiten -- weder Direktor Schauspieler Enge ziehen -- Geschmack Nation Folge Kreis bezeichnen -- 
  Sozietät existieren gewiß Bedingung -- Theater -- 
  Gewiß Manier Redensart -- gewiß Gegenstand Handelsweisen ausschließen -- 
  arm -- Hauswese ziehen -- 
  hierüber einig uneinig -- 
  Wilhelm meister Seite englischen -- Serlo Seite französisch Theater -- 
  einig leer Stunde -- Schauspieler -- Gesellschaft berühmtesten Schauspiel beide Theater durchzugeh -- gut Nachahmenswert bemerken -- 
  Anfang französisch Stück -- 
  Aurelie entfernen jedesmal sobald Vorlesung anging -- 
  Anfangs halten krank -- einst fragt Wilhelm -- auffallen -- 
  Vorlesung gegenwärtig -- -- hören urteilen -- Herz zerrissen -- 
  Hasse französisch Sprache Seele -- 
  Sprache Feind -- rufen Wilhelm -- groß Bildung schuldig -- schuldig -- ehe Wesen Gestalt gewinnen -- 
  Vorurteil -- versetzt Aurelie -- unglücklich Eindruck -- verhaßt Erinnerung treulos Freund Lust schönen ausgebildet Sprache rauben -- 
  ganz Herz hassen -- 
  freundschaftlich Verbindung schreiben deutsch -- welch herzlich -- wahr -- kräftig Deutsch -- -- fing französisch schreiben -- vorher manchmal Scherz geschehen -- 
  fühlen -- merken bedeuten -- 
  muttersprache sagen errötet -- gut Gewissen hinschreiben -- 
  Reservation -- Halbheit Lüge trefflich Sprache -- perfid Sprache -- 
  finden -- Gott -- deutsch Wort -- perfid Umfange ausdrücken -- 
  armselig treulos unschuldig Kind -- 
  Perfid treulos Genuß -- Übermut Schadenfreude -- 
  O -- Ausbildung Nation beneid -- fein Schattierung Wort auszudrücken wissen -- 
  französische sprach Welt -- wert allgemein Sprache -- Betrüg belügen -- 
  französisch Brief lassen lesen -- 
  sich_es einbilden -- klingen warm leidenschaftlich -- genau besehen Phrase -- vermaledeit Phrase -- 
  Freude Sprache -- französisch Literatur -- schön köstlich Ausdruck edl Seele Mundart verdorben -- schaudern französisch Wort hören -- 
  Weise stundenlang fortfahr Unmut zeigen -- Unterhaltung unterbrechen verstimmen -- 
  Serlo launig Äußerung Bitterkeit -- gewöhnlich Abend Gespräch zerstören -- 
  Fall -- mehrere zusammentreffend Mensch Umstand hervorbringen -- vollkommen erhalten -- 
  Theatergesellschaft Reiche -- Zirkel Freund Armee lassen gewöhnlich Moment angeben -- hoch Stufe Vollkommenheit -- Übereinstimmung -- Zufriedenheit Tätigkeit stehen -- verändern schnell Personal -- Glied treten hinzu -- Person passen Umstand -- Umstand Person -- -- vorher verbinden -- fallen nunmehr auseinander -- 
  sagen -- Serlo Gesellschaft Zeitlang vollkommen -- deutsch Rühm -- 
  meister Schauspieler stehen Platze -- -- tun -- 
  persönlich Verhältnis leidlich jeder scheinen Kunst versprechen -- jeder Schritt Feuer Munterkeit -- 
  entdecken -- Automat -- erreichen -- wohin Gefühl gelangen -- mischen Leidenschaft -- gewöhnlich gut Einrichtung Weg stehen auseinander zerr -- vernünftig wohldenkend Mensch halten wünschen -- 
  Philines Abgang unbedeutend Anfangs glauben -- 
  Geschicklichkeit Serlo unterhalten -- Übrig reizen wissen -- 
  Ertrug Aurelie Heftigkeit Geduld -- eigenst Geschäft Wilhelm schmeicheln -- 
  Art Bindungsmittel für -- Verlust müssen fühlbar -- 
  Serlo Liebschaft leben -- 
  Elmir -- herangewachsen beinahe sagen schön -- Aufmerksamkeit erregen -- Philine klug -- Leidenschaft -- merken -- begünstigen -- 
  -- pflegen sagen -- Zeit auf Kuppel legen -- bleiben übrig alt -- 
  Serlo Elmire dergestalt nähern -- Philine Abschied einig -- Roman interessiert -- alte -- Unregelmäßigkeit Scherz verstehen -- geheim halten Ursache -- 
  Elmires Schwester Verständnis -- Serlo müssen Mädchen viele nachsehen -- 
  groß Untugende unmäßig Nascherei -- unleidlich Gefräßigkeit -- worin Philine keineswegs gleichen -- Schein Liebenswürdigkeit erhalten -- gleichsam Luft leben -- aß Schaum Champagnerglase groß Zierlichkeit wegschlurfen -- 
  müssen Serlo -- Schöne fallen -- Frühstück Mittagessen verbinden -- Vesperbrot Abendessen anknüpfen -- 
  Serlo Plan -- Ausführung beunruhigen -- 
  glauben gewiß Neigung Wilhelm Aurelie entdecken -- wünschen -- ernstlich -- 
  hoffen mechanisch Theaterwirtschaft Wilhelm aufzubürden -- -- Schwager -- treu fleißig Werkzeug finden -- 
  groß Besorgung unmerklich übertragen -- Aurelie führen Kasse -- Serlo leben früh Zeit Sinn -- 
  -- sowohl Schwester heimlich kränken -- 
  Publikum Art -- öffentlich Mensch anerkannt Verdienst verfahren -- fangen gleichgültig -- begünstigen gering neu erscheinend Talent -- übertrieben Forderung -- lassen fallen -- 
  Serlo Aurelie Gelegenheit hierüber Betrachtung anzustellen -- 
  Ankömmling -- jung Wohlgebildete -- Aufmerksamkeit -- Beifall ziehen -- Geschwister müssen meister -- eifrigsen Bemühung -- willkommen Klang zusammenschlagend Hand abtreten -- 
  freilich kommen besonderer Ursache -- 
  aurelie Stolz auffallend -- Verachtung Publikum unterrichten -- 
  Serlo schmeichelt Einzeln -- spitz Rede öfter herumgetragen wiederholen -- 
  Glied hingegen teils fremd unbekannt -- teils jung -- liebenswürdig hülfsbedürftig -- sämtlich Gönner finden -- 
  innerlich Unruhe Mißvergnüg -- bemerken -- Wilhelm Beschäftigung Regisseurs übernehmen -- fangen meister Schauspieler desto unartig -- Weise Ordnung Genauigkeit bringen wünschen -- bestehen -- mechanisch Ding pünktlich ordentlich sollen -- 
  kurz Verhältnis -- Zeitlang beinahe idealisch halten -- gemein -- herumreisend Theater finden -- 
  Augenblick -- Wilhelm Mühe -- Fleiß Anstrengung Erfordernissen Metier Person sowohl Geschäftigkeit vollkommen bilden -- scheinen trüb Stunde -- Handwerk -- nötig Aufwand Kraft verdienen -- 
  Geschäft lästig Belohnung gering -- 
  jeder übernehmen -- -- vorbei -- Ruhe Geist genießen -- -- überstanden mechanisch Mühseligkeit hoch Anstrengung Geist Empfindung Ziel Tätigkeit erreichen -- 
  müssen Klage Aurelie Verschwendung Bruder hören -- müssen Winke serlos mißverstehen -- Heirat Schwester fern leiten suchen -- 
  Kummer verbergen -- tief drücken -- zweideutig Offizier fortgeschickt Bote -- hören lassen -- Freund Mariane zweitenmal verlieren fürchten müssen -- 
  fallen allgemein Trauer -- wodurch nötigen -- Theater Woche schließen -- 
  ergriff Zwischenzeit -- Geistliche besuchen -- Harfenspieler Kost -- 
  finden angenehm Gegend -- Pfarrhofe erblicken alt -- Knabe Instrument Lektion -- 
  bezeugt Freude Wilhelm sehen -- stehen reicht Hand -- sehen -- Welt nützen -- erlauben fortfahr -- Stunde eingeteilen -- 
  geistliche begrüßen Wilhelm freundlich erzählen -- alt anlaß Hoffnung völlig Genesung -- 
  Gespräch fallen Methode -- Wahnsinnig kurieren -- 
  Physische -- geistliche -- unüberwindlich Schwierigkeit Weg legen worüber denkend Arzt Rate ziehen -- finden Wahnsinne heilen einfach -- 
  -- wodurch gesund Mensch hindern wahnsinnig -- 
  errege Selbsttätigkeit -- gewöhn Ordnung -- geben Begriff -- Schicksal gemein -- außerordentlich Talent -- groß Glück hoch Unglück Abweichung gewöhnlichen -- wahnsinn einschleichen -- -- verschwinden -- 
  alt Mann Stunde eingeteilen -- unterrichten Kind Harfe -- helfen Garten arbeiten Heiterer -- 
  wünschen Kohle genießen -- pflanzen -- wünschen Sohn -- Harfe Todesfall schenken -- emsig unterrichten -- Knabe brauchen können -- 
  Geistlich such wunderbar Skrupel sagen -- tätig Leben führen Ereignis herbei -- fühlen -- Art Zweifel Wirksamkeit heben -- 
  gehen sacht Werk -- Bart Kutte wegnehmen -- gewinnen -- bringen nah Wahnsinn -- auszeichnen -- erhalten gemein Verstand -- Sinn Mensch leben -- vieler Erziehung unser bürgerlich Einrichtung -- wodurch Kind Tollheit vorbereiten -- 
  Wilhelm verweilt vernünftig Manne -- erfahren interessantest Geschichte -- verrückt Mensch -- -- klug -- Weise halten pflegen -- Eigentümlichkeit nah Wahnsinn grenzen -- 
  dreifach beleben Unterhaltung -- Medikus eintreten -- Geistliche -- Freund -- öfters besuch -- menschenfreundlich Bemühung beizustehen pflegen -- 
  ältlich Mann -- schwächlich Gesundheit Ausübung edelst Pflicht zubringen -- 
  Freund Landlebe fast frei Luft -- äußerst gesellig tätig -- besonderer Neigung Landgeistlichen Freundschaft stiften -- 
  -- nützlich Beschäftigung kennen -- suchen Weise beizustehen -- -- unbestimmen -- suchen Liebhaberei einzured -- Edelleut -- Amtmänner Gerichtshaltern Verbindung stehen -- stille Kultur zweig Landwirtschaft beitragen -- Feld -- Tier Mensch ersprießlich -- Bewegung bringen -- wahrste Aufklärung befördern -- 
  Mensch -- -- Unglück -- Idee festsetzen -- Einfluß tätig Leben tätig Leben abziehen -- 
  -- -- gegenwärtig Fall vornehmen reich Ehepaar -- Kunst mißglücken -- fast gehören Fall Fach -- Pastor -- jung Mann erzählen -- 
  Abwesenheit vornehm Mann verkleiden -- lobenswürdigen Scherz -- jung Mensch Hauskleidung Herr -- 
  Gemahlin anführen -- Posse erzählen -- fürcht -- Absicht -- edlen -- liebenswürdig Dame Weg abzuleiten -- 
  Gemahl unvermuten -- treten Zimmer -- glauben sehen -- fallen Melancholie -- Überzeugung nähren -- sterben -- 
  überläßen Person -- religiös Idee schmeicheln -- sehen abhalten -- Gemahlin Herrenhuter -- groß Vermögen -- Kind -- verwandter entziehen -- 
  Gemahlin -- rufen Wilhelm -- Erzählung erschrecken -- ungestüm -- 
  -- versetzen Arzt -- Wilhelm Ausrufung menschenfreundlich Teilnahme hören glauben -- Dame tieferen Kummer behaften -- Entfernung Welt widerlich -- 
  jung Mensch nehmen Abschied -- vorsichtig aufkeimend Neigung verbergen -- kühn -- schließen Arm -- drücken Brillant besetzt Porträt Gemahl gewaltsam wider Brust -- 
  empfinden heftig Schmerz -- vergehen -- Rot Spur lassen -- 
  Mensch überzeugen -- vorzuwerfen -- Arzt gewiß -- Druck übl Folge -- lassen ausreden -- Verhärtung -- Gefühl Wahn benehmen -- behaupten -- Augenblick fühlen -- fest eingedrucken -- Übel Krebsschade endigen -- Jugend -- Liebenswürdigkeit völlig verlieren -- 
  unglückselig -- rufen Wilhelm -- Stirn schlagen Gesellschaft Feld laufen -- 
  Zustande befinden -- 
  Arzt geistliche -- seltsam Entdeckung höchlich erstaunt -- Abends -- zurückkommen umständlicher Bekenntnis Begebenheit auf Lebhafteste anklagen -- 
  Mann nehmen groß Anteil -- übrig Lage schwarz Farbe augenblicklich Stimmung malen -- 
  lassen Arzt bitten Stadt -- Gesellschaft leisten -- Aurelie -- Freund bedenklich Umstand zurückgelassen -- Hilfe verschaffen -- 
  finden schlimm -- vermuten -- 
  Art überspringendem Fieber -- beizukommen -- Anfälle Art vorsätzlich unterhielt Verstärkt -- 
  fremd Arzt einführen -- betragen gefällig klug -- 
  sprechen Zustand Körper Geist -- Freund erzählt Geschichte -- Person -- ungeachtet Kränklichkeit -- hoch Alter erreichen können -- schädlich Fall -- vorsätzlich Erneuerung leidenschaftlich Empfindung -- 
  verbergen -- Person glücklich finden -- herzustellend kränklich Anlage wahrhaft religiös Gesinnung nähren bestimmen sein -- 
  bescheiden Weise gleichsam historisch -- versprechen Freund interessant Lektüre Manuskript verschaffen -- Hand nunmehr abgeschieden vortrefflich Freundin erhalten -- 
  unendlich wert -- -- vertrau Original -- 
  Titel Hand -- Bekenntnis schön Seele -- 
  diätetisch medizinisch Behandlung unglücklich aufgespannt Aurelie -- vertrauen Arzt Wilhelm Rat -- versprechen schreiben -- 
  inzwischen Wilhelm Abwesenheit Veränderung vorbereiten -- vermuten -- 
  Wilhelm Regie Geschäft gewiß Freiheit Liberalität behandeln -- vorzüglich Sache sehen -- Kleidunge -- Dekoration Requisit reichlich anständig anschaffen -- gut Wille Leute erhalten Eigennutz schmeicheln -- edler Motiv beikommen -- finden hierzu berechtigen -- Serlo Anspruch -- genau Wirt -- Glanz Theater gerne loben hören zufrieden -- Aurelie -- Haushaltung führen -- Abzug Kosten -- versichern Schuld -- hergab nötig Schuld abzutragen -- Serlo unterdessen außerordentlich Freigebigkeit Schöne laden -- 
  Melina -- indessen Garderobe besorgen -- -- kalt heimtückisch -- Sache still zusehen -- wissen Entfernung Wilhelm zunehmend Krankheit Aurelie Serlo fühlbar -- eigentlich einnehmen -- ausgeben -- zurücklegen Willkür lustig leben können -- 
  Serlo hören Melina wagen Plan hervor -- 
  -- -- behaupten -- Schauspieler gegenwärtig Gage -- verdienstvoll Leute Ort willkommen -- Einnahme -- verschaffen -- erhalten -- 
  Vorschlag Oper einrichten -- Schauspiel betreffen -- sagen -- Mann Schauspiel ausmachen -- 
  erfahren -- Verdienst verkennen -- 
  -- Mitspieler vortrefflich -- -- lassen außerordentlichen Talent Gerechtigkeit widerfahren -- 
  Stelle -- geschehen -- -- suchen mittelmäßig -- sagen schlecht Leute gering Gag ziehen -- stutzen Volk -- verstehen -- Mechanisch -- wenden übrig Oper sehen -- Mühe Kosten Zufriedenheit erregen -- ungleich Geld gewinnen -- 
  Serlo schmeicheln -- Einwendung Stärke -- 
  gestehen Melina -- Liebhaberei Musik längst wünschen -- sehen freilich -- Neigung Publikum Abweg leiten Vermischung Theater -- Oper Schauspiel -- notwendig Überrest Geschmack -- bestimmt ausführlich Kunstwerk völlig verlieren müssen -- 
  Melina scherzt fein Wilhelm pedantisch Ideal Art -- Anmaßung Publikum bilden -- bilden lassen -- vereinigt Überzeugung -- Geld einnehmen -- reich lustig sollen verbargen -- Person wünschen -- Plan Weg stehen -- 
  Melina bedauern -- schwächlich Gesundheit Aurelie lang Leben versprech -- denken Gegenteil -- 
  Serlo scheinen beklagen -- Wilhelm Sänger verstehen -- entbehrlich halten -- 
  Melina treten Register Ersparnisse -- -- hervor -- Serlo Schwager dreifach ersetzen -- 
  fühlen -- Unterredung Geheimnis zusagen -- knüpfen nehmen Gelegenheit insgeheim vorkam -- besprech -- Aurelie Wilhelm unternahmen tadeln neu Projekt Gedanke ausarbeiten -- 
  verschwieg Plan -- Wort verrien -- politisch -- Gesinnung Handelsweise verbergen -- 
  Melina widersetzen Wilhelm Fällen -- Kreis liegen -- Serlo -- niemals glimpflich Schwester umgehen -- bitter -- jemehr Kränklichkeit zunehmen -- jemehr ungleich -- leidenschaftlich Laun Schonung verdienen -- 
  Emilie Galotti -- 
  Stück glücklich besetzen -- beschränkt Kreis Trauerspiel Mannigfaltigkeit Spieles zeigen -- 
  Serlo Marinelli Platz -- Odoardo vortragen -- Madam Melina spielt Mutter vieler Einsicht -- Elmire zeichnen Rolle Emilien Vorteil -- Laert treten Appiani Anstand -- Wilhelm Studium mehrere Monat Rolle Prinz verwenden -- 
  Gelegenheit sowohl Serlo Aurelie Frage abgehandeln -- welcher Unterschied edel vornehm Betrag zeigen -- wiefern -- enthalten brauchen -- 
  Serlo Marinelli Hofmann rein -- Karikatur vorstellen -- äußern Punkt gut Gedanke -- 
  vornehm Anstand -- -- schwer nachzuahmen -- eigentlich negativ -- anhaltend Übung voraussetzen -- 
  Benehme darstellen -- anzeigt -- fallen förmlich stolz Wesen -- vielmehr vermeiden -- Unwürdig Gemein -- vergessen -- -- vergeben -- -- -- rühren scheinen -- bewegen -- niemals übereilen -- Moment fassen wissen -- äußere Gleichgewicht erhalten -- innerlich stürmen -- 
  edel Mensch Moment vernachlässigen -- vornehmen -- 
  wohlgekleidet Mann -- nirgends anlehn -- Hüten streichen -- unterscheiden -- stehen bleiben -- Kunst -- zuletzt schwer Leichtigkeit ausführen -- Vornehme -- ungeachtet Absonderung -- verbinden scheinen -- nirgends Steif -- überall wenden -- erscheinen Aufdring -- 
  sehen -- -- vornehm scheinen -- vornehm müssen -- sehen Frau Durchschnitt eher ansehen geben Mann -- Hofleute Soldat schnellsen Anstande gelangen -- 
  Wilhelm verzweifelen fast Rolle -- Serlo helfen -- Einzeln feinst Bemerkung mitteilen -- dergestalt ausstatten -- Aufführung -- Augo Menge -- fein Prinz darstellen -- 
  Serlo versprechen Vorstellung Bemerkung mitteilen -- allenfalls -- unangenehm Streit Bruder Schwester hindert kritisch Unterhaltung -- 
  Aurelie Rolle Orsina Weise spielen -- niemals sehen -- 
  Rolle -- Probe gleichgültig behandeln -- Aufführung ziehen -- sagen -- Schleuse individuell Kummer -- Darstellung -- Dichter Feuer Empfindung denken -- 
  unmäßig Beifall Publikum belohnt schmerzlich Bemühung -- liegen halb ohnmächtig Sessel Aufführung aufsuchen -- 
  Serlo übertrieben Spiel -- nennen -- Entblößung innersten Herzen Publikum -- fatal Geschichte -- Unwille erkennen geben -- -- Zorn pflegen -- zähnen geknirscht Füße stampfen -- 
  lassen -- -- Übrig umgeben Sessel finden -- ehestens nackt Theater treten -- Beifall willkommen -- 
  Undankbarer -- rufen -- Unmenschlicher -- nackt tragen -- Beifall unser Ohr -- 
  Wort springen eilt Türe -- 
  Magd versäumen Mantel bringen -- Portechais -- geregnet rauh Wind ziehen Straße -- 
  reden vergebens -- übermäßig erhitzen -- vorsätzlich langsam lobt Kühlung -- begierig einzusaugen scheinen -- 
  Haus -- Heiserkeit Wort sprechen -- gestehen -- Nacken Rücken hinab völlig Steifigkeit fühlen -- 
  überfiel Art Lähmung Zunge -- Wort für sprechen -- bringen Bette -- häufig angewandte legen Übel -- zeigen -- 
  Fieber stark Zustand gefährlich -- 
  ruhig Stunde -- 
  lassen Wilhelm rufen übergeben Brief -- 
  Blatt -- -- warten Augenblick -- 
  fühlen Leben heran nahen -- versprechen -- abgeben Wort leiden Ungetreue rächen -- 
  fühllos Tod Augenblick schmerzen -- 
  Wilhelm übernehmen Brief -- tröstet Gedanke Tod entfernen -- 
  -- versetzen -- benehmen nächster Hoffnung -- 
  erwarten freudig Arm schließen -- 
  Arzt versprochen Manuskript -- 
  ersuchen Wilhelm vorzulesen -- Wirkung Leser beurteilen -- folgend Buch -- 
  heftig trotzig Wesen arm Freundin gelind -- 
  Brief schreiben -- scheinen sanft Stimmung -- fordern Wilhelm -- Freund -- Nachricht Tod betrüben -- tröst -- versichern -- Verzieh -- Glück wünschen -- 
  still scheinen weniger Idee beschäftigen -- Manuskript suchen -- woraus Wilhelm vorlesen müssen -- 
  Abnahme Kraft sichtbar unvermutet finden Wilhelm Morgens tot -- besuchen -- 
  Achtung -- -- Gewohnheit -- leben -- Verlust schmerzlich -- 
  einzig Person -- eigentlich meinen -- Kälte Serlo letzter Allzusehr fühlen -- 
  eilt aufgetragen Botschaft ausrichten wünscht entfernen -- 
  Seite Melina Abreise erwünscht -- weitläufig Korrespondenz -- unterhieln -- Sänger Sängerin einlassen -- Publikum einstweilen Zwischenspiel künftig Oper vorbereiten -- 
  Verlust Aurelie Wilhelm Entfernung Weise übertragen -- Freund zufrieden Urlaub Woche erleichteren -- 
  sonderbar wichtig Idee Auftrage -- 
  Tod Freundin tief gerührt frühzeitig Schauplatze abtreten -- müssen notwendig -- Leben verkürzen -- kurz Leben qualvoll -- feindselig sinnen -- 
  ungeachtet letzter gelind Wort Sterbende -- Überreichung Brief streng Gericht ungetreu Freund ergehen lassen -- zufällig Stimmung vertrauen -- dachen Rede -- Ausarbeitung pathetisch billig -- 
  völlig gut Komposition Aufsatzes überzeugen -- -- auswendig lernen -- Anstalt Abreise -- 
  Mignon Einpacke gegenwärtig fragen -- Süden Norden reise -- letzter erfahren -- -- 
  erwarten -- 
  bitten Perlenschnur Mariane -- lieb Geschöpf versagen -- Halstuch -- 
  stecken Schleier Geist Mantelsack -- -- Flor Gebrauch -- 
  Melina übernehmen Regie -- Frau versprechen Kind mütterlich Auge -- Wilhelm ungern losriß -- 
  Felix lustig Abschied fragen -- 
  wollen mitbringen -- -- 
  Höre -- bring Vater -- 
  Mignon scheidend Hand -- -- heben -- treuherzig lebhaft Kuß -- Zärtlichkeit -- Lippe drücken -- -- Meister -- Vergiß kommen -- 
  lassen unser Freund tausend Gedanke Empfindung Reise antreten -- zeichnen Schlus Gedicht -- Mignon groß Ausdruck einigemal rezitieren -- mitteilen Drang sonderbaren Ereignis verhindern -- 
  Heiß reden -- heiß schweigen Geheimnis Pflicht -- innere zeigen -- Schicksal -- 
  vertreiben Sonne Lauf finster Nacht -- erhell -- hart Fels schließen Busen Mißgönnt Erde tiefverborgen Quelle -- 
  suchen Arm Freund Ruhe -- Brust Klage ergießen -- Schwor drücken Lippe Gott vermögen aufzuschließen -- 
  Wilhelm Meister Lehrjahre -- 
  Buch -- 
  Bekenntnis schön Seele -- 
  gesund Kind -- wissen erinnern -- Geburt -- 
  Anfang Jahr bekommen Blutsturz Augenblick Seele Empfindung Gedächtnis -- 
  klein Umstand Zufall stehen Auge gestern ereignen -- 
  monatlich Krankenlager -- Geduld aushielt -- -- dünken -- Grund Denkart legen -- Geist Hilfsmittel reichen -- Art entwickeln -- 
  litt lieben -- eigentlich Gestalt Herzens -- 
  heftig Hust abmattend Fieber still Schnecke -- Haus ziehen -- Luft -- Angenehme fühlen -- übrig Genuß versagen -- suchen Auge Ohr schadlos halten -- 
  bringen Puppenwerk Bilderbücher Sitz Bette -- müssen erzählen -- 
  Mutter hört biblisch Geschichte -- Vater unterhieln Gegenständen Natur -- 
  besitzen artig Kabinett -- 
  bringen gelegentlich Schublade herunter -- zeigen Ding erklären Wahrheit -- 
  Getrocknete Pflanze Insekt Art anatomisch Präparat -- 
  Menschenhaut -- Knoch -- Mumi dergleichen kommen Krankenbett -- Vögel Tier -- Jagd erlegen -- vorgezeigen -- ehe Küche gehen -- Fürst Welt Stimme Versammlung behieln -- erzählt Tante Liebesgeschicht Feenmärche -- 
  annehmen fassen Wurzel -- 
  Stunde -- lebhaft unsichtbar Wesen unterhielen -- wissen Vers -- Mutter Feder diktieren -- 
  erzählt Vater -- lernen -- 
  Arznei -- fragen -- wachsen Ding -- -- 
  sehen -- 
  heißen -- 
  Erzählung Tante Stein fallen -- 
  denken schön Kleid begegnen allerliebst Prinz -- Ruhe rasen -- wissen -- unbekannt schön -- 
  ähnlich Abenteuer reizend Engel -- weiß Gewand golden Flügel bemühen -- setzen fort -- Einbildungskraft Bild fast Erscheinung erhöhen -- 
  Jahresfrist ziemlich herstellen -- Kindheit Wilde übrig bleiben -- 
  Puppe spielen -- verlangt Wesen -- Liebe erwiderten -- 
  Hund -- Katze Vögel -- dergleich Vater Art ernähren -- vergnügten -- geben -- Geschöpf besitzen -- märch Tante wichtig Rolle spielen -- 
  schäfchen -- Bauermädch Walde aufgefangen ernähren -- artig Tier steckt verwünscht Prinz -- schön Jüngling zeigen Wohltäterin Hand belohnn -- 
  schäfchen gerne besessen -- 
  keiner finden -- zugehen -- müssen Hoffnung köstlich Besitz fast vergehen -- 
  unterdessen trösten -- Buch lesen -- wunderbar Begebenheite beschreiben -- 
  christlich deutsch Herkules liebsen -- andächtig Liebesgeschicht Sinn -- 
  Begegnete Valiska -- begegnen grausam Ding -- beten -- ehe Hilfe eilen -- Gebet stehen ausführlich Buch -- 
  gefallen -- 
  Hang Unsichtbar -- dunkel Weise fühlen -- vermehren -- allemal Gott vertraute -- 
  heran wachsen -- lesen -- Himmel wissen -- römisch Oktavia behalten Preis -- 
  Verfolgung Christ Roman kleiden -- erregn lebhaft Interesse -- 
  fing Mutter stet Lese schmälen -- Vater Liebe Buch Hand -- 
  klug bemerken -- ausrichten -- Drang -- Bibel fleißig lesen -- 
  lassen treiben -- Las heilig Büch Anteil -- 
  Mutter sorgfältig -- verführerisch Buch Hand kommen -- schändlich Schrift Hand werfen -- Prinz Prinzessinn äußerst tugendhaft -- wissen natürlich Geschichte menschlich Geschlecht merken lassen -- meistens Bibel lernen -- 
  bedenklich Stelle halten Wort Ding Auge kommen -- bringen Wißbegierde Kombinationsgabe Wahrheit glücklich heraus -- 
  Hexe gehören -- Hexerei -- 
  Mutter Wißbegierde danken -- heftig Hang Buch kochen lernen -- sehen -- 
  Huhn -- Ferkel aufzuschneiden -- fest -- 
  Vater bringen Eingeweide redet jung Student -- pflegen innig Freude mißraten Sohn nennen -- 
  zwölfte zurücklegen -- 
  lernen französisch -- Tanze zeichnen -- erhalten gewöhnlich Religionsunterricht -- 
  letzter Empfindung Gedanke regen -- Zustand beziehen -- 
  hören Gott reden -- stolz meinesgleichen reden -- lesen Eifer Buch -- Stand setzen Religion schwatzen -- fallen denken -- stehen -- Seele gestalten -- Spiegel gleich -- ewig Sonne glänzen -- allemal voraussetzen -- 
  französische lernen vieler Begierde -- 
  Sprachmeister wacker Mann -- 
  leichtsinnig Empiriker -- trocken Grammatiker -- Wissenschaft -- Welt sehen -- 
  Sprachunterricht sättigt Wißbegierde mancherlei Weise -- 
  lieben -- Ankunft Herzklopfe erwarten -- 
  Zeichne fallen schwer -- bringen -- Meister Kopf Kenntnis -- Hände Übung -- 
  tanzen Anfangs gering Freude -- Körper empfindlich lernt Gesellschaft Schwester -- 
  Einfall unser Tanzmeister Schüler Schülerin Ball geben -- Lust Übung beleben -- 
  Knabe Mädchen zeichnen Sohn Hofmarschall -- jung alt -- alt -- Kind Schönheit -- Geständnis übertrafen -- schön Kind sehen -- 
  erblicken -- Haufen -- 
  Augenblick tanzt Aufmerksamkeit wünschen schön tanzen -- 
  -- Knabe vorzüglich bemerkten -- -- 
  Stunde Freund -- Lustbarkeit -- ausmachen -- nächstens sehen -- 
  Freude -- entzücken -- galant Billet -- Blumenstrauß begleiten -- Befinde erkundigen -- 
  fühlen -- fühlen -- 
  artigkeiten Artigkeiten -- Briefchen Briefchen erwidern -- 
  Kirche Promenade Rendezvous -- jung bekannte luden jederzeit -- schlau -- Sache dergestalt verdecken -- Eltern einsahen -- halten -- 
  Liebhaber bekommen -- 
  entscheiden -- gefiel -- stehen auf gut -- 
  Altest krank -- krank wissen Leidende Übersendung Artigkeit kranke schicklich Leckerbisse erfreuen -- Eltern Aufmerksamkeit dankbar erkannt -- Bitte lieben Sohn Gehör geben samt Schwester -- Bette verlassen -- einluden -- 
  Zärtlichkeit -- womit empfangen -- kindisch -- entscheiden -- 
  warnen -- Bruder geheim -- Feuer verbergen -- Eifersucht Jüngster Roman vollkommen -- 
  spielen tausend Streich -- Lust vernichten Freude -- vermehrt Leidenschaft -- zerstören suchen -- 
  gewünscht schäfchen finden -- Leidenschaft Krankheit Wirkung -- still schwärmend Freude ziehen -- 
  einsam gerührt Gott fallen -- 
  bleiben vertraute -- wissen -- Träne Knabe -- fortkränkelt -- beten Anhielt -- 
  kindisch Vorgang -- tragen Bildung Herzens -- 
  Unserem französisch Sprachmeister müssen täglich -- gewöhnlich Übersetzung -- Brief Erfindung schreiben -- 
  bringen Liebesgeschicht Name Phylli Damon Markt -- 
  alt -- -- treuherzig -- loben Arbeit -- 
  kühn -- offenherzig heraus Detail Wahrheit getreu -- 
  wissen -- Stelle einst Gelegenheit -- sagen -- artig -- -- 
  Phylli nehmen -- ernsthaft -- 
  verdroß -- Sache ernsthaft halten -- fragen pikieren -- ernsthaft verstehen -- 
  lassen zweimal fragen -- erklären deutlich -- Schrecken verbergen -- 
  Verdruß einstellten -- übel -- Gedanke hegen können -- fassen -- schön rechtfertigen feuerroten Wang -- Herr -- Phylli ehrbar Mädchen -- 
  boshaft -- ehrbaren Heldin aufzuziehen -- -- französisch sprechen -- -- honet -- spielen -- Ehrbarkeit Phylli Bedeutung durchführen -- 
  fühlt lächerliche äußerst verwirrt -- 
  -- furchtsam -- brechen -- bringen Gespräch Gelegenheit Bahn -- 
  Schauspiel Geschichte -- lesen übersetzen -- geben Anlaß zeigen -- schwach Schutz sogenannter Tugend Aufforderunge Affekt -- 
  widersprechen -- ärgern heimlich -- Anmerkung Last -- 
  gut Damon Verbindung -- 
  Schikan jung unser Umgang zerrissen -- 
  sterben blühend Jünglinge -- 
  weh -- vergessen -- 
  Phyllis wachsen schnell heran -- gesund fing Welt sehen -- 
  Erbprinz vermähln treten Tod Vater Regierung -- 
  Hof Stadt lebhaft Bewegung -- 
  neugierde mancherlei Nahrung -- 
  Komödie -- Ball anschließen -- Eltern halten -- müssen Hof -- einführen -- erscheinen -- 
  Fremden strömen herbei -- Haus Welt -- Kavalier empfehlen introduziert -- Oheim Nation antreffen -- 
  ehrlich Mentor fahren fort -- bescheiden treffend Weise warnen -- heimlich übel -- 
  keineswegs Wahrheit Behauptung überzeugen -- -- Unrecht -- Frau Umstand schwach halten -- reden zudringlich -- einst bange -- -- lebhaft -- 
  Gefahr menschlich Herz schwach -- Gott bitten -- bewahren -- 
  naiv Antwort scheinen freuen -- loben Vorsatz -- ernstlich meinen -- diesmal leer Wort -- Empfindung Unsichtbar fast verloschen -- 
  Schwarm -- umgeben -- Zerstreute reißen stark Strom fort -- 
  leer Leben -- 
  tagelang reden -- gesund Gedanke -- schwärmen -- Sache -- 
  geliebt Buch denken -- 
  Leute -- umgeben -- Ahnung Wissenschaft -- deutsch Hofleute Klasse minde Kultur -- 
  Umgang -- denken -- Rand Verderben führen -- 
  leben sinnlich Munterkeit -- sammelt -- beten -- denken Gott -- sehen Führung -- schön -- reich wohlgekleidet Mann gefallen -- 
  liederlich versteckt -- schrecken -- Gespräch ziert Zweideutigkeit -- beleidigen halten kalt -- Unart überstieg manchmal Glaube -- erlauben -- grob -- 
  überdies Alter vertraulich eröffnen -- meister leidig Bursch Tugend Gesundheit Mädchen Gefahr -- 
  graut -- besorgt -- Weise nahe -- 
  hütet Gläser Tasse Stuhle -- aufstanden -- 
  Weise moralisch physisch isolieren -- Artigkeiten -- sagen -- stolz schuldig Weihrauch -- 
  fremde -- aufhalten -- zeichnen jung Mann -- Scherz Narziss nannn -- 
  diplomatisch Laufbahn gut Ruf erwerben -- hoffen verschieden Veränderung -- unser Hof vorgingen -- vorteilhaft platzieren -- 
  Vater -- Kenntnis Betragen öffnet Weg geschlossen Gesellschaft würdigst Mann -- 
  Vater sprechen Lobe -- schön Gestalt Eindruck -- Wesen Art Selbstgefälligkeit zeigen -- 
  sehen -- denken -- sprechen -- 
  Balle -- befinden -- tanzen Menuett -- nah Bekanntschaft -- 
  heftig Tänze angingen -- Vater lieben -- Gesundheit besorgt -- vermeiden pflegen -- begeben Nebenzimmer -- unterhalten alt Freundin -- Spiel setzen -- 
  Narziss -- Weile herumgesprungen -- Zimmer -- befinden -- fing -- Nasenblut -- tanzen überfiel -- erholen -- mancherlei sprechen -- 
  binnen halb Stunde Diskurs interessant -- Spur Zärtlichkeit drein mischen -- tanzen vertragen -- 
  necken -- Irre lassen -- 
  Abend Gespräch anknüpfen schont Gesundheit -- 
  Bekanntschaft -- 
  Narziss wartet Schwester -- fing Wide ran gewahr -- wissen -- worüber denken -- empfinden -- worüber Gespräch ausdrücken verstehen -- 
  neu Freund -- jeh Gesellschaft -- historisch politisch Fache -- übersehen -- ausgebreitet literarisch Kenntnis -- bleiben neue -- Frankreich herauskommen -- unbekannt -- 
  bringen senden manch angenehm nützlich Buch -- müssen geheimer verboten Liebesverständnis halten -- 
  gelehrten Weiber lächerlich -- unterrichtet leiden -- wahrscheinlich -- unhöflich halten -- unwissend Mann beschämen lassen -- 
  Vater -- Gelegenheit -- Geist ausbilden -- erwünschen -- verlangen ausdrücklich -- literarisch Kommerz Geheimnis bleiben -- 
  währen Umgang beinahe -- sagen -- Narziss Weise lieb Zärtlichkeit äußern -- 
  bleiben artig verbindlich -- zeigen Affekt -- vielmehr scheinen Reiz jung Schwester -- außerordentlich schön -- gleichgültig lassen -- 
  Scherz allerlei freundlich Name fremd Sprache -- mehrere sprechen -- eigentümlich Redensart deutsch Gespräch mischen -- 
  erwidern Artigkeiten sonderlich -- fädchen binden -- rasch empfindlich -- selten Kleinigkeit uneins -- 
  Mutter Tante wissen halten -- Glied Familie -- 
  wissen Weise fortgeleben -- sonderbar Zufall Verhältnis verändern -- 
  Schwester gewiß Haus bitten -- wohin gerne -- 
  Gesellschaft mischen -- finden Mensch -- rohsen plattst Schlage -- diesmal Narziss laden -- seinetwillen neigen -- gewiß finden -- Weise unterhalten -- 
  Tafel auszustehen -- Mann stark getrunken -- Tisch müssen Pfänder spielen -- 
  rauschend lebhaft -- 
  Narziss Pfand lösen -- -- Gesellschaft Ohr sagen -- angenehm -- 
  Nachbarin -- Frau Hauptmann -- verweilen -- 
  Ohrfeige -- -- sitzen -- Puder Auge fliegen -- 
  Auge auswischen Schrecken einigermaßen erholen -- Mann bloß Deg -- 
  Narziss bluten -- -- Wein -- Zorn Eifersucht -- übrig Gesellschaft halten -- 
  Narzissen Arm führen Türe hinaus Treppe hinauf and Zimmer -- Freund tollen Gegner sicher glauben -- riegelt Türe sogleich -- 
  halten Wunde ernsthaft -- sehen leicht Hieb Hand -- Strom Blut -- Rücken hinunterfloß -- gewahr -- zeigen Wunde kopfe -- 
  bange -- 
  eilt Vorplatz Hilfe schicken -- ansichtig -- unten bleiben -- rasend Mensch bändigen -- 
  Tochter Haus herauf gesprung Munterkeit ängstigen -- toll Spektakel verfluchen Komödie fast Tod lachen -- 
  bitten dringend Wundarzt schaffen -- -- wild Art -- springen Treppe hinunter -- hohlen -- 
  verwundeter -- band Schnupftuch Hand Handtuch Türe hing -- Kopf -- 
  bluten heftig -- Wundarzt -- Verwundete erblaßen scheinen Ohnmacht sinken -- 
  Nähe -- beistehen -- ungezwung Arm suchen Streichel Schmeichel aufmuntern -- 
  scheinen Wirkung geistig Lebensmittel -- bleiben -- sitzen totenbleich -- 
  tätig Hausfrau erschrak -- Freund Gestalt Arm liegen Blut überströmen -- vorstellen -- Narziss verwunden -- meinen -- glücklich hinaus bringen -- 
  Wein -- wohlriechend Wasser erquicken erfrischen -- Überfluß -- Wundarzt abtreten -- Narziss halten fest Hand -- halten stehen bleiben -- 
  fahren Verband fort -- Wein anzustreichen achten -- Gesellschaft nunmehr umh stehen -- 
  Wundarzt endigen -- Verwundet stummen verbindlich Abschied Haus tragen -- 
  führen Hausfrau Schlafzimmer -- müssen auskleiden verschweigen -- -- Blut Körper abwusch -- erstenmal zufällig Spiegel gewahr -- Hülle schön halten -- 
  kein Kleidungsstücke anziehen -- Person Haus stark -- seltsam Verkleidung groß erstaun Eltern Haus -- 
  Schrecken -- Wunde Freund -- Unsinn Hauptmann -- Vorfall äußerst verdrießlich -- 
  fehlen -- Vater -- Freund Stelle rächen -- Hauptmann heraus fordern -- 
  Schalt anwesend Herr -- meuchelmörderisch Beginnen Stelle ahnden -- offenbar -- Hauptmann sogleich -- schlagen -- Deg ziehen narzissen hinten verwunden -- Hieb Hand führen -- Narziss Degen greifen -- 
  unbeschreiblich alteriert affizieren -- ausdrücken -- Affekt -- tief Grund Herzen ruhen -- losgebroch -- Flamm Luft bekommen -- 
  Lust Freude schicken -- Liebe erzeug stille nähren -- -- Natur herzhaft -- Schrecken leichtesn antreiben -- entscheiden erklären -- 
  Töchterchen Arznei legen Bette -- 
  frühsen eilt Vater verwundet Freund -- stark Wundfieber krank danieder liegen -- 
  Vater -- reden -- suchen Folge -- Vorfall -- beruhigen -- 
  Rede -- Abbitte begnügen können -- Sache gerichtlich müssen dergleichen -- 
  kennen Vater -- glauben -- Sache Zweikampf endigen sehen wünschen -- bleiben still -- Vater früh lernen -- Weiber Händel mischen -- 
  scheinen -- Freund vorgefallen -- betreffen -- vertraut Vater Inhalt Unterredung Mutter -- 
  Narziss -- -- äußerst gerührt geleistet Beistand -- umarmt -- ewig Schuldner erklären -- bezeigen -- verlangen Glück -- teilen -- Erlaubnis ausgebeen -- Vater ansehen -- 
  Mama treulich -- hängt wohlmeinend Erinnerung -- -- Bewegung -- dürfen -- 
  freilich -- antworten angenommen Kälte -- fühlen Himmel wissen wieviel -- 
  Narziss bleiben Monat krank -- Wunde Hand schreiben -- bezeigen inzwischen Andenken verbindlichst Aufmerksamkeit -- 
  gewöhnlich Höflichkeit halten -- Mutter erfahren -- -- beständig Kopf voll Grill -- 
  Stadt unterhalten Begebenheit -- 
  sprechen besonderer Tone -- ziehen Folgerung -- -- ablehnen suchen -- nahe gehen -- 
  vorher Tändelei Gewohnheit -- Ernst Neigung -- 
  Unruhe leben -- heftig -- sorgfältig Mensch verbergen suchen -- 
  Gedanke verlieren -- erschreckt Möglichkeit nähern Verbindung zittern -- 
  Gedanke Ehestande halbklug Mädchen gewiß Schreckhaftes -- 
  heftig Erschütterung erinnern -- 
  bunt Bild zerstreut Leben -- Nacht Auge schweben -- weggeblasen -- 
  Seele fing regen -- unterbrochen Bekanntschaft unsichtbaren Freund herstellen -- 
  bleiben ziemlich Entfernung -- -- Unterschied -- 
  Zweikampf -- worin Hauptmann stark verwunden -- vorüber -- erfahren -- öffentlich Meinung Sinn Seite Geliebten -- Schauplatze erscheinen -- 
  Ding lassen verbunden Haupt eingewickelt Hand Haus tragen -- 
  klopfen Herz Besuche -- 
  Familie gegenwärtig -- bleiben Seite Danksagung Höflichkeit -- finden Gelegenheit geheim Zeichen Zärtlichkeit geben -- wodurch Unruhe vermehren -- 
  völlig erholen -- besuchen Winter Fuß ehemals -- leisen Zeichen Empfindung Liebe -- -- bleiben unerörtert -- 
  Weise stet Übung halten -- 
  Mensch vertrauen Gott entfernen -- 
  wild vergessen -- denken -- Bekanntschaft erkalten -- Zeremonienvisit -- -- überdies -- erscheinen -- schön Kleid anlegen -- Tugend -- Ehrbarkeit Vorzug -- glauben -- Zufriedenheit vorweisen -- scheinen Schmucke bemerken -- 
  Höfling -- Fürst -- Glück erwarten -- betrug -- beunruhigt -- übel Mute -- brauchen -- Gesundheit Bequemlichkeit -- Gott Andenken gefallen lassen -- -- -- glauben Schuldigkeit tun -- 
  denken freilich -- wahrhaft Gestalt Seele -- 
  Gesinnung ändern reinig Anstalt -- 
  Frühling heran -- Narziss besuchen unangemelden -- Haus -- 
  erscheinen Liebhaber fragen -- Herz -- ehrenvollen -- wohlbesoldet Stelle erhielten -- dereinst Hand schenken -- 
  Dienst nehmen -- Anfang halten -- Ehrgeiz fürchten -- -- schnell empor heben lassen -- Vermögen -- Besoldung -- 
  Neigung wissen -- Mann -- handeln -- 
  verweisen Vater -- Einwilligung zweifeln scheinen -- Stelle einig -- 
  -- Beistimmung Eltern notwendig Bedingung -- 
  sprechen Alsdann förmlich -- zeigen Zufriedenheit -- Wort hoffend Fall -- avancieren -- 
  Schwester Tante benachrichtigen -- Geheimnis strengster anbefohlen -- 
  Liebhaber Bräutigam -- 
  Verschiedenheit zeigen -- 
  Liebhaber wohldenkend Mädchen Bräutigame verwandeln -- Wohltat Geschlecht -- Verhältnis Ehe erfolgen -- 
  lieb Person nehmen -- vernünftig -- 
  Unzählige Torheit -- Koketteri Laun fallen hinweg -- 
  Äußert Bräutigam -- Morgenhaube schönsen Aufsatze fallen -- wohldenkend Mädchen gewiß Frisur gleichgültig -- natürlich -- Solid denken Hausfrau Welt Putzdocke bilden wünschen -- 
  Fäch -- 
  Mädchen Glück -- Bräutigam Verstand Kenntnis besitzen -- lernen hoch Schule fremd Land geben -- 
  nehmen Bildung -- -- suchen Weg bringen -- 
  Liebe vieler unmögliche -- weiblich Geschlecht nötig anständig Unterwerfung sogleich -- Bräutigam herrschen Ehemann -- bitten -- Geliebte suchen abzumerken -- wünschen -- eher vollbringen bitten -- 
  Erfahrung lehren -- viele missen -- 
  glücklich -- wahrhaft glücklich -- Welt -- -- kurz -- 
  Sommer still Freude -- 
  Narziss minde Gelegenheit Beschwerde -- -- Seele hing -- wissen wissen schätzen -- 
  inzwischen entspann anscheinend Kleinigkeit -- unser Verhältnis schädlich Narziss Bräutigam -- wagen -- begehren -- verbieten -- 
  Grenze Tugend Sittsamkeit verschieden Meinung -- 
  sicher erlaubt Freiheit -- allenfalls Welt wissen -- 
  -- Nascherei gewöhnen -- finden Diät streng -- setzen beständig Widerspruch -- lobt verhalten suchen Entschluß untergraben -- 
  fallen ernsthaft alt Sprachmeister -- Hilfsmittel -- angeben -- 
  Gott bekannt -- 
  lieben Bräutigam geben wissen -- 
  irdisch Liebe konzentriert Geist setzt Bewegung -- Beschäftigung Gott widersprechen -- 
  klagen -- bange -- bemerken -- -- bange -- wünschen begehrten -- 
  stark beten -- bewahr Versuchung -- Versuchung Gedanke hinaus -- 
  losen Flitterschmuck Tugend erscheinen dreist Gott -- stoßen weg -- gering Bewegung hinterlassen sanft Eindruck Seele -- Eindruck bewegen aufsuchen -- 
  Welt Narzissen tot -- Reiz -- 
  Liebe Putz Zweck -- fallen -- wissen -- -- Sorgfalt wenden -- 
  tanzen -- -- scheinen -- Bewegung vertragen -- 
  brillantes Fest -- zugegen -- weder neu anschaff -- alt Mode gemäß aufstutzen -- 
  leiben -- sagen -- lästig -- 
  glaubt Abend zubrachen -- alt Person Spiel ausmachen -- wozu mindeste Lust -- alt Freund scherzhaft aufzog -- lächelen erstemal Abend -- 
  Promenade gesellschaftlich Vergnügung -- denken lassen -- 
  einzig erkoren -- scheinen gebären -- Begehrte Gunst -- 
  Gesellschaft einsam -- völlig Einsamkeit meistens -- 
  geschäftig Geist weder schlafen träumen -- fühlte denken erlangt Fertigkeit -- Empfindung Gedanke Gott reden -- 
  entwickelt Empfindung anderer Art Seele -- widersprechen -- 
  Liebe Narziss Schöpfungsplane gemäß stoßen nirgend Pflicht -- 
  widersprechen unendlich verschieden -- 
  Narziss einzig Bild -- vorschweben -- Liebe beziehen -- Gefühl beziehen Bild unaussprechlich angenehm -- 
  geben -- 
  Geliebt -- Geheimnis wissen -- erfahren hiervon -- 
  merkte denken -- öfter Schrift -- -- Zusammenhäng Unsichtbar heißen -- leicht schwer Waffe bestreiten -- 
  Las Buch -- kommen -- wissen Wort -- gestehen -- 
  Wissenschaft Kenntnis Widerspruch -- Mann -- spottet gelehrt Frau bilden unaufhörlich -- 
  Gegenstand -- Rechtsgelehrsamkeit ausnehmen -- pflegen sprechen -- Schrift allerlei Art beständig zubrachten -- wiederholen bedenklich Lehre -- Frauenzimmer wissen heimlich halten müssen -- Calvinist Glaube katholisch Land -- natürlich Weise Welt klüg unterrichtet zeigen pflegen -- -- gelegentlich Eitelkeit widerstehen -- Vorzüg sprechen -- 
  berühmt Einfluss -- Talente Geist geschätzt Weltmann -- finden unser Hofe Beifall -- 
  zeichnen Narzissen beständig -- 
  streiten Tugend Frau -- 
  Narziss vertrauen weitläufig Unterredung -- bleiben Anmerkung dahinten -- Freund verlangt schriftlich Aufsatz -- 
  schreiben ziemlich geläufig französisch -- alte gut Grund legen -- 
  Korrespondenz Freund Sprache führen -- fein Bildung französisch Buch nehmen -- 
  Aufsatz Grafe fallen -- müssen Lied hergeben -- kurz dichten -- 
  -- Narziss scheinen Geliebte Rückhalt -- Geschichte endigt Zufriedenheit geistreich Epistel französisch Vers -- Graf Abreise zusandn -- worin freundschaftlich Streit denken -- Freund glücklich preisen -- Zweifel Irrtum arme reizenden tugendhaft Gattin -- Tugend -- Sicherst erfahren -- 
  Gedicht fast zeigen -- denken -- 
  mehrere Fall müssen fremde -- schätzen -- unser Haus -- 
  gräflich Familie halten unser geschickt Arzt Zeitlang -- 
  Haus Narziss Sohn halten -- führen -- finden würdig Person angenehm Unterhaltung Geist Herz -- gewöhnlich Zeitvertreibe Gesellschaft scheinen Haus leer anderwärts -- 
  wissen stehen -- behandeln -- Umstand bringen -- lassen Hauptverhältnis unberührt -- 
  erwähn Bekanntschaft -- Folge Leben Einfluß -- 
  fast Verbindung verstreichen -- Frühling -- 
  Sommer -- ernsthaft Heißer -- 
  unerwartet Todesfall Amt erledigen -- Narziss Anspruch -- 
  Augenblick nahe -- Schicksal entscheiden -- indes Narziss Freund Hof möglichst Mühe geben -- gewiß Eindruck -- ungünstig -- vertilg -- erwünscht Platz verschaffen -- wendeten Anliegen unsichtbaren Freund -- 
  freundlich aufnehmen -- wiederkommen -- 
  frei gestehen Wunsch -- Narziss Stelle gelangen -- bitte ungestüm -- fordern -- Gebet Wille geschehen -- 
  Stelle gering Konkurrent besetzen -- 
  erschrak heftig Zeitung -- eilt Zimmer -- fest zumachen -- 
  Schmerz lösen Träne -- nächster Gedanke -- 
  ungefähr geschehen -- sogleich folgt Entschließung -- gefallen lassen -- anscheinend Übel wahren gereichen -- 
  drang sanftest Empfindung -- Wolke Kummer zerteilen -- herbei -- fühlen -- Hilfe ausstehen lassen -- 
  heit Tisch groß erstaun Hausgenossen -- 
  Narziss Kraft -- müssen trösten -- 
  Familie begegneen Widerwärtigkeite -- drückt -- wahr vertrauen -- Stadt -- vertrauen -- 
  Negotiation fremd Dienst -- glücklich -- fühlen tief seinet- meinetwill -- tragen zuletzt Ort -- Anliegen aufnehmen -- 
  sanft Erfahrung -- desto öfter suchen erneuern -- suchen Trost -- finden -- finden -- -- Sonne wärmen -- Weg stehen -- Schatten -- 
  -- fragen -- 
  spürt Sache eifrig -- bemerken deutlich -- Beschaffenheit Seele abhing -- geradest Richtung Gott kehren -- bleiben kalt -- fühlt Rückwirkung -- Antwort vernehmen -- 
  Frage -- 
  verhindern Richtung -- 
  weit Feld -- verwickelt Untersuchung -- beinahe Liebesgeschicht fortdaueren -- 
  endigen -- Spur -- gestehen -- suchen tausend Ausflücht -- 
  finden -- Richtung Seele töricht Zerstreuung Beschäftigung unwürdig Sache stören -- klar -- 
  herauskommen -- Welt gleichgültig toll -- 
  Sache Ort stellen lassen -- geradewohl hingeleben Leute -- wohlauf -- -- Innere widersprechen -- 
  Gesellschaft entziehen Verhältnis verändern -- -- 
  Kreis hinein sperren -- gewiß Verbindung -- angelegen Sache drängen häufen Fatalität -- 
  legen Träne Bette -- stehen schlaflosen Nacht -- bedurft kräftig Unterstützung -- verlieh Gott -- Schellenkappe herum laufen -- 
  Abwieg Handlung -- tanzen Spiel Untersuchung nehmen -- 
  Ding reden -- denken -- schreiben -- aufsuchen -- besprach -- Las -- Erwog -- vermehrt -- verwerfen -- unerhört herumplagen -- 
  unterließ Ding -- gewiß -- Narzissen beleidigen -- 
  fürchten äußerst Lächerliche -- Anschein ängstlich Gewissenhaftigkeit Welt -- 
  -- Torheit -- schädlich Torheit halten -- Geschmack -- bloß seinetwillen -- entsetzlich schwer -- 
  unangenehm Weitläufigkeiten Wiederholung Bemühung darstellen -- anwendet -- Handlung -- zerstreut innerer Frieden stören -- verrichten -- Herz Einwirkung unsichtbaren Wesen bleiben -- schmerzlich empfinden müssen -- Streit Weise beilegen können -- 
  sobald Gewand Torheit kleiden -- bleiben bloß Maske -- Narrheit durchdrang sogleich -- 
  Gesetz bloß historisch Darstellung überschreiten -- Betrachtung dasjenig -- vorging -- 
  -- Geschmack Sinnesart ändern -- zwanzigsen -- -- Vergnügen Ding finden -- Leute Alter unschuldig belustigen -- 
  unschuldig -- 
  Antwort -- unschuldig -- gleich unbekannt Seele -- 
  -- wissen Erfahrung -- Ungesucht erlangen -- hoch Empfindung geben -- Vergnügen wahrhaftig gewährt -- vergebens Lustbarkeit suchen -- hoch Freude geheim Schatz Stärkung Unglück aufbewahren -- 
  gesellig Vergnügung Zerstreuung Jugend müssen notwendig stark Reiz -- -- -- täte -- 
  Kälte -- -- Irre -- Meister drohen -- 
  Mittelweg halten -- müssen reizend Vergnügung erquickend innerlich Empfindung entbehren -- 
  Streit Seele eigentlich Bewußtsein entscheiden -- 
  -- sinnlich Freude hinsehnen -- genießen -- 
  Wein lieben -- Lust Trink vergehen -- voll Fässer Keller befänd -- verdorben Luft ersticken drohen -- 
  Reine Luft Wein -- fühlen lebhaft -- Anfang Überlegung kosten -- Reizende vorziehen -- Furcht -- Narziss Gunst verlieren -- abhalten -- 
  tausendfältig Streit -- wiederholt Betrachtung -- scharf Blick Band werfen -- fest halten -- entdecken -- schwach -- zerreißen lassen -- 
  erkennen -- Glasglock -- luftle Raum sperrn -- Kraft entzwei schlagen -- retten -- 
  Gedacht wagen -- 
  ziehen Maske handeln jedesmal mir_es um Herz -- 
  Narzissen zärtlich lieb -- Thermometer -- vorher heiß Wasser gestehen -- hing natürlich Luft -- hoch steigen -- Atmosphäre warm -- 
  Unglücklicherweise erkälten -- 
  Narziss fing ziehen fremd -- stehen frei -- Thermometer fallen -- ziehen -- 
  Familie bemerken -- befragen -- verwundern -- 
  erklären männlich Trotz -- aufgeopferen -- bereit -- ferner an Leben Widerwärtigkeite teilen -- Handlung völlig Freiheit verlangen -- Laß Überzeugung abhängen müssen -- niemals eigensinnig Meinung beharren -- vielmehr Grund gerne anhören -- Glück betreffen -- müssen Entscheidung abhängen -- Art Zwang dulden -- 
  Räsonnement groß Arzt bewegen -- gesund geliebt Speis nehmen -- Erfahrung beweisen -- jederzeit schädlich -- Gebrauch Kaffees anführen -- Handlung -- verwirren -- moralisch zuträglich aufdemonstriren lassen -- 
  stille vorbereiten -- Debatte hierüber eher angenehm verdrießlich -- 
  Herz Luft -- fühlen Wert Entschlusse -- 
  wich Haar breit -- kindlich Respekt schuldig -- derb abfertigen -- 
  Haus siegen -- 
  Mutter Jugend ähnlich Gesinnung -- reife gedeihen -- Not drängen -- Mut Überzeugung durchsetzen erhöhen -- 
  Freut still Wunsch erfüllen sehen -- 
  jung Schwester scheinen anschließen -- aufmerksam still -- 
  Tante meister einwenden -- 
  Grund -- vorbrachen -- scheinen unwiderleglich -- -- gemein -- 
  nötigen -- zeigen -- Sinn Stimme Sache -- lassen selten merken -- Sinn verharren -- 
  einzig -- Begebenheit nahen ansah Empfindung bleiben -- 
  tun -- sagen -- Gemüt eingeschränktest Begriff -- 
  Vater benehmen Denkart gemäß -- 
  sprechen -- öfter Sache -- Grund verständig -- Grund unwiderleglich -- tief Gefühl Recht Stärke -- disputieren -- 
  verändert Szene -- müssen Herz Anspruch -- 
  drängen verstand brechen affektvollst Vorstellung -- 
  lassen Zunge Träne frei Lauf -- 
  zeigen -- Narzissen lieben -- Zwang antun -- gewiß -- handeln -- bereit Gewißheit Verlust geliebt Bräutigam anscheinend Glück -- nötig -- Hab versiegeln -- Vaterland -- Eltern Freund verlassen -- Brot Fremde verdienen -- Einsicht handeln -- 
  verbergen Rührung -- schweigen still erklären öffentlich -- 
  Narziss vermeiden Haus -- Vater wöchentlich Gesellschaft -- befinden -- 
  Sache Aufsehen Hofe Stadt -- 
  sprechen gewöhnlich Fall -- Publikum heftig nehmen pflegen -- verwöhnen -- Entschließung schwach Gemüt Einfluß -- 
  kannt Welt -- wissen -- Person tadeln -- wozu bereden lassen -- innerer Verfassung vorübergehend Meinung -- 
  versagen -- Neigung Narzissen nachzuhängen -- 
  unsichtbar -- Herz ändern -- 
  lieben zärtlich -- gleichsam gesetzt vorher -- 
  Überzeugung stören -- -- Bedingung Königreich ausschlagen -- 
  mehrere Monat tragen Empfindung Gedanke herum -- still stark fühlen -- ruhig setzen Werk -- schreiben höflich -- zärtlich -- Billet -- fragen -- kommen -- 
  Art kennen -- gering Ding erklären -- stillschweigend -- dünken -- Drang gegenwärtig Vorsatz -- 
  erhalten scheinen abgeschmackt Antwort -- weitläufig Stil unbedeutend Phrase -- gut Stelle einrichten -- Hand anbieten können -- wissen -- hinderlich gehen -- glauben -- fortgesetzt fruchtlos Umgang können Renommee schaden -- erlauben -- bisherig Entfernung halten -- Stande -- glücklich -- Wort -- geben -- heilig -- 
  antwortet Stelle -- 
  Sache Welt -- mögen spät -- Renommee menagieren -- sein Gewissen Unschuld sicherst Bürg -- gäbe hiermit Wort Bedenken -- wünschen -- Glück finden -- 
  Stunde erhalten kurz Antwort -- Wesentliche völlig gleichlautend -- 
  bleiben -- erhalten Stelle anfragen -- Glück teilen -- 
  heißen -- 
  erklären verwandte bekannte -- Sache abtun -- 
  Monat hernach Erwünschteste befördern -- lassen Hand nochmals antrag -- freilich Bedingung -- Gattin Mannes -- Haus müssen -- Gesinnung ändern -- 
  danken höflich -- eilt Herz Sinn Geschichte weg -- Schauspielhause heraus sehnen -- Vorhang fallen -- 
  kurz -- -- reichen ansehnlich Partie finden -- Art glücklich wissen -- Beruhigung vollkommen -- 
  Stillschweigen übergehen -- einigemal -- ehe Bedienung erhalten -- nachher ansehnlich Heiratsantrag tun -- Bedenken ausschlug -- Vater Mutter Nachgiebigkeit Seite wünschen -- 
  scheinen stürmisch März April schön Maiwetter bescheren -- 
  Genoß gut Gesundheit unbeschreiblich Gemütsruh -- umsehen -- -- Verlust gewinnen -- 
  Jung voll Empfindung -- dünkt Schöpfung tausendmal schön vorh -- Gesellschaft Spiel müssen -- Weile schön Garten -- 
  Frömmigkeit schämen -- Herz lieb Künst Wissenschaft verbergen -- 
  zeichnen -- malen -- las finden Mensch -- unterstützen -- Welt -- verlassen -- vielmehr -- verlassen -- bildet klein -- reich Unterhaltender -- 
  Neigung gesellschaftlich Leben -- leugnen -- -- alt Bekanntschaft aufgeben -- Einsamkeit grauten -- 
  finden hinlänglich -- entschädigen -- 
  bekanntschaften weitläufig -- einheimische -- Gesinnung Meinig übereinstimmen -- fremde -- 
  Geschichte fruchtbar -- Mensch neugierig -- Mädchen sehen -- Gott schätzen Bräutigam -- 
  gewiß religiös Stimmung Deutschland bemerkbar -- 
  mehrere fürstlich gräflich Haus Sorge Heil Seele lebendig -- 
  fehlt Edelleut gleich Aufmerksamkeit hegen -- gering Ständen Gesinnung verbreiten -- 
  gräflich Familie -- erwähnen -- ziehen nah -- 
  indessen verstärken -- verwandte Stadt wenden -- 
  schätzbar Person suchen Umgang -- ihrigen -- 
  Verwandtschaft -- lernt Haus Fürst -- Graf Herr Reich kennen -- 
  Gesinnung Geheimnis -- Ehre schon -- erlangt Zweck bleiben Anfechtung -- 
  Weise Welt führen -- 
  verweilen Stiefbruder Vater -- vorbeigehen besuchen -- lang -- 
  Dienst Hof -- ehren Einfluß -- verlassen -- Sinn -- 
  Verstand Charakter streng -- Vater ähnlich -- gewiß Grad Weichheit -- wodurch leicht Geschäft nachzugeben Überzeugung -- geschehen lassen -- Unwille alsdann Stille vertraulich Familie verkochen -- 
  Oheim viele jüng -- Selbständigkeit äußerer Umstand bestätigen -- 
  reich Mutter -- nahen fern verwandte Vermögen hoffen -- bedürfen kein fremd Zuschuß -- anstatt Vater mäßigen Vermögen Besoldung Dienst fest knüpfen -- 
  unbiegsam Oheim häuslich Unglück -- 
  liebenswürdig Frau hoffnungsvoll Sohn früh verlieren -- scheinen entfernen -- Wille abhehen -- 
  Familie gelegentlich Selbstgefälligkeit Ohr -- wahrscheinlich heiraten -- Kind Erbe Vermögen ansehen können -- 
  achten -- Betragen übrig Hoffnung stimmen Festigkeit Charakter gewöhnen -- Unterredung widersprechen -- vielmehr Meinung freundlich anhören -- Art Sache dachen Argument Beispiel erheben -- 
  kennen glauben stets einerlei Meinung -- überwiegend Verstand Vorstellungsart versetzen -- 
  glücklich -- Empfindung Rede -- Ahnung -- schonend -- teilnehmend verständig Gesinnung sprechen -- auffallend -- -- worin Grund Handlung liegen -- offenbar Begriff -- 
  geheim -- entdeckt Endzweck ungewöhnlich Aufenthalt -- 
  -- bemerken -- jung Schwester ausersehen -- Sinn verheiraten glücklich -- gewiß körperlich geistig Gabe -- ansehnlich Vermögen Schale legen -- Partien Anspruch -- 
  Gesinnung gleichfalls pantomimisch erkennen -- Platz Stiftsdame verschaffen -- wovon Einkünfte ziehen -- 
  Schwester Fürsorge zufrieden dankbar -- 
  entdeckt Herzensangelegenheit -- weislich verbergen -- fürchten -- geschehen -- möglich Weise Verbindung Manne -- fallen -- widerran -- 
  möglichster -- gelingen -- 
  Absicht Oheim ernsthaft deutlich -- Aussicht Schwester -- Weltsinne -- reizend -- Neigung -- Verstand mißbilligen -- aufzugeb Kraft -- 
  sanft Leitung Oheim ausweichen -- Grund Plan legen -- 
  Hofdame benachbart Hof -- Freundin -- Oberhofmeisterin groß ansehen stehen -- Aufsicht Ausbildung übergeben -- 
  begleiten Ort Aufenthalt -- 
  Aufnahme -- erfuhren -- zufrieden -- manchmal müssen Person -- Stiftsdame -- jung fromm Stiftsdame -- Welt spielen -- heimlich lächeln -- 
  früh Zeit Verhältnis verwirren -- Kopf verrückt -- -- umgeben -- gelassen -- 
  lassen Stille paar Stunde frisieren -- putzen denken -- Verhältnis Galalivree anzuziehen schuldig -- 
  angefüllt Sälen sprechen -- Gestalt Wesen stark Eindruck lassen -- 
  Haus -- müde Bein meist Gefühl -- bringen -- 
  verstande nützten Mensch -- -- Muster menschlich Tugend gut edl Betragen lernen Frau -- Oberhofmeisterin -- kennen -- Schwester bilden Glück -- 
  fühlt Rückkunft glücklich körperlich Folge Reise -- 
  groß Enthaltsamkeit genauest Diät Herr Kraft -- 
  Nahrung -- Bewegung -- aufsteh Schlafengehen -- Ankleid Ausfahren hing Haus Wille Empfinde -- 
  Lauf gesellig Kreis stocken -- unhöflich -- nötig -- leisten -- Pflicht halten -- wissen -- vorüber -- gesund jemals fühlen -- 
  Demungeachtet müssen fremd unruhig Leben stark fühlen wirken -- 
  Haus ankommen Eltern befriedigend Erzählung erfreuen -- überfiel Blutsturz -- -- gefährlich schnell vorüber -- merklich Schwachheit hinterlassen -- 
  Lektion aufsagen -- 
  freudig -- fesselt Welt -- überzeugen -- niemals finden -- heitersen ruhigsen Zustande -- -- Verzicht auf Leben tun -- Leben erhalten -- 
  Prüfung auszustehen -- Mutter drückend Beschwerde überfallen -- tragen -- ehe Schuld Natur bezahlen -- 
  Übung -- 
  Bangigkeit stark -- lassen Nacht Bett rufen -- Gegenwart zerstreuen -- bessern -- 
  Schwerer -- tragen -- Druck -- Vater elend anfehen -- 
  Jugend öfters heftig Kopfschmerz -- auf lang dreißig Stunde anhielten -- 
  bleibend hoch Grad steigen -- zerreißen Jammer Herz -- 
  Stürme fühlen körperlich Schwäche meisten -- hindert -- heiligsen lieb Pflicht erfüllen -- Ausübung äußerst beschwerlich -- 
  prüfen -- Weg -- einschlagen -- Wahrheit Phantasie -- denken -- Gegenstand Glauben Realität -- groß Unterstützung finden letzter -- 
  Richtung Herzen Gott -- Umgang Beloved One suchen finden erleichteren -- 
  Wanderer Schatten -- eilt Seele Schutzort -- 
  außen drücken niemals leer -- 
  neu Verfechter Religion -- Eifer Gefühl scheinen -- Mitgläubig auffordern -- Beispiel wirklich Gebetserhörunge -- wahrscheinlich -- Brief Siegel wünschen -- Gegner diplomatisch juristisch Leib -- 
  unbekannt wahr Gefühl -- echt Erfahrung -- 
  sagen -- leer -- Druck Not Gott suchen -- 
  unendlich -- sagen -- 
  wichtig Erfahrung kritisch Augenblick -- matt -- unbedeutend -- unwahrscheinlich Erzählung -- einzeln Fall anführen -- 
  glücklich -- tausend Vorgang -- gewiß Atemhol Zeichen Leben -- beweisen -- Gott Welt -- 
  nahe -- -- 
  ist_es -- geflissentlich Vermeidung theologisch Systemsprach groß Wahrheit sagen -- 
  wünschen -- System befinden -- früh Glück -- Selbst -- fremd Form rein Zusammenhäng bewußt -- 
  Ernst Seligkeit -- 
  vertrauen bescheiden fremd ansehen -- ergeben völlig hallisch Bekehrungssystem -- Wesen Weg hineinpassen -- 
  Lehrplan Veränderung Herzen tief Schreck sünd anfangen -- Herz Not verschuldet Strafe erkennen Vorschmack Hölle kosten -- Lust sünd verbittern -- 
  merklich Versicherung Gnade fühlen -- Fortgang verstecken Ernst suchen -- 
  treffen weder nah fernen -- 
  Gott aufrichtig suchen -- lassen finden -- halten Ding -- 
  hinten -- unwürdig wissen -- -- Erkenntnis Gebrechen Angst -- 
  Augenblick Furcht Hölle ankommen -- Idee bös Geist Straf- Quälort Tod keineswegs Kreis Idee Platz finden -- 
  finden Mensch -- Gott leben -- Herz vertrauen Liebe Unsichtbar zugeschlossen -- unglücklich -- Hölle äußerer Strafe eher Linderung versprechen -- Schärfung Strafe drohen scheinen -- 
  Mensch Welt ansehen -- gehässig Gefühl Busen Raum geben -- Art verstock Schlecht aufdringen -- Auge zuschließen -- behaupten -- Sonne geben Schein -- Ausdruck scheinen Mensch elend -- 
  Hölle schaffen -- Zustand verschlimmern -- 
  Gemütsbeschaffenheit bleiben -- 
  erhalten Probe -- schmerzhafen Sterbebette geliebt Mutter -- 
  -- Gelegenheit heit Gemütsverfassung frommen schulgerecht Leute verbergen -- müssen freundschaftlich Verweis erdilden -- 
  meinen vorstellen -- Ernst anwenden -- gesund gut Grund legen -- 
  Ernst fehlen lassen -- 
  lassen Augenblick überzeug Leben traurig voll Schrecken -- 
  verwundern -- allemal -- 
  Gott denken -- heit vergnügen -- lieb Mutter schmerzensvollen graut Tod -- 
  lernen vieler Sache -- unberufen Lehrmeister glauben -- Stunde -- 
  Einsicht hochberühmter Leute zweifelhaft bewahrt Gesinnung Stille -- 
  gewiß Freundin -- einräumen -- Angelegenheit mengen -- nötigen -- einst entscheiden -- Mühe bleiben -- braucht Rat -- kennen Gott Führer -- 
  finden beleidigt glauben -- mir_es verziehen -- 
  Entschluß -- Rate Einwirkung Freund geistlich Sache entziehen -- Folge -- äußerlich Verhältnis Weg Mut gewinnen -- 
  Beistand treu unsichtbar Führer übel geraten -- weis glücklich Leitung erstaunen -- 
  wissen eigentlich worauf ankommen -- wissen -- 
  Ding -- erklären böse Ding -- Wesen trennen -- Leben empfangen -- Leben nennen -- unterhalten -- Ding sünd nennen -- kennen -- 
  Umgang unsichtbaren Freund fühlt süßest Genuß Lebenskräfte -- 
  verlangen -- Glück genießen -- -- unterließ -- Umgang stören -- hierin Erfahrung gut Lehrmeister -- 
  kranke Arznei Diät helfen suchen -- 
  tun -- -- 
  Einsamkeit bleiben -- gut Zerstreuung Gedanke finden -- 
  nachh Getümmel -- desto groß Eindruck -- 
  eigentlichst Vorteil bestehen -- Liebe Stille herrschend -- ziehen -- 
  erkennen Art Dämmerung -- Elend Schwäche -- suchen helfen -- schonen -- aussetzen -- 
  diätetisch Vorsicht ausüben -- 
  halten schlimm finden Zustand wünschenswert -- 
  sonderbar Umstand Verhältnis Stufe stehen bleiben -- sonderbaren Weg -- Rat Freund knüpft neu Verhältnis -- 
  Einwendung machen anfangs stutzig -- 
  sogleich wenden unsichtbar Führer -- vergönnt -- Bedenken Weg fort -- 
  Mann Geist -- Herz Talenten Nachbarschaft ankaufen -- 
  fremde -- kennen lernen -- Familie -- 
  stimmen unser Sitte -- Hausverfassunge Gewohnheit überein -- anschließen -- 
  Philo -- nennen -- gewiß -- Vater -- Kraft abnehmen anfingen -- gewiß Geschäft groß Beihilfe -- 
  innig Freund unser Haus -- -- -- Person finden -- ausschweifend leer Welt -- trocken Ängstliche stille Land -- vertraut Freund -- 
  angenehm brauchbar -- 
  minde Anlage Neigung -- weltlich Geschäft misch Einfluß suchen -- hören gerne -- wissen -- Nähe Ferne vorging -- 
  weltlich Ding lieben -- gefühllos Deutlichkeit verschaffen -- 
  Empfindung -- Innigkeit -- Neigung bewahrt Gott -- meinig Freund -- 
  letzter -- sagen -- Verbindung Philo eifersüchtig -- Seite -- hierüber warnen -- 
  leiden Stille -- Einwendung leer eigennützig halten -- 
  jeher gewohnen -- Einsicht unterzuordn -- diesmal Überzeugung -- 
  flehen Gott -- warnen -- hindern -- leiten -- hierauf Herz abmahnen -- Pfad getrost fort -- 
  Philo entfernt Ähnlichkeit Narzissen -- fromm Erziehung Gefühl halten beleben -- 
  Eitelkeit -- Charakter -- weltlich Geschäft fein -- genau -- anhaltend unermüdlich -- klar -- scharf -- schnell -- arbeitet unglaublich Leichtigkeit -- 
  erfahren innerst Verhältnis fast vornehm Person -- Äußer Gesellschaft kennen lernen froh Warte Getümmel weiten zusehen -- 
  Philo verhehlen -- vertraut äußerer innerer Verbindung -- 
  fürchten -- gewiß Umstand Verwicklung voraus -- übel schnell vermuten -- 
  gewiß Bekenntnisse zurückhalten zuletzt entdeckt -- schlimme vermuten -- 
  Wirkung Herz -- 
  gelangt Erfahrung -- neu -- 
  unbeschreiblich Wehmut Agathon -- Hain Delphi erziehen -- Lehrgeld schuldig -- schwer rückständig Zins abzahlten -- Agathon genau verbunden Freund -- 
  Teilnahme lebhaft vollkommen -- litt -- befinden sonderbar Zustande -- 
  Gemütsverfassung beschäftigen -- wendet Betrachtung -- 
  Gedanke -- -- steigen Wolke -- breitet -- verfinstert Seele -- 
  denken bloß -- -- fühlen -- fühlen -- fühlen -- 
  schnell Übergang -- 
  müssen empfinden -- unsichtbar Hand umschränkt -- Girard -- Cartouche -- Damien Ungeheuer nennen -- -- Anlage fühlen deutlich Herz -- 
  Gott Entdeckung -- 
  Wirklichkeit sünd Erfahrung leisesten gewahr -- Möglichkeit Ahnung auf schrecklichste deutlich -- kennen Übel -- fürchten -- fühlte -- schuldig -- anklagen -- 
  tief überzeugen -- Geistesbeschaffenheit -- wofür meinig anerkennen müssen -- Vereinigung hoch Wesen -- Tod hoffen -- schicken -- fürchten -- Trennung geraten -- 
  böse -- entdecken -- Lieb Haßte fühlen -- wünschen ernstlich hassen -- Wunsch -- Krankheit -- Anlage Krankheit erlösen -- gewiß -- Arzt Hilfe versagen -- 
  einzig Frage -- heilen Schaden -- 
  Tugendübung -- 
  denken -- 
  bloß Tugend üben -- erkannt Greuel tief Seele verbergen liegen -- David losbrechen -- Bathseba erblicken -- Freund Gott -- Innerst überzeugen -- Gott Freund -- 
  unvermeidlich Schwäche Menschheit -- gefallen lassen -- Herrschaft Neigung empfinden -- bleiben Wille übrig Fall -- tun -- verabscheuen -- ähnlich Gelegenheit fallen -- 
  Sittenlehre Trost schöpfen -- 
  weder Strenge -- wodurch Neigung bemeistern -- Gefälligkeit -- Neigung Tugenden -- genügen -- 
  Grundbegriffe Umgang unsichtbaren Freund eingeflößen -- entschiedeneren Wert -- 
  einst Lied studieren -- David häßlich Katastrophe dichten -- auffallend -- wohnenden bös Stoff -- woraus -- erblicken -- entsündigen -- dringendst rein Herz flehen -- 
  gelangen -- 
  Antwort symbolisch Büchern wissen -- Bibelwahrheit -- Blut Jesu Christi Sünde reinigen -- 
  bemerken -- wiederholt Spruch verstehen -- 
  Frage -- -- 
  zugehen -- arbeiten Nacht -- 
  glauben Schimmer sehen -- -- suchen -- Menschwerdung ewig Wort -- erschaffen -- suchen -- 
  Uranfängliche Tiefen -- stecken -- durchschauen umfassen -- einstmals Bewohner begeben -- Verhältnis Stufe Stufe Empfängnis Geburt Grabe durchgegangen -- sonderbar Umweg licht Höhe aufgestiegen -- wohnen -- glücklich -- 
  -- dämmernden Ferne -- offenbaren -- 
  O -- Ding reden -- Bild gebrauch -- äußerer Zustand anzeigen -- 
  Hohes Tief -- Dunkles Helles -- unten -- Nacht -- 
  ähnlich -- können -- 
  unschätzbar Wohltat nehmen -- 
  Glaube -- antworten Schrift -- 
  Glaube -- 
  Erzählung Begebenheit halten -- helfen -- 
  Wirkung -- Folge zueignen -- 
  zueignend Glaube -- natürlich Mensch ungewöhnlich Zustand Gemüt -- 
  -- Allmächtiger -- 
  schenk Glaube -- flehen einst groß Druck Herzens -- 
  lehnen Tisch -- sitzen -- verbergen betrennt Gesicht Hand -- 
  Lage -- -- Gott Gebet -- selten -- 
  schildern -- fühlen -- 
  Zug bringen Seele Kreuze -- Jesus einst erblaßen -- Zug -- nennen -- demjenigen völlig -- wodurch Seele abwesend geliebter führen -- zunahen -- vermutlich wesentlich Wahrhafter -- vermuten -- 
  naht Seele Menschgeworden Kreuz gestorben -- Augenblick wissen -- Glaube -- 
  Glaube -- -- springen halb erschreckt Höhe -- 
  suchen Empfindung -- Anschauens gewiß -- Kurze überzeugen -- Geist Fähigkeit aufzuschwingen erhalten -- neu -- 
  Empfindung verlassen Wort -- 
  deutlich Phantasie unterscheiden -- Phantasie -- Bild -- geben Gewißheit Gegenstand -- beziehen -- Einbildungskraft -- Zug abwesend geliebter vormaltn -- 
  Entzück vorüber -- bemerken -- Zustand Seele vorher -- Stärke empfinden -- 
  niemals fest halten -- behalten -- 
  glauben -- Menschenseel andermal empfinden -- 
  Zweifel -- lehren -- Gott -- 
  ehemals anwandelnd Kraft zufrieden -- sonderbar Schickung unerwartet Plage widerfahren -- Vermögen Kredit kommen -- Zustande zufrieden bleiben -- 
  Augenblick Flügel bekommen -- 
  vorher bedroht aufschwingen -- Vogel singend schnell Strom Mühe fliegen -- hündchen ängstlich bellend stehen bleiben -- 
  Freude unbeschreiblich -- entdecken -- merkt Meinig ungewöhnlich Heiterkeit -- begreifen -- Ursache Vergnügen -- 
  geschwieg -- rein Stimmung Seele erhalten suchen -- 
  Umstand verleiten lassen -- Geheimnis hervor treten -- abermals umweg ersparen -- 
  vorhergehend zehnjährig Christenlauf notwendig Kraft Seele -- Fall anderer redlich Leute befinden -- helfen -- Phantasie Bild erfüllen -- Bezug Gott -- wahrhaft nützlich -- schädlich Bild bös Folge abhalten -- 
  Sodann ergreifen Seele geistig Bild -- schwingen Höhe -- jung Vogel Zweig flatteren -- 
  besseres -- Übung verwerfen -- 
  Gott zielend Bild Eindruck verschaffen kirchlich Anstalt -- Glocke -- Orgeln Gesänge -- Vortrag Lehrer -- 
  unsäglich begierig -- Witterung -- körperlich Schwäche halten -- Kirche besuchen -- sonntägig Geläute Krankenbette Ungeduld verursachen -- 
  Unser Oberhofprediger -- trefflich Mann -- hört Neigung -- Kollege wert -- wissen golden Äpfel göttlich Wort irden schalen gemein Obste heraus finden -- 
  öffentlich Übung möglich Privaterbauunge -- nennen -- hinzufügen Phantasie fein Sinnlichkeit nähren -- 
  Gang gewöhnen -- respektieren -- hoch Einfiel -- 
  Seele Fühlhörner Auge -- tasten sehen -- -- 
  Auge bekommen schauen dürfen -- 
  voll verlangen Predigt -- -- geschehen -- 
  finden finden -- 
  Prediger stumpfen Zahn schalen -- indessen Kern Genoß -- 
  müssen müde -- halten -- finden wissen -- verwöhnen -- 
  Bild -- äußerer Eindruck bedürfen -- glauben Reines geistig Bedürfnis fühlen -- 
  Philos Eltern Herrnhutischen Gemeinde Verbindung gestehen -- Bibliothek finden Schrift Grafe -- 
  einigemal klar billig sprechen -- ersuchen -- Schrift durchzublättern -- -- psychologisch Phänomen kennen lernen -- 
  halten Grafe arg Ketzer -- lassen Ebersdorfer Gesangbuch liegen -- Freund ähnlich Absicht gleichsam aufgedrungen -- 
  völlig Mangel äußerer Ermunterungsmittel ergriff ungefähr gedacht Gesangbuch -- finden erstaunen Lied -- -- freilich seltsam Form -- dasjenig deut schienen -- fühlen -- Originalität Naivität Ausdrücke ziehen -- 
  Empfindung scheinen Weise ausdrücken -- Schulterminologie erinnern Steif Gemeines -- 
  überzeugen -- Leute fühlen fühlen -- finden glücklich -- Versche Gedächtni fassen tragen -- 
  Augenblick -- Wahr schenken -- verfloss Weise ungefähr Monat -- 
  fassen Entschluß -- Freund Philo entdecken -- Mitteilung Schrift bitten -- Maß neugierig -- 
  -- unerachten Herzen ernstlich Abriet -- 
  erzählt Philo Geschichte umständlich -- Hauptperson -- Erzählung strengster Bußepredigt enthalten -- äußerst betroffen rühren -- 
  Zerfloß Träne -- 
  Freut -- glauben -- völlig Sinnesänderung bewirken -- 
  versorgt Schrift -- verlangt -- überflüssig Nahrung Einbildungskraft -- 
  Fortschritt Zinzendorfischen Art denken sprechen -- 
  glauben -- Art Weise Grafe gegenwärtig schätzen wissen -- lassen Gerechtigkeit widerfahren -- leer Phantast -- sprechen Wahrheit meist kühn Flug Einbildungskraft -- geschmähen -- wissen Eigenschaft weder schätzen -- unterscheiden -- 
  gewinnen unbeschreiblich leiben -- 
  Herr -- gewiß Vaterland Freund verlassen -- ziehen -- unfehlbar verstehen schwerlich vertragen -- 
  Genius -- häuslich Verfassung einschränken halten -- 
  Reise -- Hausgart -- 
  Pflege alt schwächlich Vater Arbeit -- ergötzungsstunden edeln Phantasie Zeitvertreib -- 
  einzig Mensch -- -- Philo -- Vater lieben -- offen Verhältnis letzter Erklärung einigermaßen gelitten -- 
  Rührung tief dringen -- Versuch -- Sprache reden -- gelingen -- vermied Materie leicht -- ausgebreitet Kenntnis Gegenstand Gespräch herbei führen wissen -- 
  herrnhutisch Schwester Hand -- Wendung Gemüt Neigung Oberhofprediger verbergen -- Beichtvater schätzen Ursache -- Verdienst gegenwärtig äußer Abneigung herrnhutisch Gemeinde Auge schmälern -- 
  würdig Mann Betrübnis erleben -- 
  mehrere auswärts kavalier redlich fromm Mann kennen lernen -- -- Gott ernstlich suchen -- ununterbrochen Briefwechsel bleiben -- 
  schmerzhaft geistlich Führer -- Kavalier Folge herrnhutischen Gemeinde einlassen -- Brüdern aufhieln -- eifrig Mann -- Freund Brüdern entzweiten -- Nähe wohnen entschließen -- Leitung auf völlig überlassen scheinen -- 
  neuangekommene gleichsam Triumph geliebt schäfch Oberhirt vorstellen -- 
  Haus einführen -- Vater sehen pflegen -- 
  kavalier finden Approbation -- Gesittete Hof einnehmend Gemeinde -- schön natürlich Eigenschaft -- heilige -- kennen lernn -- worüber geistlich Gönner äußerst freuen -- 
  äußerer Umstand Gemeine brouillieren -- Herz Herrnhuter -- 
  hing Realität Sache -- Tändelwerk -- Graf hängen -- höchst angemessen -- 
  Vorstellung Redensart gewöhnen -- nunmehr alt Freund sorgfältig verbergen müssen -- desto notwendig -- Häufcher vertraut Person erblicken -- Versche -- Litaneie Bilderch hervor rücken -- finden -- denken -- Beifall -- 
  wissen Sache -- tändelen Art fort -- 
  bleiben unbekannt -- 
  einst besuchen -- frei Stunde -- krank Freundin -- 
  treffen mehrere bekannter -- merken -- Unterredung stören -- 
  lassen merken -- erblicken -- Verwunderung -- Wand herrnhutischen Bild -- zierlich Rahmen -- 
  fassen geschwind -- -- Haus -- vorgehen -- bewillkommt Erscheinung angemessen Vers -- 
  denken erstaunen Freundin -- 
  erklärt -- Stelle einig vertraut -- 
  suchen öfter Gelegenheit ausgehen -- 
  finden Woche -- adelig Apostel heimlich Gemeinde -- 
  besuchen -- -- Versammlung -- gesellig Sinn unendlich angenehm -- vernehmen mitteilen -- ausarbeiten -- 
  einnehmen -- bemerken -- Sinn zart Wort Ausdrück fühlen -- -- ehemals kirchlich symbolisch Sprache -- fördern -- 
  Demungeachtet fort -- lassen Irre -- 
  denken -- Untersuchung Herzensprüfung berufen -- 
  unschuldig Übung Besseren vorbereiten -- 
  hinweg -- Drang -- Rede -- Sinn -- zart Gegenstand eher Wort verstecken andeuten -- lassen still Verträglichkeit Art gewähren -- 
  ruhig Zeit heimlich gesellschaftlich Genuß -- folgen Sturm öffentlich Streitigkeit Widerwärtigkeite -- Hof Stadt Bewegung erregn -- beinahe sagen -- Skandal verursachten -- 
  Zeitpunkt kommen -- Oberhofprediger -- Widersacher herrnhutischen Gemeinde -- gesegnet Demütigung entdecken -- anhänglichst Zuhörer sämtlich Seite Gemeinde neigen -- 
  äußerst kränken -- vergessen Augenblick Mäßigung Folge -- -- ziehen -- 
  heftig Debatte -- glücklich Weise nennen -- Zufällig Mitglied verhaßt Zusammenkunft -- eifrig Führer Vater Freund bürgerlichen Angelegenheit entbehren -- 
  erhalten Neutralität still Zufriedenheit -- Empfindung Gegenstand wohlwollend Mensch unterhalten -- verdrießlich -- tief Sinn fassen -- Oberfläche verweilten -- 
  Widersacher streiten -- worüber Freund verstehen -- scheinen unnütz -- verderblich -- 
  bemerken -- liebevollen edel Mensch -- Fall Herz widerwillen Haß rein halten -- Ungerechtigkeit übergingen -- -- äußerer Form verteidigen -- best Innerst beinahe zerstören -- 
  würdig Mann Fall Unrecht -- aufzubringen suchen -- niemals herzlich Achtung versagen -- 
  kennen genau -- Art -- Sache ansehen -- Billigkeit versetzen -- 
  niemals Mensch Schwäche sehen -- auffallend vorzüglich Mensch -- 
  wünschen Mal -- -- privilegieren -- Tribut -- Abgabe zahlen -- 
  ehrt vorzüglich Mann -- hoffen Einfluß still Neutralität -- Frieden -- Waffenstillstand nutzen -- 
  wissen -- bewirken -- Gott fassen Sache kurz -- -- 
  bahre weinen -- vorher Wort streiten -- 
  Rechtschaffenheit -- Gottesfurcht niemals bezweifeln -- 
  müssen Puppenwerk Hand legen -- Streitigkeit gewissermaßen Licht erscheinen -- 
  Oheim Plane Schwester Stille durchführen -- 
  stellen jung Mann Stande Vermögen Bräutigam -- zeigen reichlich Aussteuer -- erwarten -- 
  Vater willigt Freude -- Schwester frei vorbereiten -- verändern gerne Stand -- 
  Hochzeit Oheim Schloß ausrichten -- Familie Freund einladen -- kommen heiter Geist -- 
  erstenmal Leben erregt Eintritt Haus Bewunderung -- 
  Oheim Geschmack -- italienisch Baumeister -- sammlung Bibliothek reden hören -- Verglich -- sehen -- bunt Bild Gedanke -- 
  verwundert ernst harmonisch Eindruck -- Eintritt Haus empfinden -- Saal Zimmer verstärken -- 
  Pracht Zierat zerstreuen -- fühlte sammeln führen -- 
  Anstalt Feierlichkeit Fest erregt Pracht still Gefallen -- unbegreiflich -- Mensch erfind anordn -- mehrere Vereinige können -- Sinn wirken -- 
  scheinen Wirt Seinig -- Spur steifheit leer Zeremoniell bemerken -- 
  Trauung unvermutet herzlich Art einleiten -- vortrefflich Vokalmusik überraschen -- geistliche wissen Zeremonie Feierlichkeit Wahrheit geben -- 
  stehen Philo -- Glück wünschen -- tief Seufzer -- Schwester Hand hingeben -- mir_es -- siedeheißen Wasser begießen -- 
  -- fragen -- 
  allezeit -- Kopulation ansehen -- versetzen -- 
  lachen -- nachher Wort denken -- 
  Heiterkeit Gesellschaft -- worunter jung Leute -- scheinen glänzend -- -- umgeben -- würdig ernsthaft -- 
  Hausrat -- Tafelzeug -- Service Tischaufsätze stimmen -- Baumeister Konditor Schule entsprungen scheinen -- Konditor Tafeldecker Architekt Schule gehen -- 
  mehrere bleiben -- geistreich verständig Wirt Unterhaltung Gesellschaft mannigfaltigsen sorgen -- 
  wiederholen traurig Erfahrung -- Leben -- übel gemischt Gesellschaft befinden -- überlassen allgemeinst schal Zeitvertreibe greifen -- eher gut schlecht Subjekt Mangel Unterhaltung fühlen -- 
  Oheim veranstalten -- 
  Marschall -- nennen -- bestellen -- Freude jung Welt sorgen -- 
  Tänze -- Spazierfahrt -- Spiel Erfindung -- stehen Direktion -- jung Leute Freie leben -- Einfluß Luft scheuen -- Garten Gartensaal übergeben -- Endzweck Galerie Pavillon anbauen -- Brett Leinwand edl Verhältnis -- Stein Marmor erinnern -- 
  selten Fet -- wobei -- Gast berufen -- Schuldigkeit empfinden -- Bedürfnis Bequemlichkeit Weise sorgen -- 
  Jagd Spielpartien -- kurz Promenade -- Gelegenheit vertraulich einsam Gespräch alt Person bereiten -- -- frühsen Bett -- gewiß weitesen Lärm einquartieren -- 
  Ordnung scheinen Raum -- befinden -- Welt -- -- nah betrachtet -- Schloß -- genau Kenntnis Geist Wirtes schwerlich Leute beherbergen -- Art bewirten -- 
  angenehm Anblick wohlgestaltet Mensch -- angenehm Einrichtung -- Gegenwart verständigen -- vernünftig Wesen fühlbar -- 
  reinlich Haus -- Freude -- geschmacklos bauen verziern -- zeigen Gegenwart Seite gebildet Mensch -- 
  doppelt angenehm -- menschlich Wohnung Geist hoch -- obgleich sinnlich -- Kultur entgegen sprechen -- 
  vieler Lebhaftigkeit Schlos Oheim anschaulich -- 
  viele Kunst gehören lesen -- Philo Liebhaber Gemälde -- schön Sammlung -- zeichnen -- teils Empfindung beschäftigen -- trachtet -- Not -- Reine bringen -- teils schien Sache -- sehen -- übrig weltlich Ding zerstreuen -- 
  erstenmal Äußerliches führen -- lernt Unterschied natürlichen vortrefflich Gesang Nachtigall vierstimmig Halleluja gefühlvoll Menschenkehle groß Verwunderung kennen -- 
  verbergen Freude Anschauung Oheim -- -- gehen -- unterhalten pflegen -- 
  sprechen Bescheidenheit -- besitzen Hervorgebracht -- Sicherheit Sinn -- sammeln aufstellen -- merken -- Schonung redet -- alt Art -- wovon Herr Meister glauben -- demjenigen unterzuordnen scheinen -- Überzeugung gut -- 
  -- -- denken -- Schöpfer Welt Gestalt Kreatur annehmen -- Art Weise Zeitlang Welt befinden -- Geschöpf unendlich vollkommen erscheinen -- Schöpfer innig vereinigen -- 
  Begriff Mensch Widerspruch Begriff Gottheit liegen -- gewiß Unähnlichkeit Entfernung empfinden -- desto Schuldigkeit -- Advokat bösen Geist Blößen Schwäche Natur sehen -- eher Vollkommenheit aufsuchen -- wodurch Anspruch Gottähnlichkeit bestätigen -- 
  lächelen versetzen -- Beschäme -- Oheim -- Gefälligkeit Sprache reden -- 
  sagen -- Wichtigkeit -- eigenst Sprache hören wünschen -- Alsdann -- zueign -- übersetzen suchen -- 
  -- -- eigen Weise -- Veränderung Tons fortfahren -- 
  Mensch groß Verdienst bleiben -- Umstand bestimmen bestimmen lassen -- 
  Weltwese liegen -- Steinbruch Baumeister -- Name verdienen -- zufällig Naturmasse -- Geist entsprungen Urbild groß Ökonomie -- Zweckmäßigkeit Festigkeit stellen -- 
  Element -- sagen -- -- tief liegen schöpferisch Kraft -- erschaffen vermögen -- -- ruhen rasen lassen -- Weise darstellen -- 
  -- lieb Nicht -- gut erwählen -- sittlich Wesen -- tief liebevoll Natur hoch Wesen übereinstimmend suchen -- indes tadeln -- sinnlich Mensch umfange kennen tätig Einheit bringen suchen -- 
  Gespräch vertraut -- erlangen -- -- Kondeszendenz -- sprechen -- 
  Glaube -- Oheim -- schmeichlen -- Art denken handeln Lobe -- 
  verehr Mensch -- deutlich wissen -- -- unablässig vorschreiten -- Zweck kennen ergreifen brauchen wissen -- fern Zweck klein -- Lob Tadel verdienen -- nachh Betrachtung -- 
  Glaube -- Liebe -- groß Unheil bös Welt nennen -- entstehen bloß -- Mensch nachlässig Zweck kennen lernen -- kennen -- ernsthaft arbeiten -- 
  Leute -- Begriff -- können müssen Turm bauen -- Grund stein Arbeit verwenden -- allenfalls Hütte unterschlüge -- 
  Freundin -- höchst Bedürfnis -- innerer sittlich Natur rein -- anstatt kühn Aufopferunge -- Familie -- Bräutigam -- Gemahl beholfen -- -- ewig Widerspruch -- niemals zufrieden Augenblick nossen -- 
  brauchen -- versetzen -- Wort Aufopferung -- manchmal denken -- hoch Absicht -- gleichsam Gottheit -- gering Opfer darbringen -- Herz liegen -- geliebt Schaf Gesundheit verehren Vater willig Altar führen -- 
  -- versetzen -- Verstand Empfindung -- einer hingeben -- einer wählen -- Entschiedenheit Folge -- Meinung -- verehrungswürdig Mensch -- 
  Ware Geld -- übel -- Ware lüsten -- Herz Geld hinzugeben -- -- Kauf reuen -- Ware Hand -- 
  entfernt -- Mensch tadeln -- eigentlich Schuld -- verwickelt Lage -- befinden -- regieren wissen -- 
  -- -- Durchschnitt -- übel Wirt Land Stadt finden -- Stadt -- -- 
  Mensch beschränkt Lage gebären -- einfach -- nahe -- bestimmt Zweck -- vermögen einsehen -- gewöhnen benutzen -- Hand -- sobald weit -- wissen weder -- -- einerlei -- Menge Gegenstand zerstreuen -- Höhe setzen -- 
  Unglück -- veranlassen -- streben -- regelmäßig Selbsttätigkeit verbinden -- 
  Fürwahr -- fahren fort -- Ernst Welt -- -- gebildet Mensch nennen -- eigentlich Ernst finden -- -- sagen -- Arbeit Geschäft -- Kunst -- Vergnügung Art Selbstverteidigung Werk -- leben Pack Zeitung lesen -- -- fallen jung Engländer Rom -- Abends -- Gesellschaft -- zufrieden erzählen -- Kirche Galerie Seite bringen -- 
  mancherlei wissen kennen -- wenigster angehen -- bemerken -- Hunger stillen -- Luft schnappen -- 
  Mensch kennen Lerne -- Frage sogleich -- womit beschäftigen -- Folge -- Beantwortung Frage Interesse Zeitleben entscheiden -- 
  -- Oheim -- versetzen -- streng entzieh gut Mensch -- nützlich können -- hülfreich Hand -- 
  verdenken -- antworten -- vergebens arbeiten -- 
  leiden Jugend Mensch angenehm Lustpartie einladen glauben -- Gesellschaft Danaiden -- Sysiphus bringen versprechen -- 
  Gott -- -- unglücklich Weise Kreis -- such höflichste Art hinaus komplimentieren -- Leute hören bitterst Klage verworren Lauf Welthandel -- Seichtigkeit Wissenschaft -- Leichtsinn Künstler -- Leerheit Dichter -- 
  Bedenken wenigsten -- Menge -- -- Buch lesen -- schreiben fordern -- echt Dichtung fremd -- Kunstwerk Vorurteil Beifall erlangen können -- 
  lassen abbrechen -- Schelt klagen -- 
  leitet Aufmerksamkeit verschieden Gemälde -- Wand aufhängen -- Auge halten -- Anblick reizend -- Gegenstand bedeutend -- lassen Weile geschehen -- -- gönn Genius -- Werk hervorbringen -- Aufmerksamkeit -- 
  Gemüt sehen gerne Finger Gott Natur -- Hand Nachahmer Betrachtung schenken -- 
  Sodann unscheinbare Bild aufmerksam -- suchen begreiflich -- eigentlich Geschichte Kunst bloß Begriff Wert Kunstwerk geben können -- beschwerlich Stufe Mechanismus Handwerk -- fähig Mensch Jahrhundert hinauf arbeiten -- kennen müssen begreifen -- Genie Gipfel -- bloßen Anblick schwindeln -- frei fröhlich bewegen -- 
  Sinn schön Reihe bringen -- enthalten auslegt -- moralisch Bildung Gleichniß sehen -- 
  Gedanke äußern -- versetzen -- vollkommen -- sehen -- tun -- sittlich Bildung -- einsam -- verschließen -- nachzuhängen -- vielmehr finden -- Geist moralisch Kultur streben -- Ursache -- fein Sinnlichkeit ausbilden -- Gefahr kommen -- moralisch Höhe herab gleiten -- Lockung regellosen Phantasie übergeben -- Gefahr setzen -- edl Natur Vergnügen schmacklosen Tändeleie -- schlimmerem herab würdigen -- 
  Verdacht -- zielen -- fühlen treffen -- denken -- Lied -- erbauet -- abgeschmackt -- Bildche -- geistlich Idee anschlossen -- schwerlich Auge Oheim Gnade finden -- 
  Philo indessen öfters Bibliothek aufhalten -- führen nunmehr selbig -- 
  bewundert Auswahl Menge Buch -- 
  Sinn sammeln -- beinahe finden -- deutlich Erkenntnis führen -- Ordnung anweisen -- Material geben -- Einheit unser Geist überzeugen -- 
  Leben unsäglich lesen gewiß Fach fast Buch unbekannt -- desto angenehm mir_es Übersicht sprechen -- Lücke bemerken -- beschränkt Verwirrung unendlich Ausdehnung sehen -- 
  machen Bekanntschaft interessant still Mann -- 
  Arzt Naturforscher -- scheinen Penaten Bewohner Haus gehören -- 
  zeigen Naturalienkabinett -- -- Bibliothek -- verschlossen Glasschränk -- wänd Zimmer verziert Raum veredelen verengen -- 
  erinnert Freude Jugend -- zeigen Vater mehrere Gegenstand -- ehemals Krankenbette -- Welt blickend Kind bringen -- 
  verhehlt Arzt folgend Unterredung -- -- Absicht religiös Gesinnung nähern -- loben Oheim außerordentlich Toleranz Schätzung -- Wert Einheit menschlich Natur anzeige befördern -- verlangen freilich Mensch gleich pflegen -- individuell Dünkel ausschließend Beschränktheit -- verdammen fliehen -- 
  Trauung Schwester Oheim Freude Auge -- sprechen verschieden Mal -- Kind denken -- 
  schön Gut -- bewirtschaften -- -- Zustande -- Neffe übergeben hoffen -- 
  -- befinden -- scheinen besonderer Gedanke hegen -- 
  -- -- Person überlassen -- kennen -- schätzen genießen wissen enthalten -- einsiehen -- Reicher Vornehmer -- Deutschland -- Ursache mustermäßig aufstellen -- 
  groß Gast verfliehen -- bereitet Abschied glauben letzter Szene Feierlichkeit erleben -- auf Aufmerksamkeit -- würdig vergnügen -- überraschen -- 
  Entzück verbergen -- fühlen -- Schwester Trauung Chor Menschenstimmen -- Begleitung Instrument -- hören lassen -- 
  legen nahe -- Vergnüge verschaffen -- scheinen merken -- 
  überraschen -- Abends -- Tanzmusik entfernen -- jung -- flüchtig Freund verlassen -- Ehepaar sehen ernsthaft -- Epoche scheiden -- -- wiedersehen -- regt feierlich Stimmung -- edl nähren -- Musik -- Wiederholung wünschen scheinen -- 
  lassen indes verstärkt stille geübt Chor -- achtstimmig Gesänge vortragen -- -- sagen -- Vorschmack Seligkeit geben -- 
  fromm Gesang -- Seele heiser Kehl -- Waldvögelein -- Gott loben glauben -- angenehm Empfindung -- eitel Musik Konzert -- allenfalls Bewunderung Talent -- selten -- vorübergehend Vergnüge hingerissen -- 
  vernehmen Musik tief Sinn trefflich st menschlich Natur entsprungen -- -- bestimmt geübt Organe harmonisch Einheit tief Sinn Mensch sprechen Augenblick Gottähnlichkeit lebhaft empfinden lassen -- 
  lateinisch -- geistlich Gesänge -- -- Juwele -- golden Ring gesittet weltlich Gesellschaft ausnahmen -- -- Anforderung genannt Erbauung -- geistig erheben glücklich machen -- 
  Abreise edelste beschenken -- 
  überreichen Ordenskreuz Stift -- kunstmäßig schön arbeiten emailliern -- sehen gewohnen -- 
  hing Brillant -- wodurch Band befestigen -- edelst Stein Naturaliensammlung ansehen bitten -- 
  Schwester ziehen Gemahl Gut -- kehren unser Wohnung scheinen -- äußerer Umstand anbetreffen -- gemein Leben kehren -- 
  -- Feenschloß -- platt Erde setzen -- müssen Weise benehmen behelfen -- 
  sonderbaren Erfahrung Kreis -- lassen schön Eindruck -- bleiben Lebhaftigkeit -- obgleich Oheim unterhalten erneuern suchen -- -- -- gefälligst Kunstwerk zusandn -- Genosse -- Vertauschte -- 
  gewohnen -- beschäftigen -- Angelegenheit Herzen Gemütes Ordnung bringen -- ähnlich gesinnt Person unterhalten -- Aufmerksamkeit Kunstwerk betrachten -- kehren -- 
  gewohnen -- Gemälde Kupferstich ansehen -- Buchstaben Buch -- 
  schön Druck fällen -- Buch Drucke Hand nehmen -- 
  bildlich Darstellung sagen -- belehren -- rühren -- gut -- Oheim Brief -- Kunstwerk erläutern -- reden -- bleiben alte -- 
  Natur ziehen äußerer Begebenheit -- Veränderung Familie Betrachtung -- Weile -- müssen dulden wirken -- -- schwach Kraft ertragen scheinen -- 
  ledig Schwester Arm -- gesund -- stark unbeschreiblich gütig Besorgung Haushaltung nehmen -- persönlich Pflege alt Vater beschäftigen -- 
  überfällen Katarrh -- woraus Brustkrankheit -- Woche liegen Bahr -- Tod schlagen Wunde -- Narbe gerne ansehen -- 
  liegen krank Bette -- ehe beerdiget -- alt Schaden Brust scheinen aufzuwachen -- husten heftig -- heis laut Ton hervorbringen -- 
  verheiraten Schwester Schrecken Betrübnis früh Woche -- 
  alt Vater fürchten -- Kind Hoffnung Nachkommenschaft verlieren -- gerecht Träne vermehrt Jammer -- fleht Gott Herstellung leidlich Gesundheit -- bitten Leben Tod Vater frisn -- 
  Genas -- Art -- Pflicht -- obgleich kümmerlich Weise -- erfüllen -- 
  Schwester Hoffnung -- 
  Mancherlei Sorge -- Fall Mutter anvertrauen -- mitteilen -- leben glücklich Manne -- Vater verbergen bleiben -- müssen Schiedsrichter -- eher -- Schwager Zutraue -- Mensch -- -- anstatt nachzuseh -- rechtet -- Begierde -- völlig überein Leben -- niemals einig -- 
  lernen weltlich Ding Ernst angreifen -- ausüben -- singen -- 
  Schwester gebar Sohn -- Unpäßlichkeit Vater verhindern -- reisen -- 
  Anblick Kind unglaublich heit froh -- Taufe erscheinen Art begeistern -- sagen -- Genius Gesicht -- 
  blicken freudig vorwärts Region -- eingehen hoffen -- -- hoffnungsvollen irdisch Leben -- Knabe entsprung -- abstammen -- 
  müde Rückweg Kind unterhalten -- Gestalt -- Gesundheit -- Wunsch -- Anlage Weltbürger glücklich ausgebildet möchten -- 
  Betrachtung hierüber dauern fort -- Haus anlangen -- bemerken Art Fieber -- Tisch Frost ermattend Hitze äußern -- 
  legen nieder -- fahren morgens versehen treulich Amtsgeschäft -- anhaltend -- ernsthaft Symptom abhielten -- 
  Ruhe Geist -- Klarheit Deutlichkeit vergessen -- womit Angelegenheit Haus -- Besorgung Begräbnis -- Geschäft -- groß Ordnung vornehmen -- 
  Heiterkeit -- -- lebhaft Freude steigen -- -- 
  Todesfurcht hingekommen -- Empfand -- Sollt sterben scheuen -- 
  gnädig Gott -- Grab erwecken Grauen -- ewig Leben -- 
  Umstand Tod rufen -- erfolgen -- Einsamkeit angenehmst Unterhaltung -- sichtbar Wirkung hoch Kraft wegräsonieren -- 
  Tod lieben Vater verändert bisherig Lebensart -- 
  streng Gehorsam -- groß Einschränkung groß Freiheit -- Genoß Speise entbehren -- 
  selten Stunde Haus -- verlebt Zimmer -- 
  Freund -- abgerissen Besuch -- anhaltend Umgang -- ihrig -- erfreuen -- öfter Tisch gelad -- Spazierfahrt Lustreise kommen hinzu -- bleiben nirgends -- 
  Zirkel durchlaufen -- -- unschätzbar Glück Freiheit bestehen -- tun -- -- wozu Umstand einladen -- Hindernis Rückhalt -- gerade Weg -- -- schicklich halten -- alt -- Fall -- Lehrgeld schön Überzeugung gelangen -- 
  versagen -- -- sobald -- Umgang Gliedern Herrnhutischen Gemeine fortsetzen -- fest knüpfen -- eilt nächster Einrichtung besuchen -- 
  finden keineswegs -- vorstellen -- 
  Meinung merken lassen -- suchen hinwieder Beizubring -- Verfassung ordentlich eingerichtet Gemeine -- 
  gefallen lassen -- Überzeugung wahr Geist -- -- Anstalt -- hervorblicken -- 
  Bischof -- gegenwärtig -- unmittelbar Schüler Grafe -- beschäftigen -- sprechen vollkommen Englisch -- verstehen -- meinen -- Wink -- gehören -- meinen -- Umgang geringsen fallen -- 
  Messerschmied -- geboren Mähre -- Art denken handwerksmäßig verleugnen -- 
  verstehen Herr Le * -- Major französisch Dienst -- Untertänigkeit -- vorgesetzter bezeigen -- fühlen niemals fähig -- Ohrfeige geben -- Majorin -- angesehen -- Frau Bischof Hand küssen -- 
  indessen Reise Holland verabreden -- -- gewiß -- niemals Stande -- 
  Schwester Tochter niedergekommen -- Reihe Frau zufrieden -- denken -- dereinst -- ähnlich -- Erzog -- 
  schwag unzufrieden -- abermals Tochter erfolgen -- wünschen Gut Knabe sehen -- einst Verwaltung beistehen können -- 
  halten schwach Gesundheit still -- ruhig Lebensart ziemlich Gleichgewicht -- fürchten Tod -- wünschen sterben -- fühlen Stille -- Gott geben -- Seele untersuchen nah -- 
  schlaflosen Nächte empfinden -- deutlich beschreiben -- 
  Seele Gesellschaft Körper dächen -- Körper -- fremd -- Wesen -- Kleid ansehen -- 
  stellen außerordentlich Lebhaftigkeit Zeit Begebenheite -- fühlen -- folgen -- 
  Zeit -- folgen -- Körper Kleid zerreißen -- -- wohlbekennen -- -- 
  -- erhaben tröstlich Gefühl nachzuhängen -- lehren edl Freund -- nah verbinden -- Arzt -- Haus Oheim kennen lernen -- Verfassung Körper Geist unterrichten -- zeigen Empfindung -- -- unabhängig äußerer Gegenstand -- nähren -- gewissermaßen aushöhlen Grund unser Dasein untergraben -- 
  Tätig -- -- Mensch Bestimmung -- Zwischenzeit -- auszuruh nötigen -- anwend deutlich Erkenntnis äußerlich Ding erlangen -- Folge abermals Tätigkeit erleichtern -- 
  Freund Gewohnheit kennen -- Körper äußerer Gegenstand ansehen -- wissen -- Konstitution -- Übel -- medizinisch Hilfsmittel ziemlich kennen -- anhaltend fremd leiden halber Arzt -- leiten Aufmerksamkeit Kenntnis menschlich Körper Spezereien -- übrig nachbarlich Gegenstand Schöpfung -- führen Paradiese umher -- zuletzt -- Gleichnis fortsetzen -- lassen Abendkühl Garten wandelnd Schöpfer Entfernung ahnden -- 
  gerne nunmehr Gott Natur -- Gewißheit Herzen tragen -- interessant Werk Hand -- dankbar -- Atem Mund beleben -- 
  hoffen auf -- Schwester -- Knabe -- Schwager sehnlich entgegen -- Geburt erleben -- 
  wack Mann sterben Folge unglücklich Sturz Pferd -- Schwester folgen -- Welt schön Knabe geben -- 
  hinterlassen Kind Wehmut ansehen -- 
  gesund Person -- kranke -- hingegang -- hoffnungsvoll Blüte abfallen sehen -- 
  kannt Welt -- wissen -- Gefahr Kind -- hoch Stande -- herauf wachsen -- scheinen -- Jugend gegenwärtig Welt vermehren -- 
  fühlen -- Schwäche -- Kind Stande -- desto erwünscht Oheim Entschluß -- Denkungsart entspringen -- Aufmerksamkeit Erziehung liebenswürdig Geschöpf verwenden -- 
  gewiß -- verdienen Sinn -- wohlgebilden -- versprach -- Verschiedenheit -- sämtlich gutartig verständig Mensch -- 
  Arzt aufmerksam -- betrachtet Familienähnlichkeit Kind verwandte -- 
  Vater sorgfältig Bild Vorfahre aufbewahren -- Kind leidlich Meister malen lassen -- Mutter verwandter vergessen -- 
  kennen Charakter Familie genau -- vergleichen -- suchen Kind Ähnlichkeite äußeren inneren -- 
  alt Sohn Schwester scheinen Großvater -- väterlich Seite -- gleich -- jugendlich Bild malen Sammlung unser Oheim aufstellen -- lieben -- brav Offizier zeigen -- Gewehr -- womit -- besuchen -- beschäftigen -- 
  Vater schön Gewehrschrank hinterlassen -- eher Ruhe -- Paar Pistole Jagdflint schenken -- heraus bringen -- deutsch Schloß aufzuziehen -- 
  Handlung Wesen rauh -- vielmehr sanft verständig -- 
  alt Tochter Neigung fesseln -- -- ähnlich -- vieren meister halten -- 
  sagen -- genau beobachten -- heran wachsen -- desto beschämt -- Kind Bewunderung -- beinahe sagen -- Verehrung ansehen -- 
  edl Gestalt -- ruhig Gemüt gleich -- Gegenstand eingeschränken -- Tätigkeit -- 
  Augenblick Leben unbeschäftigen -- jeder Geschäft Hand würdig Handlung -- 
  scheinen -- verrichten -- Platz -- ruhig -- Ungeduld -- bleiben -- finden -- 
  Tätigkeit Bedürfnis Beschäftigung Leben sehen -- 
  Unnachahmlich Jugend Betragen Notleidende Hülfsbedürftige -- 
  gestehen -- niemals Talent -- Wohltätigkeit Geschäft -- karg Arm -- Verhältnis -- gewissermaßen kaufen -- müssen angeboren -- Sorgfalt abgewinnen -- 
  Grade Gegenteil lob Nicht -- 
  niemals arme Geld geben sehen -- Endzweck erhalten -- verwandeln nächster Bedürfnis -- 
  niemals erscheinen liebenswürdig -- Kleider Wäscheschränke plünderen -- finden -- tragen braucht -- alt Sache schneid zerlumpt Kind anpassen -- groß Glückseligkeit -- 
  Gesinnung Schwester zeigen -- vieler Mutter -- versprechen Frühe Zierlich reizend scheinen Versprechen halten -- Äußeren beschäftigen wissen -- -- Auge fallend Weise putzen tragen -- 
  erinnern -- Entzück Kind Spiegel besehen -- schön Perle -- Mutter hinterlassen -- ungefähr finden -- umbinden müssen -- 
  verschieden Neigung betrachten -- angenehm denken -- Besitzung -- Tod -- zerfallen lebendig -- 
  Jagdflint Vater Rücken Neffe Feld herumwandeln -- jagdtasch Hühner heraus fallen -- sämtlicher Garderobe Osterkonfirmation -- lauter Mädchen anpassen -- Kirche herauskommen Stoff sittsam Bürgermädchen Brauttage schmücken -- Ausstattung Kind ehrbar arm Mädchen Natalie besonderer Neigung -- -- bemerken -- Art Liebe -- sagen -- Bedürfnis Anhänglichkeit sichtbar unsichtbar Wesen -- Jugend lebhaft zeigen -- Weise merken lassen -- 
  denken -- Jüngst Perle Juwele Hof tragen -- Ruhe Besitzung -- Körper -- Element wiedergeben -- 
  Kind wachsen heran -- Zufriedenheit gesunden -- schöne wack Geschöpf -- 
  ertragen Geduld -- Oheim entfernt halten -- sehen -- Nähe Stadt -- selten -- 
  wunderbar Mann -- französisch Geistliche halten -- Herkunft unterrichten -- Aufsicht sämtlichen Kind -- verschieden Ort erzog Kost -- 
  anfangs Plan Erziehung sehen -- Arzt zuletzt eröffnen -- Oheim Abbe überzeugen lassen -- -- Erziehung Mensch wollen -- müssen sehen -- wohin Neigung Wunsch -- sodann müssen Lage versetzen -- -- sobald befriedigen -- -- sobald erreichen -- Mensch -- irren -- früh Irrtum gewahr -- treffen -- passen -- desto eifrig halten desto emsig Fortbild -- 
  wünschen sonderbar Versuch gelingen mögen -- gut Natur -- 
  -- Erzieher billigen -- -- Kind entfernen suchen -- Umgang unsichtbaren -- einzig treu Freund führen können -- 
  verdrießen Oheim -- Kind gefährlich halten -- 
  praktisch Mensch tolerant -- 
  versichern -- Art Wesen gerne lassen wollen -- suchen Tätigkeit ausschließen -- denken -- 
  Art -- Kind entfernen -- betrüben desto -- Realität Glauben überzeugen -- 
  göttlichen Ursprung -- wirklich Gegenstand -- praktisch wirksam erweiset -- 
  durch Praktisch unser Dasein gewiß -- Weg Wesen überzeugen -- gut Hand reichen -- 
  vorwärts -- rückwärts gehen -- Handlung Idee ähnlich -- Vollkommenheit -- täglich Leichtigkeit fühlen -- halten -- Schwäche Körper -- Dienst versagen -- lassen menschlich Natur -- verderben tief eingesehen -- erklären -- 
  -- 
  erinnern Gebote -- erscheinen Gestalt Gesetzes -- Trieb leiten führen -- folge Freiheit Gesinnung -- wissen Einschränkung -- Reue -- 
  Gott -- erkennen Glück schuldig Vorzug Demut denken -- 
  niemals Gefahr -- Vermögen stolz -- deutlich erkennen -- welcher Ungeheuer menschlich Busen -- hoch Kraft bewahren -- erzeugen nähren können -- 