Bild sagen Schweiz -- 
  Jeremias Gotthelf -- 
  Bändch -- 
  schwarz Spinne -- 
  -- Ritter Brandis -- gelb Vögelein arm Margrithli -- 
  Solothurn -- Verlag Jet & Gaßmann -- 1842 -- 
  Gedruckt J. Gaßmann -- Sohn -- Solothurn -- 
  Vorwort -- 
  Norden Süden -- deutsch Welsche schreiben Schweizerland Bewohner -- Landstraße fahren -- Wirtstafel sitzen Weitem Fenster schauen -- schön glitzern Haus Abendschein -- 
  Schweizer -- Land gebären leben -- Fußweg kennen -- mancherlei Tisch sitzen gegessen -- Fenster schweizerisch Haus schweizerisch Herz sehen -- Entschuldigung bedürfen -- Land reden -- -- -- -- 
  freilich wissen -- Franzose -- Bötzinger Höhe Nase strecken -- Buralist -- seinig zuweilen Höhe Schreibtisch heben -- wissen -- schreiben -- 
  Glatter freilich Beschreiber Schweiz Worte Mund -- ehrlich kommen Herz -- 
  Glätt Schweizer besonderer Anspruch -- -- Vater -- -- Gott -- Sohn bleiben -- Ehrlichkeit Lauf Welt niedrig Preis stehen -- 
  Ehrlichkeit Verfasser erzählen -- Schweiz Sitte sagen wissen erfahren -- erzählen -- erzählen -- gut Samen freundlich Wort streuen Herz lieben Landsleute -- lieb Wort zukommen lassen -- Wort -- Gemüt erheitern -- Glaube stärken -- -- Gott Hilfe treu Pflege Teufel Welt Trotze gedeihen mitten -- 
  Büchlein freundlich Grüße -- zweimal Verfasser send -- rauh Wesen ärgern -- leiben gewinnen bleiben Jeremias Gotthelf -- 
  schwarz Spinne -- 
  Berg heben Sonne -- leuchteen klar Majestät freundlich eng Tal wecken fröhlich Leben Geschöpfe -- schaffen Sonne Leben freuen -- 
  vergoldet Waldessaume schmettert Amsel Morgenlied -- funkelnden Blume perlend Grase erscholl sehnsüchtig Wachtel eintönend Minneruf -- dunkel Tann tanzen brünstig Krähe hochzeitreigen krächzen zärtlich Wiegenlieder dornig Bettchen ungefiedert Junge -- 
  Mitte sonnenreich Halde Natur fruchtbaren -- beschirmt Boden eingraben -- mitten stehen stattlich Blank schön Haus -- eingefassen prächtig Baumgarte -- Hochäpfelbaum prangen spät Blumenkleid -- halb stehen Hausbrunn bewässern üppig Gras -- halb Futtergange zuwandern -- 
  Haus liegen sonntäglich Glanz -- Besenstrichen -- angebracht Samstag Abend Nacht -- erzeugen vermögen -- Zeugnis köstlich Erbgut angestammt Reinlichkeit -- pflegen -- Familienehr -- einzig unbewacht Stunde Flecken bringen -- Blutflecke -- unauslöschlich bleiben Geschlecht Geschlecht -- Tünche spottend -- 
  umsonst glänzt Gott Hand erbaut Erde Mensch Hand erbaut Haus reinsten Schmucke -- glänzt Stern blau Himmel -- hoch Feiertag -- 
  -- Sohn Vater gehen -- Zeugnis -- Leiter Himmel stehen -- Engel auf niedersteig Seele Mensch -- Leib entwind Heil Augenmerk Vater droben Erde -- -- Pflanzenwelt Himmel entgegenwächsen blühen voll Üppigkeit -- Mensch neu werdend Sinnbild Bestimmung -- 
  Wunderbar erklingen Hügel -- wissen woher Kling -- tönt Seite -- Kirche draußen weit Täler -- kündet Glocke -- Tempel Gott öffnen -- Herz Stimme Gott -- 
  rege Leben bewegen schön Haus -- 
  Brunnen Nähe besonderer Sorgfalt Pferd striegeln -- stattlich Mutter umgaukelt lustig Fülle -- breit Brunnentroge stillen behaglich blickend Kuh durst zweimal müssen Bube Besen Schaufel nehmen -- Spur Behaglichkeit sauber weggeräumen -- 
  Herzhaft wusch Brunnen handlich Zwilchfetz stämmig Mägde Rotbräg Gesicht -- Haar Knäuel Ohren zusammengedrehen -- tragen eilfertig Emsigkeit Wasser geöffnet Türe mächtig Stöße heben blau Luft empor kurz Schornsteine dunkel Rauchsäule -- 
  Langsam gebeugen Hakenstock Großvater Haus -- schweigend treiben Knecht Mägde -- streichelt Pferd -- wehrt Kuh schwerfällig Mutwille -- zeigen Stecke unachtsamen Bube vergessen Strohhalm fleißig lang Weste tief Tasche Feuerzeug -- Pfeif -- Morgen trotz schwer Atem leben -- anzünden -- 
  rein gefegt Bank Haus Türe sitzen Großmutter -- schön Brot schneidend mächtig Kachel -- dünn Größe Bissen -- unachtsam Köchinn Stubenmägde -- manchmal Stück Wallfisch ersticken müssen -- 
  Wohlgenährte stolz Hühner schön Taube stritt Brosame Fuß -- schüchtern täubchen -- werfen Großmutter Stücklein eigens -- tröstend freundlich Wort Unverstand Ungestüm -- 
  Drinn weiten rein Küche knistert mächtig Feuer Tannenholz -- Pfanne knallt Kaffeebohne -- stattlich Frau hölzern Kelle durcheinander rühren -- nebenbei knarrt Kaffeemühle Knium frischgewaschen Magd -- offen Stubentüre stehen -- offen Kaffeesack Hand -- schön Blasse Frau -- 
  -- -- Hebamme -- rösten Kaffee schwarz -- können -- Pulver sparen -- 
  Götti -- Pate -- 
  Frau grausam mißtreu legen Ungunst -- 
  halb Pfund -- 
  Vergiß Weinwarm bereit halten -- 
  Großvater -- Kindstauf -- Gevatterleuten Weinwarm aufstellen -- ehe Kirche -- 
  Spar -- Hörst -- 
  Schüssel Kachelbank Safran Zimt -- Zucker Tisch -- nimm Wein -- dünken -- halb -- Kindstaufe brauchen Kummer -- Sache brauchen -- -- 
  hören -- Kindtauf halten Haus -- Hebamme versiehen Amt Köchin schicken -- Amt Wehmutter -- spuen -- fertig einfach Herde kochen -- Sitt fordern -- 
  Keller mächtig Stück Käse Hand stämmig Mann -- blanken Kachelbank Teller -- legen Käse Stube Tisch tragen braun Nußbaumholz -- 
  -- Benz -- Benz -- rufen schön Blasse Frau -- lachen -- gut Teller Kindstaufe -- -- 
  glänzend Schrank Kirschbaumholz -- Buffet nennen -- -- Glasfenst Hause Zierd prangen -- 
  schön Teller -- blau rändern -- Mitte Blumenstrauß -- umgeben sinnig Sprüche -- z. B. -- O Mensch faß Gedanke -- Batz gelten z -- Pfund anken -- 
  Gott Mensch Gnade -- wohn Maat -- 
  Hölle -- heiß -- Hafner schaffen Fleiß -- 
  Kuh -- frißen Gras -- Mensch -- Grab -- 
  Käse stellen mächtig Zupfe -- eigentümlich Berner Backwerk -- geflocht Zöpfe Weiber -- schön Braun gelb feinst Mehl -- eiern Butter backen -- jährig Kind fast schwer -- unten pflanzen Teller -- 
  Hochaufgetürmt liegen appetitlich Küchlein -- Habeküchlein -- Eierküchlein -- 
  heiß dick Nidel stehen schön geblümt Hafen zudecken Ofen dreibeinigen glänzend Kann gelbem Deckel kochen Kaffee -- 
  Harrt erwartet Gevatterleut Frühstück -- Fürst selten Bauer Welt Berner -- 
  Tausend Engländer rennen Schweiz -- weder abgejagt Lord steifbeinig Ladies Frühstück -- 
  -- kommen -- bereit -- seufzen Hebamme -- 
  jedenfalls -- fertig -- jeder Sache -- Pfarrer grausam pünktlich scharf Verweis -- -- 
  Großvater erlauben Wägeli nehmen -- jung Frau -- 
  Glaube -- Kind -- Taufe tragen -- führen -- träge Lebtag Bein brauchen lerne -- 
  Gotte -- Patin -- -- versäumen längsten -- Götten kurz können immerhin nachlaufen -- -- 
  Angst Gevatterleute verbreiten durch Haus -- 
  -- -- -- hören Allenthalt -- eck Haus schauen Gesicht -- Türk bellt leibeskräfte -- herbeirufen -- 
  Großmutter -- 
  -- ehemals -- wissen -- aufzusteh Herr warten -- -- 
  stürzt Bub Küche Nachricht -- Gotte kommen -- 
  -- schweißbedecken belad Neujahrkindlein -- 
  Hand schwarz Schnür blumenreich Wartsäcklein -- -- fein weiß Handtuch wickeln -- Zupfe stach -- Geschenk Kindbetterin -- 
  Hand tragen Säcklein Kleidung Kind -- nebst etwelch Stück eigen Gebrauch -- namentlich schön weiß Strümpfe -- arm Drucke Kränzch Spitzenkappe prächtig schwarzseiden Haarschnür -- 
  freudig tönt Gottwilchen -- Gott willkommen -- entgegen Seite Bürde abstellen -- entgegengestreckt Hand freundlich begegnen -- 
  Seite langen dienstbar Hand Last Türe stehen jung Frau neu grüßen -- Hebamme Stube mahnen -- können drinnen sagen -- Brauch -- 
  handlich Manier setzen Hebamme Gotte Tisch -- jung Frau Kaffee -- Gotte weigern vorgeben -- -- 
  Vater Schwester täte -- ungegess Haus gehen -- schade jung Mädchen übel -- sagen -- 
  alt Jungfraue -- Mägde -- möchten -- spät -- liegen -- längstens -- 
  Kaffee dick Nidel gegossen -- Gotte wehren -- lieben -- werfen Frau Stück Zucker -- 
  Gotte zulassen -- ihretwegen Zupfe angehauen -- indessen müssen tüchtig Stück vorlegen lassen essen -- 
  Käse -- nötig -- 
  -- halbmageren Schatz -- Frau -- Gotte müssen ergeben -- 
  küchle -- wissen wohin -- -- 
  glauben -- sauber gut gewöhnen -- erhalten Antwort -- 
  küchle essen -- 
  Nöt Art abgemess Schlick Kachele ausgetrunken erheben eigentlich Streit -- 
  Gotte kehren Kachele -- Platz ferner Guttat -- -- 
  sollen Ruhe lassen -- müssen verschwören -- 
  Frau -- 
  leid -- finden -- Hebamme dringlichst befohlen -- -- vermöchte wahrhaftig -- -- trinken mögen -- Nidel fehlen -- abnehmen -- Brauch -- 
  arm Gotte -- Kachele einschenken lassen -- 
  Ungeduldig Hebamme herumgetrippeln bändigt Wort lang -- -- 
  helfen -- sagen -- -- 
  -- He -- pressiern -- -- Frau -- 
  arm Gotte -- rauchen Dampfkessel -- verstehen Wink -- versorgen heißen Kaffee schnell -- Absätz -- glühend Trank zwingen -- 
  -- z'weg -- nehmen -- Hinunter bringen -- kommen -- -- 
  stehen -- packen Säcklein -- übergeben Zupfe -- Kleidung -- Einband -- blank Neutaler eingewickeln schön gemalt Taufspruch -- Entschuldigung -- -- 
  darein redet Hausmutter Ausruf -- Art Gattung -- verköstig -- fast nehmen dürfen -- wissen -- ansprechen -- 
  Mädchen Werk -- verbeiständen Hebamme Hausfrau -- wendet Möglichst -- schön Gotte Schuh Strümpfen -- hinauf Kränzche kostbaren Spitzenkappe -- 
  Sache umständlich -- trotz Ungeduld Hebamme -- Gotte Sache -- Ort -- 
  Großmutter herein -- 
  -- sehen schön Gotte -- -- 
  nebenbei lassen fallen -- Zeichen läuten Götteni draußen äußerer Stube -- 
  draußen sitzen männlich Pate -- alt jung -- neumodischen Kaffee -- -- verschmähend -- dampfend Weinwarm -- altertümlich -- gut Bernersuppe -- bestehend Wein -- geröstet Brot -- eiern -- Zucker -- Zimt Safran -- altertümlich Gewürz -- Kindstaufschmaus Suppe -- Voress -- süß Tee vorkommen -- 
  lassen wohlschmecken -- alt Götti -- Vetter nennen -- allerlei Späße Kindbettiman -- -- 
  schon Weinwarm schließen -- gönnen -- sparen -- Merk -- Zwölfmäßig Sack letzter Dienstag Boten Bern geben Safran bringen -- 
  wissen -- Vetter -- -- Letzthin Nachbar Kindbetti -- Boten Sack mitgegeben 6 Kreuzer Auftrage -- 
  sollen Sacke 6 Kr -- gelb Pulver bringen -- Mäße Anderthalbes -- Kindstaufen müssen -- Weiber -- 
  Gotte hinein -- jung Morgensonne -- Mitgevatt Gottwilchen heißen Tisch ziehen -- Teller voll Weinwarm stellen essen -- -- Kind zurecht machen -- 
  arm Gotte wehrt Hände Fuß -- behaupten -- gegessen -- können schnaufen -- 
  helfen -- 
  alt Jung Spott Ernst -- Löffel greifen -- seltsam -- Löffel finden Plätzchen -- 
  Hebamme schön eingewickelt Kind -- ziehen gestickt Käppche rosenrot Seidenband -- legen schön Deckbettlein -- stecken süß Lulle Mäulchen -- 
  begehr versäumen denken -- wollen zurecht -- können -- wollen -- 
  Umstand Kind rühmen billig -- wunderappetitlich Bübch -- 
  Mutter freut Lobe -- 
  -- gerne Kirche kommen Gott empfehlen helfen -- -- Kind taufen -- sinnen -- versprechen -- 
  zudem unbequem -- Woche Dachtraufe -- Hand voll Anpflanze -- -- 
  Großmutter -- 
  -- Sohnsfrau arm Frau Kirchgang müssen -- Hebamme setzen hinzu -- gerne -- jung Weiber Kind Kirche gehen -- 
  Angst -- gehen daheim Krummes -- Andacht Kirche Heimweg pressieren stark -- versäumen -- erhitzt -- übel krank sterben -- 
  Gotte Kind Deckbette arm -- Hebamme legen schön weiß Tauftuch schwarz Quast Eck Kind -- sorgfältig schön Blumenstrauß Gotte Brust schonend -- -- -- Gott -- heilig Name -- -- 
  Großmutter legen Hand beten still inbrünstig Segen -- 
  Mutter Zug hinaus Türe -- 
  -- Bübli -- Bübli -- sehen Stunde -- halten -- -- 
  alsobald schoß Auge -- rasch fahren Vortuch Haus -- 
  Rasch schriten Gotte Halde Kirchweg entlang -- stark arme munter Kind -- hintendrein Götteni -- Vater Großvater -- Sinn -- Gotte Last entledigen -- obgleich jung Götti stattlich Maium Hute Zeichen Ledigkeit tragen -- Auge leuchten Wohlgefallen Gotte -- freilich Blende Gelassenheit verbergen -- 
  Großvater berichten -- welch schrecklich Wetter -- Kirche tragen -- Hagel Blitz Kirchgänger geglauben Leben -- 
  Hinten_h Leute allerlei weissagen -- Wetter -- schrecklich Tod -- Glück Krieg -- gehen Stille -- siebzigsen weder Früh sterben Glück Krieg -- 
  halb Weg gehen -- Jungfrau nachgesprungen -- Kind Haus tragen -- sobald taufen -- Eltern Gevatterleute alt schön Sitt Predigt beiwohnen -- 
  Jungfrau anwend Kraft -- schön -- handlich Arbeit verspäten Gotte Kind abnehmen -- lassen -- zureden -- 
  Gelegenheit schön ledig Götti zeigen -- stark Arm erleiden möchten -- 
  stark arm Frau Bauer anständig zart -- liederlich Stäbch -- Bysluft -- ernstlich -- auseinander wehen -- stark arm Mutter Kind Heil -- Vater sterben -- Mutter Rute führen -- alleine Haushaltungswagen Loch heben müssen -- geraten -- 
  ist_es -- stark Gotte Zupfe halten -- Kopf schlagen -- prallen ordentlich -- Jungfrau Kind -- bleiben stellen -- Strumpfband -- 
  -- gesellt Mann -- mischen Gespräch -- Großvater unterbrechen -- ablenken Gegenstand -- fassen -- 
  halten -- alt Leute meist gewohnen -- Gegenstand fest -- knüpfen unverdrossen abgerissen Fade neu -- 
  Kind Vater -- versuchen allerlei Frage Privatgespräche verführen -- einsilbig lassen angesponnen Fade fallen -- 
  Gedanke -- Vater -- Kind Taufe tragen -- namentlich Bübch -- 
  näh Kirche -- desto Leute schließen Zug -- warten Psalmbücher Hand Weg -- springen eilig eng Fußweg hinunt -- Prozession ähnlich -- rücken Dorf -- 
  Kirche stehen Wirtshaus -- Haus -- nah Beziehung stehen Freude Leid teilen Ehre -- 
  stellen -- Bübch trocken Kindbettiman bestellt Maß -- einredet -- 
  sollen -- Herz verlangen möchten weder Dickes Dünne -- 
  indessen Wein -- tranken -- vornehmlich Jungfrau -- denken -- müssen Wein trinken -- Wein geben wollen geschehen lang manchmal -- 
  Gotte Tropfen bewegen -- trotz Zureden -- nehmen -- Wirtin -- 
  sollen nachlassen nötige -- Mädchen zusehends blass Hoffmannstropfen tun Nöter Wein -- 
  Gotte -- Glas bloß Wasser -- müssen Tropfen Riechfläschchen auf Nastuch schütten lassen -- ziehen unschuldigerweise verdächtig Blick rechtfertigen -- helfen lassen -- 
  gräßlich Angst leiden Gotte merken lassen -- 
  -- Name Kind erhalten sollen -- Gotte alt Übung Pfarrer -- Kind übergeben -- einzuflüstern -- eingeschriebenen Name -- Kind taufen -- verwechseln -- 
  -- besorgend Ding Angst -- spät -- Mitteilung Namen vergessen -- Name fragen -- Vater Schwester -- Bas -- Mal streng verbieten -- Kind unglücklich wollen -- sobald Gotte Kind Name fragen -- zeitlebens -- neugierig -- 
  Name wissen -- fragen -- Pfarrer vergessen -- laut öffentlich fragt -- Schuß Buben Mädeli Bäbeli taufen -- Leute lachen Schande Lebenlang -- 
  schrecklich -- stark Mädchen zittert Bein Bohnenstaude Wind -- blass Gesicht rann Schweiß bachweise -- 
  mahnen Wirtin Aufbrechen -- Pfarrer angerebelen -- Gotte -- 
  -- Meitschi stehst -- wissen frischgewaschen Hemd -- -- 
  laufen -- meinen -- gut -- frisch Luft kommen -- 
  gut -- schwarz scheinen Leute Kirche fing Kind schreien -- mörderlich Mörderlicher -- 
  arm Gotte beginnen wieg arme -- heftig Heftiger -- laut schreien -- Blatt stoben Maium Brust -- 
  Brust eng schwer -- laut hört Atemfasse -- 
  hoch Brust heben -- hoch fliegen Kind arme -- hoch fliegen -- laut Schrie -- laut Schrie -- Gewaltiger lesen Pfarrer gebeter -- 
  Stimme prasselten ordentlich Wänd Gotte wissen -- sauste braust meereswog Kirche tanzt Luft herum -- 
  Pfarrer -- Amen -- -- schrecklich Augenblick -- entscheiden -- Spott Kind Kindeskinder -- müssen Tuch abheben -- Kind Pfarrer geben Name Ohr flüstern -- 
  decken -- zitternd bebend -- reichen Kind dar -- Pfarrer -- -- fragen scharf Auge -- tauchen Hand Wasser -- netzen plötzlich schweigend Kind Stirn taufen Mädeli -- Bäbeli -- Hans Uli -- ehrlich wirklich Hans Uli -- 
  war_es Gotte sämtlicher Emmentaler Berg Herz fallen -- Sonne -- Mond Stern -- feurig Ofen tragen kühl Bad -- Predigt bebt Glied stillen -- 
  Pfarrer predigen schön eindringlich -- eigentlich Leben Mensch sollen Himmelfahrt -- Andacht bringen Gotte -- Predigt -- Text vergessen -- 
  warten -- geheim Angst offenbaren Grund blass Gesicht -- 
  Lachen Witz müssen hören Neugierde Weiber fürchten Mädchen anhängten -- Bube täte -- 
  getrost fragen -- 
  schön Haberacker -- niedlich Flachsplätz -- herrlich Gedeihen Wiese Acker ziehen Aufmerksamkeit fesselt Gemüt -- 
  finden Grund langsam -- still stehen -- schön steigend Maisonne warm -- Heim kommen -- Glas kühl Wein -- sträuben -- 
  setzen Haus -- Küche Hand emsig rühren -- Feuer gewaltig prasselen -- 
  Hebamme glüht feurig Ofen -- 
  rufen Essen -- Dienst -- spei vorweg -- reichlich -- froh -- Knecht namentlich -- Weg kommen -- 
  langsam fließen Haus sitzend Gespräch -- versiegen -- essen stören Gedanke Magen Gedanke Seele -- indessen lassen gerne innerer Zustand inne -- bemänteln langsam Wort gleichgültig Gegenstand -- 
  stehen Sonne über Mittag -- Hebamme flammend Gesicht -- blank Schürze -- Türe erscheinen willkommen Nachricht bringen -- essen -- sein -- 
  Meister geladener fehlen gesandt Bo bringen Knecht Evangelium -- allerlei Bescheid -- Unterschied -- eigentlich -- -- Werkleute -- Leute bestellen müssen wohin -- -- warten sollen -- fürfahren Sache -- 
  Rätig -- Mahnung folgen -- warten müssen -- -- können Mond kommen -- nebenbei freilich brummt Hebamme -- 
  dümmer Wartenlassen -- Herz gerne eher -- sollen merken -- 
  müssen Mühe Wärme stellen -- wissen -- -- fertig -- 
  Rat Abwesende schnell fassen -- anwesende fertig -- bedenklich Mühe Stube -- Sitz bringen -- -- -- -- 
  sitzen -- Suppe Tisch -- schön Fleischsuppe Safran färben würzen schön weiß Brot -- Großmutter eingeschniten -- dick gesättigen -- Brühe sichtbar -- 
  entblößt Häupt -- Hand falten feierlich beten jeder Geber gut Gabe -- 
  greifen langsam blechern Löffel -- wischt schön weiß Tischtuch lassen Suppe -- Wunsch laut -- -- begehrn -- 
  Suppe fertig -- wischen Löffel Tischtuch -- Zupfe herumgebot -- schneiden Stück -- Voress Safranbrühe aufgetrag -- Voressen Hirn -- Schaffleisch -- saure Leber -- 
  erledigen bedächtig Zugreifen -- Schüssel aufgeschichten Rindfleisch -- grün dürr -- Belieben -- kommen Dürre Bohne Kannenbirenschnitze -- breit Speck prächtig Rückenstücke Dreizentnerche Schwein -- schön rot wissen saftig -- 
  folgen langsam -- neu Gast -- Suppe aufgetragen müssen anfangen -- -- einzig Gericht schenken -- 
  Zwischendurch schenken Benz -- Kindbettiman -- schön weiß Flasche -- Maß enthielt Wappe Sprüche reich zieren -- fleißig -- 
  wohin Arm reichen -- tragen Schenkamt -- nöten ernstlich Trink -- mahnen -- -- -- -- trinken -- -- Hebamme Schüssel hineintragen -- bringen Glas bringen -- -- allemal gehörig Bescheid -- Küche wunderlich -- 
  jung Götti müssen Spottred hören -- Gotte Trinke halten wissen -- Gesundheit verstehen -- krieg Frau -- 
  -- O -- Hans Uli begehren -- -- Gotte -- -- ledig Bursch Sache Kopf Heirat -- Meister vermöchen -- -- 
  -- He -- -- Hans Uli -- dünken -- 
  Schlärpli -- meister Mädchen -- geben teuer Frau -- Meister meinen -- brav Frau -- nötig blau seiden Tüchlein Kopf -- Händschli Sommer gesticken Pantoffel Winter -- 
  Kuh fehlen Stalle -- freilich übel schlagen -- können ändern -- Frau -- Haus Hof bringen -- Austubacket -- müssen behalten -- 
  nützlich -- sinn Sache Heirat lassen Mädchen -- Mädchen -- 
  -- -- -- -- alt Götti -- -- unscheinbar Männche gering Kleid -- Ehre halten Vetter -- Kind -- bezahlt Hof 100,000 Schweizerfranke Zins -- -- -- -- -- -- -- Weibervolk -- 
  sagen -- hie -- Haus anstehen -- dünn säen -- 
  Narrenwerk Hoffart Kopf -- ziehen Pfauen -- ziehen sturm Störch -- halb arbeiten -- Kopfweh liegen Bett -- ehe selber -- 
  alte buhlen -- -- müssen Kummer -- krieg brav Hausmutter Hausnarr Hausteufel -- -- 
  -- He -- he -- Götti Uli -- -- Gotte -- reden -- kommen -- -- -- deinen Zeit Bauerntöchter -- 
  Kennst achtest Mädchen -- alt Manne anstehen -- -- alt jung -- 
  rühmen -- Vater manchmal -- fortfahren -- tun Mutter selig -- berühmt Frau -- 
  schwer Schwein vorig -- Vater Markt führen -- 
  Metzger manchmal -- 
  meitschi sehen -- mästen -- 
  heutig Bube klagen -- lieben Welt Wille -- 
  Tubacke -- Wirtshaus sitzen -- weiß Hüte Seite tragen Auge aufsperren Stadttore -- Kegelt -- Schießet -- schlecht Meitschene nachstreichen -- -- Kuh melken Acker fahren -- fertig -- Werkholz Finger nehmen -- tun dumm Herr Schreiber -- 
  manchmal verreden -- wollen Mann -- wissen gewiß fahren können -- hie Bauer abgeben -- wissen -- Mann -- -- 
  lachen -- treiben Mädchen Blut Gesicht Gespött -- 
  -- Probe nehmen müssen -- gewiß wissen Mann -- 
  lachen Scherz Fleisch -- vergessen Kannenbirenschnitze -- alt Götti -- 
  -- dünk -- einstweilen Tisch weg -- Bein Tisch steif Pfeif schmecken -- zuvor Fleisch gegessen -- -- 
  Rat erhalten Beifall -- Kindbettileute einredet -- 
  sollen Tisch weg -- -- bringen Mensch fast -- 
  -- Kummer -- Base -- -- Vetter -- -- Tisch stellen -- gering Mühe -- strecken -- handlich Essen -- -- 
  Mann machen Runde Ställe -- tun Blick Bühne -- alt Heu vorhanden -- rühmen schön Gras schauen Baum hinauf -- Segen mögen -- hoffen -- 
  blühend Baum Vetter Halt -- -- schick abzusitz Pfeifch anzustecken -- kühl -- Weiber anrichten -- nahe Hand -- -- 
  gesellt Gotte -- Weiber Garten Pflanzplätze besehen -- 
  Gotte kommen Weiber -- lassen nieder Gras -- vorsichtig schön Kittel Sicherheit bringend -- unterröcke hell rot Rand Gefahr aussetzend -- Andenken erhalten grün Grase -- 
  Baum -- Gesellschaft lalagelen -- stehen oberhalb Haus sanft Anfang Halde -- 
  Auge fallen schön Haus -- weg Blick schweifen jenseitig Tal Rand -- schön reich Hof weiterhin grün Hügel dunkel Täl weg -- 
  -- stattlich Haus -- angeben -- -- Vetter -- -- Platz -- begreifen -- schlecht Haus leiden -- Geld Holz bauen -- Exempel -- -- 
  -- Vexier -- Vetter -- -- Großvater -- -- Beidem rühmen -- bauen wüs Sache -- wissen anfangen -- aufhören -- manchmal Weg -- Ort anderer -- -- 
  -- fällen Haus ausnehmend -- -- Frau -- 
  -- neu -- scheu Kosten -- 
  sobald Mann -- besehen -- dünken -- einer können -- Himmel -- 
  fragen -- nehmen ungut -- Fenster -- wüs schwarz Fensterpost -- Bystel -- -- stehen Haus übel -- -- 
  -- Großvater bedenklich Gesicht -- ziehen hart Pfeif -- 
  -- Holz fehlen Aufricht -- anderer Hand -- Not Eile alt Haus nehmen -- -- 
  -- -- -- Frau -- -- schwarz Stück Holz -- unten ansetzen -- Nachbar Herzen gerne neu Stück geben -- -- 
  -- -- halten sinnen Nachbar neu plagen -- geholfen Holz Fahren -- -- antworten alt -- 
  -- Höre -- Aetti -- -- Vetter -- -- machen Schneckentänze -- gib Wahrheit aufrichtig Bericht -- 
  raunen hören -- Punktum Wahr vernehmen -- 
  schicken -- Weiber Braten z'weg -- Würdest kurz -- gib aufrichtig Bericht -- -- 
  Schneckentanz Großvater -- ehe verstehen -- Vetter Weiber lassen versprechen -- ausdrücklich Vorbehalt -- -- erzählen -- bleiben kommen -- 
  scheuen Leute Haus -- alt gerne Leute bös Spiel -- 
  -- Allemal Holz betrachten -- -- beginnen ehrwürdig alt -- -- verwundern -- Zuging -- fern Morgenlande -- Menschengeschlecht entstehen -- Mensch hierher kommen -- Winkel eng Graben finden -- denken -- -- hierher verschlagen drängen -- ausstanden -- -- 
  nachfragen -- erfahren -- Gegend früh bewohnen -- Sumiswald -- ehe Heiland Welt -- Stadt -- aufgeschrieben stehen Nirgends -- 
  wissen -- sechshundert -- Schloß stehen -- Spital -- wahrscheinlich stehen Haus -- gehören samt Umgegend Schlos -- müssen dorthin Bodenzinse geben -- Frondienst leisten -- Mensch Leibeigen rechtens -- -- sobald -- 
  ungleich Mensch -- nahe wohnt Leibeigene -- Händel -- schwer -- fast unerträglich -- drücken -- Leben sicher -- 
  Zustand hing jeweil Herr -- ungleich fast unumschränkt Meister Leute finden -- leichtlich wirksam klagen -- 
  -- Schloß gehören -- schlimm Zeit Meister -- Schlöss gehören -- 
  meister Schlöss gehört Familie -- kommen Vater Sohn -- kennen Herr Leute Jugend -- Leute Vater -- 
  Schloß nämlich früh Hand Ritter -- deutsche nennen -- -- befehlen -- nennen Komtur -- 
  Oberen wechseln -- Sachsenland Schwabenland -- anhänglichkeit bringen Brauch Art Land -- 
  -- eigentlich Polen preußenland Heide streiten -- -- obgleich eigentlich geistlich Ritter -- gewöhnen fast heidnisch Leben gehen Mensch -- Gott Himmel -- heim kommen -- meinen -- Heidenland treiben gleich Leben fort -- 
  -- Schatten lustig leben wüssen Land blutig streiten -- -- Wunde heilen -- Leib stärken müssen -- kommen Gut -- Orden -- Gesellschaft Ritter nennen -- Deutschland Schweiz besitzen -- tun Art wohlgefiel -- 
  Wüstest Hans Stoffeln -- Schwabenland -- zugetragen -- wissen -- Vater Sohn vererbet -- 
  -- Hans Stoffeln fallen -- hinten Bärhegenhubel Schloß bauen -- -- -- wild Wetter geben -- Schloßgeister Schatz sonnen sehen -- stehen Schloß -- 
  bauten Ritter Schlösser Straße -- Wirtshäuser Straße bauen -- beider Leute plündern -- verschieden Weise freilich -- 
  Ritter wild wüsst Hubel Einöde Schloß -- wissen -- -- Bauer Schloß gehören -- müssen bauen -- 
  Ritter fragt Jahreszeit geboten Werk -- Heuet -- Ernte -- Säet -- 
  Zug müssen fahren -- Hand müssen arbeiten -- letzter Ziegel decken -- letzter Nagel schlagen -- 
  schenkt Zehntgarbe -- Mäße Bodenzins -- Fasnachthuhn -- Fasnachtei -- Barmherzigkeit kennen -- Bedürfnis arm Leute kennen -- 
  ermuntert heidnisch Weise Schlägen Schimpfen -- müde -- langsam rührt ruhen -- Vogt Peitsche -- weder alt Schwachheit verschonen -- 
  --- wild Ritter -- Freude dran -- Peitsche knallen -- treiben Schabernack Arbeiter -- Arbeit mutwillig verdoppeln -- Sparte -- Freude Angst -- Schweiß -- 
  -- Schloß fertig -- Ellen dick Maur -- wissen -- stehen -- Bauer froh -- stehen -- stehen müssen -- letzter Nagel schlagen -- letzter Ziegel -- 
  -- wischt Schweiß Stirn -- sehen betrübt Herz Besitztum -- sehen seufzend unselig Bau zurückgebracht -- 
  lang Sommer Gott -- fassen Mut kräftig Pflug -- trösten Weib Kind -- schwer Hunger gelitt -- Arbeit Pein scheinen -- 
  -- Pflug Feld führen -- Botschaft -- Hofbau Abends bestimmt Stunde Schloß Sumiswald einfinden -- 
  bangten hoffen -- 
  freilich gegenwärtig Bewohner Schlosses genießen -- laut Mutwille Härte -- dünken billig -- Herr tun unerhört Frondienst -- dünken -- meinen -- dünk Herr -- selb Abend Geschenk Nachlaß verkünden -- 
  -- finden bestimmt Abend zeitig klopfend Herz -- müssen warten Schloßhofe -- Knecht Gespött -- 
  Knecht Heidenland -- 
  zudem -- jeder halbbatzig Herrenknechtlein meinen -- gesessen Bauer verachten verhöhnen -- 
  -- Rittersaal entboten -- öffnet schwer Türe -- drinnen sitzen schwer Eichentisch schwarzbraun Ritter -- wild Hund Füßen -- obenan Stoffeln -- wild mächtig Mann -- Kopf doppelt Bernmäß -- Auge Pflugsräder -- Bart alt Löwenmahn -- 
  gerne hinein -- stoßen -- lacht Ritter -- Wein Humpen spritzen wütend stürzt Hund -- zitternd -- zagend Glied sehen -- -- gehören jagend Wilde -- 
  Bauer Mute -- dünken -- daheim sein drücken -- 
  hund Ritter schwiegen -- erheben Stoffeln Stimme tönt hundertjährig Eich -- 
  -- Schloß fertig -- einer fehlen -- Sommer droben Schattengang -- 
  Monat sollen Pflanze -- sollen einhundert ausgewachsen Buche nehmen Minneberg -- Ast Wurzel -- sollt pflanz Bärheg einzig Buch fehlen -- büßen Blut -- 
  drunter stehen Trunk Imbiß -- Buch Bärheg stehen -- -- 
  Trunk Imbiß hören -- meinen -- Ritter gnädig launen -- beginnen reden notwendig Arbeit Hunger Weib Kind Winter -- Sache -- 
  beginnen Zorn Ritter Kopf groß groß schwell Stimme brechen Donner Fluh -- 
  gnädig -- übermütig -- 
  Polenlande nackt Leben -- küss Fuß -- Kind Rind -- Dach Fach -- -- 
  Gehorsamer Genügsamer machen -- Hans Stoffeln -- Monatsfrist hundert Buche stehen -- lassen peitsch Fingerlang -- Weiber Kind werfen Hunde -- 
  -- wagt Einred -- begehren Trunk Imbiß -- drängt -- zornig Befehl geben -- Türe hinaus -- gerne -- folgen Ritters donnernd Stimme -- Ritter Gelächter -- Knechte Spott -- Rüden Geheul -- 
  -- Weg beugen -- Schloß sehen -- setzen Weg Rand weinen bitterlich -- Trost -- Mut recht Zorn -- Not Plage Mut auslöschen -- Kraft Zorne -- Jammer -- 
  3 Stunde wild Weg Buche führen Ast Wurzel steil Berg hinauf -- Berg wachsen schön Buche -- müssen stehen lassen -- 
  Monatsfrist Werk geschehen -- -- Baum -- schleppen durch Tal -- steil Berg -- ermattet Vieh -- 
  Maimond -- Bauer rühren Acker -- fast Nacht verlassen -- Brot Speise Winter -- 
  -- ratlos weinen -- ansehen -- Jammer sehen -- Seinige zusammenschlagen -- heim Botschaft -- Jammer heim tragen Weib Kind -- stehen plötzlich -- wissen woher -- dürr grün Jägersmann -- 
  kecken Barett schwanken rot Feder -- schwarz Gesicht flammen rot Bärtch -- gebogen Nase zugespitzen Kinn -- fast unsichtbar -- Höhle überhangend Gestein -- öffnet Mund fragen -- -- -- gut Leute -- sitzet heulet -- Stein Boden sprengen Äste Bäumen -- -- 
  zweimal fragen -- zweimal erhalten Antwort -- 
  -- schwärz grüne schwarz Gesicht -- Röter rot Bärtch -- scheinen Knister spretzeln -- Feuer Tannenholz -- Pfeil spitzt Mund -- auseinander fragen Holdselig Mild -- 
  -- gut Leute -- helfen -- sitzet heulet -- 
  könneen heul Sündflut -- eu Geschrei Stern Himmel sprengen -- wahrscheinlich helfen -- 
  Leute fragen -- hättet -- Leute -- -- helfen können -- sollten Heulen -- Antwort vernünftig Wort reden -- hülfen -- -- 
  schüttelt alt Mann weiß Haupt sprechen -- 
  -- haltet ungut -- -- worüber weinen -- nehmen Jägersmann -- Herz Jammer verschwollen -- Wort heraus -- -- 
  -- schüttelt spitzig Haupt grüne sprechen -- 
  -- Vater -- reden dumm -- -- 
  schlagen -- Stein Baum -- Ton -- Klaget -- 
  Mensch klagen -- klagen -- klagen -- helfen gute -- 
  Jägersmann -- wissen -- daheim tüchtig Gespann -- Holz stein Buche Tanne führen -- -- 
  -- arm Bauer Wort Gespann hören -- fallen Herz -- Hoffnungsfunk -- Auge sehen alt Mund -- sprechen -- 
  -- -- sagen -- Herz -- anhören -- -- helfen können -- wollen Hehl -- 
  schwer gelitt Schloßbau -- Hauswesen Herrschaft -- bitterlich Mangel -- 
  frisch aufgeatmet -- Meinung -- frei Hand Arbeit -- neu Mut Pflug Feld führen -- soeben Komtur befohlen -- Minneholz gewachsen Buche Monatsfrist Schloß Schattengang pflanzen -- 
  wüßn vollbring Frist -- abgekarrt Vieh -- vollbrächen -- hülfen -- 
  Anpflanze können müssen nachher Hunger sterben -- Fall hart Arbeit töten -- 
  Botschaft dürfen Heimtrag -- möchten alt Elend Jammer schütten -- -- 
  -- grüne mitleidig Gesicht -- heben drohend -- mager -- schwarz Hand Schloß empor vermaß schwer Strafe Tyrannei -- 
  wollen helfen -- 
  Gespann -- kein Land -- sollen Kilchstalde -- diesseits Sumiswald -- Buche -- dorthin bringen vermöchen -- Bärheg führen -- leiben -- Ritter trotz gering Lohn -- 
  -- horcht arm Mann unerwartet Anerbiet -- 
  Lohn einig -- retten -- Kilchstald Buche führen -- Landarbeit versäumen Grunde gehen -- 
  alte -- -- sagen -- verlangst -- Handel einig -- -- 
  grüne pfiffig Gesicht -- knistert Bärtch Schlangenaug funkelt Auge -- gräulich lachen stehen Mundwinkel -- 
  -- -- begehr -- ungetauft Kind -- -- 
  -- Wort zucken Mann Blitz -- Decke fallen Auge -- Spreu Wirbelwinde stoben auseinander -- 
  -- lachte hellr grüne -- Fisch Bach bargen -- Vögel Dickicht suchen grausig schwanken Feder Hute nieder Bärtch -- 
  -- -- Besinnet -- Suchet euren Weiber Rat -- Nacht finden -- -- -- rufen Fliehenden scharf tönend Stimme -- Wort Ohr hängen bleiben -- Pfeil Widerhak hängen bleiben Fleisch -- 
  -- Blaß zitternd seel Gliedern stäuben Mann Haus -- -- Hals drehen -- Gut Welt -- 
  verstört Mann gestoben kommen -- Taube Vogel gejagen Taubenschlag -- drang Schrecken Haus -- bebt Kunde -- Mann Glied durcheinander werfen -- 
  -- zitternd Neugierde schlich Weiber Mann -- Ort -- stille vertraut Wort reden -- 
  müssen Mann Weib erzählen -- Schloß vernehmen -- hört Wut Fluch -- müssen erzählen -- begegnen -- antragen -- 
  Ergriff namenlos Angst Weiber -- Wehgeschrei ertönt Berg Tal -- -- Kind Ruchlose begehren -- 
  einzig Weib schreien -- 
  grausam handlich Weib -- Lindauerin -- Hofe gewohnen -- 
  wild schwarz Auge fürchten Gott Mensch -- 
  böse -- Mann Ritter rundweg begehren abschlagen -- -- sagen -- -- 
  grüne hören Antrage Mann gestoben -- böse -- Schalt Mann Feigheit -- grüne keck Gesicht sehen -- Lohne begnügen -- Arbeit Schloß -- Seele schaden -- Teufel machen -- 
  ergrimmt Seele -- -- -- Teufel sehen wissen -- Aussehen -- 
  weinen Weib -- redet Grimm hart Wort Mann Mann -- 
  -- folgend Tag -- still Gewimmer Wehgeschrei verglommen -- sitzen Mann -- suchten Rat finden -- 
  Anfangs Rede neu bitt Ritter -- bitten -- scheinen Leib Leben feil -- 
  Weiber Kind schicken Geheul Jammer -- verstummen schnell Weiber reden beginnen -- Weiber Nähe -- Mann Rate sitzen -- 
  wissen Rat -- Gott Name Gehorsam versuchen -- Messe lesen lassen -- Gott Beistand gewinnen -- Nachbaren nächtlichen geheim Hilfe ansprechen -- offenbar Herr erlauben -- teilen -- Hälfte Buche schaffen -- Hälfte Hafer säen Viehes warten -- 
  hoffen Weise Gott Hilfe täglich 3 Buche Bärheg hinauf schaffen -- grüne reden -- denken -- verzeichnen -- 
  -- teilen -- rüsteten Werkzeug -- Maitag Schwelle -- sammeln Mann Minneberg beginnen gefißtem Mute Arbeit -- 
  weit Ring müssen Buche umgraben -- sorgfältig Wurzel schonen -- sorgfältig Baum -- verletzen -- Erde lassen -- 
  Himmel -- Buche Abfahrt bereit liegen -- führen -- schwer Weg Hand Vieh gegenseitig helfen können -- 
  stehen Sonne Mittag Buch Walde hinaus -- stehen Berg Zug Sumiswald hinaus -- finden Fuß Berge -- Schloß stehen -- Buche pflanzen -- 
  -- Unster -- 
  Mißgeschick treffen -- Geschirre zerrissen -- Wagen brechen -- Pferd Ochsen fallen weigert Gehorsam -- 
  Ärger -- 
  Not bringen Immerfort Mühe -- rastlos Arbeit keucht arm Buch -- Buch Sumiswald hinausgeschaffen -- 
  -- stoffeln schalt fluchen -- Schalt fluchen -- groß Unster -- stetiger Vieh -- 
  Ritter lachen höhnen -- freut Zappel Bauer -- Zorn Stoffeln -- 
  lachen Stoffel neu Schloß nackt Gipfel -- 
  geschworen -- Monatsfrist müssen schön Laubgang droben -- 
  fluchen -- lacht Ritter -- wein tat Bauer -- 
  -- fürchterlich Mutlosigkeit erfassen -- Wagen -- Zug unbeschädigen -- Buche Stelle bringen -- Kraft erschöpfen -- 
  -- Nacht -- schwarz Wolke steigen -- blitzen Mal -- 
  Weg Mann setzen -- gleich Beugung Wege -- sitzen -- wissen -- 
  sitzen Hornbachbaur -- Lindauerin Mann -- Knecht sitzen -- 
  Buche warten -- Sumiswald -- ungestört sinn Elend -- ruhen lassen zerschlagen Glied -- 
  -- rasch -- fast Pfiff Wind pfeifen -- Kammer entronnen -- Weib -- Korb Kopfe -- 
  Christin -- Lindauerin -- Hornbachbauer Eheweib -- kommen -- Herr Feld ziehen -- 
  Weiber froh -- daheim -- still Geschäft beschicken -- kümmern Haus Kind -- 
  Christin wissen -- Rat geben -- gehen -- meinen -- 
  -- Speise Magd sanden -- schwer Korb Kopf nehmen Mann suchen umsonst -- bitter Wort lassen fallen -- sobald finden -- 
  unterdessen müßig -- reden schaffen gleich -- 
  stellen Korb -- decken Kübel -- Hafermuß -- legen Brot Käse zurecht -- stecken Mann Knecht Löffel -- heißen zugreifen -- speislos -- 
  fragt Mann Tagewerk schaffen -- 
  Hunger Wort Mann ausgehen -- greifen Löffel Antwort -- 
  leichtfertig Knechtlein -- gleichgültig -- regne Sonnenschein Ernte -- umging Lohn -- Essenszeit essen Tisch -- greifen Löffel berichten Christine -- Buch pflanzen -- gehen Verhext sein -- 
  -- Schalt Lindauerin -- eitel Einbildung Mann Kindbetterinn -- schaffen Weinen -- hocken heulen -- Buche Bärheg bringen -- 
  widerfahren -- Ritter Mutwille ausließen -- weib Kind Wille müssen Sache Hand nehmen -- 
  plötzlich Achsel Weibe schwarz Hand gellend Stimme rufen -- -- -- -- -- 
  mitten stehen grinsend Gesicht grüne -- lustig schwankt rot Feder Hute -- 
  heben Schreck Mann dannen -- stoben Halde Spreu Wirbelwinde -- 
  -- Christine -- Lindauerin -- fliehen -- erfahren -- Teufel leibhaftig sehen kriegen -- Wand malen -- 
  bleiben stehen bannen -- müssen schauen rot Feder Barett -- rot Bärtch lustig auf niederging schwarz Gesicht -- 
  Gellend lacht grün Mann -- Christine zärtlich Gesicht fassen höflich Gebärde Hand -- 
  Christin wegziehen -- entrinnen grüne -- zisch Fleisch glühend Zange -- 
  schön Wort beginnen reden Wort zwitzert lüstern rot Bärtch -- 
  schön Weibche sehen -- -- Herz lach Leib -- zudem gerne mutig -- liebsn -- stehen bleiben dürfen -- Mann laufen -- 
  reden Christine grüne schreckhaft -- reden -- denken -- wissen laufen -- Wüstere sehen -- 
  Gedanke -- lassen -- reden wissen -- täte Gefallen -- übertölpeln Mann -- 
  wissen -- fahren grüne fort -- scheu -- Mensch -- grob -- müssen wundern -- Leute täte -- liebsn -- 
  fassen Christine Herz antworten -- 
  erschreck Leute -- schrecklich -- 
  ungetaufen Kind verlangen -- Lohn reden -- kommen Leute verdächtig -- Kind Mensch ungetaufen einer Hand geben -- Christ -- 
  -- Lohn gewohnen -- fahren -- fragen Kind -- kennen -- 
  jung liebsn weg -- Freude Mühe -- 
  jüng -- Kind erziehen Manier -- bringen -- Taufe nötig -- -- 
  Christin -- Lohne begnügen -- wachsen Gedanke -- 
  einzig betragen -- 
  -- -- 
  verdienen wollen -- müssen Lohne begnügen -- geben können -- gegenwärtig Haus ungetaufen Kind Monatsfrist geben keins -- müssen Buche liefern -- 
  schwänzelen höflich grüne -- 
  -- begehr Kind Voraus -- 
  sobald versprechen -- liefern ungetaufen -- gebären -- zufrieden -- 
  gefallen Christin -- 
  wissen -- geraum Kind geben Herr Gebiet -- 
  grün Versprechen halten Buche pflanzen -- brauchen geben -- weder Kind -- lassen Messe lesen Schutz Trutz lach tapf grüne -- dachen Christine -- 
  danken Herzhaft Anerbiet -- 
  Bedenken wollen Mann reden -- 
  -- -- -- grüne -- -- weder denken reden -- 
  bestellen -- Bescheid -- Ort bloß -- 
  mußt sagen -- nachh Handel wissen -- -- 
  Christin Sache verdrehen -- gerne -- sogar gerne zärtlich Stündigung erhalten -- grüne auflegen -- wanken -- -- -- 
  sobald Handel schließen einzig Kind -- wollen Nacht Buche Bärheg führen -- Mitternacht unten Kilchstalde lieferen -- Empfang nehmen -- 
  -- -- -- schön Frau -- bedenken -- -- grüne -- klopfen Christine holdselig Wange -- 
  klopfen Herz -- Mann hineingestoßen -- Hintendrein Schuld geben -- 
  drängen -- Mann Sündenbock -- Glaube verlassen -- listig grüne -- Einfall -- lang Nase abspeisen -- 
  Christin -- Person wollen zusagen -- Mann -- vermöchte -- sollen entgelten lassen -- 
  Versprechen -- können -- hinlänglich zufrieden -- grüne -- 
  schauderen Christine Leib Seele -- meinen -- kommen schrecklich Augenblick -- Blut Blute grün Akkord unterschreiben müssen -- 
  grüne leichtlich -- 
  hübsch Weiber begehr Unterschrift -- Kuß zufrieden -- 
  somit spitzen Mund Christinne Gesicht Christine fliehen -- wiederum bannen -- Steif starr -- 
  berührt spitzig Mund Christinne Gesicht -- spitzig Eisen Feuer Mark Bein fahren -- Leib Seele -- gelb Blitz fahren zeigen Christine freudig verzerren grüne teuflisch Gesicht -- Donner fahren -- Himmel zersprungen -- 
  -- Verschwinden grün Christine stehen versteinern -- tief Boden hinunt Fuß Wurzel treiben schrecklich Augenblick -- 
  Glied mächtig -- Gemüte brausten sau -- mächtig Wasser Flut wälze turmhoh Fels hinunt schwarz Schlund -- 
  donner Wasser Stimme hören -- Christin Gedanke bewußt Tos -- donnert Gemüte -- 
  Unwillkürlich fliehen Berg hinan -- glühend fühlt Brenn Wange -- grün Mund berühren -- Rieb -- wusch -- Brand -- 
  -- wild Nacht -- 
  lüften Klüft heuln tost -- Geist Nacht Hochzeit halten schwarz Wolke -- Winde wild Reigen spielen graus Tanze -- Blitz Hochzeitfackel sein Donner Hochzeitsegen -- 
  Jahreszeit Nacht erleben -- 
  -- finster bergesthale regt Haus drängen schirmend Obdach -- 
  treiben Gewittersturm Angst Herd Landmann Dach -- sorgsam wachend Gewitter Himmel stehen -- Wahret hüten Haus -- 
  gemeinsam Not größ Angst Gewitter -- 
  treiben Haus -- vorbeigehen müssen -- Sturm Münnebrg treiben -- -- Bärheg flüchten -- 
  Graus Nacht elend vergessend -- hören klagen groll Mißgeschick -- 
  Unglück Toben Natur kommen -- 
  Pferd Ochsen scheu -- betäuben -- Wagen zertrümmeren -- Fels stürzen -- schwer verwunden stöhnter Tiefem Schmerze -- laut schreien zerrissen Glied einziehen Zusammenband -- 
  -- elend hinein flüchtet schauerlich Angst -- grüne sehen -- erzählten Bebend wiederholt Erscheinung -- 
  Bebend hört Menge -- Mann erzählten -- drängen weit dunkel Raume Feuer -- Mann sitzen Wind Sparren fahren Donner Haus rolln -- schreien laut Menge -- meinen -- brech durch Dach grüne -- zeigen Mitte -- 
  -- Schreck verging -- alt Elend bleiben Jammer Leidenden lauter -- steigen allmählich Gedanke -- Mensch -- Not -- gerne Seele bringen -- 
  beginnen rechn Wert einzig ungetaufen Kind -- vergaßen -- Schuld Seele tausendmal schwer wieg Rettung tausend abermals tausend Menschenleben -- 
  -- Gedanke allmählich laut begann misch verständlich Wort Schmerzensgestöhn Leidenden -- 
  fragen näh grüne -- grollt -- Rede gestehen -- nehmen fürchten -- tun Mensch -- 
  Tal helfen -- Herz Ort -- 
  beginnen Mann entschuldigen -- 
  sagen -- Teufel spaßen lassen -- -- Ohr Leihe -- Kopf geben müssen -- reden grüne schrecklich Gestalt -- Flammenbarte -- feurig Feder Hute -- Schloßturm -- schrecklich Schwefelgeruch -- ertragen -- 
  Christinne Mann -- gewöhnen -- Wort Zustimmung Frau Kraft erhalten -- -- Frau fragen -- können sagen -- aushalt -- kuraschirt Weib -- wüßten -- 
  sehen Christin -- -- 
  Rettung denken -- -- Trocken sitzen -- meinen -- säßen -- 
  fallen -- Christin schrecklich Augenblick sehen -- Haus kommen -- 
  beginnen Mann jammern -- -- Christin helfen wissen -- 
  plötzlich Türe Christine stehen mitten -- Haar trieft -- rot Wang Auge brannen dunkel unheimlich Feuer -- 
  Teilnahme -- der Christine gewohnen -- empfangen -- erzählen -- denken -- Kummer -- 
  Christin -- bedeuten verbergen innerer Glut spöttisch Wort -- werfen Mann übereilt Flucht arm Weib bekümmern -- umgesehen -- grüne beginnen -- 
  brechen Sturm Neugierde -- wissen -- grüne anfangen -- Hinterst hoben -- hören Frau nah sehen -- grüne nahe gestehen -- 
  sagen -- meinen Christin -- verdienen -- Fremde übel plagen Tale -- Weiber übl Name anhängen -- Mann allenthalben Stiche lassen -- sinnn Mut -- weder Trost Ausweg -- 
  redet Christine -- werfen hart Wort Weiber -- glauben -- Bodensee groß Schloßteich -- anhalten -- hart scheinen -- stützen besondes -- -- sagen -- übel ausleg -- Sache kommen -- -- kommen übel -- lüde Schuld Verantwortung -- 
  -- Versammlung Christine Knien liegen -- bitt Fleh verwundeter laut aufschrien Anhielt -- scheinen Christin erweichen beginnen erzählen -- Stand gehalt grüne Abred treffen -- Kuß -- -- Wang brannen -- getost Gemüte -- 
  erzählen -- seither gesinnt verschlagen Gemüte -- 
  Wichtigste -- Buche Bärheg schaffen -- -- können sagen -- wollen -- Hauptsache -- -- -- Kind gebären -- 
  -- laufen kalt Rücken Erzählung -- sehen können -- wollen -- gefallen -- 
  -- jung Weibchen weinen bitterlich -- Auge Hand waschen -- sagen -- 
  alt ehrwürdig Weib -- hochgestalten Gesicht -- beugen fliehen müssen -- treten Mitte sprechen -- 
  Gottvergessen handeln -- Ungewisse Gewisse stellen spielen ewig Leben -- 
  bösen einlassen -- kommen böse nimmer -- Finger geben -- behalten Leib Seele -- 
  elend können helfen Gott -- verlass Not -- versinke Not -- 
  diesmal verachtet alt Rede schweigen heißen jung Weibche -- Wein heulen diesmal helfen -- bedürf Hilfe anderer Art -- heißen -- 
  -- rätig Sache versuchen -- 
  Bös können bösest Fall -- mal -- Mensch schlimmsen Geist betrügen -- wüßn -- fänd Priester Rat Ausweg -- 
  finsteren Gemüte denken -- bekennen -- Geld umtriebe wagen ungetauft Kind -- 
  -- Rat Christinne Sinn fassen -- wirbelwind Haus zusammenstießen -- He wild Jäger vorübersausten -- Pfosten Haus wankten -- Balken bogen -- Baum splittert Haus -- speer Ritterbrust -- 
  Blaß drinnen Mensch -- Grauen überfiel -- Rat lösen -- grauendem beginnen Ausführung -- 
  -- schön hell -- 
  Gewitter Hexenwerk verschwinden -- Äxte hieben scharf -- Boden locker Buch fallen -- Wagen brechen -- Vieh willig stark Mensch schützen Unfall -- unsichtbar Hand -- 
  sonderbar -- 
  unterhalb Sumiswald führen Weg hintern Tal -- Sumpf -- zügellos grüne bewässern -- müssen Stalden durch Dorf fahren -- Kirche vorbei -- 
  -- fahren früh Zug -- helfen Rat -- Kraft Vieh -- Sumiswald fahren -- außerhalb Dorf Kirchstalden -- Kapelle stehen -- unterhalb eben Weg Buche ablegen -- 
  sobald Stalden eben Weg Kirche kommen -- Gewicht Wagen leicht -- schwer schwer -- müssen Tier vorspannen -- -- müssen unmenschlich schlagen -- müssen Hand Speiche legen -- scheuten sanftest Ros -- Unsichtbarer Kirchhofe Weg stehen -- dumpf Glockenton -- fast verirrt Schall fern Totenglocke -- Kirche -- eigentümlich grauen stark Mann ergreifen jedesmal Mensch Tier bebten -- Kirche -- 
  vorbei -- ruhig fahren -- ruhig abladen -- ruhig frisch Ladung -- 
  -- Buche laden selbigen Tag abgeredet Stelle -- Buche folgend Bärheg pflanzen -- durch Tal Achse gehören -- umgedrehen Spule -- Fuhrleut üblich Geschrei -- Pferd Wieher -- Ochsen einförmig Gebrüll -- 
  Buche stehen -- sehen -- -- Buche -- unten Stald hinlegen -- -- 
  -- Staun Tale Neugierde regen Männiglich -- 
  absonderlich Ritter Wunder -- Pacht Bauer schließen Weise Buche Stelle schaffen -- 
  gerne heidnisch Weise Bauer Geheimnis ausgepreßen -- 
  sehen -- Bauer wüßen -- halb erschrocken -- 
  zudem wehren Stoffel -- 
  gleichgültig -- Buche Bärheg -- Gegenteil -- Buche heraufkommen -- gerne -- Bauer schonen -- 
  sehen -- Spott Ritter Unbesonnenheit verleiten -- Bauer Grund gehen -- Feld unbestellt bleiben -- Herrschaft groß Schaden -- Stoffeln -- bleiben -- 
  Erleichterung -- Bauer verschaffen -- -- gleichgültig -- Seele verschreiben -- gehen Bauer Seele -- Tod Leiber nehmen -- 
  lacht Ritter schützt Bauer Mutwille -- 
  Handel ergründen sandt Knappe Wache -- finden Morgen halb tot Gräben -- wohin unsichtbar Hand schleudern -- 
  -- ziehen Ritter Bärheg -- kühn Deg -- Wagnis bestehen Heidenland -- bestehen -- 
  finden erstarren Boden -- Rede mächtig -- sagen -- rot Ritter feurig Lanze niedergerannen -- 
  neugierig Weibsseel enthalten -- Mitternacht -- Spalte Lucke Weg Tal sehen -- 
  Alsbald wehten giftig Wind -- Gesicht schwellen -- Woche weder Nase Auge sehen -- Mund Mühe finden -- 
  verging Leute Spähen -- Auge Tale -- Mitternacht liegen -- 
  -- plötzlich Mann sterben -- bedürfen letzter Trost -- Priester holen -- Mitternacht nahe Weg führen Kilchstalde vorbei -- 
  laufen unschuldig Bübch -- Gott Mensch leiben -- Angst Vater ungeheißen Sumiswald -- 
  Kilchstalde -- Buche auffahr Boden -- feurig Eichhörnch ziehen nebenbei reit schwarz Bock grün Mann -- feurig Geißel Hand -- feurig Bart Gesicht -- Hute schwanken Glutrot Feder -- 
  Zug gefahr Lüfte Egg weg -- schnell Augenblick -- 
  Knabe -- -- 
  -- Woche vergehen -- Stunde neunzig Buche Bärheg -- machen schön Schattengang -- schlagen üppig -- einzig Verdorrt -- 
  Ritter Stoffel erging -- wehten allemal heimlich Grauen -- Sache wissen -- -- trösten -- fehl -- tragen Schuld -- 
  -- Bauer wohlet Buch -- -- Buch wachsen Hoffnung -- Herr genügen -- grüne betrügen -- Unterpfand -- Hunderteste -- fragen grüne -- 
  indessen Sache sicher -- fürchten -- spielen Schabernack lassen Stiche -- 
  Urbanustage bringen letzter Buche Kilchstalde alt Jung schlief selber Nacht -- fast glauben -- Umstand Kind Pfand Arbeit vollenden -- 
  -- folgend -- Sonne -- Alt Jung Bein -- regen gleich neugierig Angst -- wagen Platz -- Buche liegen -- wissen -- liegen Beize -- -- grüne betragen -- 
  -- wild Küherbub -- Zieg Alp bringen -- wagen -- springen voran finden Buche -- Hinterlist Platz kund -- 
  trauen Spiel -- vorauf müssen Küherbub Bärheg -- 
  Ordnung -- hundert Buche stehen Reih Glied -- verdorren -- laufen Gesicht -- Glied weh -- 
  steigen Jubel Herz Spott grün Ritter fließen -- 
  mal sandt wild Küherbub lassen Stoffel sagen -- 
  Bärheg Ordnung -- Buche zählen -- 
  gräulich lassen sagen -- -- heimkämen -- 
  gerne sagen lassen -- Schattengang wegschaffen -- -- Ritter -- heißen -- fürchten -- wissen Bauer Pacht Handel mischen -- 
  -- Kühersbub Bescheid bringen -- schwoll Herz trotzig -- wild Jugend tanzt Schattengang -- wild Jodel halln Kluft Kluft -- Berg Berg -- hallter Mauer Schlosses Sumiswald -- 
  bedächtig alte warnen bat -- trotzig Herz bedächtig alt Warnung -- Unglück -- alt Zag Warne herbeigezogen -- 
  -- erkennen -- Trotz Unglück Boden stampfen -- 
  Jubel ziehen Berg Tal Häuser -- Finger Fleisch rauche hing -- kochen -- Hand Butter Hafen -- kücheln -- 
  -- Fleisch gegessen -- Küchle schwand -- verronnen -- anderer steigen Himmel -- 
  nah -- Weib Kind gebären -- nah -- dringlich Angst -- grüne künden -- fordern gehören -- Beize legen -- 
  -- Jammer jung Weibe -- Kind gebären -- ermessen -- 
  Haus tönen -- ergriff Glied Haus -- Rat wissen -- -- -- einlassen -- trauen -- 
  nah verhängnisvoll Stunde -- nah drängen arm Weibch Gott -- umklammert arme -- Leib Seele ganz Gemüte heilig Mutter bittend Schutz gebenedeien Sohn Wille -- 
  klar -- Leben sterben Not groß Trost Gott -- -- dürfen böse -- -- 
  -- deutlich treten Glaube Seele -- Priester Herr Allerheiligst -- heilig Leib Erlöser Geburt zugegen -- bewaffnet kräftig Bannsprüche -- dürfen bös Geist nahen -- alsobald Priester neugeboren Kind Sakramente Taufe versehen -- damalig Sitt erlauben -- arm Kind Gefahr entrissen -- Vermessenheit Vater bringen -- 
  Glaube steigen -- Jammer jung Weiber Herz -- scheut -- Priester Pacht Satan bekennen -- seither Beicht gehen -- Rede gestehen -- 
  fromm Mann -- Ritter Schlosses treiben Kurzweil -- Wahrheit -- 
  Sache tun -- können hindern -- Bauer denken -- -- berichten -- Gewissen -- 
  -- drang Weibe Jammer Herzen -- laufen offenbart Priester Handel arm Weibe Wunsch -- 
  Gewaltig entsetzt fromm Mann -- leer Wort verlieren -- kühn treten arm Seele Kampf gewaltig Widersacher -- 
  -- hart Kampf scheuen -- krönen Krone ewig Leben wissen -- krönen -- Kampf -- 
  -- ums Haus -- Weib Stunde harren -- ziehen heilig Bann geweiht Wasser -- böse Geist überschreiten -- segnet Schwelle -- Stube ruhig gebar Weib -- ungestört tauft Priester Kind -- 
  Ruhig bleiben draußen -- klar Himmel flimmern hell Stern -- leis Lüfte spielen Bäum -- 
  wiehernd Gelächter gehören ferne -- meinen -- Käuzlein Wald Saum -- 
  -- -- freuen höchlich -- Angst verschwinden -- meinen -- grüne angeführen -- können gleichen -- 
  -- mal zugerichten -- Gast entboten -- 
  Umsonst mahnen Priester Herr Schmaus Jubel -- mahnen Zag beten -- Feind besiegen -- Gott sühnen -- 
  Geist -- dürfen Buße Sühnung auferlegen -- nah Buße gewaltig schwer Gott selbsteigen Hand -- 
  hören -- befriedigen Speise Trank -- 
  betrüben Weg -- bitten -- wüßten -- tun -- rüstet Bete Faste kämpfen getreu Hirte anvertraut Herde -- 
  -- mitten Jubelerenden Christine sitzen -- sonderbar still glühend Wang -- düstern Auge -- seltsam zuck Gesicht -- 
  Christine Geburt zugegen erfahren Wehmutter -- plötzlich Taufe Gevatter stehen frech Herz Furcht -- Priester Wasser sprengen Kind taufen hoch Name -- -- drucken plötzlich feurig Eisen Stelle -- grüne Kuß empfangen -- 
  jäh Schrecken zucken -- Kind fast Erde fallen seither Schmerz abnehmen -- glühend Stunde Stunde -- 
  Anfangs still gesessen -- Schmerz erdrücken heimlich schwer Gedanke gewälzt erwacht Seele -- häufig fahren Hand brennend Fleck -- giftig Wespe sitzen scheinen -- glühend Stachel bohr Mark hinein -- 
  Wespe verjagen -- Stiche heiß -- Gedanke schrecklich -- beginnen Christin Wange zeigen -- fragen -- sehen -- Neuem fragt Christin -- -- späh Wang Lust kürzen -- 
  alt Weib erbitten -- kräht Hahn -- graut -- alt Christinne Wange fast unsichtbar Fleck -- 
  -- alt -- vergehen -- -- 
  -- Christine tröst -- vergehen -- Pein unmerklich wachsen Punkt sehen fragen -- schwarzes geb Gesicht -- 
  denken -- Rede fahren Stiche Herz -- wecken schwer Gedanke -- müssen denken -- gleich Fleck grüne küßen -- gleich Glut -- Blitz Gebein fahren -- bleibend brennen Zehre -- 
  weichen Schlaf -- Essen schmeckt Feuerbrand -- unsten laufen hierhin -- dorthin -- suchen Trost finden -- Schmerz wachsen -- schwarz Punkt groß schwärz -- einzeln dunkel Streife laufen -- Mund scheinen rund Fleck Höcker pflanzen -- 
  -- litt laufen Christin lang Nacht -- Mensch Angst Herzen offenbaren -- grün Stelle erhalten -- wissen -- Weise Pein -- Himmel Erde opfern -- 
  Natur vermess Weib -- erwilden wütendem Schmerze -- 
  -- geschehen -- wiederum Weib Kind erwarten -- 
  diesmal Angst -- Leute wohlgemut -- sobald Priester sorgen -- meinen -- grüne spotten -- 
  Christin -- 
  näh Geburt -- desto schrecklich Brand Wange -- desto mächtig dehnt schwarz Punkt -- deutlich Bein strecken -- kurz Haar treiben empor -- glänzend Punkt Streifen erscheinen Rücken -- Kopfe Höcker -- glänzend giftig blitzt -- Auge hervor -- 
  laut schri -- giftig Kreuzspinn sehen Christines Gesicht -- voll Angst Grauen fliehen -- sehen -- fest sitzen Gesicht herausgewachsen -- 
  Allerlei reden Leute -- raten -- anderer -- Christine gönnen -- -- wichen -- fliehen -- -- 
  Leute fliehen -- desto treiben Christine -- fahren Haus Haus -- fühlt Teufel mahnen verheißen Kind -- Opfer Leute einzured unumwunden Wort -- fahren Höllenangst -- 
  kümmern -- Christine peinigen -- weh -- litt -- -- Meinung -- verschuldet -- entrinn -- sagen -- 
  -- sehen -- 
  Kind verheißen -- einer -- -- 
  wütend Rede setzen Manne -- 
  fliehen -- fliehen -- sprechen Christine kaltblütig -- gut -- Malzeich -- -- auswachsen -- hören Schmerz abzubinden -- 
  -- unterdessen hören Schmerz -- jeder Bein Höllenbrand -- Spinne Leib Hölle -- Weibe erwartet Stunde -- Christine umwall Feuermeer -- wühlt feurig Messer Mark -- fahren feurig Wirbelwind Gehirn -- 
  Spinne schwellen -- bäumt -- kurz Borst hervor quoll giftig Auge -- 
  Christin glühend Pein nirgends Teilnahme -- Kreisende bewachen finden -- stürzen Wirbelsinnig Weg entlang -- Priester müssen -- 
  -- Raschen Schritt Halde entlang -- begleiten handfest Sigrist -- heiß Sonne steil Weg hemmen Schritt -- gelten Seele retten -- unendlich Unglück wenden -- entfernt kranke kommend -- bangt Priester schrecklich Säumnis -- 
  Verzweifelnd werfen Christine Weg -- umfaßt Knie -- bitten Lösung Hölle -- Opfer Kind -- Leben kennen -- Spinne schwellen hoch -- funkeln schrecklich schwarz Christin rot angelaufen Gesicht gräßlich Blick glotzt Priester heilig Gerät Zeichen -- 
  schieben Christine rasch Seite -- schlagen heilig Zeichen -- Feind -- lassen Kampf -- Seele retten -- 
  Christine fahren -- stürmen versuchen Äußerste -- Siegristen stark Hand halten wütend Weib Priester Haus schützen -- geweiht Hand Kind empfangen Hand legen -- Hölle überwältigen -- 
  draußen unterdessen Christin schrecklich Kampf kämpfen -- 
  Kind ungetaufen Hand -- hinein Haus -- stark Mann wehrn -- 
  -- Windstöße stieß Haus -- fahl Blitz umzüngelten -- Hand Herr -- Kind taufen Christin umkrei vergeblich machtlos Haus -- 
  wilderer Höllenqual ergriffen stoßen Ton -- Tön glich Menschenbrust -- Vieh schlotteren ställen reißen Strick -- eich Walde rauschen -- entsetzend -- 
  -- Haus beginnen Jubel Sieg -- grüne Ohnmacht -- Helfershelferin vergeblich Ringen -- draußen liegen Christine entsetzlich Pein Boden werfen -- feurig Gesicht beginnen Wehe kreisen -- Wöchnerin erfahren Erde -- Spinne Gesichte schwellen hoch brannt glühend Gebein -- 
  -- Christin -- plötzlich Gesicht platz -- glühend Kohle gebären -- lebendig -- gramselt Gesicht weg -- Glied weg -- lebendig glühend gramsle Leib weg -- 
  Blitz fahl Schein langbeinig giftig -- unzählbar schwarz Spinne laufen Glied -- hinaus Nacht -- entschwunden laufen langbeinig giftig -- unzählbar -- 
  früh Folge -- Brand Gesicht legen -- Spinne lassen nieder -- fast unsichtbar Punkt -- schaut erlöschend Auge Höllenbrut -- gebären -- ausgesandt -- Zeichen -- grüne spaßen lassen -- 
  -- Matt -- Wöchnerin -- schlich Christin Haus -- Glut heiß brannt Gesicht -- Glut Herzen abnehmen -- matt Glied Ruhe sehnten -- grüne lassen Ruhe -- -- -- 
  -- Drinnen Haus jubeln freuen -- hören -- Vieh brüllt tobt Stalle -- 
  fahren -- nachzuseh -- Schreckensblaß kommen -- gehen -- bringen Kunde -- schön Kuh liegen tot -- Übrig toben wütet -- sehen -- 
  -- Absonderliches walen -- 
  verstummt Jubel -- laufen Vieh -- Gebrüll erscholl Berg Tal -- Rat -- 
  Zauber versuchen weltlich geistlich Kunst -- umsonst -- -- graut -- Tod sämtlicher Vieh Stalle strecken -- 
  Stumm -- beginnen brüllen brüllen -- -- hören ställ Not brechen -- wehelich Vieh Meister Hilfe rufen grausen Angst -- 
  -- Flamm dach schlüge eilen heim -- Hilfe bringen -- strecken Tod Vieh -- wehgeschrei Mensch Tier erfüllen Berg Tal -- Sonne -- Tal fröhlich verlassen -- entsetzlich Jammer hinein -- 
  Sonne scheinen -- sehen Mensch -- Ställe -- Vieh fallen -- wimmle zahllos schwarz Spinn -- 
  kroch Vieh -- Futter -- berühren -- vergiften -- lebendig -- beginnen toben -- Tod strecken -- 
  spinn Stall -- -- säubern -- wüchsen Boden herauf -- Stall -- -- behüten -- unversehens kroch Wand -- fallen Haufenweise Diele -- 
  treiben Vieh Weide -- treiben Tod Rachen -- 
  Kuh Weide Fuß setzen -- beginnen lebendig Boden -- schwarz Spin sproßten -- schrecklich Alpenblume -- kroch Vieh -- fürchterlich wehelich Geschrei erschallen Berg nieder Tale -- 
  Spinne sehen Spinne Christinne Gesicht ähnlich Kind Mutter -- sehen -- 
  -- geschrei arm Tier Schlos dringen -- kommen Hirt -- verkündend -- Vieh gefall giftig Tier -- höherem zorne vernehmen Stoffel -- Herde Herde verlieren gehen -- vernehmen -- Pacht grüne -- zweitenmal betrog Spinne ähnlich Kind Mutter -- Spinne Lindauerin Gesicht -- grün Bund alleine -- Bericht geben -- 
  riten Stoffel grimmem Zorn Berg hinauf donnert arme -- ihretwill Herde Herde verlieren wollen -- schädigen -- müssen ersetzen -- versprechen -- müssen halten -- freiwillig tun -- müssen tragen -- 
  Schaden leiden ihretwegen wollen -- leiden -- müssen büßen tausendfältig -- 
  können vorsehen -- 
  redet -- unbekümmert -- zumuten -- treiben -- fallen -- tun -- rechnen -- 
  -- meisten aufgedämmeren -- Spinnen Plage bösen -- Mahnung -- Pacht halten -- Christine Näheres wissen müssen -- -- grüne verhandeln -- 
  zittert grüne -- lachen -- zittert weltlich Herr -- befriedigt -- geistlich Herr -- erlauben -- Buße -- 
  Angst versammelt Angesehenst einsam Scheuer -- Christine müssen klar Bescheid geben -- eigentlich verhandeln -- 
  -- Christine verwildern -- rachedurstig -- auf wachsend Spinne foltern -- 
  -- Zag Mann Weiber -- erzählt Punktum -- begegnen -- grüne schnell Wort nehmen Pfande Kuß geben -- achten -- 
  selbig Fleck Spinne wachsen Höllenpein Augenblick -- Kind taufen -- 
  Spinne -- Kind taufen grüne narren -- Höllenpein Spin gebären ungemessen Zahl -- narren lassen ungestraft -- fühlen tausendfach Todesschmerze -- 
  wachsen Spinne -- Pein mehrere -- nächster Kind grüne -- wissen -- gräßlich einbrechend Plage -- gräßlich Ritter Rache -- 
  -- erzählt Christine Herzen Mann bebten -- reden -- 
  kommen angstgepreßt Kehle abgebrochen Laute hervor -- zusammensetzen -- meinen Christin meinen -- einzeln Einwilligung geben Rat -- 
  stehen redet deutlich -- gute schiene -- Christine tot schlagen -- tot -- grün tote halten -- Handhabe Lebendig -- 
  lacht Christin wild -- treten Gesicht -- 
  sollen zuschlagen -- -- grüne wollen -- ungetaufen Kind -- zeichnen -- können Hand zeichnen -- vergreifen -- 
  zucken Mann Hand -- reden -- setzen hören schweigend Rate -- 
  abbrechen -- -- -- bedeuten -- überein -- nächster Kind opfern -- Hand bieten -- Kind Kilchstalde tragen -- Buche hinlegen -- 
  -- meinen -- Teufel brauchen -- scheuen -- persönlich Bekanntschaft begehrn -- 
  erbieten Christine willig -- Teufel -- Mal schaden -- 
  wissen -- nächster Kind gebären -- redet Vater zugegen -- 
  -- Verständigt Wort -- auseinander -- 
  -- jung Weib -- grauenvoll Nacht -- Christine Bericht grüne bringen -- zagen weinen -- wissen -- erwartet nächster Kind -- 
  früh Vorgang machen getrost zuversichtlich -- unnennbar Angst liegen Herz -- weder Bete Beichte wegbrehen -- 
  verdächtig schweigen scheinen -- umringen -- sprechen Spinne -- verdächtig scheinen Auge -- ruhen -- scheinen berechnen Stunde -- Kindes habhaft -- Teufel versöhnen können -- 
  -- einsam verlassen fühlt unheimlich -- Beistand Schwiegermutter -- fromm Frau -- stehen -- vermögen alt Frau wild Menge -- 
  Mann -- versprechen -- jammert Vieh gedacht arm Weibe Angst -- 
  Priester verheißen -- -- schnell früh verlangen -- begegnen Augenblick -- gesandt -- -- arm Weib zuverlässiger Boten Mann -- Schutz Wache -- wohnen Christine Haus Mann Bruder verwandte -- waise Haus kommen -- 
  arm Weibe Herzensangst denken -- Bete fromm Mutter finden Vertrauen -- alsobald Schwand -- sobald böse Auge -- 
  -- unterdessen Krankheit -- unterhielt Schrecken -- 
  freilich hie fallen Stück -- selten zeigt Spinne -- 
  sobald Schreck nachlassen -- sobald denken -- übel lassen Bedenken -- ehe Kind versündig -- Christinne Höllenpein -- Spinne blähte -- denken reden -- kehren neu Wut Tod Herde -- 
  nah erwartet Stunde -- scheinen Not zuzunehmen -- erkannt -- bestimmt Abred treffen müssen -- Kinde sicher sond Fehl bemächtigen können -- 
  Mann fürchten meisten -- Gewalt brauchen -- Zuwider -- 
  übernehmen Christin gewinnen -- gewinnen -- 
  Sache wissen -- weib Wille -- Priester holen -- eilen -- Abwesenheit vorgehen -- wollen fragen -- finden Gewissen -- Gott Messe abfinden -- arm Kind Seele -- denken -- gewinn fromm Priester Teufel -- Handel -- tun böser prellen -- 
  denken Mann -- jedenfalls -- mögen -- wollen -- Sache Schuld -- sobald Hand tätig -- 
  -- arm Weibche verkaufen -- wissen -- hoffen Bangen Rettung -- beschließen Rate Mensch Stoß Herz -- droben beschließen -- deckt Wolke -- Zukunft liegen -- 
  -- gewitterhaft Ernte kommen -- Kraft angespannen -- heiter Stunde Korn sicher Dach bringen -- 
  heiß Nachmittag -- schwarz Häupt streckt Wolke dunkel Berg empor -- ängstlich um Dach flattert Schwalben -- arm Weibche eng bingen Haus -- Großmutter draußen Acker helfen Wille -- 
  zuckt Zweischneidende Schmerz Mark Bein -- dunkelt Auge -- fühlen nah Stunde -- -- 
  Angst treiben Haus -- schwerfällig schriten Acker -- müssen niedersetzen -- fern Stimme schicken -- beklemmt Brust -- 
  klein Bübch -- Beinchen brauchen lernen -- Bein Acker -- Mutter Arm -- 
  Bübch müssen arm Weib Boten brauchen -- wissen -- Acker finden -- Beinchen tragen -- 
  treu Bübch -- Angst Mutter -- laufen fallen stehen -- Katze jagt Kaninchen -- Taube Hühner laufen Fuß -- stoßend spielend springen Lamm -- Bübchen -- lassen säumen richten treulich Botschaft -- 
  -- Atemlos erscheinen Großmutter -- Mann säumen -- Fuder sollen ausladen -- heißen -- 
  Ewigkeit verstreichen -- -- wiederum verstreichen Ewigkeit -- langsam lang Weg -- Todesangst fühlen arm Weib -- Stunde schnell schnell nahen -- 
  -- frohlockend Christine draußen Acker zusehen -- 
  Heiß brannt Sonne schwer Arbeit -- Spinne brennen fast scheinen Gang nächster Stunde -- 
  treiben fröhlich Arbeit eilt Heimgehen -- wissen -- langsam Bote -- 
  letzter Garbe laden -- Windstöße nahe Gewitter verkünden -- eilt Christine Beute -- sichern -- meinen -- 
  Heimging -- winken bedeutungsvoll Begegnende -- Nickt -- tragen rasch Botschaft heim -- schlottert Knie Seele beten unwillkürlich Angst -- -- 
  -- Drinn Stübchen wimmeren arm Weib Ewigkeit Minute -- Großmutter vermögen Jammer still -- Bete Tröst -- 
  stübch verschlossen schwer Gerät Türe stellen -- 
  Haus -- -- Christin heimkommen sehen -- schleichend Tritte Türe hören -- draußen manch Tritt hören heimlich Flüstern -- Priester zeigen -- anderer treu Mensch -- näh nah ersehnt Augenblick treten -- denken -- Angst arm Weiber schwimmen -- siedender Öl -- Hilfe Hoffnung -- 
  hören -- Christine Türe wich -- fühlt arm Weib wild Schwägerin feurig Auge Türe hindurch -- brannen Leib Seele -- 
  wimmeren Lebenszeichen Kind Türe -- unterdrücken schnell -- spät -- 
  Türe fliegen wütendem vorbereitet Stoß -- Raub Tiger stürzen -- stürzen Christine arm Wöchnerin -- 
  alt Frau -- Sturm entgegenwirfen -- fallen nieder -- heilig Mutterangst raffen Wöchnerin -- schwach Leib brechen -- Christinne händ Kind -- gräßlich Schrei brechen Herz Mutter -- hüllen schwarz Schatten Ohnmacht -- 
  -- Zag Grauen ergriff Mann -- Christin geraubt Kind heraus -- 
  Ahn grausen Zukunft -- Mut -- hemmen -- Furcht Teufel Plage stark -- Furcht Gott -- 
  Christine zagen -- glühend leuchtet Gesicht -- Sieger leuchten überstanden Kampfe -- -- Spinn sanft Jucke liebkosen -- Blitz -- Weg Kilchstalde umzüngeln -- scheinen fröhlich Licht -- donner zärtlich Grollen -- lieblich Säusel racheschnaubend Sturm -- 
  -- Hans -- arm Weibe Mann -- Versprechen halten -- 
  langsam Weg gehen -- bedächtig Acker beschauen -- Vogel nachgesehen -- Fisch Bach abgewarten -- sprang Mück fangen eintretenden Gewitter -- 
  jucken vorwärts -- rasch Schritt -- Ansatz Springen -- -- jagen -- Haar kopfe emportreiben -- Gewissen -- -- Vater verdienen -- Weib Kind verraten -- Liebe -- Weibe Leibesfrucht -- 
  halten anderer -- stark -- Furcht Mensch -- Furcht Teufel Liebe -- nehmen -- 
  langsam -- langsam Mensch -- letzter Gang tun -- Richtstätt -- 
  -- wissen Mensch -- letzter Gang tun -- wissen -- täten -- -- 
  -- spät -- ehe Sumiswald -- 
  schwarz Wolke jagen Minneberg -- schwer Tropfen fallen -- versengt Staube -- dumpf beginnen Glöcklein turm Mensch mahnen -- denken möchten Gott bitten -- Gewitter Gericht lassen -- 
  Haus stehen Priester -- jeglicher Gang rüsten -- bereit -- Herr -- Haupt fahren -- Sterbende brennend Haus wohin rufen -- 
  Hans -- erkennen Ruf schwer Gange -- schürzt Gewand sandte Botschaft läutend Sigrist -- ablösen lassen Glockenstrang einfind Begleitung -- 
  unterdessen stellen Hans Labetrunk -- wohltätig rasch Lauf schwül Luft -- Hans bedürftig -- Priester ahndet Tücke Mensch -- 
  Bedächtig laben Hans -- 
  Zögernd finden Sigrist -- gerne Tranke -- Hans bieten -- 
  Gerüstet stehen Priester -- verschmähend Trank -- Gang Kampf bedürfen -- 
  heißen ungern Kanne weggehen -- aufstellen -- ungern verletzt Gast -- kennen -- höh Gastrecht -- säumig trinken fahren zornig Glied -- 
  -- fertig -- endig -- bekümmern Weib harren -- grauenvoll Untat -- Weib Untat müssen stehen heilig Waffe -- säumen -- -- droben -- -- durst unten löschen -- 
  sprechen Hans -- harrend Weibe Mann -- eil -- Weibe gehen Sache schwer -- 
  alsobald flammen Blitz Stube -- blenden -- donner brechen über Haus -- Pfoster Haus -- jeder Glied Haus beben -- 
  sprechen Sigrist -- Segenspruch vollenden -- 
  hören draußen -- Himmel bestätigen -- Hans -- warten -- nützen -- gehen -- lebendig kommen Nimmer hinauf -- -- Weibe Eile -- 
  stürmt Gewitter -- Menschengedenken erleben -- 
  schlünd Grund stürmen heran -- stürmt Seite -- Winde treiben Sumiswald -- Wolke Kriegesheer Wolke stürmen -- Wolke Leben -- Wolkenschlacht beginnen Gewitter stehen -- Blitz Blitz entbinden -- Blitz Blitz schlagen Erde nieder -- Durchgang bahn Erde Mitte Erde Seite -- 
  Unterlaß brüllen Donner -- zornesvoll heuln Sturm -- geborsen Wolke Schoß -- Flut stürzen nieder -- Gefährte zauderen -- 
  plötzlich gewaltig Wolkenschlacht losbrach -- Priester Siegristen antworten -- niedergesetzen -- immersteigend bangen ergreifen -- Drang -- hinauszustürzen Element Tobe -- hören Donner schrecklich Stimme Weibe markdurchschneidend Wehruf -- donner plötzlich Gott schrecklich Scheltwort Säumnis -- -- sagen -- 
  Schritt -- fassen -- hinaus feurig Wetter -- Sturme Wut -- Wolke Flut -- langsam -- unwillig kommen -- 
  -- sau brau toster -- Ton zusammenschmelzen letzter Posaune -- Welt Untergang verkünden -- feurig Garb fallen Dorf -- Hütte aufflammen -- Diener -- Donner Stimme Blitz Knecht -- Mitknecht gleich Herr fürchten -- Gott -- getrost Gott Wettern überlassen -- 
  Schritt Priester unerschrocken Wetter Kilchstalde -- 
  gleich Mute folgen -- gleich Ort Herz -- Kilchstalde -- Wetter -- Nacht -- Hans besonderer Grund -- -- 
  bat Priester umkehren -- -- Hans wissen näh -- Sigrist gut -- warnen Wasser Tale -- aufgeschwollen grüne -- 
  Priester hören -- achtet Rede -- wunderbar Drange treiben -- eilt Flügel Gebet kilchstalden -- Fuß stoßen Stein -- Auge Blitz blenden -- bebend -- decken -- meinen -- Heiligst -- Priester tragen -- folgen Hans Sigrist -- 
  -- hinaus kommen Dorf -- Tal hinunt Stald senken -- stehen Priester plötzlich still schirmen Hand Auge -- 
  unterhalb Kapelle schimmeren Blitz Schein rot Feder -- Priester scharf Auge sehen grün Haage hervorragen schwarz Haupt -- schwanken rot Feder -- 
  lang schauen -- sehen jenseitig Abhange schnellst Lauf -- jagen Wind wildest Stoß -- fliegen wild Gestalt dunkel Haupt -- Fahne rot Feder schwanken -- 
  -- lodert Priester heilig Kampfesdrang -- -- böse ahnend -- -- Gott geweiht Herzens -- Trieb Samenkorn -- Leben dringen -- Blume dringen -- entfalten -- Held -- Feind Schwert erheben -- 
  Lechzende Strome kühl Flut -- Held Schlacht -- stürzen Priester Stalden nieder -- stürzen kühnst Kampf -- drang grün Christine -- Kindlein Arm legen -- mitten hinein -- schmettern hoch heilig Name -- halten Heiligst grüne an Gesicht -- sprengen heilig Wasser Kind treffen Christine -- 
  fahren fürchterlich Wehegeheul grüne dannen -- Glutroter Streifen zucken -- Erde verschlingen -- geweiht Wasser berühren -- schrumpfen entsetzlich Zischen Christine -- Wolle Feuer -- Kalk Wasser -- schrumpfen zischend -- Flamme sprühend -- schwarz -- hochaufgeschwollen -- grauenvoll Spinne Gesichte -- schrumpfen -- Zischt hinein -- sitzen giftstrotzend trotzig mitt Kind -- sprühen Auge zornig Blick Priester entgegen -- 
  sprengen Weihwasser entgegen -- zischen heiß Stein gewöhnlich Wasser -- größ Spinne -- strecken schwarz Bein Kind -- glotzen giftig Priester -- fassen feurig Glaubenswut kühn Hand -- 
  griff glühend Stachel hinein -- unerschütteren greifen fest -- schleudern Ungeziefer weg -- fassen Kind -- eilen sond Weile Mutter -- 
  -- Kampf -- stillt Kampf Wolke -- eilten dunkel Kammer -- flimmert still Sternenlicht Tal -- vorher wilde Schlacht toben -- fast atemlos ereilt Priester Haus -- Mutter Kind Freveltat begehen -- 
  -- Mutter ohnmächtig -- gellend Schrei Leben fortgesenden -- sitzen betend alt -- bauen Gott -- mächtig Teufel böse -- 
  Kind bringen Priester Mutter Leben -- 
  erwachend Kindlein -- durchfloß Wonne -- Engel Himmel kennen -- Mutter arme taufen Priester Kind Name Gott Vater -- Sohn heilig Geist -- entreissen Teufel Gewalt -- freiwillig übergeben -- 
  hüten Gott -- Gewalt Seele übergeben -- Leib Spinne vergiften bleiben -- 
  -- schied Seele -- Brandflecko Leibchen zeichnen -- 
  arm Mutter weinen -- -- gehöret -- Gott Seele -- Erde Leib -- finden Trost -- -- -- 
  -- sobald Priester heilig Amt verrichten -- beginnen seltsam Jucke fühlen Hand Arm -- womit Spinne weggeschleuderen -- 
  schwarz Flecken Hand -- sichtbarlich groß schwollen -- Todesschauer rieselen durch Herz -- 
  segnen Weiber eilen Heim -- heilig Waffe getreu Streiter bringen -- gehören -- Hand -- 
  schwellen Arm -- schwarz Beule quollen hoch -- kämpfen Tod Mattigkeit -- erliegen -- 
  -- Kilchstalde -- Hans -- gottvergeßen Vater -- wissen bleiben -- mitten Weg Rücken liegen -- 
  Hochgeschwollen brandschwarz Gesicht -- mitten sitzen schwarz grausig Spinne -- 
  Pfarrer -- blähte -- giftig bäumt Haar Rücken -- giftig sprühend glotzt Auge -- Katze -- rüsten sprung Todfeinde Gesicht -- 
  beginnen Priester gut Spruch heben heilig Waffe Spinne schrak -- kroch langbeinig schwarz Gesicht -- verlieren zischend Grase -- 
  Pfarrer vollends heim -- stellen Allerheiligste Ort -- wild Schmerz Leib Tod rissen -- harren süß Frieden Seele Gott -- streiten kühn gotteskampfe -- lassen Gott harren -- 
  -- solch süß Friede -- still Herr Harret -- hinten Tale -- Berg -- 
  -- Augenblick -- Christin geraubt Kind Berg hinunt gefahr Teufel -- Heilloser Schreck Herzen fahren -- 
  fürchterlich Ungewitter bebten Mensch Schrecken Tod -- Herz wissen -- Gott Hand vernichtend kommen -- wohlverdient -- 
  Gewitter vorüber -- laufen Kunde Haus Haus -- Pfarrer Kindlein zurückgebracht taufen -- Hans -- Christine sehen -- 
  -- grauend finden lauter bleich Gesicht -- schön Sonne färben -- wissen -- Schreckliche -- 
  hören -- schwarz Beule Pfarrer sterben -- finden Hans schrecklich Gesicht -- gräßlich Spinne -- Christine verwandeln -- hören seltsam verwirrt Wort -- 
  -- schön Erntetag -- Hand rührt Arbeit -- Leute laufen -- pflegen -- Unglück begegnen -- 
  fühlen bebend Seele heißen -- irdisch Not Plage unsterblich Seele loskaufen -- fühlen -- Gott Himmel -- Unrecht -- arm Kind -- wehren -- antun -- fürchterlich räch -- 
  Stunde bebend -- jammern -- -- heim -- Zank Streit -- Schuld -- abgemahnt warnen -- dawider -- Strafe Schuldigen treffen -- Haus Strafe -- 
  schrecklich Harren Streit neu unschuldig Opfer wissen -- -- freveln -- Hoffnung -- retten -- 
  -- schreien mitten Haufen entsetzlich -- -- glühend Dorn treten -- Nagle glühend Nagel Fuß Boden -- ström Feuer Mark Gebein -- 
  haufen fahren auseinander -- Auge sehen Fuß -- Hand Schreiende fahren -- 
  Fuße sitzen schwarz Spinne glotzen giftig schadenfroh Runde -- 
  starren Blut Ader -- Atem Brust -- Blick Auge -- ruhig schadenfroh glotzt Spinne umh -- Fuß schwarz Leib war_es -- Kampf zischend wütend Feuer Wasser -- Angst sprengen Fessel Schrecken -- Haufen stob auseinander -- 
  wunderbar Schnelle Spinne Sitz verlassen -- kroch Fuß Ferse -- Glut fahren Leib gräßlich Geschrei jagt Fliehende heftig -- 
  Windeseil -- Todesschrecke -- gespenstig Wild wild Jagd -- stoben Hütte -- meinen Spinne -- verrammelt Türe -- hören beben unsäglich Angst -- 
  -- Spinne verschwinden -- neu Todesgeschrei hören -- Leute müssen verrammelt Haus verlassen -- müssen Speis suchen für Vieh -- tun Todesangst -- 
  Spinne -- unversehens Fuß setzen -- 
  vorsichtigst niedertrat Auge schärfsen spähen -- Spinn plötzlich sitzend Hand Fuß -- laufen über Gesicht -- sitzen schwarz Nase -- glotzen Auge -- feurig Stachel wühlt Gebein -- Brand Hölle schlagen -- Tod strecken -- 
  -- Spinne nirgends -- -- -- Tale unten -- Berg -- zischt durch Gras -- fallen Decke -- taucht Boden -- 
  hell Mittage -- Leute Habermuß sitzen -- erscheinen glotzend unten Tisch -- ehe Mensch Schrecken auseinander sprengen -- Hand laufen -- sitzen Tisch Hausvater Haupt -- glotzen Tisch -- schwarz werdend Hand weg -- 
  fallen nachts Leute Gesicht -- begegnet Walde -- suchen heim Stalle -- 
  Mensch meiden -- nirgends allenthalben -- Wachen schützen -- schlafend sicher -- 
  Sicherst wähnn unterem frei Himmel -- Baume Gipfel -- kroch Feuer Rücken -- Spinne feurig Fuß fühlen Nack -- glotzen Achsel -- 
  Kind Wiege -- Greis Sterbebette schonen -- Sterbet -- wissen -- sterben schrecklich -- erfahren -- schrecklich Sterbe namenlos Angst Spinne -- allenthalben nirgends -- -- Sichersten wähnen -- totbringend plötzlich Auge glotzen -- 
  -- Kunde Schrecken alsobald Schloß dringen -- dorthin Schreck Streit bringen -- Regel Orden stattfinden -- 
  Stoffel bange -- heimsuchen möchten -- Vieh -- verstorben Priester äußern -- Seele aufrühren -- 
  manchmal -- Leid -- Bauer Andy -- fahren -- glauben -- meinen -- Gott Unterschied wissen Ritter Bauer -- verschieden erschaffen -- 
  Angst -- gehen Priester Wort -- hart Wort Ritter meinen -- kommen schwer Strafe leichtfertig Wort -- 
  Ritter Schuld -- schieben -- -- meinen -- gehen eigentlich Stoffel -- nehmen -- Schuld -- 
  sehen jung Polenritter -- eigentlich meister leichtfertig Wort Schloß sprechen -- Stoffel meister Bau vermessen Schattengange reizen -- 
  jung -- wilde -- vermessen gelten -- voran -- Heide fürchten weder Gott Teufel -- 
  merken -- meinen -- sagen -- merken heimlich Angst -- 
  höhnten -- Spinne fürchten -- Drache -- 
  wappnen riten Tal hinauf -- vermessend -- zurückkehren -- Stoß Spinne hingestrecken -- Faust zerdrücken -- 
  -- wild Hund springen -- Falke sitzen Faust -- Sattel hing Lanze -- lustig bäumt Pferd -- halb schadenfroh -- halb ängstlich Schlos reit gedacht nächtlich Wache Bärheg -- Kraft weltlich Waffe Feind bewähren -- 
  -- riten Saume Tannenwalde nächster Gehöft -- scharf Auge spähend -- 
  Haus erblicken -- Leute -- rufen Hunden -- Haupt Falke frei -- lose klirrt Scheide Dolch -- 
  Falke geblendet Auge Ritter kehren -- Winkes gewärtig -- prallt Faust schoß Luft -- hergesprungen Hund heulter suchen Schweif Bein Weite -- 
  vergebens riten rufen Ritter -- Tier -- 
  riten Mensch -- Kunde einziehen -- Stunde -- nahe -- 
  Schrie gräßlich floh Wald Schlucht -- Ritter Helm sitzen schwarz -- übernatürlich Größe Spinne glotzen giftig schadenfroh Land -- 
  suchen -- tragen Ritter wissen -- glühendem Zorne rufen riten Mensch -- rufen wütender -- riten Toller -- brüllen entsetzlich -- Roß Fluh hinab Tale stürzen -- 
  finden Helm Leib -- Helm hindurch Fuß Spinne brannen -- Ritter Gehirn hinein -- schrecklichst Brand entzünden -- Tod finden -- 
  -- kehren Schreck Schloß -- schließen fühlen sicher -- suchten geistig Waffe -- finden -- führen wissen führen wagen -- 
  lassen ferner Pfaff locken Geld Wort -- auszieh heilig Wasser heilig Sprüche böse Feind -- 
  stärkt Gebet Fast -- tafelen morgens früh Ritter -- zählen Becher leben Hirsch Bär -- 
  redet geistig Heldentat -- Ritter weltlichen -- Becher zählen Spinne vergessen -- 
  löscht Leben -- Hand halten erstarren Becher Gabel -- Mund bleiben -- stier Auge Punkt richten -- Stoffeln trank Becher leer erzählt Heldentat Heidenland -- 
  kopf sitzen Spinne glotzt Rittertisch -- Ritter fühlen -- 
  beginnen Glut ström Gehirn Blut -- gräßlich schreien -- fahren Hand kopfe -- Spinn -- schrecklich Schnelle Ritter Gesicht laufen -- wehren -- schreien -- Glut verzehren -- Pfaffe Glatz nieder glotzt Greuel hinein -- Becher -- Hand -- Pfaff Brand löschen -- lodert Kopf herab Mark Bein -- 
  Waffe trotzt Spinne glotzt Throne herab Greuel -- letzter Ritter letzter Schrei ausgestoß -- letzter Atemzug enden -- 
  -- Schlos bleiben Diener verschonen -- Hohn Bauer treiben -- erzählten -- schrecklich gehen -- 
  Gefühl -- Ritter geschehen -- tröstet Bauer -- Schreck groß -- gräßlich -- 
  suchen fliehen -- 
  Tal verlassen -- fallen Spinne -- 
  Weg finden Leichname -- 
  fliehen hoch Berg -- droben Spinne -- retten glauben -- sitzen Spinne Nacken Gesicht -- 
  Untier boshafter -- teuflisch -- 
  überraschen unerwartet -- brennen unversehens Tod -- sitzen Mensch Grase -- hing Baume -- glotzen giftig -- 
  fliehen Mensch -- Fuß tragen -- stehen atemlos still -- sitzen Spinne -- glotzen giftig -- 
  Floh abermals -- müssen abermals Schritt hemmen -- sitzen -- fliehen -- kroch langsam heran Tod -- 
  versuchen Verzweiflung Widerstand -- Spinne töten -- werfen zentnerig Stein -- Grase sitzen -- schlagen Keule -- Beile -- umsonst -- schwer Stein erdrücken -- scharf Beil verletzen -- unversehens sitzen Mensch Gesicht -- unversehren kroch heran -- 
  Flucht -- Widerstand -- eitel -- 
  hoffen -- Verzweiflung füllen Tal -- sitzen Berg -- 
  -- einzig Haus Untier verschonen -- erscheinen -- Haus -- Christine gewohnen -- Kindlein rauben -- 
  Mann einsam Weide anfallen -- finden Leichnam gräßlich zugerichten -- -- Zug zerrissen unaussprechlich Schmerz -- gräßlichst Zorn auslassen -- gräßlichst Wiedersehen Ehemanne bereiten -- 
  Zuging -- sehen -- 
  -- Haus kommen -- zuletzt sparen -- scheut -- erriet -- 
  -- Ort Angst eingekehren -- 
  -- fromm Weibche genesen -- zagen -- fast treu Bübch schwesterchen -- wacht Nacht -- treu Großmutter teilen Sorge Wachen -- 
  gemeinsam betet Gott -- Auge halten Wache -- erleucht stärk Rettung unschuldig Kindlein -- 
  -- -- wachen Nacht -- sehen Spinne glimmen glitzern dunkel Winkel -- glotz Fenster hinein -- Angst -- wissen Rat -- Spinne Kindlein schützen -- brünstig bat Gott Rat Beistand -- 
  allerlei Waffe Hand legen -- hören -- Stein schwere -- Beil Schärfe verlieren -- Seite legen -- 
  Mutter deutlich -- lebendig Sinn -- wagen -- Spinne Hand fassen -- vermöchte überwältigen -- 
  hört Leute -- -- Stein helfen -- Hand erdrücken versuchen -- vergeblich -- 
  gräßlich Glutstrom -- Hand Arm zucken -- tilgt Kraft bringen Tod Herz -- 
  -- erdrücken vermöcht Spinn -- erfassen dürfen -- Kraft Gott verleihen -- wohin -- unschädlich -- 
  gehören -- kundig Mann Geist einsperren Loch Fels Holz -- Nagel zuschlagen -- Nagel ausziehen -- müssen Geist bannen Loche -- 
  -- Gleiches versuchen drängen Geist -- 
  bohren Loch Bystal -- nächster liegen Hand -- Wieg sitzen -- rüstet Zapfe -- scharf Loch passen -- weiht geheiligt Wasser -- legen Hammer zurecht -- betet Nacht Gott Kraft -- 
  manchmal Fleisch stark Geist -- schwer Schlaf drücken Auge -- Traum Spinne -- glotzend Bübchen golden Locke -- fahren Traume -- fahren Bübchens Locke -- 
  Spinne -- lächeln sitzen Gesichtchen -- Kindlein lächeln -- Engel Traume sehen -- Mutter glitzert Ecke Spinne giftig Auge -- weichen Schlaf -- streng Wachen Schlaf überwältigen -- dicht umnachten -- 
  -- stürz fromm Priester -- Rettung Kindlein sterben -- herbei weit Raum ruf Ferne -- weib -- wachen -- Feind -- 
  dreimal rufen -- Mal rang Schlaf eng Bande -- schwer Augenlider mühsam heben -- langsam -- giftgeschwoll Spinne schreiten über Bettlein hinauf -- Gesichte Bübchens -- 
  dachen Gott ergreifen rasch Hand Spinne -- 
  fahren Feuerström -- treu Mutter Hand Arm Herz hinein -- muttertreu Mutterlieb drückt Hand -- Aushalten Gott Kraft -- 
  tausendfach Todesschmerze drücken Hand Spinne bereitet Loch -- zapfen schlagen Hammer fest -- 
  -- Drinn sau braust -- Meer Wirbelwinde streiten -- Haus wankt Grundfest -- fest sitzen Zapfe -- gefangen bleiben Spinne -- 
  -- treu Mutter freuen -- Kindlein retten -- danken Gott Gnade -- sterben gleich Tod -- Muttertreue löscht Schmerz -- Engel geleitet Seele Gott Thron -- Held -- Leben einsetzen -- Gott wagen -- 
  schwarz Tod -- 
  Ruhe Leben kehren Tal -- 
  schwarz Spinne sehen selben -- sitzen Loche gefangen -- sitzen -- -- 
  -- -- schwarz Holz -- -- schreien Gotte -- fahren Satz Boden -- Ameisenhaufe sitzen -- 
  Holz sitzen Stube -- 
  brennen Rücken -- drehen -- schaut -- fahren Hand -- Angst -- schwarz Spinne sitz Nacken -- 
  Herz zugeklemmen -- Großvater schweigen -- 
  bang schweigen kommen -- 
  Spott wagen -- Sache beistimmen gerne -- hört Wort -- Rede richten -- verfehlen wenigster -- 
  Hebamme -- mehrere Mal rufen -- Antwort bekommen -- hergelaufen -- Gesicht brennen Hochrot -- -- Spinne herumgekrochen -- 
  beginnen schmälen -- wollen -- laut rufen -- 
  -- wunderlich Sache -- kochen -- wollen Tisch -- -- sollen Schuld -- wissen gehen -- 
  fett Fleisch drinnen stehen -- können essen -- kalt -- ungesund -- -- 
  kommen Leute -- langsam -- Türe -- Großvater müssen voran -- 
  diesmal sowohl üblich Sitt -- Schein -- mögen warten -- Essen kommen -- zögern -- befällen -- Eingang stehen schauerlich Ort -- drinnen schauerlich -- 
  Hell glänzt Tisch -- frisch füllen -- schön Weinflasche -- glänzend Schinke prangen -- gewaltig Kalbs- Schafbrate dampfen -- frisch Zupfe liegen -- Teller Tatar -- Torten -- -- Teller dreierlei Küchele zwängen -- Kännche süß Tee fehlen -- 
  war_es schön schauen -- achteen -- sehen ängstlich Auge -- Spinne Ecke glitz prangend Schink herab anglotz giftig Auge -- 
  nirgends -- üblichen Kompliment -- 
  Sinn -- aufstellen -- essen sollen -- -- drängen unterer Ecke Tisch -- hinauf -- 
  Umsonst mahnen Gast zeigter leer Platz -- Stunde unten angenagelt -- vergebens schenken Kindbettiman rufen -- Gesundheit -- einschenken -- 
  Gotte arme -- 
  Witzigeste gib Exempel -- 
  Kraft -- klein -- sperrt Gotte rufen -- tausend Pfund sitzen -- 
  gramselt Rücken nieder führ Nessel herum -- 
  säß Bystal -- fühlen schrecklich Spinne sond Unterlaß Nacken -- 
  Schuld -- Großvater -- Großmutter -- bringst Ding auf Tapet -- 
  tragen -- Haus schaden -- 
  einst Kind Schule weinen klagen -- Kind halten -- Großmutter Hexe Bystal bannen -- -- 
  ruhig -- Großmutter -- Großvater -- vergessen -- behalten Gedächtnis ehedem -- 
  Sache Leute vernehmen Punktum Wahrheit -- ersinnen -- Wahrheit bringen unser Haus Unehr -- 
  sitzeen -- sehen -- Zapfe sitzen -- 
  tausend sitzen Furcht Zag Gefährde -- 
  böse Gedanke aufstiegen -- Teufel Handhabe -- -- Schnurre -- Katze schnurret -- anlassen -- Balg streichen -- behaglich -- fahren Rücken seltsam absonderlich -- 
  halten Mäusestill innen -- außen Gott vergessen -- warten Inn -- 
  fassen Gast Mut setzen -- nahe Großvater rücken -- 
  Kindbettiman vorlegen -- legen mächtig Stück Braten Nachbarin Teller -- schneiden Stückche -- legen Rest Nachbars Teller -- Daumen Gabel streifend -- 
  Stück -- -- 
  denken -- behalten -- -- -- neu Stück beginnen Runde -- 
  Kindbettiman einschenken vorlegen -- Gast sagen -- strengen -- Hebamm herum süßen Tee -- stark würzen Safran Zimt -- bieten fragen -- lieben -- sollen sagen -- -- 
  -- Liebhaber -- schenken Tee Wein -- lieben -- mögen Wein ertragen -- machen Kopfweh -- 
  aß trank -- 
  Lärm vorbei -- allemal entstehen -- Gericht -- still -- ernst Gesicht -- merken -- Gedanke Spinne -- 
  scheu verstohlen blickt Auge Zapfe Großvater Rücken -- scheut -- anfangen -- 
  schreien laut Gotte fast Stuhle fallen -- 
  Fliege Zapfe laufen -- glauben -- Spinne schwarz Bein gramselt Loche heraus -- zitteren Schreck Leib -- 
  ausgelacht -- Schreck willkommen Anlaß -- neu Spinne anfangen -- -- Sache Seele berühren -- schnell -- 
  -- hören Mal Vetter -- alt Götti -- Spinne seither Loche kommen -- bleiben hundert -- -- 
  -- Ehe -- Großmutter -- schwieg Sache -- Nachmittag reden -- -- 
  -- Ehe Mutter -- Vetter -- laß dein alte reden -- kurz -- vorhalt Ding -- stammen Christine -- 
  bringst Gedanke Sache -- reden -- reden -- gibt_es kurzen -- 
  Großvater -- reden -- alt vergönnen -- -- 
  -- He zwingen wollet -- zwinget meinethalben -- gescheit -- angefang Nacht -- -- Großmutter -- 
  beginnen Großvater -- Gesicht spannen -- 
  -- wissen -- -- wissen -- sagen -- heutig Exempel nehmen -- schaden wahrhaftig -- 
  -- Leute Spinne einsperren wissen -- Leben sicher -- -- Himmel lieben Gott Seligkeit mitten -- -- 
  halten Gott fliehen Teufel -- Ritter -- frisch eingezog Schloß -- Respekt Gott Hand halten mild Mensch helfen -- 
  -- Haus betrachten Ehrfurcht -- fast Kirche -- 
  Anfangs schauderen freilich -- ansahen -- Kerker schrecklich Spinne sehen denken -- losbrech Elend vorne anfangen Teufel Gewalt -- 
  sehen -- Gott Gewalt stark Teufel -- Mutter -- sterben -- halfen Kind bauen unentgeltlich Hof -- arbeiten -- 
  Ritter bewilligen -- neu Haus bauen -- Spinn fürchten -- Zufall bewohnt Haus kommen -- Nachbar helfen -- Scheu Untier -- schrecklich gezitteren -- -- 
  alt Großmutter -- 
  lehren Enkel -- Spinne gebannen Gott Vater -- Sohn heilig Geist -- heilig Name gelten Haus -- heilig Name Tisch gegessen trinken -- Spinn sicher fest Loch -- Zufall machen Sache -- 
  -- Tisch -- Spinn -- vergessen -- nötig Gott mächtig -- mahne Spinne Gott müssen Teufel Trotz -- Heil -- 
  Ließen Gott -- hundert Stunde -- Spinn finden Teufel -- 
  fassen Kind -- bleiben Haus -- wuchsen gottesfürchtig -- Haus Segen Gott -- 
  -- Bübch -- treu Mutter -- treu Mutter -- wachsen stattlich Manne -- leiben Gott Mensch -- Gnade Rittern finden -- 
  segnen zeitlich -- vergaß Gott darob -- geizig -- helfen Nöt -- wünschen -- helfen letzter Not -- schwach Hilfe -- kräftig Fürsprecher Gott Mensch -- 
  segnen weis Weibe -- unergründlich Friede -- blühn Fromm Kind -- finden spät sanft Tod -- 
  Familie blühen fort Gottesfurcht Rechttun -- 
  -- Tale liegen Segen Gott -- Glück Feld Stall -- fried Mensch -- 
  schrecklich Lehre Mensch Herz gehen -- halten fest Gott -- tun -- tun Name -- helfen -- säumen -- 
  Schlos Übel -- -- 
  Ritter wohnen -- hart Streit Heidenland Nöter Hand -- fechten -- -- Schloß -- mahnen täglich Totenhalle -- Spinne Ritter Bauer üben -- Gott gleich Kraft -- abfall -- Bauer Ritter -- 
  -- schwand Glück Segen -- Tal berühmt -- 
  stattlich Haus -- Vorrät -- manch Geldstück ruht Kasten -- Vieh schön Berg Tal -- Tochter berühmen Land Land -- Sohn gerne sehen überall -- 
  Ruhm welkt Nacht -- Jona Schattenstaude -- dauern Geschlecht Geschlecht -- gleich Gottesfurcht Ehrbarkeit Vater leben Sohn Geschlecht Geschlecht -- 
  Birnbaum -- flüssigsten Genährt -- stark treiben -- Wurm bohren -- umfrißen -- welken lassen töten -- geschehen -- -- Gott Segenstrom reichsen Mensch fließen -- Wurm Segen -- Mensch blähen blind -- Segen Gott vergessen -- Reichtum -- -- geben -- Israelit -- -- Gott helfen -- golden Kälber vergaßen -- 
  -- -- Geschlecht dahingegangen -- Hochmut Hoffart heimisch Tale -- fremd Weiber bringen Mehrt beide -- 
  Kleid hoffärtig -- Kleinode glänzen -- heilig Zeichen wagen Hoffart -- Herz Bete inbrünstig Gott sein -- hing Auge hoffärtig golden Kugel Rosenkranze -- 
  Gottesdienst Pracht Hoffart -- Herzen hart Gott Mensch -- 
  Gott Gebot bekümmeren -- Dienst Diener spotten -- Hoffart Geld -- gerne Wahn -- Gelüste Weisheit halten -- Weisheit hoch Gott Weisheit -- 
  Ritter plagen -- hart Gesinde plagten -- arbeiten -- Mutet -- Arbeit Knecht Mägde fordern -- behandelten unvernünftig Vieh -- Seele -- wahr -- denken -- 
  Geld Hoffart -- fangen bauen -- schön -- Ritter bauen -- bauen -- Ritter plagten -- schonten weder Gesinde Vieh -- Bauteufel -- 
  Wandel Haus kommen -- alt Reichtum bleiben -- 
  -- fast zweihunderen Verflossen -- Spinne Loche gefangen sitzen -- schlau kräftig Weib Meister -- Lindauerin -- glich Christin Stück -- 
  Fremd -- Hoffart -- Hochmute ergeben -- einzig Sohn -- Mann Meisterschaft sterben -- 
  Sohn schön Bube -- Gemüt freundlich Mensch Vieh -- leiben -- lassen merken -- 
  meistert Schritt Treten -- erlauben -- längst erwachsen Kameradschaft Kilbi -- Mutter Begleitung -- 
  alt glauben -- Weib Verwandtschaft -- eins Sinn -- 
  Meister -- hoffärtig hochmütig -- -- Christ -- freundlich demütig -- Anstand -- erfahren -- Meister -- 
  -- alt Haus Dorn Auge -- schämten -- Nachbar Haus reich -- 
  Sage Spinne Großmutter -- Gedächtnis -- alt Haus längst einreißen -- wehrten -- 
  nehmen Wehre Neid -- neu Haus gönnen -- 
  zudem unheimelig alt Haus -- 
  Tisch sitzen -- Schnurre behaglich Katze -- gehen leis Loch Spinne ziel Nack -- 
  fehlt Sinn -- Loch vermacht -- fürchten -- Loch öffnen -- 
  finden gut Grund -- neu Haus bauen -- Spinn fürchten -- meinen -- 
  alt Gesinde überlassen -- Hoffart Weg -- rätig -- 
  -- Christ ungern -- wissen -- alt Großmutter -- glauben -- Familiensege Familienhaus knüpfen -- Spinne fürchten -- Tisch sitzen -- scheinen -- können andächtigst beten -- 
  -- meinen -- Weiber hießen schweigen -- Knecht -- schweigen -- weinen bitterlich -- sehen -- 
  -- oberhalb Baume -- sitzen -- Haus bauen -- Gegend -- 
  -- hoffärtig Ungeduld -- Verstand bauen warten -- Haus hochmütig -- plagt bauen Gesinde Vieh übel -- schont heilig Feiertage -- gönnt Nacht Ruhe -- Nachbar -- helfen -- zufrieden -- böse wünschen -- unentgeltlich Hilfe -- leisten -- Heim -- Sache sehen -- 
  -- aufrichtet Zapfen Schwelle schlagen -- raucht Loche herauf -- nass Stroh -- anbrennen -- schüttelte Werkleute bedenklich Kopf -- sagen heimlich laut -- Bau alt -- Weiber lachen -- achtet Zeichen -- 
  Haus erbauen -- ziehen hinüber -- richten unerhört Pracht geben sogenannter Hausräuchi Kilbi -- dauern -- Kind Kindeskind erzählt Emmenthal -- 
  -- Haus seltsam Surre gehören -- Katze -- behaglich -- Balg streichen -- 
  Katze -- -- trotz Suchen finden -- unheimlich -- trotz Herrlichkeit laufen Mitten Fest -- 
  weiber hören achteten -- Haus meinen gewinnen -- 
  -- -- blind -- sehen Sonne -- Taub -- hören Donner -- 
  freuen Weiber Haus -- hoffärtig -- denken Spinne -- führen Haus üppig -- arbeitslos Leben putzen essen -- Mensch treffen -- Gott denken -- 
  -- alt Haus bleiben Gesinde alleine -- leben -- Christ Aufsicht -- duldet Weiber -- schalten -- Mutter Hochmut hauptsächlich -- Weib Eifersucht meist -- 
  drunt Ordnung Gottesfurcht -- Meister -- durchweg -- 
  Meister Tisch sitzen -- Meister draußen drinnen Zügel halten -- meinen Größter -- wüstesten tun -- gute -- ruchlosest Rede führen -- 
  -- Haus drunt -- sämtlich Gesinde glich Rudel Katze -- wüstesten -- 
  beten wissen -- weder Gott Wille -- Gabe Respekt -- 
  Hoffart Meisterweiber Grenze kennen -- tierisch Übermut Gesind Schranke -- 
  schändet ungescheut Brot -- treiben Habermuß Tisch weg Löffeln Kopf -- -- verunreinigen viehisch Speise -- boshaft Lust Essen vertreiben -- 
  neckt Nachbar -- quält Vieh -- höhnen Gottesdienst -- leugnen hoch Gewalt plagt Weise Priester -- strafend reden -- Furcht Gott Mensch tun wüster -- 
  wüste Leben führen Knecht Mägde -- plagt -- Knecht wissen -- Art mägde quälen -- fallen -- Spinne Loche mägde schrecken zehmen -- 
  schmeißen Löffel voll Habermuß Milch Zapfe -- schreien -- drinnen hungrig -- hundert -- 
  -- schri mägde gräßlich versprach -- Knecht grauten -- 
  Spiel ungestraft wiederholen -- wirken -- Mägde schri -- versprach -- Knecht beginnen treiben -- 
  fing Messer Loch fahren -- gräßlichst Flüche vermessen -- machen Zapfe -- wollen sehen drinnen -- müssen neu sehen -- 
  wecken neu entsetzen -- Bursche -- -- Meister -- zwingen -- Mägde -- 
  -- seltsam Mensch -- wissen woher -- 
  sanft Lamm -- reißend Wolf -- alleine Weibsbilde -- sanft Lamm -- Gesellschaft reißend Wolf haßen -- wollen wüs Tat Wort -- Weibsbilder liebsn -- 
  entsetzt Mägde öffentlich -- -- alleine -- liebsn -- 
  ungleich Auge -- wissen Farbe -- haßen -- sehen gleich Weg -- lang augenhaar demütig Niederseher wissen verbergen -- 
  Haar schön locken -- wissen rot falb -- Schatten schön Flachshaar -- scheinen Sonne -- Eichhörnchen röteren Pelz -- 
  quäln Vieh -- 
  haßen -- 
  Knecht meinen -- Freund -- weisen -- 
  meisterweibern alleine -- alleine oberer Haus -- tun unten Mägde Wüst -- merken -- stecken Messer Zapfe beginnen Drohen -- Mägde Kreuze krochen -- 
  behalten Spiel Wirkung -- 
  mägde gewohnen sagen -- tun -- -- -- 
  -- naht Weihnacht -- heilig Nacht -- 
  -- Weihet -- denken -- lustig Leben abgeraten -- 
  Schlos drunt Hauste alt Ritter -- bekümmeren Zeitliche -- schelmisch Vogt verwalten Vorteil -- 
  Schelmenstück edel Ungarwein abgehandeln -- Land Ritter groß Streite liegen -- edlen Weine Kraft Feuer kennen -- 
  fürchterlich Unwetter herauf -- Blitz Sturm -- selten -- Hund Ofen hervorgejagen -- 
  Kirche halten Unwetter -- sein schön Wetter gehen -- Meister alleine lassen -- halten -- Kirche besuchen -- bleiben alt Haus edl Wein -- 
  -- beginnen heilig Abend Fluchen Tanzen -- wüsteren ärgern Ding -- setzen Mahl -- wozu Mägde Fleisch kochen -- weiß Brei stehlen -- 
  Rohheit gräßlich -- schändet Speise -- lästert Heilige -- genannt Knecht spottet Priester -- teilen Brot trinken Wein -- heilig Messe verwalten -- taufen Hund unter ofen -- treiben Angst bange -- ruchlos -- 
  stach Messer Loch fluchen -- wollen Ding zeigen -- 
  darob erschrecken -- Gleich manchmal treiben -- Messer Zapfe abzubringen -- greifen halber Raserei Bohrer -- Vermaß auf Schrecklichste -- erfahren -- können -- büßen lachen -- Haar Berg stehen -- drehen wild Stoß Bohrer Zapfe hinein -- 
  laut aufschreiend stürzen -- ehe hindern -- lacht Teufel -- kräftig Ruck Bohr -- 
  beben ungeheur Donnerschlag Haus -- Missetäter stürzen Rücklings nieder -- rot Glutstrom brechen Loche hervor -- mittendrin sitzen schwarz aufgeschwoll Gift Jahrhundert Spinne glotzen giftig Lust Frevler -- versteinern tödlich Angst Glied bewegen -- schrecklich Untiere entrinnen -- langsam schadenfroh Gesicht kroch -- einimpft feurig Tod -- 
  erbebt Haus schrecklich Wehgeheul -- hundert Wölfe ausstoßen vermögen -- Hunger peinigen -- 
  erscholl ähnlich Wehgeschrei Haus -- Christ -- Berg heraufkam heilig Messe -- meinen -- Räuber einbrechen -- stark Arm trauend -- stürzen Hilfe -- 
  finden Räuber -- Tod -- rang Weib Mutter Stimme hochaufgelaufen schwarz Gesicht -- ruhig schlummeren Kind gesund rot munter Gesicht -- 
  steigen Christ schrecklich Ahnung -- geschehen -- stürzen unter Haus -- Dienst verenden -- Stube Totenkammer -- öffnen schauerlich Loch Bystal -- scheußlich entstellt Knecht Hand Bohr Bohrer Spitze schrecklich Zapfe -- 
  wissen geschehen -- schlagen Hand kopfe -- Erde verschlungen -- -- 
  kroch hinterem Ofen hervor -- schmiegen -- entsetzt fahren -- Spinne -- arm Bübchen -- Gotteswill Haus nehmen ruchlos Gesinde lassen -- geschehen -- Kind Gotteswill nehmen Teufel Hand spielen -- 
  nehmen gräueln Gesind -- erschreckt Ofen fliehen -- bleiben Spinn verschonen -- Hergang erzählen -- 
  -- Bübch erzählen -- scholl Wind Wetter Angstgeschrei Häusern -- 
  hundertjährig aufgeschwellt Lust flog Spinne Talschaft -- Las üppigst Haus -- wenigster Gott denken -- meister Welt -- Tod wenigster wissen -- 
  -- -- Kunde jeglicher Haus -- alt Spinne losgebrochen -- gehen auf totbringend Gemeinde -- liegen tot hinten Tale fahr Schrei Schrei Himmel Gezeichneten -- sterben müssen -- 
  denken -- welcher Jammer Land -- Angst Herzen -- Weihnacht Sumiswald -- 
  Freude -- bringen -- Mensch denken -- Jammer Frevel Mensch -- 
  Jammer groß -- schnell -- giftig früh Mal Spinne -- 
  vorderst -- hinderst Gemeinde -- Berg -- Tale erscheinen gleich -- 
  meist -- gezeichnen Tod -- verlassen selten Haus -- ehe vergiften -- Tod wanden -- setzt Schwelle glotzen schadenfroh Vergiftung -- sagen -- -- einsperren -- 
  -- scheinen wissen -- vergönnen -- Mühe sparen -- -- -- -- 
  laueren lieb Zug -- tote Kirche geleiten -- 
  -- -- liebsn unten Kilchstalde -- tauchen mitten Haufen -- glotzen plötzlich Sarge herab Begleitend -- 
  fahren schrecklich Wehgeschrei begleitend Zug Himmel -- Mann Mann fallen nieder -- Zug Begleitend Weg liegen rang Tod -- Leben -- Sarg Haufen tote liegen -- tapfer Krieger Fahne liegen -- Übermacht erfassen -- 
  tote Kirche bringen -- tragen -- geleit -- Tod strecken -- lassen liegen -- 
  -- Verzweiflung liegen über Tale -- 
  Wut kocht Herz -- strömt schrecklich Verwünschung arm Christ -- Schuld -- 
  -- wissen -- Christ alt Haus verlassen -- Gesinde überlassen -- 
  wissen -- Meister Gesinde minder verantwortlich -- wachen sollen Bete essen -- wehren sollen gottlos Leben -- gottlos Rede gottlos Schänd Gabe Gott -- 
  Hoffart Hochmut vergehen -- tun Laster unterst Hölle hinunt -- Gott glauben -- schmählich tragen -- fromm -- schlechtesen Kleid -- alt verachtet Rosenkränze Hand -- überredeter -- Fromm -- fehlen -- Gott Gleiche überredeten -- 
  Christ gottlos -- flüch Berg kommen Seite -- 
  gute -- Wille liegen binden weiber Wille -- Gebundensein schwer Schuld Mann -- schwer Verantwortung entrinnen -- -- Gott -- 
  Christ -- trotzig -- pocht -- schuldig dar -- -- versöhnt Leute -- schri -- Schuld müssen -- nehmen -- unterziehen -- bekennen -- wert -- 
  betet Nacht Gott -- Übel wenden -- Schrecklicher -- 
  inne -- müssen -- fehlen -- Opfer geben müssen -- liegen -- -- Ahnfrau tun -- 
  beten Gott -- feurig Herz Entschluß empor wachsen -- Talschaft retten -- Übel sühn -- Entschluß standhaft Mut -- wanken -- bereit gleich -- Abend -- 
  -- ziehen herab Kind Haus alt Haus -- schneiden Loch Zapfe -- lassen weih heilig Wasser heilig Sprüche -- legen Zapfe Hammer -- setzen Bett Kind -- harrt Spinne -- 
  -- sitzen -- beten wacht -- rang schwer Schlafe fest Mut wanken -- Spinne -- allenthalben -- größ Sterbet -- wild Wut überlebend -- 
  mitten Schrecken wild Weib Kind gebären -- 
  Leute alt Angst -- ungetaufen Spinne Kindlein holen -- Pfand alt Pacht -- 
  weib gebärden unsinnig -- Gottvertrauen -- desto Haß Rache Herz -- 
  -- wissen -- alt grüne geschützen Zeit -- Kind gebären -- Priester Schild -- ewig Feind stellen -- 
  Priester senden -- Bote -- 
  unbegraben tote -- Spinne Leichenzüg erfassen -- sperrt Weg -- Bote wild Höhe Spinne -- wissen scheinen -- entgehen -- Priester holen -- 
  zagten -- 
  dachen Mann Weibes -- Spinne wollen -- können daheim fassen Weg -- Tod bestimmen -- entrinnen -- 
  -- Weg -- Stunde Stunde rann vorüber -- Bote -- 
  Wut Jammer entsetzlich -- Geburt rücken nah -- 
  reißen Weib Wut Verzweiflung Lager stürzen Christen Haus -- tausendfach Verwünscht -- betend Kind sitzen -- Kampf Spinne gewärtig -- 
  Weither tönt Geschrei -- Verwünschung donnern Christen Türe -- ehe aufriß Donner Stube bringen -- 
  hereinstürzt schrecklich Angesicht -- fahren -- wissen -- Christine ursprünglich Gestalt -- 
  Türe hemmen Schmerz Lauf -- Türpfosten Wand -- Flut Verwünschung ausgießend arm Christ -- 
  Bote -- verflucht wollen Kind Kindeskindern Ewigkeit -- 
  überwallen Schmerz Fluchen -- Söhnlein gebären wild Weibe Christen Schwelle -- folgen -- stoben Weite -- Schrecklichst gewärtig -- 
  unschuldig Kindlein halten Christ arme -- stechend wild giftig starrt Weibe verzerrten Zügen Auge -- tret Spinne heraus -- -- 
  Kraft Gott übermenschlich Wille mächtig -- innig Blick werfen Kind -- hüllt neugeboren Kind warm Gewand -- springen glotzend Weib -- Berg hinunt Tal entlang -- Sumiswald -- 
  heilig Weihe Kindlein tragen -- Sühne Schuld -- liegen -- Haupt Haus -- Übrige überlassen Gott -- 
  tote hemmen Lauf -- vorsichtig müssen Tritt setzen -- 
  ereilen leicht Fuß -- arm Bübch -- graut wild Weib -- kindlich Trieb Meister nachgetrieben -- 
  Stachel fahren Christen Herz -- Kind alleine wütenden Weibe -- 
  Fuß stehen still -- streben heilig Ziel -- 
  -- unten Kilchstald -- Kapelle Auge -- glühten plötzlich mitten Weg -- regt Busch -- Weg sitzen Spinne -- busche wanken rot Federbusch heben Spinne Sprunge -- 
  rufen Christ lauter Stimme dreieinig Gott -- Busche tönen wild Schrei -- Schwand rot Feder -- bübchens arme legen Kind ergreifen -- Herr Geist empfehlend -- stark Hand Spinne -- gebannt heilig Wort gleich Fleck sitzen bleiben -- 
  Glut strömt Gebein -- halten fest -- Weg frei Bübch verständigen Sinn eilt Priester Kind -- 
  Christ -- Feuer stark Hand -- eilt geflügelt Lauf Haus -- 
  schrecklich Brand Hand -- Spinne Gift drang Glied -- 
  Glut Blut -- 
  Kraft erstarren -- Atem stocken -- beten Fort fort -- halten Gott fest Auge -- halten Hölle Glut -- 
  Haus -- Schmerz wachsen hoffen -- Türe Weib -- 
  Kind -- stürzen entgegen -- Tigerin -- Junge rauben -- glauben schändlichst Verrat -- 
  achtet Winken -- hört Wort keuchend Brust -- stürzen vorgestreckt Hand -- klammeren -- Todtesangst Wütende schleppe Haus herein -- frei Arm kämpfen -- ehe gelingen -- Loch Spinne drängen -- sterbend Hand Zapfe vorschlagen -- 
  vermögen Gott Hilfe -- 
  sterbend Blick werfen Kind -- Hold lächeln Schlafe -- 
  -- hoch Hand scheinen Glut löschen -- laut betend schließen Tod Auge -- Frieden Freude finden Gesicht -- vorsichtig angstvoll kommen -- schauen -- Weib bleiben -- 
  erstaunt sehen Loch verschlagen -- Weib finden versengt verzerren Tod liegen -- Christen Hand feurig Tod holen -- 
  stehen wissen -- geschehen -- Kind Bübch wiederkehrn -- Priester begleiten -- Kind schnell taufen damalig Sitt -- wohlgerüsten mutvoll gleich Kampfe entgegen -- Vorgänger siegreich Leben lassen -- 
  solch Opfer fordern Gott -- Kampf Anderer bestehen -- 
  faßn Leute -- welcher Christ vollbringen -- 
  Glaube Erkenntnis -- beten freudig Priester -- danken Gott neu geschenkt Leben -- Kraft -- Christ geben -- 
  bat Tod Unrecht -- beschließen hoch Ehre begraben Andenken stellen glorreich heilig Seele -- 
  -- wissen -- -- schrecklich Schreck -- fort fort Glied zitteren -- geschwund -- Freude blau Himmel hinauf sehen -- Angst -- Spinne kriechen unterdessen Fuß -- 
  beschließen Messe Kilchgang -- Leiche bestatt -- Christ Drängerin -- Stätte finden -- -- 
  -- feierlich -- Tal Kirche wanderen -- Herz feierlich -- sünd erkennen -- manch Gelübde tun -- übertrieben Wesen Gesicht Kleid sehen -- 
  -- Kirche Kirchhofe Träne fließen -- Gebet geschehen -- gehen Talschaft -- Begräbnis kommen -- kommen -- Glied mächtig -- üblich Imbiß Wirtshaus -- 
  geschehen -- -- üblich -- Weiber Kind Tisch sitzen -- sämtlich erwachsen Mannschaft Platz berühmt Scheibentische -- Bären Sumiswald sehen -- 
  aufbewahren Andenken -- einst Dutzend Mann -- Tausend wohnen -- Andenken -- Leben Zweitausende Hand stehen -- Dutzend retten -- 
  säumt Gräbt -- herzen voll -- Speis Trank Platz -- 
  Dorfen hervor frei Höhe kommen -- sehen Röt Himmel -- heim kommen -- finden Haus niedergebrannt Boden -- zugegangen -- erfahren -- 
  -- Christ tun -- vergaß Leute -- Kind vergalten -- 
  Fromm Wacker Erzog frommst Haus -- vergriff Hand -- obgleich Rechnung sehen -- 
  gemehrt besorgt -- Kind aufwachsen -- betrog -- Seele -- 
  rechtschaffen gottesfürchtig Mensch -- Gnade Gott Wohlgefallen Mensch -- Segen Leben finden Himmel -- 
  bleiben Familie -- fürchten Spinne -- fürchten Gott -- -- -- Gott -- bleiben -- Haus stehen -- Kind Eltern folgen Gedanke -- -- 
  schweigen Großvater -- schwieg -- sann Gehörten -- meinen -- schöpf Atem fahren fort -- 
  alt Götti -- 
  -- Scheibentisch manchmal sitzen Sterbet gehören sämtlicher Mannschaft Gemeinde Platz -- 
  Punktum zugegangen -- sagen -- 
  stürmen -- -- 
  sagen -- vernehmen -- -- 
  -- He -- Großvater -- erben Vater Sohn -- Andenken Leute Tale verlieren -- halten Familie heimlich scheut -- Mensch lassen -- 
  Familie reden -- Glied vergessen -- Haus Bauet -- Haus zerstören -- Segen bringen Segen vertreiben -- 
  Hörst alte -- ungern -- öffentlich reden -- 
  dünken -- täte lang Nöter reden -- Hochmut Hoffart bringen -- 
  tun geheim Sache -- Mal -- gut Freund erzählen -- 
  denken -- Familie Glücke erhalten -- schaden -- -- Geheimnis -- Glück Gott Segen bringen -- -- 
  -- -- Vettermann -- antworten Götti -- fragen -- Haus -- einrissest -- uralt -- fast glauben -- -- 
  -- -- Großvater -- 
  uralt Haus baufällig fast dreihunderen -- Segen Gott Feld Matte Platz -- 
  Familie verlassen neu bauen -- vergessen -- früh ergehen -- 
  Verlegenheit -- fragen weis Mann -- Haslebach gewohnen -- Rat -- 
  antworten -- neu Haus können bauen Stelle alt anderswo -- Ding müssen bewahren -- alt Holz worin Spinne -- alt Sinn -- alt Holz Spinne stoßen -- alt Segen Haus -- 
  -- bauten Haus fügen Gebet Sorgfalt alt Holz -- Spinne rühren -- Sinn Segen ändern -- 
  -- Haus wiederum alt klein -- wurmstichig faul Holz -- Posten bleiben fest eisenharen -- 
  Vater bauen -- erwehren -- -- 
  lang zögern wagen -- 
  Früher -- fügen alt Holz Haus Spinne regen -- 
  gestehen -- 
  Lebtag beten brünstig -- verhängnisvoll Holz Hand -- Hand -- Leib brennen -- unwillkürlich müssen sehen -- schwarz Flecken wüchsen Hand Leib -- Berg fallen Seele -- Ort stehen -- 
  Überzeugung fest -- weder Kind Kindeskind Spinne fürchten -- fürchten Gott -- -- 
  schweigen Großvater -- Schauer verflogen -- Rücken heraufgekrochen -- hören -- Großvater Holz Hand -- denken -- -- darein nehmen müssen -- 
  Vetter -- 
  -- schade -- wissen -- Ding -- 
  glauben -- Sache -- alt Holz -- 
  -- wollen -- können lernen -- jung Götti -- kurz -- dünk -- Kirche kommen -- -- 
  -- sagen -- Großmutter -- fang Alter Geschichte -- essen trinken -- schand -- essen trinken -- 
  sollen -- anwenden -- verstehen -- -- 
  gegessen trinken zwischendurch wechseln verständig Rede -- gold Himmel Mond stehen -- Stern Kammer treten -- mahn Mensch -- -- schlafen Kämmerlein -- 
  Mensch sehen geheimnisvoll Mahner -- sitzen heimelig klopften unheimlich unter Brusttuch -- an heimgehen denken -- -- -- 
  stehen Gotte schicken zitternd Herz weggehen -- fehlt sicher Begleiter -- verlassen Gesellschaft gastlich Haus gut Wunsch -- trotz Bitte Einzeln -- Gesamtheit -- 
  lang bleiben -- finster -- 
  still um Haus -- still -- 
  friedlich liegen -- rein schön glänzt Mond Schein Tal entlang -- sorglich freundlich Barg brav Leute süß Schlummer -- schlummern -- Gottesfurcht Gewissen Busen tragen -- schwarz Spinn -- freundlich Sonne Schlummer wecken -- 
  Sinn wohnen -- Spinn regen -- weder Nacht -- 
  -- Sinn ändern -- wissen -- wissen -- Kraft zuteilen -- Spinnen Mensch -- 
  Ritter Brandis -- 
  Sage Umrahmung Schrift entnehmen -- Titel -- -- Wassernot Emmenthal -- -- 1838 Langlois Burgdorf heraus -- 
  Sage nebst bedeutend Anzahl Stelle genannt Schrift Herr Seeger verseen -- gereimen verschieden Zeitschrift -- namentlich Morgenblatt -- eingerücken -- 
  Herr Seeger angeben -- Wort Geste reimen -- glauben Verfasser Schrift Herausgeber Schrift -- sagen -- Verdacht frei bleiben -- -- Herr Seger Reim ungereimt Publikum auftischen -- 
  Sonntag Abend 13. August 1837 stehen Brücke Lützelflüh -- Straße Luzern Bern bernisch Emme führen -- bebend Menge -- 
  angstvoll -- seltsam Woche Herr vorangegangen -- 
  schwer Gewitter -- 4. August -- scheinen Herbst herbeigerufen -- gräulich Kampf Sommer rang -- 
  nebelvoll -- herbstlich -- glauben Läut Kuh -- Hund Jagdgebell hören -- Mittag brennen Sonne Dünste verdoppelt Glut -- Abend hallt Donner gewaltig Stimme Berg -- 
  nebelheer Schweiz ziehen -- Berg steigen -- Täl stürzen lagerten grau Wüst Talgründ Talwände -- 
  Seite hergekommen -- Mächt ehemalig sogenannter heilig Allianz -- rings umwohn -- Land Dünste -- Luft trübend zusammengeblasen fortgeblasen Grenze -- Berg herein -- ablagerer Niederschlage Grau verderben arglosen Schweizer -- 
  Astronom berichten -- Deutschland Norden -- pfiffig Preuß wohnen -- witzig Berliner -- Morgens Abends unser Herrgott bedauern -- Witze -- Atmosphäre laut durchsichtig -- August -- Nebelmassen -- Abend wolkenmassen schwarz schwer Schweizer Kopf hingen -- 
  vernehmen -- seltsam Wetter Sturme westindisch Insel -- 2t August selten Heftigkeit wüten -- Anfang nehmen -- 
  Masse arglos Wölkche -- sanft Wind leise Fittiche reisen Land Land rosenrot Abendrot Schein lächeln über Land herein -- Masse bargen Verderben Schoß -- tragen Blitz Donner Land -- 
  beginnen Ergüs Wut blau Berg -- jagen Kuh Sennhütt -- schwemmen Längnau Schwein durch Dorf -- erschrecken Schadet -- 
  ziehen Jura weg Land hinauf -- Hauptstadt -- trüb feucht -- Hauptstadt wetteren -- 
  Baum brechen -- Haus krachen -- Turm wanken -- bleich verstummt Mensch -- barg sündig Haupt Haus sicherst Winkel -- 
  wälzen -- Dünst schwer -- Nebelmassen gewaltig -- Land hinauf Berg -- 
  reich sättigen -- vermocht Schwing hoch Berg hoch Firn trocken Italien -- weit Meer -- 
  Voralpe bleiben hängen -- tobend wild -- sprühten gewaltig Wassergüsse -- 
  12. August Truber -- Schangnauer -- Marbacher Escholzmatter tüchtig eingeschwemmen -- rötenbach meinen arg Schreck erleben -- menschenleben gehen verlieren -- Land verwüsten -- 
  wild Schwester -- verschieden Mütter gebären -- zornmütig Emme -- frech Ilfi stürzen brüllend -- aufbegehrend -- rasend Umarmung Land hinab -- entsetzen Brücke Mensch -- überall eng weit Bett -- 
  allgewaltigen Strome stehen bebend Mensch -- 
  fühlt Grenze -- fühlen -- -- Wasserströme brausen lass Erde zügle kühn mächtig Hand -- 
  wild zügellos Emme sehen -- unzählbar Tanne -- borstig Schuppe -- bedeckt grau Rücken -- Mensch erwartet Entsetzlich -- Hand -- losgelassen -- zügeln -- Gefahr entfloh -- Bett binden ohnmächtig geworden Strom -- 
  Bleich erheben Tags -- Sonntag 13t August -- Sonne lieben Ländchen -- 
  Mensch glauben -- Schreck gestern -- schnell wild Wolkenheer überzogen -- Weile Wang -- arm Mensch wissen -- Grauen -- Zeuge selbig -- lieben Sonne Antlitz -- 
  still verfließen unterer Land Sonntag -- besonderes ahnt Mensch -- gestrig Schreck redet -- verlaufen Emme verursachen -- 
  Nachmittag schwarz Wolkenrand oberer Berg erheben -- rand Blitz Regen -- dumpf Donnerlaut drang zuweilen unter Tal -- achten -- gewöhnlich -- 
  Dunkler Himmel -- Tropfen fallen spärlich -- streichen schön Regen über Land -- Tabakspfeife rüsteen gelassen Mann -- sonntäglich Schoppen nachgehen -- 
  Mensch wissen Stunde -- Mensch selber Stunde -- selten glücklich Stunde vergönnen -- 
  donnern schrecklich seltsam Berg friedlich sonntäglich Gelände -- näh näh -- bleich Schreck legen Gesicht Mensch -- meister kannen Donner -- schrecklich nah nah donnern -- 
  alte kennen -- selten gehören -- nennen -- sagen -- Emme Gebrüll -- Jahrhundert selten zweimal hören -- 1764 vernehmen -- stürzt Menge Ufer -- Brücke -- 
  fließen Trüb matt Strom Brücke -- Windstöße strich näh nah wälzt Donner -- 
  Lebendig -- schwarz Bette Emme -- schauerlich Gewimmel rolln heran -- ungeheur Leib -- tausend Glied durcheinander wanden -- fahren -- schlangen bargen -- 
  Druck Luft -- schwer Mergel gesättigt Strom treiben rollend -- polternd Maß leicht Holz -- 
  Stirn wappnen desto wilder Anlauf -- 
  entsetzlich schauen -- Holzstoß -- unsichtbaren treiben -- wirbelen -- Stück Leben -- suchen jeder retten -- 
  spritzt dunkel Geröll grau Wasser -- Woge Woge bäumen hoch empor -- Häupter zerschlugen Brücke -- Zunge leckt Tentsch -- 
  entsetzen schäumend Wut hinein -- Hausgerät tanzen jeglicher Art -- Bütten Spinnräder jagen -- Tisch Zuber treiben -- Korb -- Wieg fahren -- Stück Haus Brücke anfuhren -- 
  jeder Herz brechen Jammer entsetzlich Unglück -- -- Zeuge laut brüllend Strom Auge vorüber führen -- 
  leichtern Gerät führen gewaltig Tanne -- Tausend Tausend -- Säg Wälder -- stürmt Brücke -- stauchen Hundert -- schmettern Trämel Trämel Joche -- schleudern wütendem Grimm Tann Schwefelhölzer aufgestaucht Haufen Brücke empor -- umsonst -- 
  wälzt Dach gebrochen Brücke heran -- sperren Bahn Jochen mitten Strome -- werfen Tanne Tanne stemmt unermeßlich Gewalt Gewicht Brücke -- bog -- kracht -- spritzt Wasser jauchzender Gebrüll -- 
  jäh Schreck ergreifen Mensch Brücke -- tragen zitternd Glied sicher Grund -- angstvolle bangen klemmen Herz Umstehenden -- Mensch Brust stockt Stimme -- 
  Nachbar fassen arm Nachbar -- -- -- hörbar lautlos Menge -- 
  zerschlug Wut Strom Werk -- schmettert ungeheur Baum schwellend Dach -- Brücke bohrst Dach verschwinden Brücke bäumend Welle -- 
  Durchgang Wasser öffnen -- Stimme frei Mensch Brust steigen freudig Gottlob Opfergabe empor -- verderben Schranke setzetn -- 
  Ärgste erwarten -- blind Wut Weg verlegen -- helfen Gott -- maßlos Wut müssen Zweck zerstören -- 
  Gefahr vorüber -- bringen Augenblick -- Wasser nehmen -- frisch Tanne stürmen -- 
  Brücke beben ununterbrochen Holz- Wasserstöße -- 
  Post wagen hinüber -- verwegenst Mensch betran -- 
  Nacht -- Wolke liegen Himmel -- deckt Mond -- Donner unsichtbaren Flut erfüllen dreifach Grausen Mensch -- 
  zuweilen rissen Wolke auseinander -- Spalte werfen Mond Licht Wasserwüste -- blass Strahl erleuchtet Streife schauerlich Bild -- 
  Spitze Wog Silber funkeln -- Tann Wasser bäumen wiegen -- riesig Schlange -- Baum heben -- dunkel Äste strecken flimmernd Wellenschaum -- ungeheuer Kracken ähnlich -- Arm ausbreitet ungewohnt Wasser -- 
  plötzlich schließen Spalt Wolke -- Licht schwand -- Nacht graus Bild versinken -- Donner Flut hören vorüber fahren -- 
  -- 10 war_es -- nehmen Wasser -- groß Gefahr vorüber -- Aufregung Mensch -- 
  Ruhe Mann -- Angst unbekannte -- geschehen -- Trieb -- vernehmen -- wissen -- treiben Schoppen -- Emme abgerufen -- 
  Windesflügel fliegen allerlei Kunde Fluß hinauf -- Fluß hinab -- wissen bringen -- woher -- elektrisch Schlage Ohr -- Mund sprechen gläubig -- 
  halb Dutzend Dorf zerstören -- ungezählt Menschenleben verlieren gehen -- nennen Name -- erzählen Tod Art Weise -- 
  Rügsaubrücke fünfzig Leben Tod Beute -- Lochbachsteg -- desto vornehm -- Brücke Burgdorf -- Kirchberg Bätterkinden brechen -- wissen genau -- 
  -- Ferne zugetragen -- erzählt Ding -- Ort Stelle vorgefallen -- befreundet Auge sehen -- erzählen -- bildet Zweitemal innig Überzeugung Wahrheit -- sehen -- 
  Brücke Lützelflüh erzählt Kühen -- lebendig durchgeschwommen -- Kind -- schlafend Wiege -- Mann -- Tanne Brücke durchgeritn Auge -- 
  erzählen -- 
  Klapperplatz -- Stunde oberhalb Lützelflüh Emme Bäuerin samt Roß Wagen fortgenommen -- Brücke durchgefahren -- Roß eingespennen lebendig voraus -- Bäuerin Bolzgrade -- munt Fett hinten Sitz -- Leitseil Hand -- rot Nastuch -- Auge trocknen -- Brücke kommen -- Leute -- 
  gut Abend geben ech Gott -- 
  erzählen -- 
  aufrechtstehend Kirschbaum dachergeschwommen -- Seelenangst zugekirset -- 
  Brücke kommen -- Kratt -- voll -- Leute entgegengestrecken -- nähen -- d'r mögigen -- 
  merkwürdig Sache -- Unglücksfäll Ort Stelle -- Unglück walten -- Ding erzählen -- Haar Berg stehen -- lauter Lug Trug -- geglauben Evangelium Mann Mann -- entstehen -- kommen -- ergründen -- 
  selten bedeutend Unglück ereignen -- besonderer Zeichen ankündigen -- 
  Mensch Schoppen sitzen -- erzählt Unglücksfälle sattsam verhandeln -- Nacht geheimnisvoll Schauer nah Mitte rücken -- -- 
  furchtbar Wassernot jüngst voraussagen -- Wort achten -- 
  Holzhändler -- erzählen -- Wald Rötenbach besichtigen Kröte frösch Tangrotz antreffen -- 
  Tiere Höhe flüchten -- sicher Zeichen nah Wasserflut -- sicher Erde sein -- 
  wissen -- Anderer -- kommen -- merkt Katze Erdbeben flüchten -- 
  bestimmt wissen -- Emme anlaufen -- 
  vergangen Nacht gehören -- Pfähl schlagen Läng Emme -- hören -- anlaufen -- 
  wissen Pfähleschlag -- gehören vergangen Nacht -- bezeugt -- sicher Vorbedeutung -- gerne vernehmen -- eigentlich -- herrühren -- wissen -- 
  still Ecke Männlein sitzen Wort -- 
  ausraufen -- reuen Fünfbätzner -- -- erzählen -- Punktum Wahrheit -- Pfähle schlagen Emme Wehre Schwelle -- müssen -- hören deutlich Streich Streich -- 
  männch Mund sprechen -- Versprechen halten -- wollen erzählen -- schwellen müssen Mitternacht jeglicher Wassergröße -- Großmutter Hundertmal erzählen -- wissen gegenwärtig meister Leute -- 
  alsobald schön Lohn verheißen -- beginnen -- unten lesen -- 
  -- Schloß Brandis gestehen -- verbrennen -- Franzose kommen -- wissen -- schön Schloß -- breit sehen -- schön stehen Land -- 
  hundert stehen Schloß Brandis gleich Stelle -- steilen Hügel oberhalb -- umh Land hinein Graben -- 
  haust Freiherro Brandi uralt Zeit -- reich grimmig Geschlecht -- sicher Feind wohnen Schild angehörige -- Herr Sinn fallen -- tun -- müssen dulden -- Klage -- 
  Zwingherr -- erzählen -- Grimmigst -- ärg Vieh behandelt Leute -- 
  grausam reich -- tun Leute -- müssen jagen -- fisch -- pflügen -- holzen u. S. W. -- vielmehr Verbriefet -- 
  Gewalt -- fragt Brief -- 
  breit Land -- 
  sitzen hoch Turm schauen über Land -- schaun -- arbeiten -- schaut müßig Hand -- 
  lässig matt -- sprengen Fuchsrotem Hengste züchtigt unmenschlich Weise -- geißelen Abends Schloßhofe Hand -- 
  Arbeit fordern -- essen -- bleiben Kraft -- entrinn Peitsche -- müssen essen -- Weiber Kind pflanzen -- Weiber Kind müssen arbeiten -- Mann tun -- 
  selten -- laut pergamenten Brief schuldig -- 
  -- Wort redet Brief -- -- Turmloch werfen Kröten schlangen lassen Zwingherr vermodern -- 
  weithin durch Tal hört gefangener schreien jammern -- Freiherr Hunger -- giftig Ungeziefer marterten -- 
  -- Leute Winter arbeiten -- holzen -- schwell Emme -- Schwelle weg Herbste Emme eingebroch grob Unheil anrichten -- 
  -- Farbe Bleiche stehen -- 
  müssen unnötig Bau Zwingherr bauen -- zornig Ungeduld preßen Mensch Vieh fast Leben -- 
  -- merkt Märztage Müller Abends -- Flühluft -- Föhn -- Berg kommen warm Italien -- Stieggrad schwarz Weg bekommen -- unten -- sicher Zeichen eintretend Tauwetter -- 
  -- Marei -- Frau -- Stein führen Oberburg -- verflucht Bau -- -- 
  Sieh Stieggrad schwarz Streife grausam Schnee Flühn liegen -- 
  Schmilzt Schnee schwellen -- nehmen Emme Haus Mühle weg -- 
  -- früh auf Schloß -- Herr sagen -- schwellen -- Nutzen -- Nutzen -- Verstand -- 
  -- Uli -- Frau -- Schloß gehst Leib sterben -- Verstand such Herr -- 
  -- Emme nehmen Mühle weg -- Herr schlagen Kopf -- Mühl bauen -- Kopf kriegst -- Herr dein einschlagen -- -- -- 
  -- Müller Frau -- mühle leiben -- kopfe traut -- halb Nacht disputieren -- war_es gewohnt -- Schlafe stören -- 
  -- Schlief -- -- Schloß -- betet Kirche Lützelstüh -- Weg liegen -- Vater -- selber beten Müller -- sogar Wirt -- 
  -- Müller mächtig Mann -- Rücken Tennthor breit -- Bein schwer -- Schloßweg aufgehen -- 
  früh -- Schlos gewaltig Lärm -- hunde bellten Hof -- Pferd wieheren -- Knecht klirrten Waffe mitten Hof stehen demütig Bäuerlein -- 
  -- Bären Herde brechen Spur nachgehen -- führen Hölle -- dunkler Waldgrund Egg -- Lützelflüh Affoltern -- 
  Hölle umgangen -- Bären -- Rache treiben Schlos -- Ritter Bären verraten -- 
  treiben -- freiwillig Schlos -- 
  bett Freiherr fahren -- Jagd befohlen -- befohlen -- Bäuerlein treiben -- lechzen Bärenstreit Bärenfleisch -- Bauernfleisch liegen -- Müller treten Hof -- rasselnd schwer Rüstung -- fast Schuh -- rot augenbraun fast fingerslang -- 
  grau augenpaar blitzen wild Hof -- Flüche donnert bärtig Mund Knecht -- langsam schien Bärenbrunst -- 
  Müller Herz Hand -- stellen Gesicht bitten demütig Gebärde dringlich -- hoch Herr gestatten -- Haus bleiben -- schwellen Emme -- gehen Haus Hof Grunde -- 
  Flühluft gehen -- Stieggrad Weg fast breit Schloßweg -- regne warm Berg Schwelle -- Freiherr sehen -- 
  reden -- schlagen eisern Handschuh Ritter Müller auf Maul -- donnert Wort -- 
  -- -- Stein lassen -- Bären hilfst treiben -- Stein fährstn -- mühl -- Emme -- kümmern -- 
  Müller ansetz Rede -- Ritter -- Roß -- schlagen Kopf Eisenfaust -- treiben bäumendem Rosse Tore hinaus -- voran schmelzend Schnee müssen Müller Ritter -- 
  alt Buchenlaube wischen Müller blutend Gesicht -- wutblutend Herz Laube abwischen -- 
  -- rasch riten Ritter Hölle -- voran Müller -- erwarten darinnen -- rasch treiben Knecht keuchend Bäuerlein -- 
  hinaus kommen -- Neuegg liegen -- außen Egg -- finden Bärenspur führen schnurstracks Hölle -- 
  Schlucht umgangen -- Jäger verstellen -- Hund bleiben koppeln -- Bäuerlein beginnen treiben -- 
  Ritter wagen Bauer Hunde gefährlich Jagd -- 
  -- Bären halten hart -- Wild gerne trocken Lager verlassen -- Sturm beginnen -- 
  stürzen -- fast berühren Treiber -- finsteren Schlund brummend zornig Dickicht -- schnurstracks Ritter -- 
  stehen -- abgesessen Rosse -- Schwert Spieß rüsten -- alleine Rinne -- Bären kommen -- stellen entgegen -- Mauer -- wehren handlich Schwert Spieß -- wütend Bären Ritter -- abgesess Rosse -- darhalen -- 
  Müller -- Treiber -- Ritter Drangsal -- gedacht bied Schweizermann -- -- Bärennot Mensch -- Ritter springen Hilfe schnell Bären fällen -- liegen tot blutig Grund -- 
  -- Ritter sitzen Roß -- Schlitten Bären legen -- Bäuerlein ziehen Schlitten -- Müller ziehen Schlitten -- Wort Dank Ritter -- 
  mühselig ziehen -- 
  warm Wind gekommen Regen Schnee Boden aufgeweichen Müller Kraft nötig -- 
  Schaufelbühl vorbei ziehen hervor Hochwacht kommen -- niedersiehen Emme Furrenfluh -- unterhalb -- diesseits Stromes -- Mühle stehen -- sehen Emme tobend Wut Land brechen -- Farbschache niederfluhten -- 
  lassen Müller ungefragt Schlitten fahren -- stürzen Wald Weide Tal hinab -- nächster Weg Mühle -- 
  finden -- finden Halde Weib Kind -- Säugling fehlen -- 
  Nachbar halten verzweifelnd Weib -- Flut stürzen -- ertrunken Kind -- 
  lautlos -- gerungen Hand stehen Müller wild Wasser Halde Rand -- 
  Fuchsrotem Hengste Ritter angesprengen -- fahren Tobe Drohen Müller -- ungefragen unerlaubt Schlitte verlassen -- 
  -- heben Fäuste ballen Ritter nennen Kindesmörder Teufel leibhaftig Sohn -- 
  schmettern Ritter Streitaxt Retter nieder -- Wort Dank -- geborsten Schädel stürzen rücklings Halde hinab wild Flut -- 
  Müllerin Ritters -- reißen haltend arme -- heben Himmel Hand verflucht Ritter -- Ruhe Grab sollen -- Emme -- Emme schwellen müssen dunkel Nacht -- drohend Wassergröße -- stürzen Mann Kind Welle -- 
  betäubt Menge blutig Kreis Müller gebrochen Schädel Wasser niederziehen -- hochausgestrecken fluchend Hand Müllerin -- 
  Trotzig Ritter betäubt Menge verschwindend Leiche -- trotzig -- würdig trotzig Geschlecht -- riten Heim trotzig gebärden -- 
  unsichtbar Gewalt scheinen mächtig Leib verzehren -- fallen sichtbarlich -- ehe Flühluft Bergen -- trotzig Freiherr Brandis begraben Lützelflüh -- 
  liegen tief Kirche Chor -- Grabmal sehen -- 
  -- Flühluft Berg wehen -- Stieggrad schwarz Streife zeigen -- heiß Dünste wettern Berg -- regen stöhnen Ritter Grab -- 
  -- schwer Streitaxt fassen knöchern Hand -- eisern Gewande Emme -- rot augenbraunen flatternd Nachtwinde -- 
  locker Pfähle Schwelle sehen -- festschlag Streitaxt -- einschlag -- Not tun Mensch wahren -- Klopf Schlag -- dunkl Nacht schauerlich Fels Fels hallen -- Anwohner warnen -- wehren wahr Emme Schwelle Eigentum -- stehen -- Müller erschlagen -- wittern Morgenluft -- Augenbraun flattern Morgenwinde -- Mühl herauf Hahn krähen -- Grabe Moder -- 
  Bann drücken gewaltig stolz Familie -- 
  schwer Geld kundig Mönchlein lösen -- Glaube -- Geld Gewalt -- trotzig -- 
  Mönchlein sprechen lang Forsche -- 
  Bann lösen -- Fluch Ritter wecken Grab -- rufen Emme Schwelle Wehre -- Emme zehmen -- Schwelle brauchen -- Herr Müller drücken -- Freiherr vergessen -- 
  -- erschrak Familie -- -- Fluch überleben -- verkauft Haus Hof -- 
  grauenvoll Ahnherr schwell Hämmer hören hoch Schloß dunkl Nacht -- Schwelle Wehre Leibeigen -- 
  alt müssen bleiben -- wohin Fluch bannen -- Familie ziehen Bündnerlande -- wohin wenden -- Fürder bleiben -- Fluch lösen -- Emme zehmen -- Freiherr vergessen -- -- 
  sprechen Männche -- weitläufig lesen -- 
  zuhörern manch kalt Schauer Haut laufen -- wohlig um Herz -- Schoppen -- bezahlt -- zählen -- 
  Nacht Schoppen zahlen ungezählen -- Männche Nacht erzählen -- 
  endigen -- endigen -- Türe -- Ruck gab_es -- manch Glas fallen Erde manch anderer verschütten -- Türe sehen alt Ritter -- rot Augenbraun -- flatternd Nachtwinde -- 
  kaltblütig -- sehen Ritter -- Postillon zurückgeblieben Post -- Pferd Stube Stiefeltritt -- rot Augenbraun flatternd Gesicht -- 
  fröstelt Rücken -- daheim -- Kopf Hauptkisse -- 
  fehlen Schlaf -- beginnen Bett schwimmen Emme -- Trämel Trämmel fahren -- Anderer Bäuerin fahren Wägelein rot Schnupftuch Auge wischen -- recken Hand Kirschenkratt -- Brücke herein reichen -- reckt recken -- erlangen -- Bärenjagd -- meinen Müller fühlen Ritter Streitaxt Schädel -- 
  Schliefe weich Bett -- Schuttstatt Lager -- teuer Haupt verlieren gehen -- Engel Hauptteten wacht -- selbsteigen Schuld -- 
  Bericht -- Berg vorgehen -- vernehmen folgenden -- 
  hören -- Dunst Nebelmas -- 8 Land herum wettern -- Samstag Zug Berg umsonst versuchen -- sammeln oberer Täler Emmenthal -- diesseits Berg -- Emmenthal scheid Oberland -- 
  nebelschaaren -- Wolkenheere entboten -- loszureiß Täler -- Höhe -- -- 
  Windesflügel -- Windessause -- Heer Heer kommen -- Hohnegg lagern -- -- grauenvoll Maß ballen -- durchzubrech Tunertal -- lüsternen Städtchen weg Weg bahn frommeren Land sinnlicher Land -- 
  Minute Minute Dichter grauenvoll ungeheuer dunkel Wolkenknäuel -- Wand Hohnegg legen -- Gipfel beugen suchen -- leicht durchgegange schwer beladen Wolkenmas -- 
  alt Bernerberg wanken -- ungeheuer Andrang -- klug Beuge schienen -- 
  Wolkenheere tausend Stimme heulend -- tausendmal fürchterlich tausend Hunnenheern -- herangestürmen -- schweigend trotzig Majestät Berg liegen kühn Weg sperren alt Schweizerweise -- Feind hineinließ Land hinaus -- 
  hoch hoch Knäuel heben -- schwere niedergedrücken -- ergrimmen fürchterlich Wut -- feurig Schoße Blitz Blitz schleudern Berg Gipfel -- Sturm Donner erschüttern versuchen Berge Grund Seite -- 
  umtoset grimmigst Wetter alt Bernerberg wanken -- Haupt gebeugt zornerglühen Blitzesstrahl -- 
  schwarz Leichentuch -- durchwirken feurig Blitz -- Wolkenheer tief senken ergrauend Erde -- plötzlich ungeheur Wolkenschoß zerrissen -- entbund Wassermasse luftig Kammer -- Wassermeere niedergefluten Berg Täler -- Wasserströme stürzen Himmel -- Wasserströme Seite Berg nieder -- ungeheuren Strome Rötenbach -- Talgrund Bett Flut -- Rücken Welle wilder Tanze Wald Haus fahren -- 
  Donner verhallen -- Blitz leuchten -- Himmel Berg Erde Wasser kommen -- Tal hinunter -- Wirbel ergreifen -- verschlung -- alt Chaos -- 
  Mensch erkennen Gott Gewalt Sündenschuld -- jung angebrochen -- meinen -- bitten -- Gott Gnade Schuld Vergebung -- 
  -- Schreckens Posaune verstummen -- Mensch Auge aufgehen Zeitliche -- 
  weit Grab sehen vergangen Herrlichkeit -- stundenlang Grab -- grau graus -- stehen weinend Mensch -- jammern untergegangen Herrlichkeit -- wiederkehren -- -- 
  Herrlichkeit wiedergekehren verheert Täl blühen herrlich -- Zeichen Gott -- Irdische vorübergehen -- Freude Herrlichkeit -- Leid -- Graus -- 
  gelb Vögelein arm Margrithli -- 
  stübch beginnen dunklen -- 
  Fenster sitzen alt Mütterche -- schürz hingen munter Enkel -- 
  draußen hingen Baum voll Schnee -- bissig Kälte Scheibe beginnen Blume bilden -- 
  gewaltig plagt Großmütterli -- erzählen -- Großmütterli klagen -- wissen -- 
  Erdmännchen erzählen -- Leutche lieben Kind allerlei schön Gfätterzeug bringen -- schön Feefrau -- Walde verirrt Kind heimbrächen -- mäusch Großmütti -- wissen -- 
  Kind lassen Bat Fort fort -- Großmütti -- ume no Eis G'schichtli -- 
  rufen plötzlich eins Kind -- 
  -- Lüget -- lüget schön Gäll Vögeli -- Fenster steitn Spatz u gwungerig -- Stübli lügen -- 
  Großmütti lüg -- schön gwungerig isch -- dürfen ne Brodbrösmeli Gäh us dr Tischdrucke -- -- 
  Großmutter -- meister Großmütter -- abschlagen -- fensterchen öffnen Brösmeli Sinzel streuen -- 
  vögelchen flog Öffn Fenster nächster Baum -- -- flattern emsig herbei -- vergaßen kalt Füßch -- vorhin herabhängend Gefied erwärmen suchen -- 
  Kind freuen -- gelb Vögelein -- Gilberich -- Goldammer -- -- beschauen können -- 
  -- Kind weinen fast Betrübnis -- 
  absolut Großmütti wissen -- vögelchen wiederkommen -- hungrig -- mögen hingeflogen -- 
  Großmütti -- drängen Frage -- -- wollen erzählen -- vögelchen eigentlich -- kommen wohin fliegen -- müssen hübsch Still aufmerksam -- 
  Kind Freude versprechen -- Großmutter Prise -- fahren verkehrt Hand Nase beginnen folgend Geschichte -- 
  -- lieb Gott tausend Engelein -- brauchen Liebe Nutz Mensch -- 
  Engelein vieler Gattig -- manchmal sehen Engelein Mensch manchmal Vögelein -- 
  gelb Vögelein engelein Gott -- senden Winter Liebe Nutz arm Leute -- 
  Mann -- Frau Kind -- arm Leute -- -- verdienen -- manchmal verdienen -- 
  kalt stark regnen -- schicken Bauer -- Vater taunen -- Haus -- Lohn müssen daheim essen -- 
  arm Vater müssen anschaffen -- Kleid Kind -- Essen -- Hauszin bezahlen Winter Holz kaufen -- 
  Bauer Sprießen Behausung -- bieten manchmal -- fremd Holz stehlen wollen -- wollen Rosse heimführen -- 
  mager Geiß -- nehmen Milch -- Mutter manchmal Anke Milch Flasche -- zuweilen Schmutzig -- Suppe -- -- vermögen -- 
  -- Kind -- arm Leute -- Kind mager bleich -- sagen -- 
  -- brav Leute bleiben brav Leute -- 
  Vater Scheit fremd Holz -- Flachs -- Mutter spinnen bekommen -- einzig Näthlig -- 
  Kind schärften früh -- lieben Gott Himmel wollen -- Geringste nehmen -- Leute -- Herzenleid -- Kind versündigen sehen fremd Sache -- 
  O glustig sehen manchmal arm Kind schön Äpfel Birn Weg Boden liegen -- nehmen -- freundlich sehen schön rot backen gehen denken -- lieb Gott sicher schön rot Apfel saftig Birn zukommen lassen -- Getreu lieben Kind bleiben -- 
  -- Bauer Bäuerin -- arm Kind schön Äpfel vorbeiging aufhoben Hofstatt werfen -- Weg vertreten -- erhalten manchmal Scheibe voll Äpfel Birn schönsten bloß halbfaul Auflesobst -- 
  erhalten ungebetteln -- betteln Eltern hießen -- 
  verdienen -- Nüßlikraut zusammenzules Rabünzli -- Erdbeeren Brombeere -- Bein früh spät freuen kindlich herzlich -- arm Müetti Kreuzer Geld heimbringen -- Stückle Brot kaufen Schlückli Milch -- 
  alt Kind heißen Margrithli klug -- anschlägig -- diesig Mädchen -- 
  fast Haushaltung -- Mutter ungestört Spinnrad sitzen -- klein Kind Müetti -- lieblich geduldig -- 
  -- grausam kalt Winter -- Stein Bein Monat gefroren Kälte Haus drang -- -- stübch arme drang grausam -- 
  Vater Misch -- Moos -- Wand vermachen -- -- helfen -- 
  Fenster fallen fast faul Einzel heraus -- Türe schließen Seite Häuschen Bysluft Zweck -- 
  tüchtig Heize fruchten -- tüchtig heizen grundschlecht Ofen -- neu bau Bauer Vater Stein führen -- Sohn anderer brauchen -- 
  tüchtig heizen -- arm Leute -- Holz teuer -- Vater fast Taglohn brauchen -- Stube warm -- Kälte verdienen -- 
  Holz Geld gelten -- verkauft Leute verschenken -- 
  Leute Vater dürr Tannli geben erlauben -- Baum aufzuschneiden -- erlauben -- Leute selber brauchen -- sagen -- 
  arm Leute anfangen -- -- teur Holz -- desto schenken -- Verdienst Spinn -- alt Öfen Häuschen schlecht -- Großmutter -- 
  arm Leute schlecht Häusche anfangen -- wissen -- 
  kalt -- Biecht Wand -- heizen -- feucht naß kälter -- Bett dünn -- fast Nacht schlotterten -- arm Leute -- 
  -- Vater Kälte arbeiten dünn Kleid -- finden daheim warm Ofen -- Bett -- Erwarme -- kalt müssen Kälte hinaus -- 
  morgens Vater fort -- schrecklich Fieber -- -- Feuer liegen -- Eiszapfen -- spießen gusle -- schüttelt -- fast häusch zitteren -- Angst -- eng Häuschen -- 
  Frau Kind Angst Aetti -- Stunde Bett herum fragen Augenblick -- o Aetti -- Aetti bessern no nüt -- 
  Mutter Säckle Hämpfeli Bocksbart -- geschwind Tee -- Fieber abnehmen -- 
  jammeren -- dürr Kirsche -- für Fieber Besseres trinken -- sagen Leute -- arm Hing -- -- dürr Kirsche -- 
  Margrithli Stich durch Herz -- Vater gut -- Kirsche trinken -- -- Vater stöhnen jämmerlich -- 
  Margrithli leis Türe hinaus -- arm Vater Kirsche -- Mal betteln -- 
  wissen Frau -- Wort geben -- Kirsche geben -- denken -- 
  irren -- Kachele voll -- halb weinend bitten versprechen -- wollen Sommer Camille z'säme lesen -- wollen -- Geld kein -- grausam arm wüßten -- Aetti verdienen können -- 
  -- aetti verdienen -- arm -- kält stübch -- 
  Kind gehen Wald -- dürr Äste zusammenzulesen -- Wald erlesen -- finden -- bloß Hämpfeli -- -- Tag Warmes -- grausam kalt -- erleiden -- 
  fallen tief Schnee arm Kind Wald -- Holz -- Warme -- 
  entlehnten paar Scheiter -- paar -- Ort entlehnen -- unverschämt -- -- 
  wissen entlehnen -- elend Vater -- kält Bein backen -- deckt -- vermochn -- 
  halten Margrithli Jammer -- 
  denken -- lieben Gott sicher zürnen -- betteln gehen Not -- Leute Herz geben Reichtum -- arm Kind helfen -- Aetti Müeti krank -- 
  schlich leis Türe hinaus streng Kälte -- Nähe betteln -- gut Frau -- Kirsche geben -- 
  nächster Dorf -- Leute wohnen -- Holz gäben Kreuzer Geld -- kaufen -- 
  Fror grausam -- arm Meiteli -- Bysluft -- 
  durchsichtig Hemmeli -- dünn indiennig Tschöpeli -- bös kurz Kitteli -- abgeschabt Strümpfche ausgetrappen Schuh -- Treten blutt Fersere Kälte -- Gloschli -- Pfäffli -- Händschli -- kalt Hand baulich Schäubeli -- wärmen -- 
  laufen nächster Dorfe -- näh -- desto ängstlich -- betteln fremd Leute -- 
  Haus -- fast doppeln doppelt Leise -- hören -- -- redet leise -- Frau verstehen -- kalt Bysluft ungeduldig -- anschnauzen -- Maul gönnen mögen -- söll gheie -- Küchentür zuschlagen -- 
  fast nächster Haus stehen -- ehe künden wagen -- fühlen Angst Kälte -- 
  -- strecken Fensterläufterli Stückle Brot dar -- ehe Anliegen dartun -- Läufterli zuschieben -- 
  müssen fort -- müssen Haus -- allenthalben ähnlich -- 
  -- -- reden -- jammern Hand verwerfen -- Weise eingeübt Bettelkinder dick Bäuerinn weich Herz öffnen -- abwarten -- schüchtern Stimmlein Wort finden Not Vater Jammer -- 
  weint arm Kind -- -- Träne gefror Auge -- 
  gstabelig Herz nehmen -- irgendwo fragen -- Hineinkomme Ofen wärmen dürfen -- 
  sicher erlauben wahrscheinlich helfen -- Spinnerinnen gwunderig -- Bettelkind Ofen wärmen -- Bescheid Antwort geben -- schier wissen -- 
  -- fragen Herz leer Mitleid erwecken -- -- Schüchter Bettelkind kalt Winter -- gerne draußen Bescheid warten -- übel -- 
  treffen Haus Holz abladend Bauer bitten -- Bauer pressiert Antwort -- hinzusetzen -- kalt krank Vater -- 
  Bauer -- 
  führ Holz Haus -- Haus wegzuschenken -- -- Finger zeigen Waldeck -- Respe -- können seinetwegen Bündel nehmen -- 
  goß Freude arm Margrithli Wärme kalt Beinchen dünn Kitteli -- schnell böse Schuh erlauben -- eilt Walde -- 
  finden Haufen bauchig Respe Herz Leib lachen -- traurig -- -- wegzuschleifen vermögen -- 
  fast Kraft -- hoffen -- Weg -- fortkommen -- 
  rücken -- Dünkt Ihns -- mögen lang -- -- 
  Kälte scheinen tief Leibchen dringen -- 
  Glied schwer -- Leib matt Auge legen gewaltiger Gewicht -- zudrücken -- wachsen Lust -- Stücklein schlafen -- 
  kalt Vater daheim -- fühlen kalt Stübchen -- Auge leicht Ruck Respe -- 
  -- Weg hüpfen flattert gelb Vögelein -- warten fast -- fliegen Schritt sehen ihn freundlich -- sagen -- 
  Komme -- kommen -- näh arm Vater -- 
  -- dachen arm Kind -- Feck -- heim fliegen -- Vögelein verstehen -- heimsenden -- Mutter sagen -- Margrithli -- kalt schwer Auge -- 
  -- dunkl Auge -- dunkler gelb Vögelein -- obgleich nah bleiben -- 
  fühlen -- können -- schlafen müssen -- ehe Respe Niedersank -- bitten Gott -- Vögelein befehlen -- heimflög Mutter sagen möchten -- Margrithli schlaf Walde Holz arm Vater -- sollen geschwind -- ihn weck Holz holen -- 
  Vögelein schlafen lassen -- fliegen auf Gesichtchen -- pickt sanft backen Lippe -- Schlaf liegen bleiern -- wecken -- 
  fliegen schnell trüb Fenster schlecht Häuschen picken stark lockern Scheibe -- 
  -- Mutter gelb Vögelein Fenster picken -- 
  Margrithli schlafen niederlegen draußen Walde Respe -- Vater legen tief letzter Schlaf -- Auge geschlossen letzter Atemzug tun -- 
  Mutter Kopf legen Jammer hören Elend -- Vögelein Margrithli -- 
  erwacht Schlafe Erde -- folgend finden starr Leiblein kalt Walde Respe legen Vater Leiche auf Bett -- legen dunkel Grab -- wärm -- kalt Stübchen -- 
  -- gelb Vögelein traurig -- arm Margrithli Tod retten -- bat lieb Gott -- Winter aussend -- arm gut Kind Bettel ersparen -- arm Leute tief Elend bewahren -- arm margrithli sterben müssen dunklem Walde -- 
  lieben Gott freut Bitte schicken Winter -- 
  Winter kalt Schnee girret glitzert -- lassen gelb Vögelein Haus -- klein arm Hüttlein sehen -- fliegen Sinzel lug scharf stübche -- Not Elend -- stecken Schnäbelche Fuge Fenster -- merken -- kalt warm drinnen -- 
  Elend merken Not kalt Stübche -- fliegen reich Haus nötlich Fenster Bsetzi -- flattern Bäume herum -- Bäuerin merken -- fri arm Familie Nähe leid Not -- fliegen ängstlich Bauer herum Weg -- Holz fahren Holz schwer Geld fortführen -- mahnen -- arm Margrithli Weg Walde erfrieren -- Holz verkaufen keiner verschenken wollen -- flattern Förster -- holzsteigerungen reiten fahren -- ängstlich Bein -- schön gelb Vögelein -- möchten Herz schreien -- manch arm Margrithli frieren müssen -- betteln müssen umsonst -- Haushaltung fast erfrieren müssen -- Geld lösen Staatskasse -- Herz arm Margrithli -- 
  meister sehen gelb Vögelein Stadt -- Bern namentlich -- flattern -- meister befehl -- Fuß herum -- Gas -- setzen Fenstersinzel sehen kläglich wehmütig Stube hinein -- Herr berat Land -- möchten reden arm Margrithlen -- kalt stübch -- krank Vater -- trostlos Mütter -- 
  -- gut Vögelein Winter treulich Tagwerk -- lieb Vater Himmel sehen Herz achten -- Reiche Vornehme Vögelein -- Not arme erbarm Vorsorge treffen -- Fleißig betteln Not Margrithli erfriern -- herzen schreiben -- Segen -- sterben -- nehmen schön Himmel -- -- 
  erzählt Großmutter -- andächtig Kind zuhören geweinen arm Margrithli Not -- 
  Großmutter fertig -- sehen Gesicht sagen -- -- -- Großmüetti -- wüst King -- z -- Basel-Heiris krank u Hei nüt -- u Hei daheim nüt gefeit u Hei wissen -- u Niss de Vögeli cho mahnen -- 
  O Großmüetti -- gib -- gschwing Brot Milch -- Weine Ga bringen -- -- 
  -- Nei King -- Großmutter -- müßeen -- Bett -- Sellig nimmer vergeß -- Lüge -- nötig -- -- 
  Kind versprach halten -- vergaßen -- Not -- gelb Vögelein mahnen umsonst -- 