Reisebilder H. Heine -- 
  -- 
  Hamburg -- Hoffmann Campe -- 1826. Dedikation -- 
  Frau Geh -- Legationsrätin Friedrike Varnhag v. Ense widmen achtundachtzig Gedicht -- Heimkehr Verfasser -- 
  Heimkehr -- 
  -- 1823 -- 1824. -- Altar heilig Decke -- Diebe Scheuselige Blöße liederlich wunden -- 
  golden Kelchwein Gefühl -- gesoff Trunkenbolde -- 
  Rose -- stolz -- Tau Himmel empfangen -- Herberge giftgeschwollen Spinne -- 
  -- Immermann Cardenio Celinde -- 1ster Akt -- 3t Auftr -- -- 
  I. 
  dunkl Leben strahlen einst süß Bild -- süß Bild erblichen -- gänzlich nachtumhüllt -- 
  Kind Dunkle -- beklomm Gemüt -- Angst bannen -- singen laut Lied -- 
  -- toll Kind -- sing Dunkelheit -- Lied ergötzlich -- Macht_es Angst befreien -- 
  II. 
  wissen -- bedeuten -- traurig -- märchen alt Zeit -- Sinn -- 
  Luft kühl dunkeln -- ruhig fließen Rhein -- Gipfel Berge funkeln Abendsonnenschein -- 
  schön Jungfrau sitzet wunderbar -- golden Geschmeid blitzeen -- kämmen golden Haar -- 
  kämmen golden -- singen Lied -- wundersam -- Gewaltige Melodei -- 
  Schiffer Schiff Ergreift wild Weh -- schauen Felsenriff -- schauen hinauf Höhe -- -- 
  glauben -- Welle verschlingen Schiffer Kahn -- singen Lore-Ley tun -- 
  III. Herz -- Herz traurig -- lustig leuchten Mai -- stehen -- gelehnen Linde -- alt Bastei -- 
  Drunt fließen blau Stadtgrabe still Ruhe -- -- Knabe fahren Kahne -- angeln pfeifen -- 
  jenseits erheben freundlich -- winzig -- bunt Gestalt -- Lusthäuser -- Garten -- Mensch -- Ochs -- Wiese -- Wald -- 
  Mädchen bleich Wäsche -- springen Gras -- herum -- Mühlrad stäuben Diamant -- hören fern Gesumm -- 
  alt grau turm Schilderhäuschen stehen -- rotgerockt Bursche nieder -- 
  spielen Flint -- funkeln Sonnenrot -- präsentieren schulteren -- -- schösse tot -- 
  IV. 
  Walde wandle Wein -- Drossel sitzen Höhe -- -- springen Singt feine -- weh -- 
  -- schwalben -- Schwester -- können_es sagen -- Kind -- wohnt klug Nester -- Liebchen Fenster -- 
  V. 
  Nacht feucht stürmisch -- Himmel sternenleer -- Wald -- rauschend Bäumen -- Wandle schweigend einher -- 
  flimmeren fern Lichtchen einsamen Jägerhau -- -- verlocken -- sehen verdrießlich -- 
  blind Großmutter sitzen ledern Lehnstuhl -- Unheimlich starr -- Steinbild -- sprechen einzig Wort -- 
  fluchend nieder Förster rothköpfig Sohn -- werfen Wand Büchse -- lachen Wut Hohn -- 
  schön Spinnerin weinen -- 
  feuchten Träne Flachs -- Wimmernd Füßen Schmiegt Vater Dachs -- 
  VI -- 
  -- Reise -- zufällig Liebchen Familie finden -- Schwesterche -- Vater Mutter -- freudig erkennen -- 
  fragen Befinde -- sagen selber sogleich -- 
  verändern -- Gesicht bleich -- 
  fragt Muhme Base -- langweilig Geselle -- hündchen -- sanft Belle -- 
  vermählt geliebter Fragen nebenbei -- freundlich Antwort -- 
  Woche -- 
  freundlich gratuliert -- lispeln liebevoll -- 
  herzlich tausendmal grüßen -- 
  Schwesterche rufen -- 
  hündchen -- sanft klein -- toll -- ertränkt -- Rhein -- 
  gleichen geliebter -- -- lachen -- Auge -- elend -- 
  VII -- 
  sitzen Fischerhause -- schauen See -- Abendnebel kommen -- 
  steigen Höhe -- 
  Leuchtturm Licht Allmählich anstecken -- weit Ferne Schiff entdecken -- 
  sprachen Sturm Schiffbruch -- Seemann -- leben -- Himmel Wasser -- Angst Freude schweben -- 
  sprechen fern Küste -- Süden Nord -- seltsam Mensch -- seltsam Sitte -- 
  Gang duftet_es leuchten -- Riesenbaum blühn -- schön -- still Mensch Lotosblume knien -- 
  Lappland schmutzig Leute -- Plattköpfig -- breitmäulig klein -- kauern Feuer -- backen Fisch -- quäken Schrein -- 
  Mädchen horchten ernsthaft -- sprechen -- Schiff sichtbar -- dunkelen -- VIII -- 
  schön Fischermädchen -- Treibe Kahn an Land -- Komme setzen nieder -- kosen Hand Hand -- 
  Lege Herz Köpfchen -- fürcht -- Vertraust sorglos täglich wild Meer -- 
  Herz gleichen Meer -- Sturm Ebbe Flut -- schön Perle Tiefe ruhen -- 
  IX -- 
  Mond aufgehen überstrahlen Welle -- halt Liebchen umfang Herz schwellen -- 
  Arm holden Kind Ruhe Strand -- horchst Rausch Wind -- 
  zucken weiß Hand -- 
  -- Rauschen Wind -- Seejungfer Gesang -- Schwester -- einst Meer verschlingen -- 
  X. Wind ziehen Hosen -- weiß Wasserhos -- peitschen Welle stark -- Heulen brausen tosen -- 
  dunkl Höhe -- wild -- Regengüsse träufen -- alt Nacht alt Meer ersäufen -- 
  Mastbaum klammeren Möwe -- heiserem schrille Schreie -- flatteren ängstlich Unglück prophezeien -- 
  XI -- 
  Sturm spielen Tanze -- pfeifen Saust brüllen -- Heisa -- springen Schifflein -- 
  Nacht lustig wild -- 
  lebend Wassergebirge Bilden tosend See -- gähnen schwarz Abgrund -- türmen wissen Höhe -- -- 
  Fluchen -- Erbrech Bete -- Schallen Kajüte heraus -- halten fest Mastbaum -- wünschen -- 
  -- Haus -- 
  XII -- 
  Abend ziehen -- Nebel bedeckt See -- Geheimnisvoll rausch Wog -- steigen wissen Höhe -- -- 
  Meerfrau steigen Welle -- setzen -- Strand -- weiß Brüste quell Hervor Schleiergewand -- 
  drücken pressen tun fast Weh -- -- drückst fest -- schön Wasserfee -- 
  -- Presse -- arme -- drücken Gewalt -- erwarmen -- Abend kalt -- 
  Mond schauen blasser dämmrig Wolkenhöhe -- -- Auge Trüber Nasser -- schön Wasserfee -- 
  -- Trüber Nasser -- Auge naß trübe -- -- steigen Wasser -- Tropfen Auge bleiben -- 
  möwen schrillen kläglich -- -- 
  grollt branden See -- Herz pochen wild beweglich -- schön Wasserfee -- 
  -- Herz pochen wild beweglich -- pochen beweglich wild -- lieben unsäglich -- lieb Menschenbild -- XIII -- 
  Haus morgens vorüber gehen -- freuen -- lieb -- Fenster sehen -- 
  deinen schwarzbraun Auge Siehst forschend -- 
  -- fehlen -- fremd -- krank Mann -- 
  -- deutsch Dichter -- deutsch Land -- Nennt Name -- nennen -- 
  -- fehlen -- -- Fehlt deutsch Land -- Nennt schlimm Schmerz -- nennen -- 
  XIV -- 
  Meer erglänzen hinaus -- letzter Abendscheine -- sitzen einsamen Fischerhaus -- sitzen stumm alleine -- 
  Nebel steigen -- Wasser schwellen -- Möwe fliegen -- deinen Auge -- liebevoll -- Fiele Träne nieder -- 
  fallen Hand -- auf's Knie sinken -- weiß Hand Träne fortgetrunken -- 
  Stunde verzehren Leib -- Seele sterben Sehn -- -- unglückselig Weib Vergiftet Träne -- 
  XV -- 
  droben Berg -- stehen fein Schloß -- wohnen schön Fräulein -- Liebe Genoß -- 
  sonnabend küssen Jette -- Sonntag Julia -- Montag Kunigunde -- erdrücken beinahe -- 
  Dienstag fet Fräulein Schloß -- Nachbarschafts-Herren Dame -- kommen Wagen Roß -- 
  laden -- dumm -- 
  zischelnd Muhme Base merkten_es lachen -- 
  XVI -- 
  fern Horizont Erscheint -- Nebelbild -- Stadt Türmen -- Abenddämmerung hüllen -- 
  feucht Windzug kräuseln grau Wasserbahn -- traurig Takt ruderen Schiffer Kahn -- 
  Sonne heben Leuchtend Boden empor -- zeigen Stelle -- Liebste verlieren -- XVII -- grüßen -- -- Geheimnisvoll Stadt -- einst Schoß Liebchen umschlossen -- 
  -- Türme Tor -- Liebste -- 
  Anvertrauet -- sollten Bürge -- 
  Unschuldig Türme -- Stelle -- Koffer Schachteln Stadt verlassen schnell -- 
  Tor -- lassen Liebchen entwischen still -- Tor willig -- Törin -- XVIII -- 
  wandl alt Weg -- wohlbekannt Gasse -- kommen Liebst Haus -- stehen leer verlassen -- 
  Straße eng -- 
  Pflaster unerträglich -- 
  Haus fallen Kopf -- 
  Eile -- 
  XIX -- 
  treten Halle -- Treue versprechen -- einst Träne fallen -- Schlange hervor gekrochen -- 
  XX -- still Nacht -- ruh Gasse -- Haus wohnen Schatz -- längst Stadt verlassen -- stehen Haus Platz -- 
  stehen Mensch starren Höhe ringen Hand -- Schmerzensgewalt -- Graust -- Antlitz sehen -- -- Mond zeigen Gestalt -- 
  Doppeltgänger -- 
  bleich Geselle -- 
  äffst Liebesleid -- quälen Stelle -- Nacht -- alt -- 
  XXI -- 
  ruhig schlafen -- weisen leben -- 
  alt Zorn -- zerbrech Joch -- 
  Kennst alt Liedche -- 
  einst tot Knabe 
  Mitternacht Geliebte holen Grab -- 
  Glaub -- wunderschön -- wunderhold Kind -- leben stark tote -- XXII -- 
  -- Jungfrau schläfen Kammer -- Mond schauen zitternd hinein -- draußen singen klingen -- Walzermelodeien -- 
  mal schaun Fenster -- drunt stören Ruhe -- 
  stehen Totengerippe -- fiedeln Singt -- 
  einst Tanz versprechen -- gebroch Wort -- Ball Kirchhof -- Komme -- tanzen -- 
  Jungfrau ergreifen gewaltig -- locken hervor Haus -- folgen Gerippe -- singend fiedelnd schreiten voraus -- 
  fiedeln Tänzelt Hüpfet -- klapperen Gebein -- nicken nicken Schädel unheimlich Mondenschein -- XXIII -- 
  stehen dunkel Träum starren Bildnis -- gelieben Antlitz Heimlich leben beginnen -- 
  Lippe ziehen lächeln wunderbar -- Wehmutsträn Erglänzt Augenpaar -- 
  Träne fließen Wang herab -- 
  -- glauben -- verlieren -- XXIV -- 
  unglückselig Atlas -- Welt -- Welt Schmerz tragen -- trag Unerträglich -- brechen Herz Leib -- 
  stolz Herz -- 
  -- wolltest glücklich -- unendlich glücklich unendlich elend -- stolz Herz -- elend -- 
  XXV -- 
  -- Geschlecht steigen Grab -- nimmer vergehen Liebe -- Herz -- 
  sehen -- sinken auf's Knie -- sterbend sprechen -- madame -- lieben -- XXVI -- träumen -- traurig schaut Mond -- traurig scheinen Stern -- tragen Stadt -- Liebchen wohnen -- hundert Meile fernen -- 
  Haus führen -- küßen stein Treppe -- Fuß berühren -- Kleid Schleppe -- 
  Nacht -- Nacht kalt -- kalt Stein -- lugt Fenster blassen Gestalt -- Beleuchtet Mondenscheine -- XXVII -- 
  einsam Tran -- 
  trüben Blick -- 
  bleiben alt Zeit Auge -- 
  leuchtend Schwester -- zerflossen -- Qual Freude -- Zerflossen Nacht Wind -- 
  Nebel zerflossen blau Sternelein -- Freude Qual Gelächelt Herz hinein -- 
  -- Liebe selber Zerfloß eitel Hauch -- 
  alt -- einsam Tran -- Zerfließe jetzund -- XXVIII -- 
  bleich -- herbstlich Halbmond Lugt Wolke heraus -- einsam liegen Kirchhof 
  still Pfarrerhau -- 
  Mutter lesen Bibel -- Sohn starretn Licht -- Schlaftrunk dehnen alt -- jung Tochter sprechen -- 
  Gott -- langweilig Vergehen -- begraben -- Bekomm sehen -- 
  Mutter sprechen Lesen -- Irrst -- sterben -- dein Vater begraben -- Kirchhofstür -- 
  alt Tochter gähnet -- 
  verhungern -- gehen Grafe -- verlieben reich -- 
  Sohn brechen lachen -- 
  Jäger zechen Stern -- Gold lehren Geheimnis -- 
  Mutter werfen Bibel magre Gesicht hinein -- 
  -- Gottverfluchter -- Straßenräuber -- 
  hören pochen an Fenster -- sehen winkend Hand -- tot Vater stehen draußen schwarz Pred'gergewand -- XXIX -- 
  schlecht Wetter -- regnen stürmen Schneit -- sitz Fenster schau Hinaus Dunkelheit -- 
  schimmeren einsam Lichtchen -- wandeln langsam fort -- Mütterche Laternche Wankt Straße -- 
  glauben -- Mehl Ei Butter kaufen -- Kuchen backen Töchterlein -- 
  liegen Haus Lehnstuhl -- blinzeln schläfrig Licht -- golden Locke wallen süß Gesicht -- 
  XXX -- 
  glauben -- grämen bitterem Liebesleid -- glauben selber -- Leute -- -- 
  Auge -- -- unsäglich lieb -- Liebe Herz zernagt -- 
  einsam Kammer Sprache Art -- -- 
  geschwieg Gegenwart -- 
  böse Engel -- halten Mund -- -- bös Engel elend jetzund -- XXXI -- 
  weichen Lilienfinger -- küssen -- drücken Herz -- vergehen still weine -- 
  klar Veilchenaug schweben Nacht -- qualten -- 
  bedeuten süß -- blau Rätsel -- XXXII -- 
  -- äußern verliebt Wesen -- 
  Konntest Auge Niemals Gegenliebe lesen -- 
  Konntest Auge niemals Seele dringen -- 
  Esel -- Teurer Freund -- Ding -- XXXIII -- lieben -- gestehen -- sehen feindlich -- Liebe vergehen -- 
  trennen 'n zuweilen Traum -- längst sterben -- 
  wissen selber -- XXXIV -- 
  Schmerz klagen -- gähnen -- zierlich Vers bringen -- Elog -- XXXV -- 
  rufen Teufel -- Wund Runge -- 
  häßlich lahm -- -- charmant Mann -- Mann -- Verbindlich höflich welterfahren -- 
  gescheit Diplomat -- sprechen schön Kirche Staat -- 
  Blaß -- Wunder -- Sanskrit Hegel studieren jetzund -- 
  Lieblingspoet Fouqué -- 
  Kritik befassen -- gänzlich überlassen teuer Großmutter Hekat -- 
  loben juristisch Streben -- abgeben -- 
  -- Freundschaft teuer -- nicken -- fragen -- 
  sehen spanisch gesandter -- 
  besah Gesicht -- Fand alt bekannte -- XXXVI -- Mensch -- verspoten Teufel -- Lebensbahn -- ewig Verdammnis bloß Pöbelwahn -- 
  Mensch -- bezahlen Schuld -- Lebensbahn -- mußt manchmal borgen -- Gethan -- XXXVII -- heiligen König Morgenland -- fragen Städtchen -- Weg Bethlehem -- lieb Bube Mädchen -- 
  jung alte -- wissen -- König ziehen -- folgen golden Stern -- leuchten lieblich heit -- 
  Stern bleiben stehen Josephs Haus -- hineingegangen -- Öchslein brüllen -- Kindlein schreien -- heilig König sangen -- XXXVIII -- Kind -- Kind -- Kind -- klein froh -- kroch Hühnerhäusche stecken Stroh -- 
  kräht Hähn -- kommen Leute vorbei -- 
  Kikereküh -- glauben -- Hahnengeschrei -- 
  Kist unser Hof -- tapeziert -- wohnen beisammen -- machen vornehm Haus -- 
  Nachbar alt Katze öfters Besuch -- machen Bückling -- Knickse -- Kompliment -- 
  befind besorglich freundlich fragen -- alt Katze -- 
  sitzen sprechen Vernünftig -- alt Leute -- klagen -- -- lieb Treue Glaube Verschwunden Welt -- teuer Kaffee -- rar Geld -- -- -- -- vorbei Kinderspiel -- rollen vorbei -- -- Geld Welt Zeit -- Glauben Liebe -- Treue -- -- XXXIX -- 
  Herz bedrücken -- sehnlich Gedenke alten -- Welt wöhnlich -- ruhig leben Leute -- 
  verschieben -- drängen -- Not -- 
  Gestorbe Herrgott -- unten Teufel tot -- 
  schauen grämlich trübe -- krausverwirren morsch kalt -- bissch Liebe -- geben -- nirgends Halt -- 
  XL -- 
  Mond leuchtend dränget dunkel Wolkenflor -- tauchen dunkel Zeit licht Bild hervor -- 
  saßen all Verdecke -- Fuhre stolz hinab Rhein -- sommergrün Ufer Glühen Abendsonnenschein -- 
  sinnend sitzen Füßen Dame -- schön Hold -- Liebes -- bleich Antlitz Spielt -- rot Sonnengold -- 
  Lauten klingen -- Bube singen -- Wunderbare Fröhlichkeit -- 
  Himmel blau -- Seele -- 
  Märchenhaft vorüberzog Berg Burgen -- Wald Au ' -- glänz Auge schön Frau -- 
  XLI -- 
  Traum Geliebte -- bang -- bekümmert Weib -- Verwelkt abgefall blühend Leib -- 
  Kind tragen Arm -- anderer führen Hand -- sichtbar Armut Trübsal Gang Blick Gewand -- 
  schwanken Marktplatz -- begegnen -- sehen -- ruhig schmerzlich sagen -- 
  Komme Haus -- blaß krank -- fleiß Arbeit schaffen Speis -- Trank -- 
  pflegen warten Kind -- -- selber -- armes -- unglücklich Kind -- 
  erzählen -- lieben -- stirbst -- Wein Grab -- XLII -- 
  -- Teurer Freund -- 
  nützen -- Stets alt Lied leiern -- 
  ewig brütend sitzen alt Liebes-Eiern -- 
  -- 
  ewig Gatter -- schalen kriechen Küchlein -- piepsen flattern -- sperrst Büchlein -- XLIII -- ungeduldig -- alt Schmerzenskläng vernehmlich kling neu Gesäng -- 
  Wartet -- verhall Echo Schmerz -- neu Liederfrühling Sprießt geheilt Herz -- XLIV -- 
  -- Verstand Torheit entledigen -- Komödiant spielen Komödie -- 
  prächtig Kulisse -- bemalt hochromantisch Stil -- Rittermantel goldig strahlen -- fühlen fein Gefühl -- 
  säuberlich toll Tands entledig -- elend fühlen -- spielen Komödie -- 
  Gott -- Scherz unbewußt Sprache fühlen -- Tod Brust sterbend Fechter spielen -- 
  XLV -- 
  König Wiswamitra -- treibt_es Rast Ruhe -- Kampf Büßung erwerben Wasischtas Kuh -- 
  O -- König Wiswamitra -- O -- welch Och -- kämpfest Büßest -- Kuh -- XLVI -- Herz -- Herz beklommen -- ertragen Geschick -- neu Frühling -- Winter nehmen -- 
  bleiben -- 
  schön Welt -- 
  -- Herz -- fällen -- -- lieben -- XLVII -- Blume -- Hold schön rein -- Schau -- Wehmut Schleicht Herz hinein -- 
  -- Hand Haupt legen -- Betend -- Gott erhalten rein schön Hold -- XLVIII -- Kind -- 
  verderben -- geben selber Mühe -- lieb Herz Liebe Nimmermehr erglühen -- 
  mir_es gelinget -- dennoch fast betrüben -- denken manchmal dennoch -- 
  Möchtest dennoch lieben -- XLIX -- 
  Lager liegen -- Nacht Kissen hüllen -- schweben süß -- Anmutig lieb Bild -- 
  still Schlummer Geschlosse Auge -- schleichen Bild leise Hinein Traum -- 
  Traum morgens Zerrinnt nimmermehr -- trag Herzen umher -- 
  Los Mädchen rot Mündchen -- Äuglein süß klar -- lieb -- Mädchen -- denken -- immerdar -- 
  Winterabend -- -- sitzen -- schwatz -- vertraut Kämmerlein -- 
  Lippe pressen -- weiß Hand -- Träne benetzen -- -- weiß Hand -- LI -- draußen Schnee türmen -- hageln -- stürmen -- Klirrend an Fenster schlagen -- Nimmer beklagen -- tragen Brust Liebchen Bild Frühlingslust -- LII -- 
  bet Madonna -- Paul Peter -- -- beten -- schön Sonne -- 
  Gib Küsse -- gib Wonn -- gütig -- gnädig -- schöne Sonne Mädchen -- Schönst Mädchen Sonne -- LIII -- Verriet blasser Angesicht Liebeswehe -- 
  -- stolz Mund Bettlerwort gestehen -- 
  O -- Mund stolz -- Küssen scherzen -- spräch höhnisch Wort -- sterbe Schmerz -- 
  LIV -- Teurer Freund -- verlieben -- quäl Schmerz -- Dunkler Kopf -- Heller Herz -- 
  Teurer Freund -- verlieben -- bekennen -- sehen Herzens Glut Weste brennen -- 
  LV -- 
  weilen -- Seite ruhn -- Mußtest eilen -- hattest -- 
  -- Seele gänzlich ergeben -- lachtest voll Kehl -- machtesen 'n Knicks -- 
  steigern Liebesverdruß -- sogar verweigern Abschiedkuß -- 
  Glaub -- erschieße -- schlimm Sache stehen -- 
  -- Süß -- geschehen -- 
  LVI -- 
  fragmentarisch Welt Leben -- deutsch Professor begeben -- wissen Leben setzen -- verständlich System -- Nachtmütz Schlafrockfetz stopfen Lücke Weltenbau's -- LVII -- 
  Kopf zerbroch denken Sinn -- Nacht -- liebenswürdig Auge Entschluß bringen -- 
  bleiben -- Auge leuchten -- süß -- klug Pracht -- lieben -- nimmermehr denken -- LVIII -- 
  Abend Gesellschaft -- Haus lichterfüllen -- 
  hell Fenster Bewegt Schattenbild -- 
  schaust -- Dunklen Stehe unten -- schauen dunkl Herz hinein -- 
  dunkl Herz lieben -- lieben brechen -- brechen zuckt verbluten -- siehst -- 
  LIX -- 
  -- Schmerz ergössen einzig Wort -- geben lustig Winde -- tragen lustig fort -- 
  tragen -- Geliebte -- schmerzerfüllen Wort -- Hörst Stunde -- hörst Ort -- 
  nächtlichen Schlummer Geschlosse Auge -- Wort verfolgen tief Traum -- 
  LX -- Diamanten Perle -- -- Menschenbegehr -- schön Auge -- liebchen -- -- 
  schön Auge Heer ewig Lieder dichten -- liebchen -- -- 
  deinen schön Auge quälen -- Grund richten -- liebchen -- -- 
  LXI -- 
  erstenmal lieben -- glücklos -- Gott -- zweitenmal Glücklos lieben -- Narr -- 
  -- Narr -- lieb Gegenliebe -- 
  Sonne -- Mond Stern lachen -- lach -- sterbe -- LXII -- O -- gnädig Fräulein -- erlauben krank Sohn Muse -- schlummernd Ruhe Sängerhaupt Eurem Schwanenbusen -- 
  -- Herr -- wagen -- Gesellschaft sagen -- LXIII -- Gabe Rat Lehre -- Überschüttet Ehre -- Sagt -- warten -- protegieren -- 
  all Protegier -- Hunger krepieren -- -- kommen brav Mann -- Wacker -- 
  brav Mann -- 
  schaffen essen -- 
  nimmer vergessen -- 
  Schade -- küssen -- 
  brav Mann -- LXIV -- 
  liebenswürdig Jüngling verehren -- traktieren Auster -- Rheinwein Liquör -- 
  Zierlich sitzen Rock Hösche -- zierlich Binde -- -- Fragt -- wohlbefind -- spricht weit Ruhm -- Anmut -- Witze -- eifrig geschäftig dienen -- nützen -- 
  Abends -- Gesellschaft -- begeistert Gesicht -- Deklamiert Dame göttlichen Gedicht -- 
  O -- erfreulich -- Jüngling finden -- -- täglich Besseren schwinden -- 
  LXV -- träumen -- lieb Gott -- sitz Himmel droben -- Englein sitzen -- Vers loben -- 
  Kuchen Konfekt lieb Gulden -- Kardinal trinken -- -- Schuld -- 
  Langeweile plagen -- -- Erde -- lieben Gott -- Teufel -- 
  lang Engel Gabriel -- Gehe -- machen Sohle -- teuer Freund Eugen Sollst herauf holen -- 
  Suche Kollegium -- Such -- Glas Tokajer -- Suche Hedwigskirch -- Suche Mamsell Meyer -- 
  breiten Flügelpaar fliegen herab Engel -- packen -- bringen herauf Freund -- lieben Bengel -- 
  -- Jung -- lieben Gott -- regi Erde -- 
  -- Recht -- 
  Wunder tun -- entzück -- Spaß Stadt Ix-Ix beglücken -- 
  Pflasterstein Straße -- spalten -- Auster -- frisch klar -- Stein enthalten -- 
  Regen Zitronensaft tauig begießen -- straßengöss gut Rheinwein fließen -- 
  freuen Ix-Ixer -- an fressen -- Herr Landgericht -- saufen Gösse -- 
  freuen Poet Götterfraße -- 
  Leutnant Fähndrich -- lecken Straße -- 
  Leutnant Fähndrich -- klügsen Leute -- denken -- geschehen Wunder -- LXVI -- 
  schön Lippe fortgedrängen -- treiben schön arme -- fest umschlossen -- 
  bleiben -- Schwager Rosse -- 
  Leben -- Kind -- ewig Jammer -- ewig Abschiednehm -- ewig Trenn -- 
  Herz meinig umklammern -- 
  Auge halten -- LXVII -- 
  fahren dunkel Postwag Nacht -- ruht Herz -- scherzen lachen -- 
  morgens tagen -- Kind -- staunen -- 
  sitzen Amor -- blind Passagier -- LXVIII -- wissen Gott -- toll Dirne einquartieret -- fluchend -- Regenwetter -- Lauf Stadt -- 
  Gasthof hingerannen -- grob Kellner umsonst wenden -- 
  Erblick Fenster -- winken kichern Hell -- wissen -- bewohntesen -- Mädchen -- Pracht-Hotel -- LXIX -- 
  dunkel Traum stehen Haus lang Reih -- -- Tief einhüllen Mantel Schreite schweigend vorbei -- 
  Turm Kathedrale verkünden zwölft Stunde -- -- Reize Küssen erwartet Liebchen jetzund -- 
  Mond Begleiter -- leuchten freundlich -- Haus -- freudig ruf empor -- 
  danken -- alt Vertrauter -- Weg erhellen -- entlassen -- leucht übrig Welt -- 
  findest Verliebte -- einsam klagen Leid -- trö -- selber Getröstet alt -- 
  LXX -- Lippe wund küßen -- 
  Küsse Heil -- Abend fertig -- Eile -- 
  Nacht -- Herzallerliebst -- 
  solch Nacht küssen selig seyn -- LXXI -- 
  -- lich Weib -- beneiden -- lebst lauter Zeitvertreib -- lauter Plaisir Freude -- 
  Schiltst tobst -- geduldig leiden -- Vers lobst -- Laß scheiden -- LXXII -- 
  umschlang zärtlich Presse -- Seele gen Himmel fliegen -- 
  lassen fliegen -- unterdessen Necktar Lippe gesogen -- LXXIII -- dein schneeweiß Busen Haupt legen -- heimlich behorchen -- Herz bewegen -- 
  blas blau Husar -- reit Tor herein -- verlassen Herzallerliebste -- 
  verlassen -- -- dein schön arme doppelt selig seynn -- LXXIV -- 
  blasen blau Husar -- reit Tor hinaus -- kommen -- Geliebte -- bringen Rosenstrauß -- 
  wild Wirtschaft -- Volk Kriegesplage -- -- sogar herzch Einquartierung liegen -- LXXV -- -- jung -- bitter Leid erfahren Liebe Glut -- 
  Holz teuer -- erlöschen Feuer -- Ma foi -- -- 
  bedenk -- jung schön -- Schicke fort dumm Tran -- dummen Liebesharm -- 
  Leben bleiben -- vergiß alt Liebe -- Ma foi -- Arm -- LXXVI -- Himmlisch war_es -- bezwang sündig Begier -- wenn_es gelingen -- Plaisir -- LXXVII -- Blamier -- schön Kind -- grüß Linden -- nachher Haus -- 
  finden -- LXXVIII -- selten verstehen -- selten verstehen -- Kot finden -- verstehen -- LXXIX -- 
  Kastrat klagt Stimme -- erheben -- Klagte sagen -- 
  sängen grob -- 
  lieblich erheben Stimmlein -- Trillerchen -- Kristalle -- klingen Fein rein -- 
  singen Liebessehn -- Liebe Liebeserguß -- Dame schwamm Träne -- Kunstgenuß -- LXXX -- 
  Wälle Salamanka Lüfte lind labend -- -- holden Donna -- Wandle Sommerabend -- 
  schlank Leib schöne Arm gebogen -- selig Finger fühl Busen stolz Wog -- 
  ängstlich Geflüster Zieht Lindenbäum -- dunkel Mühlbach unten Murmelt böse -- bang Traum -- 
  -- -- Sennora -- Ahnung -- 
  einst relegieren -- Salamanka Wällen nimmermehr spatzieren -- LXXXI -- 
  sehen -- Auge Stimme Merkt -- gewogen -- stand Mutter -- schlimm -- glauben -- küßen -- 
  verlassen Städtchen -- eil fort alt Lauf -- lauern Fenster blond Mädchen -- freundlich grüß werfen hinauf -- LXXXII -- Berg steigen Sonne -- Lämmerherde läuten fern -- liebchen -- Lamm -- Sonne Wonne -- sehen -- 
  schauen hinauf -- spähend Miene -- 
  Leb -- Kind -- Wandre -- 
  vergebens -- 
  regen Gardine -- -- liegen schlafen -- träumen LXXXIII -- 
  Halle Markt -- stehen Löwe -- 
  Ei -- hallisch Löwentrotz -- zähmen -- 
  Halle Markt -- stehen Riese -- 
  Schwert regen -- Schreck versteinern -- 
  Halle Markt -- stehen Kirche -- 
  Burschenschaft Landsmannschaft -- Platz Bete -- LXXXIV -- schön -- wirtschaftlich Dame -- Haus Hof wohlbestellt -- Wohlversorgt Stall Keller -- Wohlbeackert Feld -- 
  Winkel Garten reuten putzen -- Stroh -- ausgedroschen -- Bett benutzen -- 
  Herz Lippe -- schön Dame -- liegen brach -- Hälfte benutzetn traut Schlafgemach -- LXXXV -- dämmernd liegen Sommerabend Wald grün Wiese -- Goldener Mond -- blau Himmel -- Strahlt herunter -- duftig labend -- 
  Bach Zirpt Grille -- regen Wasser -- Wanderer hören Plätscher -- atmen Stille -- 
  Dorten -- Bach alleine -- Badet schön -- Arm Nacken -- wissen lieblich -- Schimmern Mondenscheine -- LXXXVI -- Nacht liegen fremden -- -- Krankes Herz müde Glied -- -- -- fließen -- still Segen -- süß Mond -- Licht hernieder -- 
  süß Mond -- dein Strahl Scheuchest nächtig Graue -- zerrinnen Quale -- Auge überthauen -- LXXXVII -- Tod kühl Nacht -- Leben schwülen -- 
  dunkelen -- schläferen -- müde -- 
  Bett erheben Baum -- singen jung Nachtigall -- singen lauter Liebe -- hören sogar Traum -- LXXXVIII -- -- Sage -- -- schön liebchen -- einst schön besung -- zaubermächtig Flamme Wunderbar Herz durchdrungen -- 
  Flamme erloschen -- Herz kalt trübe -- Büchlein Urne asch Liebe -- Götterdämmerung -- 
  Mai golden Lichter -- seiden Lüft gewürzt Düft -- freundlich locken weiß Blüte -- grüßt tausend blau Veilchenaug -- breiten blumreich-grün Teppich -- Durchweben Sonnenschein Morgentau -- rufen herbei lieb Menschenkind -- 
  blöd Volk gehorchen Ruf -- Mann ziehen Nankinhosen -- Sonntagsröck golden Spiegelknöpf -- Frau kleid Unschuldweiß -- Jünglinge kräuseln Frühlingschnurrbart -- Jungfraue lassen Busen wallen -- Stadtpoete stecken Tasche Papier Bleistift Lorgnette -- -- jubelnd Zieht Tor krausbewegt Schar -- lagern draußen grün rasen -- Bewundert -- Baum fleißig wachsen -- Spielt bunt -- zart Blümche -- Horcht Sang lustig Vögelein -- Jauchzt hinauf blau Himmelszelt -- 
  Mai -- 
  klopfen dreimal Tür -- -- rufen -- 
  Mai -- bleich Träumer -- kommen -- Küssen -- 
  halten verriegeln Tür -- -- rufen -- 
  vergebens locksen -- schlimm Gast -- durchschauen -- durchschauen Bau Welt -- schauen -- 
  tief -- Freude -- ewig Quale ziehen Herz -- 
  schau steinern-hart Rinde Menschenhäuser Menschenherz -- schauen -- Lug Trug elend -- 
  Gesicht les Gedanke -- schlimmen -- 
  Jungfrau Scham-Erröten Sehe geheim Lust begehrlich zittern -- begeistert stolz Jünglingshaupt -- Sehe bunt Schellenkappe sitzen -- Fratzenbilder siech Schatten Sehe Erde -- wissen -- Tollhau Krankenhaus -- 
  sehen Grund alt Erde -- Kristall -- sehen Grausen -- freudig grüne bedecken Mai vergeblich streben -- 
  sehen tote -- liegen unten schmal Sarg -- Hand gefalten Auge -- Weiß Gewand wissen Angesicht -- gelb Lippe kriechen Würmer -- 
  sehen -- Sohn setzen Buhle Kurzweil nieder Vater Grab -- Spottlied singen ring Nachtigalle -- sanft Wiesenblümch lachen hämisch -- tot Vater regen Grab -- schmerzhaft zucken alt Mutter Erde -- 
  arm Erde -- Schmerz kennen -- 
  sehen Glut Busen wühlen -- tausend Ader sehen bluten -- sehen -- Wunde klaffend aufreißen -- wild hervorströmt Flamm -- Rauch Blut -- 
  sehen Riesensohn -- alt Nacht -- steigen Erde offen Schlund -- schwingen rot Fackel Hand -- legen Eisenleiter -- stürmen wild hinauf Himmelsfeste -- schwarz Zwerg klettern -- knisternd Zerstieb droben golden Stern -- 
  frech Hand reißen golden Vorhang Zelte Gott -- heulend stürzen nieder -- Angesicht -- fromm Engelschar -- 
  Throne sitzen bleich Gott -- Reißt Haupt -- Krone -- zerraufen Haar -- nah drängen heran wild Rotte -- Riese werfen rot Fackel Reich Ewigkeit -- Zwerg schlagen Flammengeißel Englein Rücken -- wind krümm Quale -- Haar fortgeschleuderen -- 
  Engel sehen -- blond Locke -- süß Zug -- ewig Liebe Mund -- Seligkeit blau Auge -- entsetzlich häßlich schwarz Kobold Reißt Boden -- bleich Engel -- Beäugelt grinsend edl Glied -- Umschlingt fest griechisch Umschlingung gellend dröhnt Schrei Weltall Säule brechen -- Erde Himmel stürzen -- herrschen alt Nacht -- 
  Ratkliff -- 
  Traumgott bringen Landschaft -- Trauerweiden -- Willkommen -- winkt -- lang -- grün arme -- Blume klug Schwesteraug still ansah -- vertraulich klingen Vögel Zwitscher -- Hund Belle scheinen -- Stimme Gestalt begrüßen -- alt Freund -- fremd scheinen -- wunderseltsam fremd -- 
  ländlich schmuck Haus stehen -- Brust bewegen sich_es -- Kopfe ruhig -- ruhig schütteln Staub Reisekleidern -- Dumpf klingen Klingel -- Tür -- 
  Mann -- Frau -- bekannt Gesicht -- 
  Stiller Kummer liegen heimlich scheu Angst -- 
  seltsam verstören -- Beileidsmien fast -- sehen -- selber Seele schaueren -- Ahnung unbekannt Unheil -- 
  alt Marg'reth ' erkennen -- forschend -- sprechen -- 
  -- Maria -- -- fragen -- sprechen -- Griff leis Hand -- führen -- leuchtend Gemächer -- Prunk Pracht Totenstille herrschen -- führen dämmernd Zimmer -- zeigen -- abgewandt Angesicht -- -- Gestalt -- Sofa sitzen -- 
  -- Maria -- -- fragen -- 
  Innerlich Erstaunt selber Festigkeit -- womit sprechen -- 
  Steiner metalllos Scholl Stimme -- 
  -- nennen Leute -- 
  schneidend Weh durchfröstelen -- hohl -- kalt Ton -- einst süß Stimme Maria -- 
  weib fahl Lilakleid -- Nachlässig anziehen -- Busen schlotternd -- Auge gläsern starr -- Wangenmuskel weiß Angesicht Lederschlaff -- 
  -- Weib einst schön -- blühend Holde -- lieblich Maria -- 
  -- Reise -- -- sprechen laut -- kalt unheimlich Vertraulichkeit -- -- schaun schmachtend -- liebst Freund gesund -- prall Lend -- Wade Bezeugt Solidität -- -- 
  süßlich lächeln Umzittert gelblich blass Mund -- 
  Verwirrung sprach_es hervor -- 
  -- -- vermählen -- 
  -- -- sprechen -- gleichgültig laut lachend -- Stock Holz -- überzog Leder -- Bette liegen -- Gemahl nennen -- 
  Holz Holz -- 
  klanglos widrig lacht -- kalt Angst Seele rann -- Zweifel ergreifen -- -- keusch -- blumenzaren Lippe Maria -- 
  heben Höhe -- rasch Stuhl Türken-Shawl -- werfen Hals -- hing Arm -- Zog hinn -- offen Haustür -- ziehen fort Feld Busch Au -- 
  glühend rot Sonnenscheibe schweben niedrig -- Purpur überstrahlt Baum Blume Strom -- Ferne majestätisch fließen -- 
  -- sehen -- golden Auge schwimmen blau Wasser -- -- rufen Maria hastig -- 
  still -- arm Wesen -- -- sprechen -- schaut dämmerlichter märchenhaft Webe -- 
  steigen Nebelbilder Feld -- Umschlang weißen -- weich arme -- Veilchen sehen zärtlich -- sehnsüchtig Zusammenbeugt Lilienkelch -- Rose glüht Wollustglut -- 
  Nelken Hauche entzünden -- selig Düft schwelgen Blume -- weinen still Wonneträne -- jauchzn -- 
  Liebe -- 
  Liebe -- 
  Liebe -- 
  Schmetterling flattern -- hell Goldkäfer summen fein Lieblingsliedche -- abendwind flüstert -- rauschen Eiche -- schmelzend singen Nachtigall -- all Flüster -- Rausch -- singen -- Schwatzt blechern klanglos kalt Stimme welke Weib -- arme hing -- 
  -- kennen 
  nächtlich Treibe Schloß -- Schatten Tropf -- nicken winken -- Blaurock Engel -- rot -- blankem Schwert -- Spinnefeind -- 
  bunt -- wunderlich Rede Schwatzt -- fort -- setzen -- Ermüdet -- nieder Moosbank -- unter alt Eichenbaume stehen -- 
  sitzen beisammen -- still traurig -- sehen -- traurig -- 
  Eich säuselt Sterbeseufzer -- Tiefschmerzlich singen Nachtigall herab -- 
  rot Licht drang Blatt -- Umflimmert Maria's weiß Antlitz -- locken Glut starr Auge -- alt -- süß Stimme sprechen -- 
  -- wußtest -- elend -- lesen jüngst dein wild Lied -- 
  eiskalt durchzog Brust -- grausen eignen Wahnsinn -- Zukunft Geschaut -- zucken dunkel Hirn -- entsetzen aufwachen -- 
  Donna Clara -- 
  -- spanisch Roman -- -- 
  abendlich Garten Wandelt Alkaden Tochter -- Pauken- Drommetenjubel Klingt herunter Schlos -- 
  -- Lästig Tänze süßen Schmeichelwort -- Ritter -- zierlich vergleich Sonne -- 
  -- Überlästig -- -- Strahl Monde -- Ritter -- Laute Nächten an Fenster locken -- 
  -- stehen Schlank mutig -- Auge leuchtend schießen Edelblass Antlitz -- Glich wahrlich Sankt Georg -- 
  dachen Donna Clara -- schaut Boden -- aufblickt -- stehen schön -- unbekannte Ritter -- 
  händedrückend -- liebeflüsternd -- Wandel umh Mondschein -- Zephir schmeicheln freundlich -- märchenartig grüß Rose -- 
  märchenartig grüß Rose -- glühn Liebesbot -- 
  sagen -- Geliebte -- plötzlich rot -- 
  -- Mück stachen -- Geliebt -- Mück -- Sommer -- tief verhassen -- wären_es langnasig Judenrott -- 
  Laß Mück Jude -- Spricht Ritter -- freundlich kosend -- 
  Mandelbäum fallen Tausend weiß Blütenflock -- 
  tausend weiß Blütenflock Duft ergossen -- 
  sagen -- Geliebte -- Herz gewogen -- 
  -- -- lieben -- Geliebter -- Heiland geschworen -- gottverflucht Jude Boshaft tückisch einst ermorden -- 
  Laß Heiland Jude -- Spricht Ritter -- freundlich kosend -- 
  Ferne schwanken traumhaft weiß Lilie -- lichtumflossen -- 
  weiß Lilie -- lichtumflossen -- Blick Stern droben -- 
  sagen -- Geliebte -- falsch geschwor -- 
  -- falsch -- Geliebter -- Brust Tropfen Blut Blut Mohr schmutzig Judenvolk -- 
  Laß Mohr Jude -- Spricht Ritter -- freundlich kosend -- Myrtenlaube Führen Alkadentochter -- 
  weich Liebesnetze heimlich umflochten -- kurz Wort -- Küs -- Herz überflossen -- 
  schmelzend süß Brantlied Singt Laube Zaubervogel -- Fackeltanze hüpfen Feuerwürmche Boden -- 
  Laube still -- hören -- verstohlen -- Geflüster klug Myrt lang Atemhol -- 
  pauken Trompet Schalle plötzlich Schloß -- erwachend Clara Ritter Arm ziehen -- 
  -- Horch -- 
  rufen -- Geliebter -- -- bevor scheid -- sollst Nenne deinen lieb Name -- verbergen -- 
  Ritter -- heit lächelnd -- Küßt Finger Holden -- Küßt Lippe Stirn -- sprechen lang Wort -- 
  -- -- Sennora -- Eu -- r Geliebt -- Sohn vielbelobten -- -- schriftgelehrten Rabbi Israel Saragossa -- 
  Almansor -- 
  -- spanisch Roman -- -- 
  I. 
  Dome Corduva Stehen Säule -- Dreizehnhundert -- Dreizehnhundert Riesensäulen tragen gewaltig Kuppel -- 
  Säule -- Kuppel -- Wand -- Ziehe unten Koran arabisch Spruch -- Klug blumenhaft verschlungen -- mohrenkönige bauen weiland Haus Allah Ruhm -- verwandeln Zeit dunkl Strudel -- 
  Turm -- Türmer Gebet aufrufen -- Heben Christenglocken Melancholisches Gesumm -- 
  Stufe -- gläubig Prophetenwort singen -- Zeig Glatzenpfäfflein Messe fad Wunder -- 
  dreher Winde buntbemalt Puppe -- blökt dampft klingeln -- dumm Kerze funkeln -- 
  Dome Corduva stehen Almansor ben Abdullah -- All Säule still betrachtend -- still Wort murmelnd -- -- O -- Säule -- stark riesig -- einst schmücken Allah Ruhm -- müßt dienend huldig verhaßt Christentum -- 
  -- bequemt Zeit -- tragen Last geduldig -- -- Ei -- Schwächere leicht beruhigen -- 
  Haupt -- heiter Antlitz -- Beugen Almansor ben Abdullah geziert Taufstein -- Dome Corduva -- 
  II. hastig schriten Dome -- Jagt fort Rappe -- Wind feucht Lock Hutes Feder wallen -- 
  Weg Alkolea -- Guadalquivir entlangen -- weiß Mandel blühen -- duftig gold-Oranger -- dorten jagen lustig Ritter -- Pfeift singen -- lachen behaglich -- stimmen Vögel -- Stromes lauten Wasser -- 
  Schloß Alkolea Wohnet Clara de Alvares -- Navarra kämpfen Vater -- freuen minder Zwanges -- 
  Almansor hören fern Pauke Trompet schallen -- sehen Schlosses Licht Blitz Baum Schatten -- 
  Schloß Alkolea Tanzen zwölf geschmückt Dame -- tanzen zwölf geschmückt Ritter -- schönsn tanzen Almansor -- 
  beschwingen munter Laune Flattert herum Saale -- wissen Dame Süß Schmeicheleie sagen -- 
  isabellen schön Hand Küßt rasch -- springen dannen -- setzen Elvira schauen froh Antlitz -- 
  lachend fragen Leonore -- gefalle -- 
  zeigen golden Kreuze Eingestickt Mantel -- 
  Dame sprechen -- 
  Herz tragen -- -- Christ -- schwören dreißig Mal Abend -- 
  III. 
  Schloß Alkolea verschollen Lust Kling -- Herr Dame verschwinden -- erlosch Licht -- 
  Donna Clara Almansor Saal bleiben -- Einsam streuen letzter Lampe Schimmer -- 
  Sessel sitzen Dame -- Schemel sitzen Ritter -- Haupt -- schlummermüde -- Ruht geliebt Knium -- 
  Rosenöhl -- golden Fläschchen -- Gießt Dame -- sorgsam sinnend -- Almansor braun Locke -- seufzt Herzenstief -- 
  süßen Kuß -- sanft Mund -- Drückt Dame -- sorgsam sinnend -- Almansor braun Locke -- wölken Stirn -- 
  Tränenflut -- licht Auge -- Weint Dame -- sorgsam sinnend -- Almansor braun Locke -- zucken Lippe -- 
  träumen -- 
  stehen -- Tief Haupt gebeugt triefend -- Dome Corduva -- hört dunkel Stimme -- 
  all hoch Riesensäule Hört murmeln unmutgrimmig -- Lang tragen -- wanken zittern -- brechen wild -- erbleich Volk Priester -- Krachend stürzen herab Kuppel -- Christengötter wimmern -- 
  wallfahren Kevlaar -- 
  I. Fenster stehen Mutter -- Bette liegen Sohn -- 
  -- aufstehen -- Wilhelm -- schaun Prozession -- -- 
  -- -- krank -- O Mutter -- hören sehen -- denk tot Gretchen -- tun Herz weh -- -- 
  -- -- Stehen -- -- Kevlaar -- Nimm Buch Rosenkranz -- Muttergottes heilen Krankes Herz -- 
  flattern Kirchenfahn -- singen Kirchenton -- Köln Rheine -- Prozession -- 
  Mutter folgen Menge -- Sohn -- führen -- singen Chore -- 
  Gelobt seisen Marie -- 
  II. 
  Muttergott Kevlaar Tragen bestes Kleid -- schaffen -- -- krank Leute -- -- 
  krank Leute bringen dar -- Opferspend -- Wach gebildet Glied -- wächsern Fuß -- Hand -- 
  Wachshand opferen -- heilen Hand Wund -- -- Wachsfuß opferen -- Fuß gesund -- 
  Kevlaar Krücke -- tanzen Seil -- spielen Bratsche -- Finger heil -- 
  Mutter Wachslicht -- bilden draus Herz -- 
  -- Bring Muttergott -- heilen deinen Schmerz -- 
  Sohn seufzend Wachsherz -- seufzend Heiligenbild -- Tran quellen Auge -- Wort Herz quellen -- 
  -- Hochgebenedeite -- rein Gottesmagd -- Königin Himmel -- Leid klagen -- 
  -- wohnt Mutter Zöllen Stadt -- Stadt -- hundert Kapell Kirche -- 
  -- wohnt Gretchen -- tot jetzund -- Marie -- bringen Wachsherz -- Heil 
  Herzenswund -- -- 
  -- Heil -- krank Herz -- spät früh Inbrünstig beten singen -- 
  Gelobt seisen -- Marie -- 
  III. 
  krank Sohn Mutter -- schlief Kämmerlein -- Muttergottes leise geschritten Herein -- 
  beugt kranke -- legen Hand leise Herz -- lächelen Mild Schwand -- 
  Mutter schauen Traum -- schauen -- erwacht Schlummer -- Hund bellten laut -- 
  liegen dahingestrecken Sohn -- tot -- spielen bleich Wang licht Morgenrot -- 
  Mutter falten Hand -- -- wissen -- andächtig singen leise -- 
  Gelobt seisen -- Marie -- 
  Stoff Gedicht Eigentum -- 
  entstehen Erinnerung rheinisch Heimat -- 
  -- Knabe -- Franziskanerkloster Düsseldorf Dressur erhalten -- Buchstabier Stillsitz lernen -- sitzen Knabe -- erzählen -- 
  Mutter Kevlaar -- Akzent liegen Silbe Ort liegen Geldernsche -- einstmals mitnehmen -- wächsern Fuß opfern -- schlimm Fuß geheilen -- 
  Knabe treffen oberer Klasse Gymnasium -- Philosophen-Kollegium Rektor Schallmeyer -- sitzen kommen -- erinnern lachend Mirakel-Erzählung -- setzen ernsthaft hinzu -- 
  Muttergott wächsern Herz opfern -- 
  hören -- unglücklich Liebschaft laboriern -- Auge Gedächtnis -- -- 
  1819 -- Bonn studieren -- -- Gegend Godesberg -- Rhein spazieren -- hört Ferne wohlbekannt Kevlaar-Lied -- wovon vorzüglich gedehnt Refrain -- Gelobt seisen -- Maria -- -- Prozession nah -- bemerken Wallfahrter Schulkamerad alt Mutter -- 
  führen -- 
  Blaß krank -- 
  Notiz Gedicht trennen -- entstehen -- abdrucken -- gleichsam verwachsen -- 
  Fall Vorneigung andeun -- -- Abneigung vorhergehend Gedicht aussprechen -- 
  -- Almansor überschrieben -- Roman -- entlehnen -- Maur -- unmutig Bekenner Islam -- dichten singen -- 
  -- wahrlich -- -- 
  sprechen englisch Schriftsteller -- -- Gott -- Urschöpfer -- stehen Dichter -- Nachschöpfer -- parteilos erhaben sektengeklätsch Erde -- -- 
  Harzreise -- 1824 -- 
  dauernd -- Wechsel -- beständig -- Tod -- 
  Schlag Herzens schlagen Wunde -- Leben ewig verbluten -- Dichtkunst -- 
  gewähren -- Natur versagen -- golden -- rosten -- Frühling -- abblüht -- wolkenlos Glück ewig Jugend -- 
  Börne -- 
  schwarz Röck -- seiden Strümpf -- weiß höflich Manschetten -- Sanfte Rede -- Embrassier -- 
  -- Herz -- 
  Herz Brust -- Liebe -- warm Liebe Herz -- 
  -- töten Gesinge erlogener Liebesschmerze -- 
  Berg steigen -- 
  fromm Hütte stehen -- 
  Brust frei erschließeen -- 
  frei Lüfte wehen -- 
  Berg steigen -- dunkel Tanne rag -- Bach rausch -- Vögel singen -- stolz Wolke jagen -- 
  Lebet -- glatt Sal -- 
  Glatte Herr -- 
  Glatte Frau -- 
  Berg steigen -- Lachend niederschauen -- 
  Stadt Göttingen -- berühmt Würste Universität -- gehören König Hannover -- enthalten 999 Feuerstell -- diverser Kirche -- Entbindungsanstalt -- Sternwarte -- Karzer -- Bibliothek Ratskeller -- Bier -- 
  vorbeifließend Bach -- Leine -- dienen Sommer Baden -- Wasser kalt -- Ort breit -- Lüder Anlauf nehmen müssen -- hinüber springen -- 
  Stadt schön -- fällen -- Rücken ansehen -- 
  stehen -- erinnern -- immatrikulieren drauf konsiliirt -- grau -- altklug ansehen -- vollständig einrichten Schnurr -- Pudel -- Dissertation -- Teedansant -- Wäscherinn -- Kompendi -- Taubenbrat -- Welfenorde -- Promotionskutsch -- Pfeifenköpfe -- Hofrät -- Justizrät -- Relegationsrät -- Profax Faxen -- 
  behaupten sogar -- Stadt Völkerwanderung erbauen -- deutsch Stamm ungebunden Exemplar Mitglied zurückgelassen -- stammen all Vandal -- Friese -- Schwabe -- Teuton -- Sachsen -- Thüringer u. S. W. -- Göttingen -- hordenweise -- geschied Farbe Mütze Pfeifenquaste -- Weenderstraße einherzieh -- blutig Wahlstätt Rasenmühle -- Ritschenkrug Bovdens ewig herumschlagen -- Sitte Gebräuche Völkerwanderung dahinleben -- teils Duces -- Haupthahn heißen -- teils uralt Gesetzbuch -- Comment legibus barbarorum Stelle verdienen -- regieren -- 
  Bewohner Göttingen's eingeteilen Student -- Professor -- Philister Vieh -- Stände streng scheiden -- 
  Viehstand bedeutend -- 
  Name Student ordentlichen unordentlich Professor herzuzählen -- weitläufig -- Augenblick Studentennam Gedächtnis -- Professor -- Name -- 
  Zahl Göttinger Philister -- Sand -- -- Dreck Meer -- wahrlich -- morgens -- schmutzig Gesicht weiß Rechnung -- Pfort akademisch Gericht aufgepflanzen -- begreifen -- Gott Lumpenpack erschaffen -- 
  Ausführlicheres Stadt Göttingen lassen bequem nachles Topographie K. F. H. Marx -- 
  Obzwar Verfasser -- Arzt Liebes erzeigen -- heilig Verpflichtung hegen -- Werk unbedingt empfehlen -- tadeln -- falsch Meinung -- Göttingerinne allzugroß Fuß -- streng widersprechen -- 
  -- sogar ernst Widerlegung Meinung beschäftigen -- vergleichend Anatomie gehören -- seltenst Werk Bibliothek exzerpiern -- Weenderstraße stundenlang Fuß vorübergehend Dame studieren -- grundgelehrt Abhandlung -- resultat Studie enthalten -- sprech 1 ° Füßen -- 2 ° Fuß alte -- 3 ° Fuß Elefant -- 4 ° Fuß Göttingerinne -- 5 ° stellen -- Fuß Ullrich Garten -- 6 ° betracht Fuß Zusammenhäng -- verbreit Gelegenheit Wade -- Knie u. S. W. -- 7 ° -- Papier auftreiben -- füge hinzu Kupfertafel Faksimile göttingsch Damenfuß -- 
  -- früh -- Göttingen verlassen -- gelehrt * * liegen gewiß Bette träumen gewöhnlich -- 
  wandl schön Garten -- Beeten lauter weiß -- Zitat beschrieben Papierchen wachsen -- Sonnenlicht lieblich glänzen -- mehrere pflücken -- mühsam neu Beet verpflanzen -- Nachtigalle süßest Tön alt Herz erfreuen -- 
  Weender Tor begegneen eingeboren Schulknab -- wovon -- 
  -- Theodor umgehen -- Lumpenkerl -- gestern wissen Mal -- Genitiv Mensa -- -- 
  unbedeutend Wort klingen -- erzählen -- -- Stadt-Motto Tor schreiben lassen -- Junge pieps alte pfeifen -- Wort bezeichnen eng -- trocken Notizenstolz hochgelahrt Georgia Augusta -- 
  Chaussee weht frisch Morgenluft -- Vögel singen freudig -- allmählich frisch freudig Mute -- 
  Erquickung Not -- 
  letzter Pandektenstall herauskommen -- römisch Kasuist Geist grau Spinnweb überzogen -- Herz einklemmen eisern Paragraph selbstsüchtig Rechtssystem -- beständig klingen Ohr -- Tribonian -- Justinian -- Hermogenian Dummerjan -- -- zärtlich Liebespaar -- Baume sitzen -- halten Corpusjuris-Ausgabe verschlungen Hand -- 
  Landstraße fing lebendig -- 
  Milchmädchen ziehen vorüber -- eseltreiber grau Zöglinge -- 
  Weende begegnen Schäfer Doris -- 
  idyllisch Paar -- wovon Geßner singen -- wohlbestallen Universitätspedelle -- wachsam aufpass -- Student Bovde duellieren -- Idee -- Dezennien Göttingen Quarantäne halten -- spekulierend Privatdozent einschmuggeln -- 
  Schäfer grüßen kollegialisch -- ebenfalls Schriftsteller -- halbjährig Schrift erwähnen -- zitieren -- -- Haus finden -- gütig -- Zitation Kreide Stubentür schreiben -- 
  rollt Einspänner vorüber -- wohlbepacken Student -- Ferienzeit -- wegreisen -- 
  solch Universitätsstadt beständig Abgehen -- finden Studentengeneration -- ewig Menschenstrom -- Semesterwelle fortdrängen -- alt Professor bleiben stehen Bewegung -- unerschütterlich fest -- Pyramide Ägypten - Universität Pyramiden Weisheit verbergen -- 
  myrtenlauben Rauschenwasser hoffnungsvoll Jünglinge hervorreien -- 
  Weibsbild -- horizontal Handwerk treiben -- Landstraße Geleit -- klätschelen geübt Hand mager Schenkel Pferd -- lachen laut -- Reuter hinten -- breit Spontaneität Galanterien Peitsche überlangen -- schieben Alsdann gen Bovd -- 
  Jünglinge jagen Nört -- johlen geistreich -- singen lieblich Rossinische Lied -- -- Trinke Bier -- lieben -- lieb Lis -- -- 
  Ton hört Ferne -- holden Sänger verlieren völlig Gesicht -- sintemal Pferd -- Grund deutsch-langsam Charakter scheinen -- entsetzlich anspornten vorwärtspeitschten -- 
  Nirgends Pferdeschinderei stark treiben Göttingen -- -- -- solch schweißtriefend -- Lahme Krack -- bissch Lebensfutter -- unser Rauschenwasserritter abgequalten -- Wagen voll Student fortziehen müssen -- denken -- -- O armes Tier -- gewiß Voreltern Paradiese verboten Hafer gefressen -- -- 
  wirtshause Nört treffen Jünglinge -- 
  verzehrt Heringsalat -- unterhielt gelbledern Magd -- Fusia Canina -- Trittvogel nennen -- 
  Anständigkeit -- Hand-gemein -- 
  Ranz erleichtern -- eingepackt blau Hose -- geschichtlich Hinsicht merkwürdig -- heraus schenken Kellner -- Kolibri nennen -- 
  Bussenia -- alt Wirtin -- bringen unterdessen Butterbrot -- beklagen -- selten besuch -- lieben -- 
  Nört stehen Sonne glänzend Himmel -- 
  meinen erwärmt Haupt -- unreif Gedanke Vollreif kommen -- 
  lieb Wirtshaussonne nordheim verachten -- kehren -- finden Mittagessen fertig -- 
  Gericht schmackhaft zubereiten -- behagen -- abgeschmackt akademisch Gericht -- salzlosen -- ledern Stockfisch alt Kohl -- Göttingen vorsetzen -- 
  Magen beschwichtigen -- bemerken Wirtsstube Herr Dame -- Begriff abzureisen -- 
  Herr grün kleiden -- tragen sogar grün Brille -- rot Kupfernase Schein Grünspan werfen -- -- König Nebukadnezar späteren aussehen -- -- Sage -- Tier Wald -- Salat aß -- 
  grüne wünschen -- Hotel Göttingen empfehlen -- raten -- Student Hotel de Brühbach erfragen -- 
  Dame Frau Gemahlin -- -- weitläufig Dame -- rot Quadratmeilen-Gesicht Grübch Wang -- Spucknäpfe Liebesgötter aussahen -- langfleischig herabhängend Unterkinn -- schlecht Fortsetzung Gesicht scheinen -- hochaufgestapelt Busen -- steif Spitze vielzackig festoniert Kragen -- Türmch Bastion umbauen -- Festung glich -- gewiß Festung -- Philipp Mazedonium sprechen -- Gold beladen Esel widerstehen -- 
  Dame -- Frau Schwester -- bildet Gegensatz beschriebenen -- 
  stammt Pharaos fett Kühen -- stammen mageren -- 
  Gesicht Mund Ohr -- Brust trostlos öde Lüneburger Heide -- -- ausgekocht Gestalt glich Freitisch arm Theologe -- 
  Dame fragen gleich -- Hotel de Brühbach ordentlich Leute logierten -- 
  bejaht gut Gewissen -- hold Kleeblatt abfuhr -- grüßte nochmals Fenster hinaus -- 
  sonnenwirt lächelen schlau wissen -- Karzer Student Göttingen Hotel de Brühbach nennen -- 
  nordheim gebirgig treten schön Anhöhe hervor -- 
  Weg treffen meistens Krämer -- Braunschweiger Messe ziehen -- Schwarm Frauenzimmer -- -- fast häuserhoh -- weiß Lein überzogen Behältni Rücken tragen -- 
  sitzen allerlei eingefangen Singvögel -- beständig piepst Zwitschert -- trägerinnen lustig dahinhüpfen schwatzen -- 
  närrisch -- Vogel Markt tragen -- 
  pechdunkl Nacht Osterode -- 
  fehlt Appetit essen legen Bette -- 
  müde Hund schliefr Gott -- 
  Traum Göttingen -- dortig Bibliothek -- 
  stehen Ecke juristisch Saal -- durchstöbert alt Dissertation -- vertieft Lese -- aufhören -- bemerken Verwunderung -- Nacht -- herabhängend Kristall-Leuchter Saal erhellten -- 
  nah Kirchenglock schlagen zwölf -- Saaltüre öffnen langsam -- Herein treten stolz -- gigantisch Frau -- ehrfurchtsvoll begleiten Mitglied Anhänger juristisch Fakultät -- 
  Riesenweib -- obgleich bejahren -- tragen dennoch Antlitz Zug streng Schönheit -- Blick verraten hoch Titanin -- gewaltig Themi -- Schwert Waage halten nachlässig Hand -- halten Pergamentrolle -- jung Doctores Juris tragen Schleppe grau verblichen Gewand -- Seite springen windig dünn Hofrat Rusticus -- Lykurg Hannover -- deklamiert Gesetzentwurf -- linker Seite humpelen -- galant wohlgelaunt -- Kavalier servent -- geheim Justizrat Cujacius -- reißen beständig juristisch Witze -- lachen herzlich -- sogar ernst Göttin mehrmals lächelnd herabbeugen -- Pergamentrolle Schulter klopfen -- freundlich flüstern -- 
  -- -- lose Schalk -- Baum herab beschneiden -- -- 
  übrig Herr treten ebenfalls nah bemerken lächeln -- neu ergrübelt Systemche -- Hypothesch -- ähnlich missgebürtch Köpfchen -- 
  geöffnet Saaltüre treten mehrere fremd Herr herein -- Mann illustren Orden kundgaben -- meistens eckig -- lauernd Geselle -- breit Selbstzufriedenheit drauf definierten distinguierten jeder Titelchen Pandektentitel disputierten -- 
  kommen Gestalt herein -- alt Rechtsgelehrt -- verschollen Tracht -- weiß Allongeperück längst vergessen Gesicht -- erstaunt -- -- Hochberühmten verflossen Jahrhundert -- sonderlich regardieren -- stimmen -- Weise -- allgemein Schwatze Schrillen Schreie -- -- Meeresbrandung -- verwirrt laut -- hoch Göttin umrauschen -- Geduld verlieren -- Tone entsetzlichst Riesenschmerz plötzlich Aufschrie -- 
  -- Schweigt -- schweigen -- 
  hör Stimme teuer Prometheu -- höhnend Kraft stumm Gewalt schmied Schuldlose Marterfels -- all euer Geschwätz Gezänke Wunde kühl Fessel zerbrechen -- -- 
  rufen Göttin -- Tränenbäch stürzt Auge -- Versammlung heuln Todesangst ergreifen -- Decke Saale kracht -- Buch taumelten herab Brett -- vergebens treten alt Münchhaus Rahmen hervor -- Ruhe gebieten -- tobn Kreischt wild -- -- fort -- drängend Tollhauslärm rettet historisch Saal -- Gnadenstelle -- heilig Bild belvederisch Apoll mediceisch Venus stehen -- stürzt Füßen Schönheitsgöttin -- Anblick vergessen all wüs treiben -- entronn -- Auge tranken entzücken Ebenmaß ewig Lieblichkeit hochgebenedeit Leib -- griechisch Ruhe ziehen Seele -- Haupt -- himmlisch Segen -- goß süßest Lyraklänge Phöbus Apollo -- 
  Erwachend hören freundlich Kling -- 
  Herde ziehen Weid läutet Glöckche -- 
  lieben -- golden Sonne scheinen Fenster beleuchten Schildereien Wände Zimmer -- 
  Bild Befreiungskriege -- worauf treu darstellen stehen -- Held -- Hinrichtungs-Scene Revolutionszeit -- Ludwig XVI -- Guillotine -- ähnlich Kopfabschneidereie -- ansehen -- Gott danken -- ruhig Bette liegen -- gut Kaffee trinken Kopf komfortabel Schulter sitzen -- 
  hing Wand Abeillard Heloise -- französisch Tugende -- nämlich leer Mädchengesichter -- worunter kalligraphisch -- prudence -- -- Timidite -- -- Pitié etc. schreiben -- Madonna -- schön -- lieblich -- hingebend fromm -- Original -- Maler sitzen -- aufsuch Weibe -- 
  freilich -- Mal Madonna verheiraten -- bitten -- ferner Umgang heilig Geist aufgeben -- leiben -- Kopf -- Vermittlung Frau -- Heiligenschein -- Verzierung gewönnen -- 
  Kaffee trinken -- anziehen -- Inschrift Fensterscheibe lesen -- Wirtshause berichtigen -- verlassen Osterode -- 
  Stadt Haus -- verschieden Einwohner -- worunter mehrere Seele -- Gottschalk's -- Taschenbuch Harzreisende -- genau nachlesen -- 
  Ehe Landstraße einschlagen -- Bestieg Trümmer uralt Osterode Burg -- 
  bestehen Hälfte -- dickmaurig -- Krebsschäd angefressen Turm -- 
  Weg Clausthal führen bergauf -- Höhe schaun nochmals hinab Tal -- Osterode rot Dach grün Tannenwälder hervor guckt -- Moosrose -- 
  Sonne lieben -- kindlich Beleuchtung -- 
  erhalten Turmhälfte erblicken imponierend Rückseite -- 
  liegen Burgruine Gegend -- 
  Hardenberg Nört schön -- 
  -- gebühren -- Herz linker Seite -- liberal -- elegisch Gefühl erwehren -- Anblick Felsennester privilegiert Raubvögel -- schwächlich Nachbrut bloß stark Appetit vererben -- 
  -- 
  Gemüt -- Göttingen entfernen -- allmählich aufgetaut -- romantisch Sinn -- wandernd dichtet folgend Lied -- Steiget -- alt Traum -- 
  Öffne -- Herzensthor -- 
  Liederwonne -- Wehmutsträn -- Strom wunderbar hervor -- 
  Tanne schweifen -- munter Quelle springen -- stolz Hirsch wandeln -- lieb Drossel singen -- 
  Berg steigen -- schroff Felsenhöhe -- grau Schloßruin Morgenlicht stehen -- 
  dorten setzen still nieder gedenk alt -- Alter blühend Geschlecht versunken Herrlichkeit -- 
  Gras bedeckt Turnierplatz -- kämpfen stolz Mann -- überwinden Kampfe Preis gewinnen -- 
  Efeu ranken Balkone -- schön Dame stehen -- stolz Überwind Auge überwand -- 
  -- Sieger Sieg rein besiegen Tod Hand -- -- 
  Dürre Sensenritter Streckt Sand -- 
  Strecke gehen -- treffen reisend Handwerksbursche -- Braunschweig -- dortig Gerücht erzählen -- jung Herzog Weg gelobt Land Türke gefangen -- können Lösegeld frei -- 
  Reise Herzog Sage veranlassen -- 
  Volk traditionell fabelhaft Ideengang -- lieblich aussprechen -- Herzog Ernst -- -- 
  Erzähler Neuigkeit Schneidergesell -- niedlich -- jung Mensch -- dünn -- Stern durchschimmern -- Ossian's Nebelgeister -- volkstümlich barock Mischung Laune Wehmut -- 
  äußern drollig rührend Weise -- womit wunderbar Volkslied singen -- 
  -- Käfer Zaune sitzen -- summ -- summ -- -- 
  schön deutsche -- verrückt -- Verrückteren fänden -- verstehen -- 
  deutsch Lied nachempfind -- totlach Totwein -- 
  tief goethesch Wort Leben Volk dringen -- bemerken -- 
  dünn Weggenos trilleren ebenfalls zuweilen -- 
  -- Leidvoll freudvoll -- Gedanke frei -- 
  Korruption Textes -- m Volke Gewöhnliches -- 
  singen Lied -- Lottchen Grab Werther -- trauern -- 
  Schneider zerfloß Sentimentalität Wort -- 
  -- Einsam Wein -- Rosenquelle -- spät Mond belauscht -- 
  Jammernd irr Silberquelle -- lieblich Wonne zugerauscht -- -- 
  Mutwille -- erzählen -- 
  -- Preußen Herberge Kassel -- Lied -- selig Stich nähen -- Groschen Tasche -- Groschen Durst -- Tran -- halten Himmel blau Kamisol -- weinen Dachtraufe -- singen Lied doppelen Poesie -- -- 
  letzterer Ausdruck wünscht Erklärung -- Schneiderlein -- Ziegenhainer Beinchen -- hüpfte rufen beständig -- 
  -- doppelt Poesie doppelt Poesie -- -- 
  bringen heraus -- doppelt gereimt Gedicht -- namentlich stanzen -- Sinn -- -- Unterdes -- Bewegung konträren Wind -- Ritter Nadel müde -- 
  freilich Anstalt bramarbasieren -- 
  -- Weg Bein nehmen -- -- 
  klagen -- Blase Fuß gehen -- Welt weitläufig -- -- Baumstamm -- lassen Sachte niedersinken -- bewegen zart Häuptlein betrübt Lämmerschwänzchen -- wehmütig lächelnd rufen -- 
  -- arm Schindluderchen marode -- -- 
  Berg steil -- Tannenwälder wogen unten grün Meer -- blau Himmel schifft weiß Wolke -- 
  Wildheit Gegend Einheit Einfachheit gleichsam zähmen -- 
  Dichter lieben Natur schroffen Übergänge -- 
  Wolke -- Bizarr gestalten zuweilen erscheinen -- tragen weiß -- mild -- blau Himmel grün Erde harmonisch korrespondierend Kolorit -- Farbe Gegend leis Musik ineinander schmelzen -- Natur-Anblick krampfstillend gemütberuhigend wirken -- -- 
  selig Hoffmann Wolke buntscheckig Bemalt -- -- 
  Dichter wissen Natur wenigster Mittel groß Effekt hervor bringen -- 
  Sonne -- Baum -- Blume -- Wasser Liebe -- 
  freilich -- fehlen letzterer Herz Beschauer -- schlecht Anblick gewähren -- Sonne bloß Meile Durchmesser -- Baum Einheize -- Blume Staubfäde klassifizieren -- Wasser naß -- -- * * -- -- 
  jung -- krank Oheim Walde Reisig suchen -- zeigen Dorf Lerrbach -- Hütte -- grau Dach -- halb Stunde Tal hinziehen -- 
  -- -- -- -- wohnen dumm Kropf-Leut weiß Mohr -- -- -- letzter Name Albinos Volke benennen -- 
  Junge stehen Bäumen eigen Einverständnis -- grüßte bekannte -- scheinen rauschend Gruß erwidern -- 
  Pfiff Zeisig -- ringsum antworteen zwitschernd Vogel -- ehe versehen -- nackt Füßch Bündel Reisig Walddickicht fortgesprungen -- 
  Kind -- denken -- jüng -- erinnern -- ebenfalls Baum Vogel -- Stande -- verstehen -- unsereiner alt Sorge -- Jurisprudenz schlecht Vers Kopf -- 
  -- -- treten Eintritt Clausthal lebhaft Gedächtnis -- 
  nett Bergstädtche -- erblicken -- stehen -- gelangt -- Glock zwölf schlagen Kind jubelnd Schule kommen -- 
  lieben Knabe -- fast rotbäckig -- blauäugig flachshaarig -- jubeln jauchzn -- wecken wehmütig heit Erinnerung -- einst -- Bübch -- dumpfkatholisch Klosterschule Düsseldorf lieben Vormittag hölzern Bank aufstehen -- Latein -- Prügel Geographie ausstehen müssen -- ebenfalls unmäßig jauchzt jubelt -- alt Franziskanerglock zwölf schlagen -- 
  Kind sehen Ranz -- Fremder -- grüßen gastfreundlich -- 
  Knabe erzählen -- Religions-Unterricht -- zeigen Königl -- Hannöv -- Katechismus -- Christentum abfragt -- 
  Büchlein drucken -- fürcht -- Glaubenslehr unerfreulich Eindruck Gemüt Kind -- erschrecklich Mißfiel -- Ein-mal- Eins -- heilig Dreiheitslehr bedenklich kollidieren -- Catechismus -- letzter Blatt -- abdrucken -- Kind frühzeitig sündhaft Zweifel verleiten -- 
  Preußischen klüg -- unser Eifer Bekehrung Leute -- Rechn verstehen -- hüt -- Katechismus abdrucken lassen -- 
  -- Krone -- Clausthal halten Mittag -- 
  bekommen frühlingsgrün Petersiliensuppe -- veilchenblauen Kohl -- Kalbsbrat -- Chimborasso Miniatur -- Art geräuchert Heringe -- Bückinge heißen -- Name Erfinder -- Wilhelm Bücklinge -- 1447 sterben -- Erfindung Wille Carl V. verehren -- -- 1556 Middelburg Bievlied Seeland reisen -- bloß Grab Mann sehen -- 
  herrlich schmecken solch Gericht -- historisch Notiz wissen verzehren -- 
  Kaffee Tisch verleiden -- jung Mensch diskursirend setzen entsetzlich schwadroniert -- Milch Tisch sauer -- 
  jung Handlungsbeflissener bunt Westen golden Petschaft -- Ring -- Brustnadel u. S. W. Aff -- rot Jack anziehen selber -- Kleid Leute -- 
  Menge Scharade wissen auswendig -- Anekdote -- anbracht -- wenigster paßten -- 
  fragen -- Göttingen neue geben -- erzählen -- Abreise Dekret akademisch Senat erscheinen -- worin Taler Strafe verbieten -- hunden Schwänze abzuschneiden -- tollen Hund Hundstag Schwänze Bein tragen -- Nicht-Toll unterscheiden -- geschehen -- Schwänze -- -- 
  Tische Weg -- Grube -- silberhütt Münze besuchen -- 
  Silberhütt -- Leben -- Silberblick verfehlen -- 
  Münze treffen -- zusehen -- Geld -- 
  freilich -- bringen -- 
  Gelegenheit Zusehen -- glauben -- Mal Taler Himmel herunter regnet -- bekommen Loch Kopf -- Kind Israel silbern Manna lustig Mute einsammeln -- 
  Gefühl -- worin komisch Ehrfurcht Rührung mischen -- betrachten neugeborenen -- blanken Taler -- -- Prägstock -- Hand -- sprechen -- jung Taler -- Schicksal erwarten -- böse stiften -- Laster beschützen Tugend flicken -- lieben verwünschen -- Schwelge -- Kuppel -- lügen Morden helfen -- rastlos umherirren -- rein schmutzig Hand -- jahrhundertelang -- -- schuldbelad Sündenmüd -- versammeln Deinig schoß Abraham -- einschmelzen läutern umbildet gut -- unschuldig Theelöffelche -- womit einst Ur-Urenkelcher lieb Breisüppchen zurechtmatscht -- 
  Befahre vorzüglichst Claustaler Grube -- -- Dorothea -- -- Carolina -- finden interessant ausführlich erzählen -- 
  halb Stunde Stadt gelangen schwärzlich Gebäude -- 
  bergleut Empfang nehmen -- 
  tragen dunkle -- gewöhnlich stahlblau -- weit -- Bauch herabhängend Jacke -- hosen ähnlich Farbe -- hinten aufgebunden Schurzfell grün Filzhüte -- randlos -- abgekappt Kegel -- 
  Tracht -- bloß Hinterleder -- besuchende ebenfalls eingekleiden -- Bergmann -- Steiger -- Grubenlicht anzünden -- führen dunkel Öffnung -- Kaminfegeloch aussehen -- steigen Brust hinab -- Regel -- Leiter fest halten -- bitten angstlos folgen -- 
  Sache gefährlich -- glauben Anfang -- Bergwerkswese verstehen -- 
  Empfindung -- auszieh dunkel Delinquenten-Tracht anziehen -- 
  Vier hinab klettern -- dunkel Loch dunkel -- Gott wissen -- Leiter -- 
  merken -- einzig -- schwarz Ewigkeit hinablaufend Leiter -- mehrere fünfzehn Sprosse -- Brett führen -- worauf stehen -- worin neu Loch Leiter hinableiten -- 
  Carolina steigen -- 
  schmutzigste unerfreulichst Carolina -- kennen lernen -- 
  Leitersprosse kotignaß -- 
  Leiter hinab -- Steiger voran -- beteuern -- gefährlich -- müssen Hand fest Sprosse halten -- Fuß sehen -- schwindlig -- Leib Seitenbrett treten -- schnurrend Tonnenseil heraufgehen -- -- vierzehn -- unvorsichtig Mensch hinunt stürzen Hals brechen -- 
  unten verworren rausch Summe -- stoßen beständig Balken Seil -- Bewegung -- Tonne geklopft Erz -- hervorgesintert Wasser -- herauf winden -- 
  zuweilen gelangen durchgehauen Gang -- Stolle nennen -- Erz wachsen sehen -- einsam Bergmann sitzen mühsam Hammer Erzstücke Wand heraus klopfen -- 
  unterst Tiefe -- -- behaupten -- hören -- Leute Amerika -- Hurra Lafayette -- schreien -- kommen -- -- -- wohin -- scheinen tief -- 
  -- immerwährend Brausen Sausen -- unheimlich Maschinen-Bewegung -- unterirdisch Quellen-Geriesel -- Seite herabtriefend Wasser -- qualmig aufsteigend Erddünste -- Grubenlicht bleich hinein flimmernd einsam Nacht -- 
  -- betäubend -- atmen schwer -- Mühe halten glitschrig Leiterspros -- 
  Anflug sogenannt Angst empfinden -- -- seltsam -- unten Tiefe erinnern -- vorig -- ungefähr -- Sturm Nord-See erleben -- meinen -- eigentlich traulich angenehm -- Schiff schaukelen -- Wind Trompeter-Stückche losblasen -- drein lustig Matrosen-Lärmen erschallen -- frisch überschauert Gott -- frei Luft -- 
  -- Luft -- -- 
  Luft schnappend steigen Dutzend Leitern Höhe -- Steiger führen schmal -- lang -- Berg gehauen Gang Grube Dorothea -- 
  luftiger frisch -- Leitern rein -- lang steil Carolina -- 
  Mut -- Spur lebendig Mensch gewahren -- 
  Tiefe zeigen nämlich wandelnd Schimmer -- bergleut Grubenlichter kommen allmählich Höhe -- Gruß -- Glückauf -- -- Widergruße Seite steigen vorüber -- befreunden ruhig -- quälend rätselhaft Erinnerung -- treffen -- tiefsinnig klar Blick -- ernstfrommen -- blaß -- Grubenlicht geheimnisvoll beleuchtet Gesicht -- teils jung -- teils alt Mann -- dunkel -- einsam Bergschachte arbeiten -- hinauf sehnt lieb Tageslicht -- Auge weib Kind -- 
  Cicerone kreuzehrlich -- pudeldeutsch Natur -- 
  inner Freudigkeit zeigen Stolle -- Herzog Cambridge -- Grube befahren -- Gefolge speisen -- hölzern Speisetisch stehen -- Stuhl Erz -- worauf Herzog sitzen -- 
  bleiben ewig Andenke stehen -- Bergmann -- Feuer erzählen -- Festlichkeite finden -- Stollen Lichter -- Blume Laubwerk verziern -- Bergknappe Zither spielen singen -- vergnügen lieb -- dick Herzog Gesundheite ausgetrunken -- Bergleute -- -- totschlagen lassen lieben -- dick Herzog Haus Hannover -- 
  -- Innig rühren jedesmal -- sehen -- Gefühl Untertanstreue einfach Naturlaute aussprechen -- 
  schön Gefühl -- 
  wahrhaft deutsch Gefühl -- 
  Volk gewandt -- Witziger Ergötzlicher -- keiner Treu -- treu deutsch Volk -- 
  Wüßt -- Treue alt -- Welt -- glauben -- deutsch Herz erfinden -- 
  deutsch Treue -- modern Adressen-Floskel -- 
  euer Höfe -- deutsch Fürst -- singen sing Lied getreu Eckart böse Burgund -- lieben Kind töten lassen -- Alsdann treu befinden -- 
  treue Volk -- irren -- glauben -- alt -- verständig -- treu Hund plötzlich toll -- Schnappe euer geheiligt Wade -- 
  deutsch Treue Grubenlicht -- Geflacker -- still sicher leiten Labyrinth Schacht Stollen -- steigen hervor dumpfig Bergnacht -- Sonnenlicht strahlen - Glück -- 
  meister Berg-Arbeiter wohnen Clausthal verbunden Bergstädtchen Zellerfeld -- 
  besuchen mehrere wacker Leute -- betrachten häuslich Einrichtung -- hören Lied -- Zither -- Lieblings-Instument -- hübsch begleiten -- lassen alt Bergmährchen erzählen -- Gebet hersagen -- Gemeinschaft halten pflegen -- -- dunkel Schacht hinunt steigen -- Gebet beten -- 
  alt Steiger meinen sogar -- bleiben Bergmann -- dennoch Abschied -- Auftrag Bruder -- Nähe Goslar wohnen -- Küs lieb Nicht -- 
  stillstehend ruhig Leben Leute erscheinen -- dennoch wahrhaft -- lebendig Leben -- 
  steinaln -- zitternd Frau -- -- Schranke -- hinter Ofen sitzen -- Viertel-Jahrhundert sitzen -- denken fühlen gewiß innig verwachsen Ecke Ofen Schnitzeleie Schrank -- 
  Schrank Öfen leben -- Mensch Seele eingeflößen -- 
  solch tief anschauungsleben -- -- Unmittelbarkeit -- entstehen deutsch Märchen-Fabel -- Eigentümlichkeit bestehen -- Tier Pflanze -- leblos scheinend Gegenstand sprechen handeln -- 
  Sinnigem -- harmlos Volke -- still -- umfriedet Heimlichkeit nieder Berg¬ Waldhütte offenbaren innerer Leben Gegenstand -- gewann notwendig -- konsequenen Charakter -- süß Mischung phantastisch Laune rein menschlich Gesinnung -- sehen Märche -- wunderbar verständ -- Nähnadel Stecknadel Schneider-Herberge verirr Dunklen -- Strohhalm Kohle Bach setzen verunglücken -- Schippe Besen stehen Treppe zanken schmeißen -- befragt Spiegel zeigen Bild schön Frau -- sogar Blutstropfen fangen sprechen -- bang -- dunkl Wort besorglichst Mitleid -- 
  -- Grund Leben Kindheit unendlich bedeutend -- wichtig -- hören -- sehen -- Eindrück Gleichmäßigkeit -- späterhin absichtlich -- Einzeln ausschließlich beschäftigen -- klar Gold Anschauung Papiergeld Bücher-Definition mühsam einwechseln -- Lebensbreit gewinnen -- Lebenstief verlieren -- 
  ausgewachsen -- vornehm Leute -- beziehen Wohnung -- Magd räumen täglich -- verändern Gutdünken Stellung Möbel -- interessieren -- neu -- Hans -- Isaac gehören -- Kleid bleiben fremd -- wissen -- Knöpfe Rocke sitzen -- Leib tragen -- wechseln Kleidungsstück -- keiner bleiben Zusammenhang innerer äußerer Geschichte -- -- vermögen erinnern -- braun Weste aussehen -- einst Gelächter zugezogen -- breit Streife dennoch lieb Hand geliebter lieblich ruht -- 
  alt Frau -- Schrank -- hinterm ofen -- tragen geblümt Rock verschollen Zeuge -- Brautkleid selig Mutter -- 
  Urenkel -- Bergmann gekleidet -- blond -- blitzäugig Knabe -- sitzen Füßen zählen Blume Rocke -- Rocke Geschichte erzählen -- ernsthaft -- hübsch Geschichte -- Jung gewiß vergessen -- vorschweben -- -- erwachsen Mann -- nächtlichen Stollen Carolina einsam arbeiten -- erzählen -- lieb Großmutter längst tot -- selber -- silberhaarig -- erloschen Greis -- Kreis Enkel sitzen -- Schranke -- hinter ofen -- 
  bleiben Nacht ebenfalls Krone -- unterdessen Hofrat B. Göttingen ankommen -- 
  Vergnügen -- alt Herr Aufwartung -- gedingen ebenfalls Goslar reisen -- 
  Fremdenbuch einschrieb Monat Juli blättern -- finden vielteuren Name Adalbert Chamisso -- Biographen unsterblich Schlemihl -- 
  Wirt erzählen -- Herr unbeschreibbar schlecht Wetter ankommen -- schlecht Wetter abgereisen -- 
  müssen Ranz nochmals erleichtern -- eingepackt Paar Stiefel werfen Bord -- heben Füße Goslar -- 
  -- wissen -- 
  erinnern -- 
  schlenderen bergauf -- bergab -- schaut Hinunter hübsch Wiesental -- silbern Wasser brausn -- süß Waldvögel zwitscherten -- Herdenglöckch läuten -- mannigfaltig grün Baum lieben Sonne goldig angestrahlen -- blauseiden Decke Himmel durchsichtig -- tief hinein schauen -- Allerheiligst -- Engel Fuß Gott sitzen -- Zügen Antlitzes Generalbaß studieren -- 
  leben Traum vorig Nacht -- Seele verscheuchen -- 
  alt Märche -- Ritter hinab steigen tief Brunnen -- unten schön Prinzessin starr Zauberschlafe verwünschen -- 
  Ritter -- Brunnen dunkel Claustaler Grube -- plötzlich erscheinen Licht -- Seitenlöcher stürzen wachsamen Zwerglein -- schniten zornig Gesicht -- hieben kurz Schwerter -- blies gellend Horn -- mehrere herzu eilen -- wackelten entsetzlich breit Häupt -- 
  Zuschlug Blut heraus fließen -- merken -- rotblühend -- langbärtig Distelköpfe -- vorher Landstraße Stocke abschlagen -- 
  verscheuchen -- gelangt hell Prachtsaal -- Mitte stehen -- wissen verschleiern -- Bildsäule starr regungslos -- Herzgeliebte -- küßen Mund -- -- ' m lebendig Gott -- 
  fühlt beseligend Hauch Seele süß Bebe lieblich Lippe -- 
  -- hören -- Gott rufen -- -- Licht -- -- blendend schoß herab Strahl ewig Licht -- Augenblick Nacht -- rann chaotisch wild -- wüst Meer -- 
  wild -- wüst Meer -- gehrend Wasser jagen ängstlich Gespenster Verstorbene -- weiß Totenhemde flattert Wind -- -- hetzend -- klatschend Peitsche -- laufen buntscheckig Harlequin -- -- plötzlich -- dunkel Welle -- reckt Meerungetüm mißgestaltet Häupt -- langen ausgebreitet Kralle -- entsetzen erwachen -- -- 
  zuweilen allerschönst Märche verdorben -- 
  eigentlich Ritter -- schlafend Prinzessin finden -- Stück kostbaren Schleier heraus schneiden -- Kühnheit Zauberschlaf brechen -- Palast golden Stuhle sitzen -- Ritter treten sprechen -- 
  allerschön Prinzessin -- Kennst -- 
  antworten -- allertapferst Ritter -- kennen -- 
  zeigen Alsdann Schleier heraus geschnitten Stück -- just hineinpassen -- Umarmen zärtlich -- Trompeter blasen -- Hochzeit feiern -- 
  Mißgeschick -- Liebestraum selten schön nehmen -- 
  Name Goslar klingen erfreulich -- knüpfen uralt Kaiser-Erinnerunge -- imposant -- stattlich Stadt erwarten -- 
  -- Berühmte Nähe besiehen -- 
  finden Nest meistens schmal -- labyrinthisch krumm Straße -- mittendurch Wasser -- wahrscheinlich Gose -- fließen -- verfallen dumpfig -- Pflaster -- holprig Berliner Hexameter -- 
  Altertümlichkeit Einfassung -- nämlich Rest Mauer -- Türm Zinne -- geben Stadt Pikantes -- 
  Türme -- Zwing nennen -- dick Mauer -- Gemächer ausgehauen -- 
  Platz Stadt -- weitberühmt Schützenhof halten -- schön Wiese -- ringsum hoch Berg -- 
  Markt klein -- Mitte stehen Springbrunn -- Wasser Metallbeck ergießen -- 
  Feuersbrünst Mal schlagen -- weitschallenden Ton -- 
  wissen Ursprunge Becken -- 
  sagen -- Teufel einst -- Nachtzeit -- Markt hingestellen -- 
  Leute dumm -- Teufel dumm -- machen wechselseitig Geschenk -- 
  Rathaus Goslar weißangestrichen Wachtstube -- 
  stehend Gildenhaus besseres ansehen -- 
  Ungefähr Erde Dach entfernt stehen Standbild deutsch Kaiser -- räucherig schwarz vergolden -- Hand Zepter -- Weltkugel -- sehen gebraten Universitäts-Pedelle -- 
  Kaiser halten Schwert -- Zepter -- 
  erraten -- Unterschied sagen -- gewiß Bedeutung -- deutsche merkwürdig Gewohnheit -- -- -- denken -- 
  Gottschalk's -- Handbuch -- uralt Dom berühmt Kaiserstuhl Goslar lesen -- 
  beide besehen -- -- Dom niedergeriss Kaiserstuhl Berlin bringen -- 
  einst Wanderer Europa vergebens Deutschland fragen -- 
  lanzenkundigen Freund eingestecken fortgeschleppen -- hoch Sättel -- 
  leben bedeutungschweren -- tausendjährig Dome abbrechen -- kaiserstühl Rumpelkammer werfen -- 
  Merkwürdigkeite selig Dom Stephanskirche aufstellen -- 
  Glasmalereie -- wunderschön -- schlecht Gemäld -- worunter Lucas Cranach -- ferner hölzern Christus Kreuz -- heidnisch Opfer-Altar unbekannt Metall -- Gestalt länglich viereckig Lade -- Karyatide tragen -- -- geduckt Stellung -- Hand stützend Kopfe halten -- unerfreulich häßlich Gesicht schneiden -- 
  indessen unerfreulich dabeistehend -- erwähnt -- hölzern Kruzifix -- 
  Christuskopf -- natürlich Haar Dorn blutbeschmiert Gesicht -- zeigen freilich höchst meisterhaft Hinsterbe Mensch -- gottgeborenen Heilands -- 
  materiell leiden Gesicht hinein schnitzeln -- Poesie Schmerzes -- 
  solch Bild gehören eher anatomisch Lehrsaal -- Gotteshaus -- 
  kunsterfahren Frau Küsterin -- herum führen -- zeigen -- besonderer Rarität -- vieleckig -- wohlgehobelt -- schwarz -- weiß Zahl bedeckt Stück Holz -- ampelartig Mitte Kirche hängen -- 
  O -- glänzend zeigen Erfindungsgeist protestantisch Kirche -- 
  -- denken -- Zahl besagt Stück Holze Psalm-Nummern -- gewöhnlich Kreid schwarz Tafel verzeichnen -- ästhetisch Sinn nüchtern wirken -- -- obig Erfindung -- sogar Zierde Kirche dienen -- vermißt Raphälsche Bild hinlänglich ersetzen -- 
  Fortschritt freuen unendlich -- -- Protestant Lutheraner -- tief betrüben -- katholisch Gegner leeren -- gottverlassen ansehen protestantisch Kirche bespötteln -- 
  logieren Gasthofe nah Markt -- Mittagessen schmecken -- Herr Wirt lang -- überflüssig Gesicht langweilig Frage setzen -- glücklich Weise erlösen Ankunft reisend -- Frage Ordnung aushalten müssen -- Quis -- Quid -- Ubi -- Quibus Auxiliis -- cur -- Quomodo -- quando -- 
  Fremd alt -- müd -- abgetragen Mann -- -- Rede hervorging -- Welt durchwanderen -- Batavia leben -- Geld erwerben verlieren -- -- dreißigjährig Abwesenheit Quedlinburg -- Vaterstadt -- zurückkehren -- -- -- -- setzen hinzu -- -- Familie Erbbegräbnis -- -- 
  Herr Wirt aufgeklärt Bemerkung -- Seele gleichgültig -- Leib begraben -- 
  -- schriftlich -- -- antworten Fremde -- ziehen unheimlich schlau Ring kümmerlich Lippe verblichen Äuglein -- 
  -- -- setzen ängstlich begütigend hinzu -- -- fremd Grab böses -- -- Türke begrab tote schön -- Kirchhof ordentlich Garten -- sitzen weiß -- beturbanen Grabstein -- Schatten Zypreß -- streich ernsthaft Bärte -- rauchen ruhig türkisch Tabak -- lang türkisch Pfeife -- -- Chinese ordentlich Lust zuzusehen -- Ruhestätt tote manierlich herumtänzeln -- beten -- Tee trinken -- Geig spielen -- geliebt Grab hübsch verzieren wissen -- allerlei vergoldet Lattenwerk -- Porzellan-Figürche -- Fetzen bunt Seidenzeug -- künstlich Blume -- farbig Laternche -- hübsch -- Quedlinburg -- -- 
  Kirchhof Goslar ansprechen -- 
  Desto wunderschön Lockenköpfche -- Ankunft Stadt hoch Parterre-Fenster lächelnd heraus schaute -- 
  Tisch suchen lieb Fenster -- stehen Wasserglas weiß Glockenblümche -- 
  klettern hinauf -- artig Blümchen Glase -- stecken ruhig Mütze -- kümmern aufgesperrt Mäuler -- versteinert Nase Glotzauge -- womit Leute Straße -- alt Weiber -- qualifiziert Diebstahle zusahen -- 
  Stunde Haus vorbei -- stehen Holde Fenster -- Glockenblümche Mütze gewahren -- Blutrot stürzen -- 
  schön Antlitz genau sehen -- süß -- durchsichtig Verkörperung Sommer-Abendhauch -- Mondschein -- Nachtigallenlaut Rosenduft -- 
  -- -- Dunkel -- treten Türe -- 
  -- nähern -- ziehen langsam dunkel Hausflur -- fasse Hand sagen -- Liebhaber schön Blume Küsse -- freiwillig -- stehlen -- küßte rasch -- entflieh -- flüstern beschwichtigend -- Reis -- Fort kommen -- fühl geheim Wiederdruck lieblich Lippe Hand -- lachend eil hinnen -- 
  -- lachen -- bedenke -- unbewußt Zauberformel aussprechen -- wodurch Roth blauröcke -- öfter schnurbärtig Liebenswürdigkeit -- Herz Frau bezwingen -- 
  -- reise fort -- kommen -- -- 
  Logis gewährt herrlich Aussicht Rammesberg -- 
  schön Abend -- 
  Nacht jagt schwarz Roß -- lang Mähn flattert Wind -- 
  stehen Fenster betrachtet Mond -- 
  Mann Monde -- 
  Slawen sagen -- heißen Clotar -- Wachse Mond bewirk Wasser-Aufgieße -- 
  klein -- gehören -- 
  Mond Frucht -- -- reif -- lieben Gott abgepflücken -- -- übrig Vollmonde -- Schrank legen -- Welt stehen -- Brett zugenagelen -- 
  groß -- bemerken -- Welt eng begrenzen -- menschlich Geist hölzern Schranke durchbroch -- riesig Petri-Schlüssel -- Idee Unsterblichkeit -- Himmel aufgeschlossen -- 
  Unsterblichkeit -- schön Gedanke -- 
  erdachen -- 
  Nürnberger Spießbürger -- -- weiß Nachtmütze kopfe weiß Tonpfeife Maule -- lauen Sommerabend Haustür sitzen -- behaglich meinen -- 
  hübsch -- fort -- Pfeifch Lebensatemche ausgehen -- lieb Ewigkeit hineinvegetieren -- 
  jung Liebender -- arme geliebter Unsterblichkeits-Gedank denken -- denken -- fühlen -- fühlen denken -- -- 
  Liebe -- 
  Unsterblichkeit -- 
  --- Brust plötzlich heiß -- glauben -- Geographe Äquator verlegen -- laufen Herz -- 
  Herz ergossen Gefühl Liebe -- ergossen sehnsüchtig weit Nacht -- 
  Blume Garten Fenster dufteen stark -- 
  Düfte Gefühl Blume -- Menschenherz -- Nacht -- einsam unbelauscht glauben -- stark fühlen -- scheinen Blume -- sinnig verschämt -- umhüllend Dunkelheit erwarten -- gänzlich Gefühl hinzugeben -- auszuhauch süß Düft -- 
  -- Ergießt -- Düfte Herzen -- suchen Berg Geliebte Traum -- 
  liegen schlafen -- Füßen kni Engel -- Schlafe lächeln -- Gebet -- Engel nachbeen -- Brust liegen Himmel Seligkeite -- atmen -- beben Herz Ferne -- seiden Wimper Auge Sonne untergegangen -- Auge aufschlagen -- -- Vögel singen -- Herdenglöckch läuten -- Berg schimmern smaragden Kleid -- schnür Ranz wandre -- 
  philosophisch Betrachtung Privatgefühlen überraschen Besuch Hofrat B. -- vorher ebenfalls Goslar kommen -- 
  Stunde wohlwollend Gemütlichkeit Mann tief empfinden -- 
  verehr ausgezeichnet -- erfolgreich Scharfsinn -- Bescheidenheit -- 
  finden ungemein heit -- frisch rüstig -- 
  letzterer -- beweisen jüngst neu Werk -- 
  -- Religion Vernunft -- -- Buch -- Nationalist entzücken -- Mystiker ärgern -- Publikum Bewegung setzen -- 
  Augenblick Mystiker -- Gesundheit -- -- Vorschrift Arzt -- Anreizung denken vermeiden -- 
  verkenn unschätzbar Wert rationalistisch Bemühung Paulus -- Gurlitt -- Krug -- Eichhorn -- Bouterwek -- Wegscheider -- u. S. W. Zufällig höchst ersprießlich -- Leute verjährt Übel forträumen -- alt Kirchenschutt -- worunter Schlange böse Dünste -- 
  Luft Deutschland dick heiß -- fürcht erstick -- geliebt Mitmystiker -- Liebeshitze -- erwürgen -- 
  gut Rationalist böse -- Luft verdünn Abkühl -- 
  Grund Natur Nationalismus Grenze stecken -- Luftpumpe Nordpol Mensch aushalten -- 
  Nacht -- Goslar zubrachten -- höchst Seltsames begegnen -- 
  Angst denken -- 
  Natur ängstlich -- Gott wissen -- niemals sonderlich Beklemmung empfinden -- z. B. blank Klinge Nase Bekanntschaft suchen -- nachts verrufen Walde verirren -- Konzert gähnend Leutnant verschlingen drohen -- Geister fürchten fast österreichisch Beobachter -- 
  Furcht -- 
  verstand Gemüt -- 
  Frage disputiert Doktor Saul Ascher -- Berlin -- Café royal -- Mittagstisch -- zufällig treffen -- 
  behaupten -- 
  fürchten -- Vernunftschlüsse furchtbar erkennen -- 
  Vernunft Kraft -- Gemüt -- 
  aß trank -- demonstrieren fortwährend Vorzug Vernunft -- 
  Demonstration pflegen sehen -- schließen -- 
  -- Vernunft hoch Prinzip -- -- -- 
  Vernunft -- 
  Wort hören -- sehen Doktor Saul Ascher abstrakt Bein -- eng -- transzendentalgrau Leibrock -- schroffen -- frierend kalt Gesicht -- Lehrbuche Geometrie Kupfertafel dienen -- 
  Mann -- tief Fünfzig -- personifiziert Linie -- bildet Gegensatz -- hogarthsch Wellenlinie leben -- 
  Streben Positiv -- arm Mann herrlich Leben heraus philosophieren -- Sonnenstrahl -- Glaube Blume -- bleiben übrig -- kalt -- positiv Grab -- 
  Apoll Belvedere Christentum speziellen Malice -- 
  letzterer schreiben sogar Broschüre -- worin Unvernünftigkeit Unhaltbarkeit beweisen -- 
  Menge Buch schreiben -- worin Vernunft Vortrefflichkeit renommieren -- wobei arm Doktor gewiß ernsthaft meinen -- Hinsicht Achtung verdienen -- 
  bestehen Hauptspaß -- ernsthaft närrisch Gesicht schneiden -- dasjenig begreifen -- jeder Kind begreifen -- Kind -- 
  mal besuchen Vernunft-Doktor Haus -- schön Mädchen finden -- Vernunft verbieten Sinnlichkeit -- 
  einst ebenfalls besuchen -- Bedienter -- Herr Doktor sterben -- 
  fühlen -- -- Herr Doktor ausgezogen -- -- 
  Goslar -- 
  -- hoch Prinzip Vernunft -- -- beschwichtigend -- Bett steigen -- 
  indessen -- helfen -- 
  varnhagen Ense's -- deutsch Erzählung -- -- Clausthal mitnehmen -- entsetzlich Geschichte lesen -- Sohn -- Vater ermorden -- Nacht Geist tot Mutter warnen -- 
  wunderbar Darstellung Geschichte bewirken -- Lesen innerer grauen durchfröstelen -- 
  erreg Gespenster-Erzählungen schauerlicher Gefühl -- Reise lesen -- zumal Nacht -- Stadt -- Haus -- Zimmer -- -- 
  Gräßlich zugetrag Fleck -- liegst -- 
  denken unwillkürlich -- 
  überdies scheinen Mond zweideutig Zimmer herein -- Wand bewegen allerlei unberufen Schatten -- Bette aufrichten -- sehen -- erblicken -- 
  Unheimlicher -- -- Mondschein -- Gesicht zufällig Spiegel sehen -- 
  Augenblick schlagen schwerfällig -- gähnend Glock -- langsam -- zwölft Glockenschlag sicher glauben -- unterdessen voll Stunde verflossen -- müssen vorn anfangen zwölf schlagen -- 
  vorletzter letzter Glockenschlag schlagen -- rasch -- fast keifend gell -- ärgerlich Langsamkeit Frau Gevatterin -- 
  eisern Zunge schwiegen -- tief Todesstille Haus herrschen -- plötzlich -- hören Korridor -- Zimmer -- schlottern schlappen -- unsicher Gang alt Mann -- 
  öffnet Türe -- langsam treten Herein verstorben Doktor Saul Ascher -- 
  kalt Fieber rieselen Mark Bein -- zittert Espenlaub -- wagen Gespenst ansehen -- 
  -- transzendentalgrauen Leibrock -- abstrakt Bein -- mathematisch Gesicht -- gelblich -- Mund -- Winkel 221 -- 2 Grad bilden -- zusammengekniffen -- Augenkreise groß Radius -- 
  schwankend -- spanisch Röhrchen stützend -- nähert -- gewöhnlich mundfaul Dialekte sprechen freundlich -- 
  -- Fürcht -- glauben -- Gespenst -- 
  Täuschung Phantasie -- Gespenst sehen glauben -- 
  Gespenst -- 
  geben Definition -- 
  deduzierer Bedingung Möglichkeit Gespenst -- 
  vernünftig Zusammenhang ständ Erscheinung Vernunft -- 
  Vernunft -- sagen Vernunft -- -- 
  schritt Gespenst Analyse Vernunft -- zitieren Kant's -- Kritik rein Vernunft -- 2t -- 1ster Abschnitt -- 2t Buch -- 3t Hauptstück -- Unterscheidung Phänomena Noumena -- konstruiert Alsdann problematisch Gespensterglauben -- setzen Syllogismus -- schließen logischen Beweis -- Geist -- 
  unterdessen laufen kalt Schweiß Rücken -- Zahn klappert Kastagnetten -- Seelenangst nicken unbedingt Zustimmung Satz -- womit spukend Doktor Absurdität Gespensterfurcht beweisen -- demonstrieren eifrig -- Zerstreuung -- golden -- Hand voll Würmer uhrtasche ziehen -- Irrtum bemerkend -- possierlich ängstlich Hastigkeit einstecken -- 
  -- Vernunft hoch -- -- schlagen Glock eins Gespenst verschwinden -- 
  Goslar -- halb Geratewohl -- halb Absicht -- Bruder Claustaler Bergmann aufsuchen -- 
  schön -- lieb Sonntagswetter -- 
  Bestieg Hügel Berg -- betrachten Sonne Nebel verscheuchen suchen -- wanderen freudig schauernd Wald -- träumend Haupt klingeln Glockenblümch Goslar -- 
  weiß Nachtmäntel stehen Berg -- Tanne rüttelen Schlaf Gliedern -- frisch Morgenwind frisiert herabhängend -- grün Haar -- Vöglein halten Betstund -- Wiesental blitzen diamantenbesät Golddeck -- Hirte schreiten läutend Herde -- 
  eigentlich verirren -- 
  schlagen Seitenwege Fußsteige -- glauben nah Ziel gelangen -- 
  Leben -- Harz -- 
  Seele -- Weg bringen -- -- finden obendrein besonderer Vergnügen -- selbstgefällig Miene wohlwollend lauter Stimme bedeuten -- Umweg -- abgründ Sümpfe versinken -- welcher Glück -- wegkundig Leute -- -- zeitig antreffen -- 
  Berichtiger finden unweit Harzburg -- 
  wohlgenährt Bürger Goslar -- glänzend wampig -- dummklug Gesicht -- -- Viehseuche erfinden -- 
  gehen Strecke -- erzählen allerlei Spukgeschichten -- hübsch klingen -- hinaus laufen -- wirklich Spuk -- -- weiß Gestalt Wilddieb -- wimmernd Stimme geworfen jung Bach -- wild Sau -- -- Geräusch Boden Hauskatz herrühren -- 
  Mensch krank -- setzen hinzu -- glauben Gespenster sehen -- wenigkeit anbelang -- selten krank -- zuweilen leid Hautübel -- kurieren jedesmal nüchtern Speichel -- 
  aufmerksam Zweckmäßigkeit Nützlichkeit Natur -- 
  Baum grün -- grün Auge -- 
  -- fügen hinzu -- Gott Rindvieh erschaffen -- Fleischsuppe Mensch stärken -- Esel erschaffen -- Mensch Vergleichunge dienen -- Mensch erschaffen -- Fleischsuppe essen Esel -- 
  Begleiter entzücken Gleichgestimmt finden -- Antlitz erglänzen Freudiger -- Abschied rühren -- 
  -- gleichsam Natur entzaubern -- sobald fort fangen Baum sprechen -- Sonnenstrahl erklangen -- Wiesenblümche tanzen -- blau Himmel umarmt grün Erde -- 
  -- wissen -- Gott Mensch erschaffen -- Herrlichkeit Welt bewundern -- 
  Autor -- -- wünschen -- Werk geloben -- 
  Bibel -- memoir Gott -- stehen ausdrücklich -- Mensch erschaffen Ruhm Preis -- 
  lang Hin Herwander gelangt Wohnung Bruder Claustaler Freund -- übernachten -- erleben folgend schön Gedicht -- I . 
  Berg stehen Hütte -- alt Bergmann wohnen -- dorten rauschen grün Tanne -- erglänzen golden Mond -- 
  Hütte stehen Lehnstuhl -- Reich schnitzen wunderlich -- sitzen -- glücklich -- Glücklich -- 
  Schemel sitzen -- Stützen Arm Schoß -- Äuglein blau Stern -- Mündlein Purpurrose -- 
  lieben -- blau Stern Schaun himmelgroß -- legen Lilienfinger Schalkhaft Purpurrose -- 
  -- sehen Mutter -- spinnen groß Fleiß -- Vater spielen Zither -- singen alt Weise -- 
  flüstern leise -- Leise -- gedämpft laut -- wichtig Geheimnis anvertrauen -- 
  -- Muhme tot -- Schützenhof Goslar -- schön -- 
  -- einsam -- kalt Bergeshöhe -- Winter gänzlich vergraben Schnee -- 
  -- bang Mädchen -- fürcht Kind bös Bergesgeister -- nachts geschäftig -- 
  plötzlich schweigen lieben -- eignen Wort erschrecken -- Händchen Äuglein bedeckt -- 
  Lauter rauschen Tanne draußen -- Spinnrad schnarren brummen -- Zither klingen -- alt Weise summen -- -- Fürcht -- -- lieb Kindchen -- böse Geist -- Nacht -- lieb Kindchen -- Halten Englein Wacht -- 
  II. 
  Tannenbaum -- grün Finger -- Pocht an niedre Fensterlein -- Mond -- gelb Lauscher -- Wirft süß Licht herein -- 
  Vater -- Mutter schnarchen leise nah Schlafgemach -- -- selig schwatzend -- halten wach -- 
  -- beten -- glauben schwer -- zucken Lippe Bete -- 
  -- böse -- kalt Zucken -- erschrecken jedesmal -- dunkel Angst beschwichtigen Auge fromm Strahl -- 
  -- bezweifle -- Glaubest -- Glaube -- Glaubst Gott Vater -- Sohn heiligen Geist -- -- -- 
  -- Kindchen -- Knabe -- sitzen Mutter Schoß -- Glaubte Gott Vater -- walten -- schön Erde erschaffen -- schön Mensch drauf -- Sonne -- Mond -- Stern -- Vorgezeichnet Lauf -- 
  groß -- Kindchen -- begriff -- Begriff -- vernünftig -- glauben Sohn -- lieben Sohn -- liebend Liebe offenbaren -- Lohne -- gebräuchlich -- Volk kreuzigen -- 
  -- auswachsen -- lesen -- reisen -- Schwillt Herz -- Herz Glaub heilig Geist -- 
  groß Wunder -- größ're tun -- zerbrach Zwingherrnburg -- zerbrach Knechtes Joch -- 
  alt Todeswunde heilen -- erneut alt -- Mensch -- gleichgeboren -- adlig Geschlecht -- 
  verscheuchen böse Nebel -- dunkel Hirngespinst -- Liebe -- Lust verleiden -- Nacht angegrinst -- 
  tausend Ritter -- wohlgewappnen -- heilig Geist erwählen -- Wille erfüllen -- mutbeseeln -- 
  teuer Schwert blitzen -- gut Banner weh 'n -- 
  Ei -- möchtesen -- Kindch -- stolz Ritter sehen 'n -- 
  -- Schau -- Kindchen -- Küs schauen dreist -- selber Ritter heiligen Geist -- 
  III. still verstecken Mond draußen -- m grün Tannenbaum -- Zimmer Lampe Flackert matt leuchten -- 
  blau Stern Strahl hell Licht -- glühn Purpurröslein -- lieb Mädchen sprechen -- 
  -- Völkche -- Wichtelmännch -- Stehle Brot Speck -- Abends liegen Kasten -- morgens weg -- 
  -- Völkche -- Sahne Nascht Milch -- lassen Unbedeckt Schüssel stehen -- Katze säufen Rest -- 
  -- Katze Hexe -- schleichen -- Nacht Sturm -- Drüben Geisterberge -- altverfallen Turm -- 
  -- einst Schloß gestehen -- Voller Lust Waffenglanz -- Blanke Ritter -- Frau Knappe Schwang Fackeltanz -- 
  -- verwünscht Schloß Leute bös Zauberin -- Trümmer bleiben stehen -- Eul nisten -- 
  -- selig Muhme -- 
  sprechen Wort -- Nächtlich Stunde -- Drüben Ort -- -- verwandeln Trümmer hell Schloß -- tanzen lustig Ritter -- Frau Knappentroß -- -- Wort sprechen -- gehören Schloß Leute -- Pauken Trompet huldig jung Herrlichkeit -- 
  blühen Märchenbilder Munde Roslein -- Auge gießen drüber blau Sternenschein -- 
  golden Haar wickeln Hand -- Finger hübsch Name -- Lacht küssen -- schweigen -- 
  still Zimmer Blickt wohlvertraut -- Tisch Schrank -- Mal schauen -- 
  freundlich ernsthaft schwatzen Wanduhr -- Zither -- hörbar -- Fängt selber klingen -- sitzen Traum -- 
  Stunde -- Ort -- Staun würdest -- Kindch -- Spräche Wort -- 
  sprech Wort -- dämmern erbeben Mitternacht -- Bach Tanne brausen lauter -- alt Berg erwachen -- 
  Zitherklang Zwergenlied Tönen Berg Spalt -- sprießen -- wie_ein toll Frühling -- Draus hervor Blumenwald -- Blume -- kühn Wunderblumen -- Blatt -- breit fabelhafen -- Duftig bunt hastig regsam -- drängen Leidenschaft -- 
  Rose -- wild rot Flamme -- Sprühn Gewühl hervor -- Lilien -- kristallen Pfeiler -- schießen himmelhoch empor -- 
  Stern -- Sonne -- Schaun herab Sehnsuchtglut -- Lilien Riesenkelche Strömet Strahlenflut -- 
  selber -- süß Kindchen -- verwandeln -- Fackelglanz Gold Seide Schimmer lustig -- 
  -- wurdest Prinzessin -- Hütte Schloß -- jubeln tanz Ritter -- Frau Knappentroß -- 
  -- erwerben -- Schloß Leute -- -- pauken Trompet huldig jung Herrlichkeit -- 
  Sonne -- 
  Nebel fliehen -- Gespenster -- m Hahnenschrei -- 
  steigen bergauf bergab -- schweben schön Sonne -- Schönheit beleuchtend -- 
  Geist Gebirges begünstigen offenbar -- 
  wissen -- Dichtermensch Hübsches wiedererzählen -- lassen Harz sehen -- gewiß -- 
  Harz -- sehen -- Augenwimpern flimmern kostbar Perle -- Gräser Tals -- 
  Morgentau Liebe feuchtet Wang -- rauschend Tanne verstehen -- Zweig tun -- bewegn herauf herab -- stumm Mensch -- Hand Freude bezeigen -- Ferne klingen wunderbar geheimnisvoll -- Glockengeläute verloren Waldkirch -- 
  -- Herdenglöckchen -- Harz lieblich -- klar rein stimmen -- 
  Stand Sonne Mittag -- Herde stoßen -- Hirte -- freundlich blond jung Mensch -- -- Berg -- Fuß ständ -- alt -- weltberühmt Brocken -- 
  Stunde ringsum liegen Haus -- froh -- jung Mensch einladen -- essen -- 
  setzen nieder dejeuner dinatoir -- Käse Brot bestehen -- schäfchen erhascht Krum -- lieben -- blank Kühlein springen herum -- klingeln schelmisch Glöckche -- lachen -- vergnügen Auge -- 
  tafelten königlich -- scheinen Wirt echt König -- einzig König -- Brot geben -- königlich besingen -- 
  König Hirtenknabe -- Grüner Hügel Thron -- Haupt Sonne schwer -- golden Krone -- 
  Fuß liegen Schaf -- Weiche Schmeichler -- rotbekreuzen -- Kavaliere Kälber -- wandeln stolz spreizen -- 
  Hofschauspieler Böcklein -- Vögel Kuh -- Flöt -- Glöcklein -- Kammermusizi -- 
  klingen singen lieblich -- lieblich rausch drein Wasserfall Tannenbäume -- König schlummern -- 
  unterdessen regieren Minister -- Hund -- knurrig Gebelle Widerhallet Runde -- 
  schläfrig lallen jung König -- 
  -- regieren schwer -- -- -- Haus Königin -- 
  -- arme Königin Ruht Königshaupt weich -- lieben Auge Liegen unermeßlich Reich -- 
  nehmen freundschaftlich Abschied -- fröhlich steigen Berg hinauf -- 
  empfangen Waldung himmelhoh Tanne -- -- Hinsicht -- Respekt -- 
  Baum nämlich Wachse -- Jugend sauer lassen -- 
  Berg Granitblöcke übersäet -- meister Baum müssen Wurzel Stein umranken sprengen -- mühsam Boden suchen -- woraus Nahrung schöpfen -- 
  liegen Stein -- gleichsam Tor bildend -- -- stehen Baum -- nackt Wurzel Steinpfort hinziehend -- Fuß Boden erfassend -- frei Luft wachsen scheinen -- 
  gewaltig Höhe empor geschwungen -- -- umklammert Stein zusammengewachsen -- stehen fest bequem Kollege zahm Forstbode flach Land -- 
  stehen Leben Mann -- Überwinden Hemmung Hindernis stärken befestigen -- 
  Zweig Tanne klettern Eichhörnch spazieren gelb Hirsch -- 
  solch lieb -- edl Tier sehen -- begreifen -- gebildet Leute Vergnügen finden -- hetzen töten -- 
  solch Tier barmherzig Mensch -- säugen schmachtende Schmerzenreich heilig Genoveva -- 
  Allerliebst schießen golden Sonnenlichter dichen Tannengrün -- 
  natürlich Treppe bilden Baumwurzel -- 
  überall schwellend Moosbank -- Stein fußhoch schön Moosart -- hellgrünen Samtpolster -- bewachsen -- 
  lieblich Kühle träumerisch Quellengemurmel -- 
  sehen -- Wasser Stein silberhell hinrieseln nackt Baumwurzel Faser bespülen -- 
  treiben hinab beugen -- Belauscht gleichsam geheim Bildungsgeschicht Pflanze ruhig Herzklopfe Berg -- 
  Ort sprudeln Wasser Stein Wurzel stark hervor bilden Kaskade -- 
  lassen sitzen -- 
  murmelen Rauscht wunderbar -- Vögel singen abgebrochen Sehnsuchtslaut -- Baum flüstern tausend Mädchen-Zung -- tausend Mädchen-Aug schauen seltsam Bergblumen -- strecken wundersam breit -- drollig gezackt Blatt -- spielend flimmern lustig Sonnenstrahl -- sinnigen Kräutlein erzählen grün Märche -- verzaubern -- heimlich Heimlicher -- uralt Traum lebendig -- Geliebte erscheinen -- -- schnell verschwinden -- 
  hoch Berg hinauf steigen -- desto kurz -- zwerghaft Tanne -- scheinen schrumpfen -- Heidelbeer Rothbeer-Sträuche Bergkräuter übrig bleiben -- 
  fühlbar kälter -- 
  wunderlich Gruppe Granitblöcke sichtbar -- erstaunlich Größe -- 
  Spielball -- böse Geist zuwerfen Walpurgisnacht -- Hexe Besenstielen Mistgabel einhergeriten -- abenteuerlich verrucht Lust beginnen -- glaubhaft Amme erzählen -- schauen hübsch Faustbilder Meister Retzsch -- 
  -- jung Dichter -- Reise Berlin Göttingen Mainacht Brocken vorbei riten -- bemerken sogar -- belletristisch Dame Bergecke ästhetisch Tea-Gesellschaft halten -- gemütlich -- Abendzeitung -- vorlasen -- poetisch Ziegenböckch -- meckernd Teetisch umhüpften -- Universal-Genie priesen -- Erscheinung deutsch Literatur Endurteil fällten -- -- -- Ratkliff -- -- Almansor -- geraten -- Verfasser Frömmigkeit Christlichkeit absprachen -- sträubt Haar jung Mann -- entsetzen ergreifen -- Pferd Sporen jagen vorüber -- 
  -- ob Hälfte Brocken besteigen -- erwehren -- ergötzlich Blocksberg-Geschicht denken -- -- mystisch -- deutsch National-Tragödie Docter Faust -- 
  -- Pferdefuß hinauf kletter -- humoristisch Atem schöpfe -- 
  glauben -- Mephisto Mühe Atem holen -- Lieblingsberg ersteigen -- äußerst erschöpfend Weg -- froh -- langersehnt Brockenhaus Gesicht bekommen -- 
  Haus -- -- vielfach Abbildung -- bloß Parterre bestehen -- Spitze Berge liegen -- 1800 Graf Stollberg-Wernigerode erbauen -- Rechnung -- Wirtshaus -- verwalten -- 
  Mauer erstaunlich dick -- Wind Kälte Winter -- Dach niedrig -- Mitte stehen turmartig Warte -- Haus liegen Nebengebäude -- wovon -- früh Zeit -- Brockenbesuchern Obdach dienen -- 
  Eintritt Brockenhaus erregt ungewöhnlich -- märchenhaft Empfindung -- 
  lang -- einsam Umhersteig Tann Klippe plötzlich Wolkenhaus versetzen -- Stadt -- Berg Wald bleiben unten liegen -- finden wunderlich zusammengesetzt -- fremd Gesellschaft -- -- dergleich Ort -- fast erwartet Genosse -- halb neugierig halb gleichgültig -- empfangen -- 
  finden Haus voll Gast -- klug Manne geziemt -- dacht Nacht -- Unbehaglichkeit Strohlager -- hinsterbend Stimme verlangt Tee -- Herr Brockenwirt vernünftig einzuseh -- krank Mensch Nacht ordentlich Bett müssen -- 
  verschaffen eng Zimmerche -- jung Kaufmann -- lang Brechpulver braun Oberrock -- etablieren -- 
  Wirtsstube finden lauter Leben Bewegung -- 
  Student verschieden Universität -- 
  vorher ankommen restaurieren -- bereiten Abmarsch -- schnüren Ranz -- schreiben Name Gedächtnisbuch -- erhalten Brockensträuß Hausmädchen -- Wang kniffen -- gesung -- Gesprunge -- johlen -- fragen -- antworten -- Wetter -- Fußweg -- Prosit -- Adieu -- 
  Abgehende angesoffen -- schön Aussicht doppelt Genuß -- Betrunkener doppelt sehen -- 
  rekreieren -- Bestieg Turmwarte -- finden Herr Dame -- jung ältlichen -- 
  jung Dame schön -- 
  herrlich Gestalt -- lockig Haupt helmartig -- schwarz Atlashut -- weiß Feder Wind spielen -- schlank Glied schwarzseiden Mantel fest umschloss -- edl Form hervortraten -- frei -- Auge ruhig hinabschauend frei -- Welt -- 
  Knabe -- denken Zauber- Wundergeschicht -- schön Dame -- Straußfeder kopfe tragen -- halten Elfen-Königin -- schön Dame -- bemerken -- Schleppe Kleide naß -- halten Wasser¬ Nixe -- 
  denken -- Naturgeschicht wissen -- symbolisch Feder dümmst Vogel herkommen -- Schleppe Damenkleide natürlich Weise naß -- 
  Knaben-Aug erwähnt jung schön -- erwähnt Stellung -- Brocken sehen -- sicher denken -- 
  Fee Berge -- Zauber aussprechen -- wodurch unten wunderbar erscheinen -- 
  -- hoch Grade wunderbar erscheinen hinabschau Brocken -- Seite unser Geist empfang Eindruck -- -- meistens verschiedenartig -- sogar widersprechend -- verbind Seele -- unentworren -- unverstanden Gefühl -- 
  gelingen -- Gefühl Begriff erfassen -- erkennen Charakter Berg -- 
  Charakter deutsch -- sowohl Hinsicht Fehler -- Vorzug -- 
  Brocken deutsch -- 
  deutsch Gründlichkeit zeigen -- klar deutlich -- Riesen-Panorama -- hundert Stadt -- Städtchen Dorf -- meistens nördlich liegen -- ringsum Berg -- Wald -- Fluß -- Fläche -- unendlich -- 
  erscheinen scharfgezeichnen -- rein illuminiert Spezialkarte -- nirgends Auge eigentlich schön Landschaft erfreuen -- geschehen -- deutsch Kompilator -- ehrlich Genauigkeit -- womit hingeben -- denken -- Einzeln schön Weise geben -- 
  Berg Deutschruhig -- Verständige -- Tolerant -- Ding klar überschauen -- 
  solch Berg Riesen-Aug öffnen -- sehen -- Zwerg -- unser blöd Äuglein herum klettern -- 
  behaupten -- Brocken philiströsen -- Claudius singen -- 
  -- Blocksberg Herr Philister -- -- 
  Irrtum -- 
  Kahlkopf -- zuweilen weiß Nebelkappe bedeckt -- Anstrich Philistrosität -- -- deutsche -- geschehen pur Ironie -- 
  sogar notorisch -- Brocken burschikosen -- phantastisch Zeit -- Mai-Nacht -- 
  werfen Nebelkappe jubelnd Lüfte -- -- Übrig -- echtdeutsch romantisch verrückt -- 
  suchen schön Dame Gespräch verflechn -- Naturschönheite genießen -- Stelle aussprechen -- 
  geistreich -- aufmerksam sinnig -- 
  wahrhaft vornehm Form -- 
  gewöhnlich -- steif -- negativ Vornehmheit -- genau -- unterlassen -- seltener -- frei -- positiv Vornehmheit -- genau -- -- -- Unbefangenheit -- hoch gesellig Sicherheit -- 
  entwickelt -- Verwunderung -- geographisch Kenntnis -- nennen wißbegierig schöne Name Stadt -- liegen -- suchen zeigen Landkarte -- Steintisch -- Mitte Turmplatte stehen -- echt Dozenten-Miene ausbreiten -- 
  Stadt finden -- Finger suchen -- Auge -- unterdessen Gesicht hold Dame orientiert -- schön Part finden -- -- Schierk -- -- elend -- -- 
  Gesicht gehören -- reizen -- selten entzücken -- fallen -- 
  lieb Gesicht -- schlimmbewegt Herz Ruhe lächeln -- 
  Dame unverheiraten -- obgleich Vollblüte -- Ehestande hinlänglich berechtigen -- 
  täglich Erscheinung -- just schön Mädchen halten schwer -- Mann bekommen -- 
  Altertum Fall -- -- -- Grazie sitzen bleiben -- 
  Verhältnis Herr -- Dame begleiten -- stehen -- erraten -- 
  dünn -- merkwürdig Figur -- 
  Köpfchen -- sparsam bedeckt grau Härche -- kurz Stirn grünlich Libellen-Aug reichen -- rund Nase hervor tretend -- Mund Kinn ängstlich Ohr ziehend -- 
  Gesichtchen scheinen zart -- gelblich Tone bestehen -- woraus Bildhauer Modell kneten -- schmal Lippe kniffen -- ziehen Wang tausend halbkreisartig -- fein Fältch -- 
  Mann sprechen Wort -- -- alt Dame Freundliches zuflüsteren -- lächelen Mops -- Schnupfe -- 
  alt Dame Mutter jung -- besitzen vornehmst Form -- 
  Auge verraten krankhaft-schwärmerisch Tiefsinn -- Mund liegen streng Frömmigkeit -- scheinen mir_es -- einst schön -- lachen Küs empfangen erwidern -- 
  Gesicht glich Kodex Palympsestus -- -- neuschwarz Mönchsschrift Kirchenvater-Textes -- halberloschen Vers altgriechisch Liebes-Dichter hervorlauschen -- 
  Dame Begleiter Italien -- erzählten allerlei Schön Rom -- Florenz Venedig -- 
  Mutter erzählt Raphälsche Bild Peterskirch -- Tochter sprechen Oper Theater Fenice -- 
  entzücken Kunst Improvisatoren -- 
  Nürnberg Dame Vaterstadt -- altertümlich Herrlichkeit wissen sagen -- 
  holdselig Kunst Meistergesang -- wovon Wagenseil letzter Klang erhalten -- erloschen -- Bürgerinne Nürnberg erbau welsch Stegreif-Unsinn Kapaunen Gesang -- 
  O Sankt Sebaldus -- arm Patron -- 
  derweil sprechen -- beginnen dämmern -- Luft kälter -- Sonne neigen tief -- Turmplatte füllen Student -- handwerksburschen ehrsam Bürgerleute -- samt Frau Tochter -- Sonnen-Untergang sehen -- 
  erhaben Anblick -- Seele Gebet stimmen -- 
  Viertelstund stehen ernsthaft schweigend -- sehen -- schön Feuerball Westen allmählich Versank -- Gesicht Abendrot angestrahlen -- Hand falten unwillkürlich -- -- stehen -- still Gemeinde -- Schiff Riesendom -- Priester erhöbe Leib Herr -- Orgel herab Ergös Palestrina's ewig Choral -- 
  Andacht versinken stehen -- hören -- ausruft -- 
  -- Natur schön -- -- 
  Wort kommen gefühlvoll Brust Zimmergenosse -- jung Kaufmann -- 
  gelangt Werkeltags-Stimmung -- Stande -- Dame Sonnen-Untergang Artiges sagen -- ruhig -- passieren -- Zimmer führen -- 
  erlauben -- Stunde unterhalten -- 
  Erde drehen Unterhaltung Sonne -- 
  Mutter äußern -- Nebel versinkend Sonne ausgeseh rotglühend Rose -- galant Himmel herab werfen weitausgebreiten -- weiß Brautschleier geliebt Erde -- 
  Tochter lächelen meinen -- öfter Anblick Naturerscheinung schwäch Eindruck -- 
  Mutter berichtigt falsch Meinung Stelle Goethe Reisebrief -- Rede Goethe Werk -- 
  ästhetisch Kollege Gelegenheit rauben lassen -- letzterer breit Gespräch einzuflechn -- 
  schreiben gerne Unwahr -- Goethe sprechen -- -- Furcht -- -- deutsch Literatus -- Lieblingsthema Festschwatze -- Gespräch Gegenstand leiten -- kommen römisch Vase -- Angorakatz -- Lord Byron -- Makkaroni -- türkisch Schal u. S. W. alt Dame lispelen hübsch Sonnenuntergangsstelle Byron Gedicht -- 
  jüngern Dame -- Englisch verstehen -- Gedicht kennen lernen -- empfehlen Übersetzung schönen -- geistreich Landsmännin -- Baronin Elise Hohenhausen -- Gelegenheit ermangelt -- jung Dame pflegen -- Byron Gottlosigkeit -- Lieblosigkeit -- Trostlosigkeit -- Himmel wissen -- eifern -- 
  Geschäft Brocken spazieren -- dunkel -- 
  Nebel stark -- betrachtet Umris Hügel -- Hexen-Altar Teufels-Kanzel nennen -- 
  schoß Pistole -- Echo -- 
  plötzlich hören bekannt Stimme fühlen umarmt küßen -- 
  Landsleute -- Göttingen verlassen -- bedeutend erstaunt -- Blocksberge finden -- 
  erzähl Verwunder Verabreden -- lachen erinnern -- Geist unser gelehrt Sibirien -- Kultur -- Bär Wirtshäuser angebunden -- Zobel Jäger gut Abend wünschen -- 
  Zimmer Abendmahlzeit halten -- 
  lang Tisch Reihe hungrig Student -- 
  Anfang gewöhnlich Universitäts-Gespräch -- Duelle -- Duelle Duelle -- 
  Gesellschaft bestehen meistens Hallenser -- Halle Hauptgegenstand Gespräch -- 
  Fensterscheibe Hofrat Schütz exegetisch beleuchten -- 
  erzählen -- letzter Cour König Zypern glänzend -- natürlich Sohn erwählen -- lichtensteinsch Prinzessin an linker Bein antrauen lassen -- Staatsmätresse abdanken -- gerührt Ministerium vorschriftmäßig weinen -- 
  brauchen erwähn -- Hallesch Bierwürde beziehen -- 
  Hernach kommen Chinese auf's Tapet -- Berlin sehen lassen -- Halle Privat-Dozent chinesisch Ästhetik abgerichten -- 
  Witze gerissen -- 
  setzen Fall -- deutscher lassen China Geld sehen -- Zweck Anschlag-Zettel schmieden -- worin Mandarin Tsching-Tsching-Tschung Hi-Ha-Ho begutachten -- echt deutsche -- worin ferner Kunststück aufgerechnen -- hauptsächlich Philosophier -- Tabakrauch Geduld bestehen -- worin schließlich bemerken -- zwölf -- Fütterungsstund -- Hund mitbringen dürfen -- arm deutsch Brocken weg schnappen pflegen -- 
  -- jung Burschenschaftler -- kürzlich Purifikation Berlin -- sprechen Stadt -- einseitig -- 
  Wisotzki Theater besuchen -- beurteilen falsch -- 
  -- schnell fertig Jugend Wort u. S. W. -- 
  sprechen Garderobe-Aufwand -- Schauspieler- Schauspielerinnen-Skandal u. S. W. jung Mensch wissen -- -- Berlin Schein Ding meister gelten -- allgemein Redensart -- duhn -- hinlänglich andeuten -- Scheinwese Brett florieren -- Intendanz meister sorg -- Farbe Bart -- womit Rolle spielen -- -- Treue Kostüm -- beeidigt Historiker vorgezeichnen -- wissenschaftlich gebildet Schneidern nähen -- 
  notwendig -- 
  trüge Mal Maria Stuart Schürze -- Zeitalter Königin Anna gehören -- gewiß Bankier Christian Gumpel beklagen -- Illusion verlieren gehen -- Mal Lord Burleigh Verseh Hosen Heinrich IV anziehen -- gewiß Kriegsrätin Steinzopf -- geb. Lilientau -- Anachronismus Abend Auge lassen -- 
  täuschend Sorgfalt General-Intendanz erstrecken bloß Schürze Hose -- verwickelt Person -- 
  künftig Othello wirklich Mohr spielen -- Professor Lichtenstein Behufe Afrika verschreiben -- Menschenhaß Reue künftig Eulalia verlaufen Weibsbilde -- Peter dummen Junge -- unbekannte geheim Hahnrei spielen -- Afrika verschreiben brauchen -- -- Verhältnis -- wirklich Schriftsteller -- Mal paar Maulschelle bekommen -- Rolle Held spielen -- Ahnfrau Künstler -- Jaromir -- rauben -- stehlen -- Lady Macbeth Dame spielen -- -- Tick verlangen -- Natur liebevoll -- blutig Anblick meuchelmörderisch Abstechen einigermaßen vertraut -- -- Darstellung seicht -- Witzloser -- pöbelhaft Geselle Angeli engagieren -- Angeli -- geistesgenossen jedesmal entzücken -- erheben wahr Größe -- -- -- -- Zoll Lump -- -- -- 
  obenerwähnt jung Mensch Verhältnis Berliner Schauspiel begreifen -- merken -- Spontinische Janitscharen-Oper -- Pauken -- Elefant -- Trompeten Tamtam -- heroisch -- erschlafft Volk kriegerisch stärken -- -- Plato Cicero staatspfiffig empfehlen -- 
  allerwenigsen Begriff jung Mensch diplomatisch Bedeutung Ballett -- 
  Mühe zeigen -- Hoguet Fuß Politik sitzen Bucholz Kopf -- Tanztour diplomatisch Verhandlung bedeuten -- Bewegung politisch Beziehung -- z. B. Kabinett meinen -- -- sehnsüchtig vorgebeugen -- Hand weitausgereifen -- -- -- -- meinen -- hundertmal Fuß herumdrehen Fleck -- Fürst meinen -- gebunden Bein herumtrippeln -- europäisch Gleichgewicht bezeichnen -- Trunkener herschwanken -- Kongreß andeuten -- gebogen Arm knäulartig verschlingen -- unser allzugroß Freund Osten darstellen -- allmählich Entfaltung Höhe heben -- Stellung ruhen -- plötzlich erschrecklichst Sprung ausbrichen -- 
  jung Manne fallen Schuppe Auge -- merken -- Tänzer honorieren Dichter -- Ballett diplomatisch Korps unerschöpflich Gegenstand Gespräch -- schön Tänzerin privatim Minister unterhalten -- gewiß Nacht abmühen -- politisch Systemchen empfänglich -- 
  ' m Apis -- 
  Zahl exoterisch klein Zahl esoterisch Theaterbesucher -- 
  stehen blöd Volk gafft bewundern Sprung Wendung -- studieren Anatomie Stellung Lemiere -- applaudieren Entrechat Röhnisch -- schwatzen Grazie -- Harmonie Lend -- merken -- getanzt Chiffre Schicksal deutsch Vaterland Auge -- 
  solcherlei Gespräch fliegen -- verlieren nützlich Auge -- Schüssel -- Fleisch -- Kartoffel u. S. W. anfüllen -- fleißig zusprechen -- 
  essen -- 
  erwähnen leichthin Nachbar -- -- Akzent -- woran Schweizer erkennen -- unhöflich antworten -- deutsch wahr Freiheit -- wahr Genügsamkeit unbekannt -- 
  zucken Achsel bemerken -- eigentlich Fürstenknechte Leckerkram-Verfertiger überall Schweizer vorzugsweise nennen -- diejetzig schweizerisch Freiheitshelde -- Politisch-Kühn Publikum hineinschwatzen -- vorkommen -- Hase -- öffentlich Jahrmärkt Pistole abschießen -- Kind Bauer Kühnheit erstaunen setzen -- dennoch hasen -- 
  Sohn Alpen gewiß böse meinen -- -- dick Mann -- folglich Mann -- -- Cervantes -- 
  Nachbar Seite -- Greifswalder -- Äußerung pikieren -- beteuert -- deutsch Tatkraft Einfältigkeit erloschen -- schlagen dröhnend Brust -- leeren ungeheuer Stange Weißbier -- 
  Schweizer -- 
  -- -- -- -- 
  -- beschwichtigend -- desto eifrig Greifswalder Geschirr -- 
  Mann Zeit -- läus Friseur hungern fürchten -- 
  tragen herabhängend lang Haar -- ritterlich Barett -- schwarz -- altdeutsch Rock -- schmutzig Hemd -- Amt Weste versehen -- Medaillon Haarbüschel Blücher Schimmel -- 
  Narr Lebensgröße -- 
  machen Bewegung Abendessen -- lassen patriotisch Streit verflechn -- 
  Meinung -- Deutschland müssen 33 Gauen teilen -- 
  hingegen behaupten -- müssen 48 -- Alsdann systematischer Handbuch Deutschland schreiben können -- notwendig -- Leben Wissenschaft verbinden -- 
  Greifswalder Freund deutsch Barde -- -- vertrauen -- arbeiten National Heldengedichte Verherrlichung Hermann Hemansschlacht -- 
  nützlich Wink Anfertigung Epos -- 
  aufmerksam -- Sümpfe Knüppelweg Teutoburger Wald onomatopoetisch wäßrig holprig Vers andeuten können -- patriotisch Feinheit -- Varus übrig Römer lauter Unsinn sprechen lassen -- 
  hoffen -- Kunstkniff -- erfolgreich Berliner Dichter -- bedenklichst Illusion gelingen -- 
  unser Tisch laut traulich -- Wein verdrängt Bier -- Punsch-Bowl dampften -- Getrunken -- schmollieren singen -- 
  alt Landesvater herrlich Lied W. Müller -- Rückert -- Uhland u. S. W. erschollen -- 
  schön Methfesselsche Melodien -- 
  allerbest Erklange unser Arndt'sr deutsch Wort -- -- Gott -- Eisen wachsen lassen -- Knecht -- -- 
  draußen braust -- alt Berg mitsäng -- schwankend Freund behaupten sogar -- schüttle freudig kahl Haupt Zimmer bewegen -- 
  Flasche leer Kopf voller -- 
  brüllen -- fistulieren -- deklamiert -- Schuld -- -- sprechen Latein -- predigen Mäßigkeit -- stellen Stuhl dozieren -- 
  -- Herr -- 
  Erde rund Walze -- Mensch einzeln Stiftch -- scheinbar arglos zerstreuen -- Walze drehen -- Stiftch stoßen tönen -- -- selten -- wunderbar -- kompliziert Musik -- Weltgeschichte -- 
  sprechen Musik -- Welt Geschichte -- letzterer teil positiv spanisch Fliege -- -- 
  Sinn Unsinn -- 
  gemütlich Mecklenburger -- Nase Punschglase -- selig lächelnd Dampf einschnupfen -- Bemerkung -- 
  Mut -- ständ Theater-Büffet Schwerin -- 
  Anderer halten Weinglas Perspektiv Auge scheinen aufmerksam betrachten -- rot Wein -- backen -- hervortretend Maul hinablufen -- 
  Greifswalder -- plötzlich begeistern -- werfen Brust jauchzen -- -- O -- verständest -- Liebender -- Glücklicher -- gelieben -- Gott verdamm -- 
  gebildet Mädchen -- voll Brüste -- tragen weiß Kleid spielen Klavier -- -- -- 
  Schweizer weinen -- küssen zärtlich Hand wimmeren beständig -- -- O Bäbeli -- 
  O Bäbeli -- -- 
  verworren Treibe -- Teller tanz Gläs fliegen lernn -- sitzen Jünglinge -- schön blaß Marmorbilder -- Adonis -- Apollo ähnlich -- 
  bemerkbar leicht Rosenhauch -- Wein Wang hinwarf -- 
  unendlich Liebe sehen -- lesen Auge -- Auge strahlen -- sein Lichttropfe hinein gefallen Schal voll lodernd Liebe -- fromm Engel Stern hinüber tragen -- 
  sprechen leise -- sehnsuchtbebender Stimme -- traurig Geschichte -- wunderschmerzlich Ton hervor klingen -- 
  -- Lore tot -- -- seufzen -- Pause erzählt Hallesche Mädchen -- Student verlieben -- Halle verlassen -- sprechen -- aß -- Nacht weinen -- Kanarienvogel betrachten -- Geliebte einst schenken -- 
  -- Vogel sterben -- Lore sterben -- -- schließen Erzählung -- Jünglinge schwiegen seufzn -- Herz zerspringen -- 
  sprechen -- 
  -- Seele traurig -- 
  Komm hinaus dunkel Nacht -- 
  Einatmen Hauch Wolke strahlen Mond -- 
  Genoß Wehmut -- 
  lieben -- Wort tönen Rohrgeflüster -- gleitend Strom -- tön Brust -- Seele traurig -- 
  erheben Jünglinge -- schlingen Arm Nacken -- verlassen tosend Zimmer -- 
  folgen -- dunkel Kammer treten -- -- Fenster -- Kleiderschrank öffnen -- -- sehnsüchtig ausgestreckt arme -- stehen bleiben wechselweise sprechen -- 
  -- Lüfte dämmernden Nacht -- -- rufen -- -- erquickend kühlen Wang -- 
  lieblich spielen flatternd Locke -- 
  stehen Berg wolkig Gipfel -- liegen schlafend Stadt Mensch -- blink blau Gewässer -- 
  Horch -- unten Tal rausch Tanne -- 
  Hügel ziehen -- Nebelgestalt -- Geist Vater -- 
  O -- jagen -- Wolkenroß -- stürmisch Nacht -- rollend See -- Stern hinauf -- 
  -- beladen Leid Seele traurig -- -- -- 
  Jüngling ebenfalls arme sehnsuchtsvoll Kleiderschrank ausstrecken -- Träne stürzt Auge -- gelbledern Hose -- Mond halten -- sprechen wehmütig Stimme -- 
  -- Schön -- Tochter Himmel -- 
  Holdselig dein Antlitz Ruhe -- 
  wandelst einh Lieblichkeit -- 
  Stern folgen deinen blau Pfaden Osten -- 
  Anblick erfreu Wolke -- licht düstern Gestalt -- 
  gleichen Himmel -- Erzeugte Nacht -- 
  beschämt -- Gegenwart -- Stern -- wenden grünfunkelnd Auge -- 
  wohin -- Morgens Antlitz erbleichen -- entfliehsen Pfade -- 
  Halle -- 
  wohnst Schatten Wehmut -- 
  Schwester Himmel fallen -- 
  -- freudig Nacht durchwallten -- -- 
  -- fallen herab -- o schön Licht -- verbirgen -- betrauern -- 
  einst Nacht -- -- vergang -- blau Pfad verlassen -- 
  erheben Stern grün Häupt -- einst Gegenwart beschämt -- freuen -- 
  gekleiden Strahlenpracht schaust herab Tor Himmel -- 
  Zerreißt Wolke -- o Wind -- Erzeugte Nacht hervor leuchten vermögen -- buschig Berg erglänz Meer schäumend Wog roll Licht -- -- 
  wohlbekannt -- mager Freund -- trinken gegessen -- obgleich Abend -- gewöhnlich -- Portion Rindfleisch verschlungen -- wovon Gardeleutnant unschuldig Kind sein -- allzugut Humor -- der heißen Schwein -- vorbeigerannen -- schieben elegisch Freund unsanft Schrank hinein -- poltert Haustür -- wirtschaften draußen mörderlich -- 
  Lärm Saal verworren Dumpfer -- 
  jünglinge Schranke jammerten wimmeren -- liegen zerschmetteren Fuß Berge -- Hals strömn edel Rotwein -- überschwemmen wechselseitig -- sprechen -- 
  -- Lebe -- 
  fühlen -- verblute -- 
  weckst -- Frühlingsluft -- 
  buhlst sprichst -- 
  betau Tropfen Himmel -- 
  Welken nahe -- nah Sturm -- Blatt herabstören -- 
  Wanderer -- Schönheit -- ringsum Auge Feld suchen -- finden -- 
  -- -- übertobt wohlbekannt Baßstimm -- draußen Türe -- Fluchen Jauchzen -- gottlästerlich beklagen -- dunkel Weenderstraß einzig Laterne brennen -- sehen können -- Fensterscheibe eingeschmissen -- 
  vertragen -- Bescheidenheit erlauben -- Bouteillen-Zahl nennen -- ziemlich konditionieren gelangt Schlafzimmer -- 
  jung Kaufmann liegen Bette -- kreideweiß Nachtmütze safrangelb Jacke Gesundheits-Flanell -- 
  Schlief sucht Gespräch anzuknüpfen -- 
  Frankfurt am -- folglich sprechen Jude -- Gefühl schön Edle verlieren -- englisch 25 Prozent Fabrikpreis verkaufen -- 
  ergriff Lust -- mystifizieren -- -- 
  Nachtwandler -- müssen Voraus Entschuldigung bitten -- Fall -- Schlafe stören -- 
  arm Mensch -- gestehen -- Nacht schlafen -- Besorgnis hegen -- Pistole -- Bett liegen -- Nachtwandler-Zustande Malheur anrichten -- 
  Grund gehen -- schlafen -- 
  Wüste -- beängstigend Phantasie-Gebilde -- 
  Klavier-Auszug Dante's -- Hölle -- -- 
  träumen -- sehen Aufführung juristisch Oper -- Falcidia heißen -- erbrechtlich Text Gan -- Musik Spontini -- 
  toll Traum -- 
  römisch Forum leuchten prächtig -- Serv -- 
  Asinius Göschenus Prätor Stuhle -- Toga stolz Falte werfend -- ergießen polternd Rezitative -- Marcus Tullius Elversus -- Prima Donna Legatarie -- hold Weiblichkeit offenbarend -- singen liebeschmelzend Bravour-Arie quicunque civis Romanus -- ziegelrot geschminkt Referendare brüllt Chor Unmündig -- Privat-Dozent -- Genie fleischfarbig Trikot kleiden -- tanzen antejustinianeisch Ballett bekränzt Blume zwölf Tafel -- Donner Blitz steigen Erde beleidigt Geist römisch Gesetzgebung -- Posaune -- Tamtam -- Feuerreg -- cum omni Causa -- 
  lärmen ziehen Brockenwirt -- wecken -- Sonnen-Aufgang ansehen -- 
  Turm finden Harrende -- frierende Hand rieben -- -- Schlaf Auge -- taumelten herauf -- stehen still Gemeinde gestern Abend versammeln -- schweigend sehen -- Horizont -- karmesinrot Kugel empor steigen -- winterlich dämmernd Beleuchtung verbreiten -- Berg weißwallenden Meer schwimmen -- bloß Spitze sichtbar hervor treten -- Hügel stehen glauben -- mitten überschwemmt Ebene -- trocken Erdscholle hervortritt -- 
  Gesehene Empfundene Wort fest halten -- zeichnen folgend Gedicht -- 
  Heller Osten Sonne Glimme -- breit Bergesgipfel Nebelmeere schwimmen -- 
  Siebenmeilenstiefel -- Lief Wind -- Bergesgipfel -- Haus lieben Kind -- 
  Bettchen -- schlummern -- Zöge leis Gardin -- Leise küßen Stirn -- Leise Mund's Rubin -- 
  leise flüstern Lilien-Ohr -- Denke Traum -- lieben -- verlieren -- 
  indessen -- Sehnsucht Frühstück ebenfalls -- Dame Höflichkeit -- eilt Hinab -- warm Stube Kaffee trinken -- 
  Not -- Magen nüchtern -- Goslarschen Stephans-Kirch -- 
  arabisch Trank rieselen warm Orient Glied -- östlich Rose umdufteten -- süß Bulbul-Lied erklangen -- Student verwandelt Kamel -- Brockenhaus-Mädche -- Congrevsch Blick -- Houris -- Philister-Nasen Minaretts u. S. W. Buch -- liegen -- Koran -- 
  Unsinn enthalten freilich -- 
  sogenannter Brockenbuch -- worin reisend -- Berg ersteigen -- Name schreiben -- Meister Gedanke -- Ermangelung -- Gefühl hinzu notieren -- 
  drücken sogar Vers -- 
  Buch sehen -- Greuel entstehen -- Philister-Troß gebräuchlich Gelegenheit -- Brocken -- vornehmen -- poetisch -- 
  Palast Prinzen Pallagonia enthalten Abgeschmacktheite Buch -- hervor glänz Herr Accise-Einnehmer verschimmelt Hochgefühl -- Comptoir-Jünglinge pathetisch Seelen- Ergüsse -- altdeutsch Revolutions-Dilettant Turn-Gemein-Plätzen -- Berliner Schullehrer verunglückt Entzückung Phrase u. S. w. Herr Johannes Hagel mal Schriftsteller zeigen -- 
  Sonnen-Aufgangs majestätisch Pracht beschreiben -- klagen schlecht Wetter -- getäuscht Erwartung -- Nebel -- Aussicht versperren -- 
  -- benebelt herauf kommen benebeln Hinunter gehen -- -- stehend Witz -- Hundert nachgerissen -- 
  Carolina schreiben -- Ersteig Berg naß Fuß bekommen -- 
  naives hannch Klage Sinn -- schreiben lakonisch -- Geschichte naß -- 
  Buch riechen Käse -- Bier Tabak -- glauben Roman Clauren lesen -- 
  besagtermaßen Kaffee trank Brockenbuch blättern -- treten Schweizer hochrot Wang herein -- voll Begeisterung erzählt erhaben Anblick -- Turm genießen -- rein -- ruhig Licht Sonne -- Sinnbild Wahrheit -- nächtlich Nebelmas kämpfen -- ausgeseh Geisterschlacht -- zürnend Riese lang Schwert ausstrecken -- geharnischt Ritter -- bäumend Rosse -- einh jag -- Streitwag -- flatternd Banner -- abenteuerlich Tierbildung wildesten Gewühle hervor tauchen -- wahnsinnigst Verzerrunge kräuseln -- blass Blasser zerrinnen -- spurlos verschwinden -- 
  demagogisch Natur-Erscheinung versäumen -- -- Untersuchung -- eidlich versichern -- wissen -- Geschmack gut braun Kaffee's -- 
  -- sogar Schuld -- schön Dame vergessen -- stehen Tür -- Mutter Begleiter -- Begriff Wagen besteigen -- 
  -- eilen versichern -- kalt -- 
  scheinen unwillig -- kommen -- glättet mißmutig Falte schön Stirn -- wunderlich Blume schenken -- vorher -- halsbrechend Gefahr -- steil Felsenwand pflücken -- 
  Mutter verlangt Name Blume wissen -- gleichsam unschicklich fänd -- Tochter fremd -- unbekannt Blume Brust stecken -- -- Blume erhalten beneidenswert Platz -- gewiß gestern einsam Höhe träumen lassen -- 
  schweigsam Begleiter öffnet Mund -- zählen Staubfäde Blume trocken -- gehören Klasse -- 
  ärgern jedesmal -- sehen -- Gott lieb Blume -- -- Kasten teilen -- ähnlich Äußerlichkeit -- nämlich Staubfaden-Verschiedenheit -- 
  mal Einteilung stattfinden -- folge Vorschlage Theophrast's -- Blume Geist -- nämlich Geruch -- einteilen -- 
  betreffen -- Naturwissenschaft System -- demnach teil -- dasjenig -- essen -- dasjenig -- essen -- 
  -- alt Dame geheimnisvoll Natur Blume verschließen -- unwillkürlich äußern -- Blume -- Garten Topfe wachsen -- erfreut -- hingegen leis Schmerzgefühl -- Traumhaft beängstigend -- Brust durchzitter -- abgebrochen Blume sehen -- eigentlich Leiche -- gebrochen -- zart Blumenleicher welk Köpfchen traurig herab hängen lassen -- tot Kind -- 
  Dame fast erschrocken trüb Widerschein Bemerkung -- Pflicht -- Voltairesch Vers verscheuchen -- 
  Paar französisch Wort gehörig Konvenienzstimmung versetzen -- 
  lacht -- Hand küßen -- huldreich lächeln -- Pferd wiehert Wagen holpern -- langsam beschwerlich -- Berg hinunter -- 
  machen Student Anstalt Abreis -- Ranz schnüren -- Rechnung -- Erwartung billig ausfallen -- berichtigen -- empfänglich Hausmädch -- Gesicht Spur glücklich Liebe -- bringen -- gebräuchlich -- Brockensträußchen -- helfen Mütz befestigen -- Küssen Groschen honorieren -- steigen Berg hinab -- -- wobei Schweizer Greifswalder -- Weg Schierk einschlugen -- -- ungefähr Mann -- wobei Landsleute -- angeführen Wegweiser -- sogenannter Schneelöcher hinab ziehen Ilsenburg -- 
  Hals Kopf -- 
  hallesch Student marschieren schnell österreichisch Landwehr -- 
  Ehe versehen -- kahl Partie Berge zerstreut Steingruppe -- kommen Tannenwald -- vorher sehen -- 
  Sonne goß festlichst Strahl herab beleuchten humoristisch buntgekleideter Bursch -- munt Dickicht dringen -- verschwanden -- Vorschein kommen -- Sumpfstell quergelegt Baumstamm laufen -- abschüssig Tiefe rankend Wurzel klettern -- ergötzlichst Tonart empor johlt -- lustig Antwort erhalten zwitschernd Waldvögel -- rauschend Tann -- unsichtbar plätschernd Quelle schallenden Echo -- 
  froh Jugend schön Natur -- freuen wechselseitig -- 
  tief Hinab steigen -- desto lieblich rauscht unterirdisch Gewässer -- -- Gestein Gestrippe -- blinken hervor -- scheinen heimlich lauschen -- an Licht treten dürfen -- Welle entschlossen hervor Gesprunge -- 
  zeigen gewöhnlich Erscheinung -- kühn Anfang -- Troß Zagenden plötzlich -- erstaunen -- Mut ergreifen -- eilen -- vereinigen -- 
  Menge anderer Quelle hüpfen hastig Versteck -- verband hervorgesprungen -- bilden bedeutend Bächlein -- unzählig Wasserfälle -- wunderlich Windung -- Bergtal hinab rauschen -- 
  Ils -- lieblich -- süß Ilse -- 
  ziehen gesegnet Ilsethal -- Seite Berg allmählich hoch erheben -- -- Fuß -- meistens Buche -- Eich gewöhnlich Blattgesträuch bewachsen -- Tann Nadelholz -- 
  Blätterholzart vorherrschend -- unterharze -- -- Ostseit Brocken nennen -- Gegensatz Westseite -- -- Oberharz -- -- hoch -- geeignet gedeihen Nadelhölzer -- 
  unbeschreibbar -- Fröhlichkeit -- Naivität Anmut Ilse hinunt stürzen abenteuerlich gebildet Felsstücke -- Lauf finden -- Wasser wild empor Zischt schäumend überläufen -- allerlei Steinspalt -- toll Gießkann -- rein Bög ergießen -- unten Stein hintrippeln -- munteres Mädchen -- 
  -- Sage -- Ilse Prinzessin -- lachend blühend Berg hinab laufen -- 
  blinken Sonnenschein weiß Schaumgewand -- 
  flattern Winde silbern Busenbänder -- 
  funkeln blitz Diamant -- 
  hoch Buche stehen ernst Vätern -- verstohlen lächelnd Mutwille lieblich Kind zusehen -- weiß Birk bewegen Tantenhaft vergnügen -- ängstlich gewagt Sprünge -- stolz Eichbaum schauen drein verdrießlich Oheim -- schön Wetter bezahlen -- vögelein lüften jubeln Beifall -- Blume Ufer flüstern zärtlich -- 
  O -- nimm -- nimm -- lieb schwesterchen -- - lustig Mädchen springen unaufhaltsam -- plötzlich ergreifen träumend Dichter -- strömen herab Blumenreg klingend Strahl strahlend Kläng -- Sinn vergehen lauter Herrlichkeit -- hören flötensüß Stimme -- 
  Prinzessin Ilse -- wohnen Ilsenstein -- Komme Schlos -- selig -- 
  Haupt benetzen klar Welle -- sollst Schmerz vergessen -- sorgenkrank Gesell -- 
  weiß arme -- weiß Brust -- sollst liegen träum alt Märchenlust -- 
  Küssen herzen -- herzen küßen lieben Kaiser Heinrich -- sterben -- 
  bleiben tot tote -- Lebendige leben -- schön blühend -- lachend Herz beben -- 
  beben Herz unten -- klingen kristallen Schloß -- tanz Fräulein Ritter -- jubeln Knappentroß -- 
  rausch seiden Schleppe -- klirren Eisenspor -- Zwerg trompeten pauken -- fiedeln blas Horn -- 
  Arm umschlingen -- Kaiser Heinrich umschlang -- halten Ohren -- Trompet erklingen -- 
  unendlich selig Gefühl -- Erscheinungswelt Gemütswelt zusammenrinnen -- grün Baum -- Gedanke -- Vogelgesang -- Wehmut -- Himmelsbläue -- Erinnerung Kräuterduft süß Arabesk verschlingen -- 
  Frau kennen Gefühl -- holdselig ungläubig lächeln Lippe schweben -- Schulstolz logischen Tat rühmen -- hübsch eingeteilen objektiv subjektiv -- Kopf apothekenartig tausend schublad versehen -- Vernunft -- Verstand -- Witz -- schlecht Witz -- -- nämlich Idee -- enthalten -- 
  Traume fortwandelnd -- fast bemerken -- tief Elsetale verlassen -- bergauf steigen -- 
  steil mühsam -- Atem -- 
  selig Vetter -- Mölln begraben liegen -- denken voraus an Bergabsteig -- Vergnügter -- 
  gelangt Ilsenstein -- 
  ungeheur Granitfelse -- keck Tiefe erheben -- 
  Seite umschließen hoch -- waldbedeckt Berg -- -- Nordseite -- frei schauen unten liegend Ilsenburg Ilse -- hinab nied Land -- 
  turmartig Spitze Felsen stehen -- eisern Kreuz -- Not Platz Menschenfüße -- 
  Natur -- Stellung Form -- Ilsenstein phantastisch Reiz schmücken -- Sage Rosenschein ausgegossen -- 
  Gottschalk berichten -- 
  -- erzählen -- verwünscht Schloß gestehen -- reich -- schön Prinzessin Ilse gewohnen -- Ilse bade -- glücklich -- Zeitpunkt treffen -- Fels -- Schloß -- führen königlich belohnen -- -- 
  erzähl Liebe Fräulein Ilse Ritters Westenberg hübsch Geschichte -- bekannt Dichter romantisch -- Abendzeitung -- besungen -- 
  erzählen -- 
  altsächsisch Kaiser Heinrich -- Ilse -- schön Wasser-Fee -- verzauberen Felsenburg kaiserlichst Stunde nossen -- 
  neu Schriftsteller -- Herr Niemann -- Wohlgeb -- -- Harzreisebuch schreiben -- worin Gebirgshöhen -- Abweichung Magnetnadel -- Schuld Stadt dergleichen löblich Fleiße genau Zahl angeben -- behaupten indes -- 
  -- schön Prinzessin Ilse erzählen -- gehören Fabelreiche -- -- 
  sprechen Leute -- Prinzessin niemals erscheinen -- -- schön Dame begünstigen -- wissen -- 
  Kaiser Heinrich wissen -- 
  umsonst hing altsächsisch Kaiser heimisch Harz -- 
  blätt hübsch Lüneburger Chronik -- gut -- alt Herr -- wunderlich treuherzig Holzschnitt -- abkonterfeit -- wohlgeharnischen -- gewappneen Schlachtroß -- heilig Kaiserkron teuer Haupt -- Zepter Schwert fest Hand -- lieben -- knebelbärtig Gesicht deutlich lesen -- süß Herz Harz-Prinzessinne traulich Rausch Harzwäld zurücksehnen -- Fremd weilt -- zitronen- giftreich Welschland -- wohin Nachfolger verlocken Wunsch -- römisch Kaiser heißen -- echtdeutsch Titelsucht -- woran Kaiser Reich Grunde gehen -- 
  rat -- Spitze Ilsenstein stehen -- weder Kaiser Reich -- schön Ilse -- bloß Fuß denken -- 
  stehen -- Gedanke verlieren -- hören plötzlich unterirdisch Musik Zauberschloss -- -- Berg ringsum Kopf stellen -- rot Ziegeldächer Ilsenburg anfingen tanz -- grün Baum blau Luft herum fliegen -- blau grün Auge -- sicher -- Schwindel erfassen -- Abgrund stürzen -- -- Seelennot -- an eisern Kreuz festgeklammern -- 
  -- mißlich Stellung -- letzterer tun -- gewiß verdenken -- 
  -- Harzreise -- bleiben Fragment -- bunt Fäden -- hübsch hineingesponn -- harmonisch verschlingen -- plötzlich -- Schere unerbittlich Parz -- abschneiden -- 
  verweb künftig Lied -- kärglich verschweigen -- Alsdann vollauf -- 
  Eins heraus -- aussprechen -- aussprechen -- 
  einzeln Werk immerhin Fragment bleiben -- Vereinigung bilden -- 
  Vereinigung Mangelhaft ergänzen -- Schroff ausgeglich Allzuherb mildern -- 
  Blatt harzreise Fall -- können minder saur Eindruck hervorbringen -- derweitig erführ -- Unmut -- Göttingen hegen -- obschon groß aussprechen -- Verehrung -- Individuum empfinden -- 
  verschweigen -- teuer Mann -- früh Zeit freundlich annehmen -- innig Liebe Studium Geschichte einflößen -- späterhin Eifer bestärken -- Geist ruhig Bahn führen -- Lebensmute heilsam Richtung anwie -- historisch Tröstung bereiten -- qualvoll Erscheinung Tag nimmermehr ertragen -- 
  sprech Georg Sartorius -- Geschichtsforscher Mensch -- Auge klar Stern dunkel -- gastlich Herz stehen fremd leiden Freude -- Besorgnis Bettler Königs -- letzter Seufzer untergehend Volk Gott -- -- 
  umhin -- ebenfalls andeuten -- Oberharz -- Harz -- Anfang Ilsethal beschreiben -- weit erfreulich Anblick romantisch malerisch Unterharz gewähren -- wildschroffen -- tannendunkl Schönheit kontrastieren -- ebenfalls -- Ilse -- Bode Selke gebildet Täler Unterharz anmutig kontrastieren -- Charakter jeder Tal personifizieren wissen -- 
  Frauengestalte -- wovon entscheiden vermögen -- schöne -- 
  lieben -- süßen Ilse süß lieblich empfangen -- singen -- 
  düster schön -- Bode -- empfangen gnädig -- schmiededunkl Rübeland erblicken -- scheinen mürrisch verhüllte silbergrau Regenschleier -- rasch Liebe werfen -- Höhe Roßtrappe gelangen -- Antlitz leuchten entgegen sonnigst Pracht -- Zügen haucht kolossal Zärtlichkeit -- bezwungenen Felsenbrust Drang hervor Sehnsuchtseufzer schmelzend Laute Wehmut -- 
  Minder zärtlich -- Fröhlicher zeigen schön Selke -- schön -- liebenswürdig Dame -- edl Einfalt heit Ruhe sentimental Familiarität entfernt halten -- halbversteckt lächeln neckend Sinn verraten -- zuschreiben -- Selkethale mancherlei Ungemach heimsuchen -- -- Wasser springen -- just Mitte hineinplumpste -- nachh -- naß Fußzeug Pantoffel vertauschen -- abhanden -- vielmehr abfüßen -- Windstoß Mütz entführt -- Walddorn Bein zerfetzen -- u. S. W. all Ungemach verzeihen schön Dame -- schön -- 
  stehen Einbildung all still Liebreiz -- scheinen sagen -- 
  lache -- -- bitte -- besingen -- 
  herrlich Bode treten ebenfalls hervor Erinnerung -- dunkl Auge sprechen -- 
  gleichsen Stolz Schmerze -- -- liebst -- 
  schön Ilse herangesprungen -- zierlich bezaubernd Miene -- Gestalt Bewegung -- gleichen hold Wesen -- Traum beseligen -- -- -- schauen -- unwiderstehlich Gleichgültigkeit innig -- ewig -- durchsichtig -- 
  -- Paris -- Göttinnen stehen -- Apfel geben schön Ils -- 
  Mai -- Meer Leben ergießen Frühling Erde -- weiß Blütenschaum bleiben Bäum hängen -- -- warm Nebelglanz verbreiten überall -- Stadt blitzen freudig Fensterscheibe Haus -- Dach bauen Spatz Nestche -- Straße wandeln Leute wundern -- Luft angreifend wunderlich Mut -- bunt Vierlanderinne bringen Veilchensträuße -- Waisenkinder -- blau Jäckche lieben -- unehelich Gesichtche -- ziehen Jungfernstieg freuen -- Vater wiederfinden -- Bettler Brücke schauen vergnügen -- gewinnen -- sogar schwarz -- ungehenkten Makler -- spitzbübisch Manufakturwaren-Gesicht einherläuft -- bescheinen Sonne tolerantest Strahl -- -- hinauswandern Tor -- 
  Mai -- denken -- schön Ilse -- -- Agnes -- nennen -- Name fällen -- -- 
  denken -- zusehen leuchtend Berg hinabläufst -- 
  liebsn unten Tal stehen auffang Arm -- -- 
  schön -- 
  überall sehen grün Farbe -- Farbe Hoffnung -- 
  überall -- hold Wunder -- blühen hervor Blume -- Herz blühen -- 
  Herz Blume -- wunderlichen -- 
  bescheiden Veilchen -- lachend Rose -- rein Lilie -- sonstig Blümchen -- artig Lieblichkeit Mädchensinn erfreuen -- hübsch hübsch Busen stecken lassen -- welkt blühen -- 
  Herz gleichen schwer -- abenteuerlich Blume Wälder Brasilien -- -- Sage -- hundert blühen -- 
  erinneren -- Knabe Blume sehen -- 
  hört Nacht Schuß -- Pistole -- folgend erzählt Nachbarskinder -- -- Aloe -- -- Knalle plötzlich aufgeblühen -- 
  führen Garten -- -- Verwunderung -- niedrig -- hart Gewäch -- närrisch breit -- scharfgezackt Blätter -- woran verletzen -- Höhe schießen -- -- golden Krone -- herrlich Blüte tragen -- 
  Kind Mal hinaufseh -- alt -- schmunzelnd Christian -- leiben -- baut hölzern Treppe Blume herum -- klettern hinauf -- Katze -- schauen neugierig offen Blumenkelch -- woraus gelb Strahlenfaden wildfremd Düfte unerhört Pracht hervordrangen -- 
  -- Agnes -- Herz Blühen -- erinnern -- einzig Mal blühen -- -- gewiß hundert -- 
  glauben -- herrlich Blüte entfalten -- müssen Mangel Sonnenschein Wärme elendiglich verkümmern -- dunkel Wintersturme gewaltsam zerstören -- 
  regen drängen Brust -- Hörst plötzlich Schuß -- 
  Mädchen -- erschricken -- 
  tot schießen -- Liebe sprengen Knospe -- schießen empor strahlend Lied -- ewig Dithyrambe -- freudigst Sangesfülle -- 
  hoch Liebe -- Mädchen -- machen bequem -- besteig hölzern Treppe -- schau hinab blühend Herz -- 
  früh -- Sonne Hälfte Wege zurücklegen -- Herz duften stark -- betäubend kopfe steigen -- wissen Ironie aufhören Himmel anfängen -- Luft Seufzer bevölkern -- zerrinnen süß Atom -- unerschaffen Gottheit -- -- -- Nacht -- Stern Himmel erscheinen -- -- unglückselig Stern -- sagen -- -- -- 
  Mai -- lumpig Ladenschwengel sentimental -- Dichter wolltest verwehren -- 
  Nordsee -- 1825 -- 
  Abteilung -- 
  uneigennützig -- uneigennützigst Liebe Freundschaft -- hoch Lust -- Maxime -- Ausübung -- frech -- spät Wort -- -- lieben -- ben -- -- Seele sprechen -- 
  -- Goethe -- Dichtung Wahrheit vierzehnt Buch -- -- 
  I. Huldigung -- 
  Lied -- 
  gut Lied -- 
  -- -- wappnen -- 
  lassen Trompet klingen -- heben Schild jung Mädchen -- Herz beherrschen -- Königin -- 
  Heil -- 
  jung Königin -- 
  Sonne droeb Reiß strahlend rot Gold -- weben draus Diadem geweiht Haupt -- 
  flatternd blauseiden Himmelsdeck -- worin Nachtdiamant blitzen -- Schneide kostbar Stück -- Häng -- Krönungsmantel -- königlich Schulter -- 
  geben Hofstaat steifgeputzt Sonette -- Stolz Terzin höflich Stanzen -- Läufer dien Witz -- Hofnarr Phantasie -- Herold -- lachend Tran Wappe -- Diene Humor -- 
  selber -- Königin -- Knie nieder -- huldigend -- rot samtkissen -- Überreich bissch Verstand -- -- Mitleid -- lassen Vorgängerin Reich -- 
  II. Abenddämmerung -- 
  blass Meeresstrande -- Saß gedankenbekümmeren einsam -- 
  Sonne neigen tief -- werfen Glührot Streifen Wasser -- weiß -- weit Welle -- Flut drängen -- Schäumte rauschen näher nah -- seltsam Geräusch -- Flüstern Pfeife -- lachen Murmeln -- Seufz Sausen -- wiegendlied-heimlich singen -- hören verschollen sagen -- Uralte -- lieblich Märche -- einst -- Knabe -- Nachbarskindern vernehmen -- Sommerabend -- Treppenstein Haustür -- still Erzähl niederkauern -- -- horchend Herz neugierklug Auge -- -- Mädchen -- duftend Blumentöpf -- Fenster sitzen -- Rosengesichter -- Lächelnd mondbeglänzen -- 
  III. Sonnenuntergang -- 
  glühend rot Sonne steigen Hinab weit_aufschauernd -- silbergrau Weltmeer -- Luftgebilde -- rosig anhauchen -- Walle -- -- herbstlich dämmerned Wolkenschleier -- traurig totblasses Antlitz -- Bricht hervor Mond -- -- Lichtfünkche -- Nebelweit -- schimmern Stern -- 
  einst Himmel -- glänzen -- Ehelich vereinen -- Luna -- Göttin -- -- Gott -- wimmelen Stern -- -- unschuldig Kind -- 
  böse Zunge zischelt Zwiespalt -- trennen feindlich hoch -- leuchtend Ehepaar -- 
  -- -- einsam Pracht -- Ergeht Sonnengott -- Herrlichkeit Angebetet vielbesungen stolzen -- glückgehärtet Mensch -- 
  nachts -- Himmel -- wandeln Luna -- arm Mutter verwaist Sternenkinder -- glänzt stumm Wehmut -- liebend Mädchen sanft Dichter weihen Träne Lied -- 
  weich Luna -- 
  weiblich sinnen -- Lieben schön Gemahl -- 
  Abend -- zitternd bleich -- Lauscht hervor leicht Gewölk -- schauen Scheidenden -- schmerzlich -- ängstlich rufen -- -- Komme -- 
  Komm -- Kind verlangen -- 
  trotzig Sonnengott -- Anblick Gattin -- erglühen doppeltem Purpur -- Zorn Schmerz -- unerbittlich eilen hinab flutenkalt Witwerbett -- 
  böse -- zischelnd Zunge Bracht Schmerz verderben ewig Gott -- 
  arm Gott -- Himmel Wandel -- qualvoll -- Trostlos unendlich Bahn -- sterben -- Schleppe strahlend Elend -- 
  -- Mensch -- niedriggepflanzen -- Tod-beglückt -- Klage lang -- 
  IV. 
  Nacht Strande -- 
  sternlos kalt Nacht -- gehren Meer -- Meer -- glatt Bauch -- Liegen ungestaltet Nordwind -- heimlich -- ächzend gedämpft Stimme -- Wie_ein störrig Griesgram -- gutgelaunt -- Schwatzt Wasser hinein -- erzählen toll Geschichte -- Riesenmährch -- totschlaglaunig -- uralt Sagen Norweg -- -- weitschallend -- lachen heulen Beschwörungslieder Edda -- grau Runensprüche -- dunkeltrotzig zaubergewaltig -- weiß Meerkinder Hochaufspring jauchzen -- Uebermuth- berauscht -- 
  derweil -- flach Gestade -- flutbefeuchtet Sand -- Schreitet Fremdling -- Herz -- wild Wind Welle -- hintritt -- sprüh Funke knistern Muschel -- hüllen fest grau Mantel -- schreiten rasch wehend Nacht -- sicher leiten Licht -- lockend lieblich schimmeren -- einsam Fischerhütte -- 
  Vater Bruder See -- Mutterseelenallein bleiben Hütte Fischertochter -- wunderschön Fischertochter -- 
  Herde sitzen horchen Wasserkessel Ahnungsüßes -- heimlich Summe -- schütten knisternd Reisig Feuer -- blasen hinein -- flackernd rot Licht Zauberlieblich widerstrahlen blühend Antlitz -- zart -- weiß Schulter -- rührend hervorlauscht groben -- grau Hemde -- -- sorgsam Hand -- Unterröckchen fest binden -- fein Hüft -- 
  plötzlich -- Tür springen -- treten herein nächtig Fremdling -- Liebe sicher ruhen Auge weiß -- schlank Mädchen -- schauernd stehen -- erschrocken Lilje -- werfen Mantel Erde -- lachen sprechen -- Siehst -- Kind -- halten Wort -- kommen -- alt -- Götter Himmel Niederstiegen Töchter Mensch -- Tochter Mensch umarmt -- zeugen Zeptertragend Königsgeschlechter Held -- Wunder Welt -- 
  staun -- Kind -- lang Göttlichkeit -- bitte -- koch Tee Rum -- draußen kalt -- Nachtluft Frier -- ewig Götter -- kriegen göttlichst Schnupfe -- unsterblich Hust -- V. Poseidon -- 
  Sonnenlichter spielen weit_hinrollende Meer -- fern Rede glänzt Schiff -- Heimat tragen -- fehlt gut Fahrwind -- sitzen ruhig weiß Düne -- einsamen Strand -- lesen Lied Odüsseus -- alt -- ewig jung Lied -- meerdurchrauscht Blatt freudig entgegenstieg Atem Götter -- leuchtend Menschenfrühling -- blühend Himmel Hellas -- 
  edl Herz begleiten treulich Sohn Laert -- Irrfahrt Drangsal -- setzt -- seelenbekümmern -- gastlich Herde -- Königinn Purpur spinnen -- helfen Lüge glücklich entrinn Riesenhöhle Nymphenarm -- Folgen kümerisch Nacht -- Sturm Schiffbruch -- dulden unsäglich Elend -- 
  Seufzend sprechen -- bös Poseidon -- Zorn furchtbar -- selber bangen Heimkehr -- 
  sprechen Wort -- 
  schäumt Meer -- weiß Welle steigen schilfbekränzt Haupt Meergotts -- höhnisch rufen -- Fürcht -- Poetlein -- 
  gering gefährd arm Schiffchen -- lieb Leben beängstigen allzubedenklich Schaukel -- 
  -- Poetlein -- erzürnen -- einzig türmchen verletzen Priamos heilig Fest -- einzig härchen versengn Auge Sohns Polüphemos -- niemals ratend beschützen Göttin Klugheit -- Palla Athene -- 
  rufen Poseidon taucht Meer -- groben Seemannswitz Lacht Wasser Amphitrite -- plumpen Fischweib -- dummen Tochter Nereu -- 
  VI -- Erklärung -- 
  Herangedämmert Abend -- Wild tost Flut -- sitzen Strand -- schaut weiß Tanz Welle -- Brust schwellen Meer -- sehnend ergriff tief Heimweh -- holder Bild -- überall umschweben -- überall rufen -- Überall -- überall -- Sausen Wind -- Brausen Meer -- seufz Brust -- 
  leicht Rohr schreiben Sand -- 
  -- Agnes -- lieben -- 
  bös Welle ergossen süß Bekenntnis -- löschn -- 
  Zerbrechliches Rohr -- zerstiebend Sand -- Zerfließend Welle -- Trau -- 
  Himmel dunkel -- Herz wild -- stark Hand -- Norwegen Wälder Reiß hoch Tanne -- tauch Ätna glühend Schlund -- Feuergetränkt Riesenfeder Schreibe dunkel Himmelsdeck -- 
  -- Agnes -- lieben -- 
  Jedwede Nacht loderen Alsdann ewig Flammenschrift -- nachwachsend Enkelgeschlechter Lesen jauchzend Himmelsworter -- 
  -- Agnes -- lieben -- 
  VII -- 
  nachts Kajüte -- 
  Meer Perle -- Himmel Stern -- Herz -- Herz -- Herz Liebe -- 
  Meer Himmel -- größ Herz -- schön Perle Sterne Leuchtet strahlen Liebe -- 
  -- jung Mädchen -- Komme Herz -- Herz Meer Himmel Vergehen lauter Liebe -- 
  blau Himmelsdeck -- schön Stern blinken -- press Lippe -- Presse wild stürmisch weinen -- 
  Sterne Auge Liebst -- tausendfältig Schimmer grüßen freundlich -- blau Himmelsdeck -- 
  blau Himmelsdeck -- Auge geliebter -- Heb andachtsvoll arm -- ben Flehe -- Holde Auge -- Gnadenlichter -- O -- beseligen Seele -- lassen sterben erwerben euer Himmel -- 
  Himmelsaug droben -- Falle zitternd licht Funke Nacht -- Seele Dehnt liebeweit -- 
  O -- Himmelsaug droben -- 
  weinen Seele -- lieben Sternenträn Überfließet Seele -- 
  Eingewiegt Meereswelle -- träumend Gedanke -- Lieg still Kajüte -- dunkel Winkelbette -- 
  offen Luke schau -- Drobe hell Stern -- geliebten -- süß Auge süßen Vielgeliebt -- 
  geliebten -- süß Auge -- wachen Haupt -- klingen winken blau Himmelsdeck -- 
  blau Himmelsdecke Schau selig Stunde -- weiß Nebelschleier verhüllen lieben Auge -- 
  brettern Schiffswand -- träumend Haupt liegen -- Brande Welle -- wild Welle -- 
  rausch Murmel heimlich Ohr -- -- Betörter Geselle -- 
  Arm -- Himmel -- Stern droben festgenagelen -- Vergeblich sehnen -- vergeblich Seufze -- gute -- schliefest -- 
  Träumt weit Heide -- überdecken weißem -- weißem Schnee -- unter weiß Schnee liegen begraben -- Schlief einsam kalt Todesschlaf -- 
  droben dunkel Himmel schauen Herunter Grab Sternenaugen -- süß Auge -- glänzt Sieghaft ruhig heit -- voll Liebe -- VIII -- Sturm -- 
  wüten Sturm -- peitschen Welle -- Welle -- wutschäumend bäumend -- Türm -- wogen lebendig weiß Wasserberge -- Schifflein erklimmen Hastig mühsam -- plötzlich stürzen Hinab schwarz -- weitgähnend Flutabgründer -- O Meer -- 
  Mutter Schönheit -- Schaumentstiegen -- 
  Großmutter Liebe -- Schone -- 
  flatteren -- leichenwitternd -- weiß -- gespenstisch Möwe -- wetzen Mastbaum Schnabel -- lechzen -- voll Fraßbegier -- Mund -- Ruhm Tochter ertönen -- 
  lechzen Herzen -- Enkel -- Schalk -- Spielzeug erwählen -- 
  vergebens Bitte Flehn -- 
  Rufen verhallen tosend Sturm -- Schlachtlärm Winde -- Braust Pfeift prasselt heulen -- 
  Tollhau Tön -- 
  zwischendurch hören vernehmbar Lockende Harfenlaute -- Sehnsuchtwild Gesang -- Seelenschmelzend seelenzerreißend -- 
  erkenn Stimme -- 
  fern schottisch Felsenküst -- grau Schlösslein hinausragen brandend See -- hochgewölbt Fenster -- Stehen schön -- krank Frau -- Zartdurchsichtig marmorblaß -- spielen Harfe singen -- Wind durchwühlen lang Locke -- tragen dunkl Lied weit -- stürmend Meer -- 
  IX -- Meeresstille -- 
  Meeresstill -- 
  strahlen Wirft Sonne Wasser -- wogend Geschmeid Zieht Schiff grün Furch -- 
  Steuer liegen Bootsmann -- Bauch -- Schnarchet leise -- 
  Mastbaum -- segelflickend -- Kauert betet Schiffsjunge -- 
  Hinterm Schmutze Wang Sprüht rot -- wehmütig zuckt breit Maul -- schmerzlich Schaun -- schön Auge -- 
  Kapitän stehen -- Tobt Flucht schilen -- Spitzbub -- 
  -- Spitzbub -- Hering Tonne stehlen -- 
  Meeresstill -- 
  Welle Taucht hervor klug Fischlein -- Wärmt Köpfchen Sonne -- Plätschert lustig Schwänzchen -- 
  Möwe -- lüften -- Schießen herunter Fischlein -- rasch Raub Schnabel Schwingt hinauf Blau -- 
  X. Seegespenst -- 
  liegen Rand Schiffe -- schaut -- träumend Auge -- Hinab spiegelklar Wasser -- schauen tief tief -- tief -- Meeresgrund -- Anfangs dämmernd Nebel -- allmählich farbenbestimmt -- Kirchenkuppel Türme zeigen -- Sonnenklar -- Stadt -- Altertümlich niederländisch -- menschenbeleben -- 
  bedächtig Mann -- schwarzbemänteln -- weiß Halskrause Ehrenkett lang Deg lang Gesicht -- Schreite -- wimmelnden Marktplatz -- treppenhoh Rathaus -- -- steinern Kaiserbild Wacht halten Zepter Schwert -- 
  Unfern -- lang Häuser-Reihe 'n spiegelblank Fenster -- Stehen pyramidisch beschnitten Linden -- wandeln seidenrauschend Jungfraue -- güld Band schlanken Leib -- Blumengesichter sittsam umschloss schwarz -- samten Mützchen -- Woraus Lockenfülle hervordringen -- 
  bunt Geselle -- spanisch Tracht -- Stolziere vorüber nicken -- 
  bejahrter Frau -- braun -- verschollen Gewänder -- Gesangbuch Rosenkranz Hand -- Eile -- trippelnd Schritt -- Dome -- Getriebe Glockengeläute rauschend Orgelton -- 
  ergreifen fern Klang Geheimnisvoller Schauer -- Unendlich sehnen -- tief Wehmut Beschleicht Herz -- kaumgeheilt Herz -- Wunde lieben Lippe aufküßn -- tun bluten -- heiß -- rot Tropfen -- langsam niederfall 'n alt Haus unten tief Meerstadt -- alt -- hochgegiebelt Haus -- melancholisch menschenleer -- unterer Fenster Mädchen sitzen -- Kopf Arm stützen -- armes -- vergessen Kind -- kenn arm -- vergessen Kind -- 
  tief -- tief Verstecktest -- kindisch Laune -- Konntest hinauf -- saßest fremd fremd Leute -- Fünfhundert -- Derweil -- Seele voll Gram -- Erde suchen -- suchen -- Immer_Geliebt -- Längst_Verloren -- Endlichgefundene -- -- finden schau süß Gesicht -- klug -- treu Auge -- lieb lächeln -- nimmer verlassen -- kommen hinab -- ausgebreitet arm Stürz -- hinab Herz -- Ergriff Fuß Kapitän -- ziehen Schiffsrand -- rufen -- ärgerlich lachend -- Doktor -- Teufel -- 
  XI -- Reinigung -- 
  Bleiben Meerestiefe -- Wahnsinniger Traum -- einst Nacht Herz falsch Glück quälen -- See-Gespenst -- Sogar hell -- Bedrohest -- Bleibe -- unten -- Ewigkeit -- werfen hinab All Schmerz sünd Schellenkappe Torheit -- Haupt umklingeln -- kalt -- gleißend Schlangenhaut Heuchelei -- Seele umwunden -- krank Seele -- gottverleugnend -- engelverleugnend -- Unselig Seele -- Hoiho -- 
  Hoiho -- 
  Wind -- 
  Segel -- 
  flattern schwellen -- stillverderblich Fläche Eilet Schiff -- jauchzt befreit Seele -- 
  XII -- Frieden -- 
  Himmel stehen Sonne -- weiß Wolke umwogt -- Meer still -- 
  sinnend liegen Steuer Schiffes -- Träumerisch sinnend -- -- halb Wachen halb Schlummer -- schauen Christus -- Heiland Welt -- 
  wallend weiß Gewand Wandelte riesengroß Land Meer -- ragt Haupt Himmel -- Hand strecken segnend Land Meer -- Herz Brust Trug Sonne -- rot -- flammend Sonne -- rot -- flammend Sonnenherz Goß Gnadenstrahle holder -- liebselig Licht -- Erleuchtend wärmend -- Land Meer -- 
  Glockenklänge ziehen feierlich -- ziehen Schwan -- Rosenbande -- gleitend Schiff -- ziehen spielend an grün Ufer -- Mensch wohnen -- Hochgetürmter -- Ragend Stadt -- 
  O Friedenswund -- 
  still Stadt -- 
  ruht dumpf Geräusch schwatzend -- schwül Gewerbe -- rein -- hallend Straße Zog Mensch -- weißgekleidet -- Palmzweig-tragende -- begegnen -- Sahe -- verständnisinnig -- schauernd -- Liebe süß Entsagung -- Küßt Stirn -- schauen hinauf Heiland Sonnenherze -- freudig versöhnend rot Blut Hinunterstrahlte -- dreymalselig sprechen -- 
  Gelobt Jesu Christ -- 
  Hättest Traumbild ersonnen -- Gäbest drum -- Geliebtester -- 
  Kopf Lend schwach -- Glauben stark -- Dreifaltigkeit ehrest Einfalt -- Mop Kreuz Pfot hoch Gönnerin täglich küssest -- hinaufgefrömmeln Hofrat Justizrat -- Rate Regierung -- fromm Stadt -- Sand Glaube blühen -- heilig Sprea geduldig Wasser Seele wäschen Tee verdünnen -- Hättest Traumbild ersonnen -- Geliebtester -- 
  trügest -- hoch Ort -- Markt -- weich -- blinzelnd Antlitz Verschwämme Andacht Demut -- Hocherlaucht -- verzückt wonnebebend -- Sänke betend auf's Knie -- Auge -- selig strahlend -- Verhieße Gehaltzulage hundert Taler Preußisch Kurant -- Stammeltest Händefaltend -- 
  Gelobt Jesu Christ -- 
  Anmerkung -- 
  obschon Korrektur Band unsäglich abmüht -- gewiß Errata stehen bleiben -- nachträglich verbessern -- Augenblick aufzufinden wissen -- 
  zufällig sehen S. 123 -- Z. 7 v. u. stehen -- erwämt -- -- -- erwärmen -- -- 
  S. 217 -- Z. 8 v. u. stehen -- Angeli -- -- 
  -- Wurm -- 
  gestehen -- Erster niemals sehen gewiß bedeutend Namensverwechselung zufällig -- S. 53 -- Z. 4 v. -- stehen -- Bettlerwort -- -- Bettelwort -- -- 
  Letztere gut Ausdruck -- -- 
  übrig Verbesserung nachgelieferen Teil Reisebild -- Hübsches enthalten -- z. B. abgebrochen Erzählung -- halb Ansicht Hauptstadt Nord-Deutschland -- sogar Bemerkung polnisch Wald deutsch Literatur u. S. W. -- Saumselig Freund -- Mspt zurückhalten gedruckt Bitte stark rühren -- geschrieben -- liebevoll andeuten -- Brief Pakete -- Aufschrift -- Heinrich Heine -- Dr. Jur -- -- per Adresse Herr Hoffmann Campe Hamburg -- jederzeit befördern -- 
  Gedruckt Langhoffschen Buchdruckerei Hamburg -- 