Ardinghello glückseligen Insel -- 
  Italienische Geschichte sechzehnn Jahrhundert -- 
  Band -- 
  Lemgo -- Verlag Meyersche Buchhandlung 1787 -- 
  -- 
  Rom -- Oktober -- 
  letzter Begebenheit Lucinde ringen kämpfen -- Torheit hinein geraten -- Natur folgen -- 
  zittre knirsch Zähn -- -- Mensch Freiheit -- 
  Sieh Insel Glückseligkeit -- verlangen kochend Herz Lust -- üppig Mut Nerv schwellen -- widerstehen kalt Überlegung Gefahr -- warten -- indes günstig Wind Wipfel hinsäuseln -- 
  -- Mensch Ruhe trachten -- hernach leiden -- 
  Ziel Kein -- erreichen -- neu -- 
  -- Wesen Frieden -- Brand Glut Urkraft -- 
  gehen stehen -- schweben Auge -- streck Arm -- Fuß bewegen Ort Aufenthalt -- 
  Kreis bannen -- scheinen and Licht -- O -- wünschen -- -- genießen -- dünken Vorschmack Fülle Seligkeit -- 
  Fiordimona -- o Fiordimona -- ewig leben -- unauflöslich verflechn -- 
  Reize Schönheit Freundin -- hoch kräftig Geist Geschlecht finden -- 
  Glaube indessen -- Benedikt -- Muße Langeweile verlieben -- beschäftig Werk bildend Kunst -- alt neueren -- Leben triumphieren -- gewinnen Gegenteil Stärke -- 
  Oktober Wetter Paradiese -- heit -- fest -- 
  Woche Vatikan eingesperren -- genössen Götterlust -- Herz ruhig -- 
  wohn Belveder Manne -- Antiko Verwahrung -- Aussicht Zimmer bezaubernd -- 
  Rom liegen still -- friedlich Überbleibsel Herrschaft Welt -- jung Sproß steigen hervor uralt hohl Stamm ehemals erhaben ungeheur Eich -- 
  Voran grüntn fruchtbar breit Tal -- wodurch Tiber strömen -- reizend Hügel -- schöne bekränzen -- grau Duft blau Ferne lagern Gebirge Sabina -- Tivoli Frascati majestätisch herum -- 
  sehen Aufenthalt süß Geschöpfe -- Seite -- Höhe -- -- hinaus flüchten -- 
  Nachwelt groß Meisterstück Malerei wild kühn Papst Julius verdanken -- selten Glück -- Heftig scharf sicher Blick Wesentliche -- Gepränge Höflingsgeschwätz täuschen Irre führen lassen -- 
  erkennen wahr Talent -- verachten Modekram -- 
  berühmtesten Künstler damalig stanz Wand allerlei Larve Bemalt -- woran Regel aussetzen -- Bramante Raphael siebzehn herbeibracht -- Zimmer versuchen -- 
  alt Meister lächelen höhnisch -- spottet Unerfahrenheit Knabe -- 
  hoch Jüngling lassen stören -- entwerfen Phantasie -- Schauplatz angemessen -- Bild -- Theologie -- Philosophie -- Poesie Gerechtigkeit -- legen Feuer Hand Theologie -- 
  Philosophie vollenden -- Julius Wahrheit Reiz Gemälde entzücken -- Stelle befehlen -- -- -- herunter schlagen -- jung Mensch Zimmer ausmalen -- 
  alt Herr schri Tyrannei Unverstand -- Welt Nachwelt hart Ausspruch rechtfertigen -- 
  Schutz Kunst Ehre -- Million -- Stümper bunt Gemisch Kunstsache verschwenden -- indes eigentlich Mann Bescheidenheit verbergen bleiben darbt -- gewöhnlich Taglöhner Stück Arbeit nebenher Vernünftig Empfehlung ungefähr bekommen -- 
  Theologie geistig Bild Religion -- vornehmst Person alt Testament beisammen -- Charakter -- 
  stellen gleichsam christlich Kirche -- 
  Gott Vater schweben Architekt freundlich Ernst -- -- er_es -- 
  Christus ruhen selig Wolkenthron Glorie Ausführung -- Mutter voll Zärtlichkeit -- 
  Patriarch -- Jünger Apostel umgeben Mittelpunkt -- Wolke Engel tragen -- 
  unten Erdbod handeln Kirchenlehrer Christ Grundlage Gebäude -- 
  Hauptgestalt Zeuge lebhaftest jugendlich Einbildungskraft -- wunderbar Bestimmtheit Umrissen -- 
  Kirchenlehrer Kraft hervor -- 
  sterblich Maler gebären -- gewiß Raphael -- 
  Figur Quelle Leben hervorgefühlen -- unterschied Art Reiz Ausdruck -- 
  Schule Athen geistig Bild Philosoph beisammen -- 
  Pythagoras fangen -- Sokrat folgen -- alsdann Plato Aristoteles -- archimede -- 
  Gruppe letzter Jüngling unaussprechlich schön reizend -- entzückend Bild meist Schüler -- Aufmerksamkeit zwei -- Verwunderung Begeisterung blickenden göttlich hingezaubert -- Moment -- Erklärung schwer Problem finden -- 
  Gesicht samt Haar hoch Schönheit Wahrheit -- 
  archimede voll schärf Verstand Überlegung -- 
  Zeichnung Malerei überall sprechen Meister heiter Sinn -- 
  studieren -- Begr -- hat_es begreifen verwundern -- frohlocken -- -- lernen -- 
  Gymnasium Philosoph wahr Zauber -- jederzeit Seele Empfänglichkeit stimmen -- 
  verschieden Kopf Raphael herrschen Wirklichkeit -- wobei frisch Kraft Phantasie erstaunen -- 
  heilig Gregorius Theologe -- Pythagoras Philosoph -- Mensch -- 
  Parnaß geistig Bild Poesie -- 
  Homer improvisieren Begeisterung hingerissen -- Apollo schön Auge verzücken himmlisch Phantasie -- Muse -- Laura -- Sappho Dichter -- theatralisch ausnehmen -- Zugeg -- 
  Gerechtigkeit bestehen vortrefflich allegorisch Figur -- Klugheit -- Stärke -- Mäßigkeit linke -- 
  Zimmer Arbeit Rom -- bleiben vorzüglich Menge Adel Gestalt -- 
  Seele Auge jeder verständig Welt erfahren Mensch süß Kern weiden -- 
  überall blicken himmlisch Blume hervor -- tief Stachel hineingräbt -- desto nahrhafter Honig finden -- 
  spät erfreuen Evangelist Johannes Theologie -- David -- Menge groß Figur süß Lächel halbzugedrücken innig-selig Blick Engelsschönheit Herz blitzen -- 
  blond Haar wallen reizend nieder Schulter -- scheinen Liebesbrief schreiben -- 
  Schule Athen angenehmst Werk -- Fülle Heiterkeit Ruhe entgegen -- Grund Streit vorstellen -- nämlich Sieg aristotelischen Philosophie Platonisch -- triumphierend widerlegt Gesicht zeigen -- 
  Held scheinen beziehen -- 
  Plato Seite Sokrat Alkibiad -- Pythagoras -- Aristoteles Kardinal Bembo Archimed -- 
  wahrscheinlich fehlen Epikur Zeno Anhing -- 
  vollkommen Meisterstück Pythagoras -- Sokrat -- Plato -- Aristoteles -- Archimed -- Bramant jung Herzoge Mantua -- 
  Natur -- Kunst vergessen denken -- 
  voll verlieben darein fertig Meister -- 
  Gruppe schön zusammengehaln -- richten Philosoph -- Unterricht erteilen -- 
  antik Gewänder hineingedachen -- merken Gezwungenes -- 
  Platonici artifices Disserendi -- non interpret Naturae aut doctor Sapientiae -- Meinung -- 
  Zusammengedrängte Jahrhundert Gemälde einzig Bild Phantasie -- 
  Zimmer tun Genius Raffael -- ausdrücken -- pittoresker Flug -- reich hoch individuell Gestalt -- 
  Heliodor schön Allegorie neu Zeit -- 
  teilen Gruppe tun Wirkung -- 
  Gruppe Engel niedergeworfen Heliodor gehören Raffael höchstes -- Natur Gestalt -- Gebärde -- Bewegung -- vermutlich feurig Römischen Bube Zorn Sprung absehen -- 
  Engel Pferd Kirche ungereimt -- herrlich Bild Schnelligkeit unwiderstehlich Gewalt -- 
  Heliodor Gefährte schreien -- gehören Schönheit -- Theorie Antiquar Mund auftun -- 
  Gruppe Weiber Papst -- Schweizer Natur kopieren Herein tragen -- reizend Kontrast -- Kopf Frau -- Hand zeigen -- schön -- wunderbar Ausdruck -- 
  Julius schauen voll Majestät -- Befehl ausführen -- 
  Hohepriester Mitte Altar bitten Zuversicht Ergebung -- 
  Bube -- Säulenfuß steigen -- zuzuschauen -- pittoresk -- samt Beleuchtung -- 
  Gemälde gehören gewiß Vortrefflichst -- Raphael hervorbringen -- -- Franzosen Italien hinausgetrieben -- innig ergötzen -- 
  sehen inzwischen deutlich -- Schüler Nebensachen helfen -- 
  ungeheur Unterschied -- Raphael meister gegenwärtig Maler sehen -- leben bedeuten -- greifen -- 
  verständigen Mensch -- 
  siehst -- schwärmen -- 
  Melde -- bewunderten Attila Wirkung -- 
  finden zusammenhängend wirklich Malerei Charakter -- obgleich Anlage trefflich -- zuviel Kompliment Leo -- Kopf wahrlich Szene schicken -- 
  Attila sehen gütig Hunnenkönig -- unerachten ungefühlt Wort Griechenheit -- Leo fein heiligen -- 
  Apostel schwer -- -- nah Luft schwebend Figur -- Gestalt -- bitten eher drohen -- halten Schwert Weiber -- 
  desto bleiben Gemälde Porträt -- Pferd verschieden Gewänder reizend Wandverzierung geistlich Fürst -- natürlich Gestalt Verstand Auge -- hundert neueren -- 
  Wunder Messe ergötzen Einheit Mannigfaltigkeit Ausdruck verschieden Gesicht -- meistens Porträt -- zeigen Raffael wunderbar Einbildungskraft -- 
  lebendig Glaube -- 
  überführn Priester -- Auge blinzend voll Beschämung erstaun Lippe -- Julius Papst hoch Meisterstück -- 
  malen -- 
  Petrus befreien Gefängnis angenehm Spiel Licht Schatten -- wozu Raphael gehören -- entwerfen -- erschrocken Soldat Treppe meisterlich -- 
  Zimmer merken -- Raphael Schüler Arbeit brauchen -- hintersten -- meister -- 
  Burgbrand vorzüglich -- 
  Gestalt vortrefflich -- Szene eher Vorwurf Tizian Correggio -- 
  Wunder eher Poesie -- bildend Kunst -- täusch Auge selten -- natürlich Weise sehen -- 
  dirn Krug kopf göttlich Figur -- Amazone modern Weiber -- voll Leben Frischheit Form -- reizend Wind angeweht Gewand -- 
  kniend Frau gleichfalls trefflich -- Gruppe Sohns -- Aeneas -- Vater retten -- Buben Meisterwerk -- 
  Tumult Weiber Kind -- weinend schreiend -- flehend erschrocken -- ergreifen Phantasie -- schön Gestalt -- 
  Nackend scheitern -- koloriert -- Wirkung hervorbringen -- 
  nackend Kerl -- herab springen -- ziegelfarbig -- sehen geschunden -- 
  Leo -- Evangelium schwören -- 
  Hauptfigur gut -- Gewissen Trefflicher ausdrücken -- kräftig -- frei Charakter -- 
  herrlich Blick gen Himmel -- 
  meisterhafen Kopf -- scharf Verstand -- Getrostheit -- Verwunderung Aufmerksamkeit -- Menge verschieden Empfindung -- 
  reizend -- überall tief Seelenklang finden -- 
  klar still tief Wasser -- worin gut Natur rein abspiegeln -- 
  Schlacht Ostia gut geharnischt Soldat grün Hose -- christlich Held -- 
  übrig Stück unbedeutend -- Papst fromm Schafsgestalt -- 
  Krönung Karls Karl einfältig Figur -- passen Szene -- Empfindung Feinheit ausführen -- sehen alt Schweizerkorporal -- Kniet abgestutzt Haar Papst -- 
  Gemälde vortrefflich Kopf -- Bischöfen geharnischt Schweizer -- 
  Gescheitesten entferntest Handlung -- ernsthaft heiter nachdenken -- 
  Bischofsmütz fatal Malerei -- Weiß doppelt gerad Reihe Vordergrunde grell -- 
  Einheit verbreiten Sänger Ecke -- 
  Kerl -- Geschenk tragen -- silbern Tisch Gefäß -- bringen Mannigfaltigkeit hinein -- 
  zusammengedrängt Pracht -- 
  letzter Zimmer -- Eingang groß -- bloß Raffael Zeichnung Anlage -- Figur -- Öl ausmalen -- nämlich Gerechtigkeit Gütigkeit -- -- obgleich allegorisch bedeutend -- Wahrheit Wirklichkeit Julio Romano Fattore niederschlagen -- 
  -- Raffael warm Leben kalt -- ist_es -- ist_es -- 
  lebendig -- 
  sind_es Maske -- 
  fehlen Bestimmtheit Teil -- fehlen fein entscheidend Zug -- schöpferischen Phantasie unmittelbar Hand quellen -- 
  zwingen -- Person sehen -- -- 
  Schlacht Konstantin gehören Verklärung Raffael groß Komposition -- schön vortrefflich anordnen -- 
  Hauptfigur hervor -- 
  Konstantin drücken Zorn -- Freude regen Sieg -- Gruppe Reiter -- Pferd verwunden -- ausgedachen -- 
  Kopf Maxentius stellen schlecht -- grausamen elend Tyrann dar -- meistens Julio erfinden -- Verzweiflung gänzlich Ohnmacht Gefahr überall umkommen -- 
  Pferd -- Untersinken Wasser halten -- Strom schwimmen -- Bark steigen umwerfen -- trefflich -- 
  Haufen voll -- Feind flüchtig -- Widerstand -- bleiben Schlacht Wahrheit Gestalt -- 
  Gruppe -- Pferd heruntergebohren -- gefallen Sohn Fahne Vater Wirkung -- 
  übrig Gemälde saal Betrachtung -- 
  Anrede Konstantin erscheinend Kreuz Luft gut -- Anrede Trajan Konstantin Triumphbog -- 
  Porträt ziehen Auge -- Jünglinge Konstantin -- 
  Schenkung Konstantin vordergrund Seite paar schön Gruppe Weiber -- samt -- Säule drängen -- 
  stanzen Logen -- lauter Gemälde alt Testamente -- wenige verzieren -- 
  Raphael paar Erker flüchtig ausmalen -- Hand anlegen -- Schüler Zeichnung -- 
  Arabesk -- 
  voll schön reizend Idee -- 
  betrachten Gang Schule Raffael eigentlich verstand -- trefflich Meister Schüler -- freuen sehen -- Schwing versuchen -- 
  umhin -- Meister neueren Michel Angelo Raphael stellen -- Richtigkeit Nackend Erhabenheit Denkungsart -- 
  Gefühl schön Form -- elend Auge Farbe -- arm Gestalt -- 
  Raphael lauter Herz Empfindung -- Quelle Leben Schönheit -- sterblich -- 
  Edel liebenswürdig bereit -- Fülle mitteilen -- Gunst Bewunderung Kern Menschheit erhalten -- 
  nackende -- unser Zeit Mensch sichtbar -- besitzen Gewalt -- 
  Gestalt reich -- fühlen Gattung Seelenschönheit auf lebendig -- 
  Farbe Oberfläche -- Nackend Reiz fühlen -- Kopf hoch Vortrefflichkeit übergetragen -- 
  Zaubere Helldunkel fremd -- 
  Fehler Gefälligkeit überall -- -- 
  scheinen -- widerwärtig Gesicht ansehen -- Köpfen Attila Heliodor -- Mörder schier -- Grazie Gefälligkeit -- 
  Heldencharakter -- bestehen -- Apollo -- Herkules -- Jupiter -- ähnlich Mensch höchst selten bloß Kopie erreichen -- 
  nackend Teil -- unser Sitte sehen -- Neueren meist Abschrift Modell -- freuen fest Hand -- 
  Vollkommenheit Antik kannen -- Vortrefflichstes wahrlich -- worin nachahmen -- 
  nackende -- plagen -- tun Wirkung -- Natur -- Grieche -- ausnehmen Kind -- Arm -- Bein -- Brüste -- Hand -- Fuß -- 
  sehen Vatikan -- vorzüglichst Person Zeitalter umging -- Gestalt -- Miene Gebärde -- Stellung Bewegung -- Reiz Gewänder Kunst -- 
  Meisterstücke Archimedes -- Aristotele -- Plato -- Pythagoras -- Theologe Kirchenlehrer -- 
  fassen -- gehören gewiß verliebt Umgang Mann -- 
  Sappho -- Laura -- Musen Apollo Parnaß -- Pindar -- Horaz -- Gestalt -- 
  welch unschuldig unbehilflich unbesorgt Wesen Kind Burgbrande -- 
  Schönheit Ausdruck Empfindung verstehen -- -- 
  gemeinst Anstrich Empfindung geben -- Seele tunken -- 
  fast -- gefühlig Gebärde innig Rührung zuweilen scharf Denker bloß Manier -- finden -- hinschicken -- 
  wahrhaftig schön Seele Kindheit gewöhnen -- 
  Gefühlvolle Gestalt -- sprechen -- eigentlich Gegenstand Malerei -- Hauptwerk historisch Komposition ausmachen -- ergreifen -- 
  vorig Woche Seligsprechung Sankt Johann Lateran -- Raffael Tapet ausgehängen -- Fest schmücken -- 
  Reihe Gemälde -- nennen -- befinden -- belaufen Stück -- 
  Bild Leben Jesu -- Apostelgeschicht -- 
  Raphael malen Karton -- Tod -- verlangen Leo -- Flandern Aufsicht gut dortig Schüler wirken -- 
  treffen Vorstellung hoch Vortrefflichkeit Schönheit -- freilich Mühe -- erblicken hierin einzeln Figur -- entzücken -- 
  müssen einschränken -- Tapete Wirkung tun -- Fein -- zart Zug -- entscheiden -- 
  vermutlich schändlich Nachlässigkeit Original zurückgelassen -- Himmel wissen -- Nebelländer hingeran -- 
  Kindermord -- Auferstehung -- Austeilung Schlüssel -- Paulus opfern -- Areopag -- Petrus Gichtbrüchigen heilen -- blind Zaubrer -- Fischzug gehören -- 
  wunderbar -- Leben groben Materie hervorbricht Herz ergreifen -- Glückliche selig Kind -- Volk vorbei ziehen -- Stille stehen -- schöne zeigen -- Religion freuen -- fromm Haus -- 
  Kindermord Künstler Segel streichen -- 
  schön Weib Träne vergießen sehen -- rührend Mutterlieb Unschuld Kind mancherlei Art ausdrücken -- 
  Mutter -- ausgebreitet Arm flatternd Haar Schrecken fliehen -- sitzen tot Kind weinen -- Mörder wütend fortstößen -- indes Kind fest klammeren -- göttlich Gestalt -- 
  unendlich Reiz Leben -- Bewegung Schönheit Stück -- Tapet bestehen -- 
  Petrus Gichtbrüchigen heilen -- gleich Meisterstück -- trefflichsn Naturgestalt Begebenheit -- vollkommen -- 
  gleich Paulus opfern -- petrus Schlüssel empfangen -- 
  Christus auferstehen -- äußerst sinnlich erfinden -- 
  Wache erschricken fliehen -- Gespenste -- 
  Hauptmann Spieße -- entsetzen tapf aushalten -- Soldat -- Furcht schmiegen -- anderer Schild Arm Kopfe -- -- ausreißen -- Meisterwerk -- 
  Marie Ferne vollenden Heiterkeit -- 
  lassen sagen -- stehen -- Schönheit hindeuen -- 
  viele nähern Bekanntschaft Raphael ahnden -- 
  theologisch Werk behalten Preis letzter -- Verklärung -- gewissermaßen Quintessenz heilig Gefühl halten -- Zuschauer Mittelpunkt christlich Religion zaubern -- Vollkommenheit Kunst -- 
  Schade -- Gemälde Haltung verlieren -- Schatten schwarz -- fein Tint verschwinden -- Luft Wirkung tun -- 
  inzwischen Gestalt hoch Mensch -- versammeln -- ergreifen -- 
  unterer Apostel voll Gutherzigkeit helfen -- -- 
  notleidenden edel Seele -- kniend Jungfrau königlich Profil erheben Szene -- 
  beseßen Bube Kind -- Kopf Ausdruck -- böse Geist angetan -- Arm Meisterstück Wut Qual -- 
  Kopf Weibe -- Hand halten -- voll Angst blass Melancholie -- rühren Bangigkeit -- 
  Berg göttlich Jüngling -- menschlich Geschlecht elende befreien -- unterer Gefährt zeigen -- Verzückung emporgehob Boden -- umschweben groß Geist Vorwelt herab Himmel -- 
  eingeschlummert Begleiter erwach Anhöhe Glut Begeisterung -- 
  Gestalt äußerst rein bestimmen -- individuell -- voll Physiognomie Schönheit Form -- 
  Kopf fast Natur römisch Welt -- täuschen -- 
  Fremder genießen -- -- kennen -- 
  Wort -- -- -- wahr Verherrlichung Verklärung -- doppelszen -- vereinigen -- füllen Moment mächtig -- Malerei leisten -- leer Kritiker tadeln -- entzückt Meister Erfindung -- Triumph Kunst Mensch Gefühl -- 
  gewiß erstaun Anzahl Werk kurz Leben -- Hange Wollust -- meister fühlen ausempfunden sehen -- 
  bloß Manier Fabrik lassen Anzahl begreifen -- arm Sünder Puppenkram -- Vernünftiger erblicken -- Stellung versetzen -- Vollkommen -- Natur herholen -- rein voll Seele -- kosten Anstrengung -- 
  Raphael innig -- zart Kindheit -- einzig lieb künstlersöhnchen voll frisch Kraft Maler Einsamkeit Leben Welt bilden -- früh angewöhnen -- Gestalt Bewegung Phantasie sammeln vorstellen -- Übung Gewohnheit stark Fertigkeit -- 
  Hand gleichfalls üben -- Auge Phantasie -- Geist Sphäre erweitern -- göttlich Jüngling Vorschein kommen -- 
  Hauptsache -- worin übertreffen -- bleiben vollkommen Fertigkeit -- Gestalt vorstellen -- Grund Natur -- Zweck Absicht -- 
  wunderbar Menge Gemälde -- 
  hoch Malerei -- Gestalt -- wobei -- zuweilen scharfsinnigst Kopf -- vergebens abmartern -- leichtest -- Quelle -- 
  sehen Komposition deutlich allemal Figur -- anstrengen -- wirklich Natur nachahmen -- 
  besitzen gut Volksverstand -- denken Empfand Geschichte natürlichsen -- Gestaltenphantasie -- kernhaft Stil -- bestimmen -- lebendig -- 
  nötigen -- Gegenlied Lob anstimmen -- Papst Julius -- 
  Glück Raphael -- Kunst Arbeit verschaffen -- keins Gegenteil -- fast bloß Kirchenmaler -- 
  einzig Werk theologisch Gemälde Porträt Geschichte psych Farnesina -- gehören -- einzeln vortrefflich Figur ausnehmen -- Best -- 
  Götter Göttinnen Abstand Antik -- 
  Entschuldigung sagen -- Apuleius kostbar erzählt Märche schier Lucianisch behandeln -- Malerscherz -- stellen kokett Weib -- reizend Schwiegertochter -- -- 
  sprechen Poussin Gelegenheit folglich höchst einseitig Urteil -- Raphael Antik Esel -- -- 
  Schüler scheinen überdies Kosten reichen Kaufmann Chigi Siena -- verschwenderisch Pracht Mahlzeit Kardinäle Prälat silbern Gefäß -- abtragen -- vorbeifließender Tyberstrom werfen lassen -- Zeitvertreib -- -- vatikanisch Strenge -- Arbeit Ernst -- welsch Amsterdamer müssen Zimmer Geliebte einräumen -- allemal Hand -- Lust wollüstig Zeichnung nackend weiblich Gestalt ankäme -- 
  Allegorie Liebesgötter sinnreichste -- Venus Psych einigemal bezaubernd -- Zeus Amor beisammen griechisch empfinden -- Merkur -- Grazie Rücken Meisterwerk -- 
  Johann Udine Blume himmlisch Frühling nossen -- 
  Galatea Saal Zärtlichkeit Empfindung Liebe ausdrücken -- Unschuld Blick -- unreif Gestalt -- Gesicht klar rein -- Exempel Köpfe Verklärung -- 
  fliegend Bübch schweben reizend schön Umriss -- 
  stanzen Gemälde -- Kirchengeschicht gehören -- müssen Person Ort fromm behandeln -- sogar Vasari Plato Aristoteles Schule Athen Apostel Petrus Paulus ansehen -- anderer Unwissend heilig Schein Kupfer stechen -- 
  Parnaß vermutlich saal Ariost Gartenhause ander Werk -- 
  Zimmer beleuchten anordnen -- Malerei überladen -- 
  fast denken -- Halbgott groß Leben Schüler gefangen sitzen -- theologisch Tyrann gefall Wand voll pinseln -- Erlösung bewegen -- 
  Raphael Druck äußerst -- Wesen Gefühl Neigung Erfahrung Spiel kommen -- Sonne himmlisch Genius Brennpunkt zünden -- 
  -- freisn schlüpfrigsten Szene Welt Künstler Gestalt frommst Gemälde übertragen -- geschehen allemal Zwang -- -- anstatt Begebenheit profan Geschichte Fabel Phantasie erhöbe begeistert -- eigentlich lebendig Zug verwirrt verunstalten -- gut Kraft verlieren -- 
  Raffael Weiber -- Exempel -- Gestalt Kindermord -- vortrefflich Sibylle Kirche alla Pace -- verschieden Madonne Wirkung Vorstellung Leben Sophonisbe -- Kleopatra -- Cornelia -- Geschichte Koriolan hervorbringen -- 
  bleiben ausmachen -- 
  Element Geist Freiheit -- unterstützen -- gewähren -- 
  Zwang hemmen drücken Natur -- Schönheit voll Reiz zeigen -- 
  Athener Demokratie Anarchie hoch Gipfel Menschheit -- 
  Rom -- November -- 
  freu -- gleich Lebenspfade hsen -- leicht Schicksale nehmen -- 
  Chiara anderer Art -- Fiordimona -- schmachten lassen -- Herrlichkeit bewußt -- 
  erfahren -- lieb Weibe überfliegen -- 
  Nebenbuhler -- glücklich Nebenbuhler -- Schein glücklich -- fesseln Triumphwag -- worauf stolz jung Römerin einherziehen alt Sylla -- siegen groß König Erde -- Held Vaterland -- 
  fühlen -- fühlen -- unaussprechlich lieben -- 
  Empfindung -- Wesen voll Schläg durchkreuzt -- fassen -- Feuer Flamme schrecklich Gewitter gestehen -- 
  erstemal -- Seele vereinigt -- geschehen Nacht Raub -- Gebüsch Gesträuch -- ewig Lichter Himmel -- Gipfel Mont Mario -- O Gott -- Reiz versunken verlieren -- 
  -- Leben -- unaufhörlich fortdaueren -- tief Elend winden herum -- 
  reißen allzubald heiß Küssen -- Abwesenheit Ball -- Prinz Villa Melini -- bemerken -- wandeln -- -- Bäumen herum -- Freudensprung Knabe -- jauchzen unfaßbar Entzück hinab Täler Tyberstrom -- Hügel widerhallen -- 
  Solltest sehen -- erhaben Gestalt -- auslesen -- Lüsternheit spröd Wesen -- 
  froh Edel wollüstiger Gesicht gibt_es -- 
  Adlerauge schauen umher -- bezaubernd -- lockend Mund -- 
  stolz Gewäch schlank Leib schwellen unter Gewand reizend hinab -- Wut wegreißen -- Brüste drängen heiß üppig hervor -- aufgehend Frühlingssonn -- 
  Wang Kinn frisch Blüte -- bilden entzückendster Oval -- woraus Licht Liebe glänzt -- 
  O braun Locke Tanze bacchantisch walln -- himmlisch Blick Musik Bewegung Süßigkeit schwamm -- nett Bein jugendlich Kraft heben -- schnell Blitz verschwinden wiederkamen -- 
  Beginn unmöglich Unternehmen -- 
  genießen hoch Dasein -- zart arm Reb umflechten -- König Gott -- 
  -- Wunder Natur Geist -- Kreatur -- worüber erstenmal geheim Ingrimm Rase -- vortrefflich -- O laß -- Ruf zuweilen Verzweiflung -- unbändigen Zug folgen -- unterliegen -- 
  glauben -- Dirne Art Kette Bande legen -- Tobe -- wissen -- bevorstehen -- 
  falsch Wahn benehmen -- aufsteigen -- 
  reich -- besitzen unmäßig Vermögen -- weder Vater -- Mutter -- Geschwister -- 
  Vater Sohn päpstlich Neffe -- bleiben -- 
  werben -- vorstellen -- Freiheit behaupten platterdings vermählen -- 
  bringen bequem frei Nacht Schlafgemach -- Morgenrot Sonne Blume Schönheit bestrahln -- ungestört Genusse Sinnen darinnen wiegen -- 
  Rede -- Gefühl -- Schwand -- süß Scherz -- Mutwille -- Spiel -- kindlich himmlisch -- 
  Trunken lechzend taumeln dannen -- 
  Weise -- Wollust Leben abziehen -- bleiben Tod übrig -- 
  -- Sappho Weiber Grazie nennen -- Liebreizende -- schön Verständigst fehlen -- 
  verstehen Kunst lieben -- kennen Wirklichkeit Sache Mannigfaltigkeit -- Virtuosin -- wissen Anfangsgründe -- 
  Sokrat unendlich verstand Schule -- Natur übersteigen Einbildung -- 
  O bloß erquickend Frucht hängen -- voll süß Traube -- woran durstig Zug saugen -- bezaubernd unüberwindlich Tyrannin Herzens Geist -- 
  sicher Vollkommenheit bedürfen Zierereyen -- 
  Grausame begnügen -- Spinne Seele -- verlangen -- -- Unmöglichkeit streben -- o töricht -- 
  -- Laß aufrichtig -- -- sprechen Abend spazierengeh Saitenspiel Gesang Liebkosung Klage Eifersucht -- 
  -- jeder Kraft Glückseligkeit bedienen -- womit Welt aussteuern -- Lage Sphäre -- wohinein Geburt setzen -- 
  heben Mensch Mensch -- groß Unterschied Gerade Genusses -- Exempel verschieden Wein Geschmack -- glauben -- Reb herkämen -- 
  sein König Halbgötter -- Löwe Rind -- Stelle gebrauchen wüßten -- -- Hieron Xenophon sprechen Erfahrung -- 
  -- Frauenzimmer unklug -- Gestalt -- fällen -- Erwuch -- Vermögen besitzen -- unauflöslich Joch Ehe aufbinden lassen -- 
  Göttin bleiben -- unverheiraten -- Herr -- Wahl wack Manne -- -- 
  leben Gesellschaft verständigst -- schön -- witzig -- Sinnreichst -- erziehen Kind Lust -- freiwillig Kind Liebe -- erhöhen Manne -- 
  hingegen Ehestand Sklavin weggefangen -- vermöcht Gesetz Gewohnheit -- Sultan -- aufgeopferen -- verachten sehen müssen -- vortrefflichen Hochachtung seelenhaft Art -- bloß Tand Wort -- erkennen geben -- -- 
  -- Prospero auseinander setzen brauchen -- ferner -- Staat gewinnen verlieren -- 
  etwaig Sünd vergeben lassen -- eigentlich Gebot -- Lebensart fromm Regierung gestatten -- -- 
  -- Eifersucht betreffen -- 
  gewiß -- eur Seite -- unnatürlich Leidenschaft -- entstehen armselig Schwäche -- Mangel -- Vorurteil -- brüd Held -- wert Mann -- Freude -- schön Weib gemeinschaftlich lieben -- 
  gering Genuß Anteilnehmung mehrere verstärken -- gewinnen voll Gehalt -- sollt groß -- 
  jung Schönheit Stande vergnügen -- 
  Verliert -- Quelle trinken -- woran Durst löschen -- 
  gut bürgerlich Gesellschaft platterdings gesellschaftlich Liebe Freundlichkeit -- Krebsschade Vorurteil vieler Jahrtausend heilen -- 
  eins einer wahrlich einsiedlerisch Natur -- behaupten -- wissen -- blind -- 
  Mannigfaltigkeit Unsinn -- jederzeit bloß Brot leben -- 
  Mensch existieren -- -- Natur -- 
  sein zusammengewachsen -- 
  geht_es Gattung Tier -- Gras Kraut Bäumen -- 
  jeder vereinigen Gelegenheit -- 
  O Armseligen -- Begriff Leben Freiheit Großheit Charakter -- 
  rein wahr Lust -- Person -- -- Element göttlich einzig unzerstörbar -- lauter Gefühl Geist -- Tropfen Ozean Meer Wesen rollen -- Vollkommen genießen -- vollkommener genießen -- Fleck kleben bleiben -- 
  genießen -- weg -- 
  allgemein Gesetz Natur -- wodurch ewig lebendig unsterblich erhalten -- -- 
  erschrak erstaunt Pindarische Schwung -- Philosophie treiben -- 
  lernen Rom -- 
  bleiben gewiß Rücksicht Hauptstadt Welt -- 
  -- jung Arabisch Roß -- Zügel Gebiß erfahren -- flatternd Mähn Flur schweifen üppig Kraft Hecke Gräben setzen -- 
  lächelt Verwunderung -- mildert feurig kühn Adlerblick -- fassen zärtlich Hand -- fahren fort -- 
  -- weise sprechen -- 
  Zeno Plato reden -- Hoch nähern -- mitleiden schwache -- 
  Glaube -- Herz sprechen -- Abstraktion kalt Vernunft -- leicht Flug mutwillig Phantasie -- necken warnen -- 
  O Abgott -- lieben -- getreu bleibst -- Furcht -- -- 
  Kennst -- vermöchte -- -- 
  vermochen -- 
  schweigen verbirg -- Laß Glückseligkeit stille genießen -- siehst -- Feind umringen -- Gut Beute -- -- 
  Schatten schier -- -- Leichtfertigkeit -- Spiel Miene Gebärde -- Pause Frage Antwort Errötung Wegwendungen Gesicht -- entschlüpfen -- schämen -- hingeschrieben -- 
  bloß Inhalt Moral -- alt -- schaffen geben -- Latein -- denken Spanne hinaus Wonnestrudel Paradiesische Leben Zauberin ergreifen festhalten -- 
  sonderbaren Liebesgespräch sonderbar -- Ausschweifung beschuldigen -- Abbati wissen -- blind schauen -- 
  halten eingezog Palast -- Landgütern befinden -- alt Base -- führen Wirtschaft Kammerweibern bedienter -- 
  wissen Ehrerbietung Gehorsam verschaffen -- keiner Mann bedürfen -- alt Vormund -- erben -- Muße -- 
  Vater Mutter außerordentlich Mensch -- begreifen -- 
  sterben -- 
  Rätsel Gespräch aufschließen -- wodurch -- Gesellschaft halten -- wohin Ankunft Kardinal begleiten -- 
  betreffen Licht welsch Literatur -- Dant -- Petrarca -- Boccaccio -- 
  letzter behaupten -- meister Mensch klügsen -- -- gewöhnlich Meinung -- meister Dichter -- 
  Novelle leuchen unendlich Erfindungsgeist hervor -- Werk -- bestimmen hauptsächlich Rang Dichter -- 
  Ver Reim Verzierung -- Licht Schatten Malerei -- Wesentliche -- 
  Charakter Sprache dürfen gut Klassiker Seite setzen -- 
  Wand verschieden -- scherzt Verteidigung gefährlich weiblich Moralist -- 
  ziehen unbeschreiblich Anmut leicht Witz Schlinge -- beschließen -- Sitte schildern -- gehören Vollkommenheit Held Heldin -- Weg Abweg Lande kennen -- Vorwurf reichen -- anderer Schaden klug -- 
  -- betracht Komödie Dante -- fügen ernsthaft hinzu -- eigentlich Satire Feind -- 
  Mann Fels -- Gestalt zeigen -- voll hoch Ehrgeiz -- 
  letzterer vermutlich unverständlich Theologie Philosophie verleiten -- berühmtesten Person Zeitalter hervorragen -- 
  Kraft -- Modemänner verachten -- gut Plan Gedicht wählen -- gotisch Gewirr -- 
  Art Homer -- 
  Stärke -- Feuer -- tief Gefühl -- Einbildung männlichen -- 
  Schicksal Verbannung lassen Ruhe Heiterkeit -- -- 
  -- Petrarca Luft -- entzücken selten lauter rein himmlisch Geist -- Gesellschaft bilden -- 
  Boccaccio meister Natur -- meister Mensch -- meister wirken -- 
  tadeln -- billig Rechnung Zeitalter setzen -- -- 
  Mann Urteil bewundern -- bezaubert schön Lippe -- Perlenreih Zähn hervor -- 
  inner Gehalt gehören -- Beisein Kardinal aussprechen -- 
  Glück -- finden -- Torheit begehen heiraen -- brennend Begierden Hoffnung Liebe dämpfen -- 
  Grundsatz -- auszudenken Stande -- ausüben -- ersprießlich Ehe -- 
  inzwischen -- Verstand anfangen -- -- Seite böse erfolgen -- 
  fernst Gedanke -- gewiß Orden hinein geraten -- treiben dannen -- 
  wissen -- woran -- Heillose foppen -- 
  Hauptpunkt vergessen -- erzählen -- singen Stegreif vortrefflich Vers -- tonvollen silbern Stimme -- Augenblick Muse Parnaß -- siren Flut vorstellen -- 
  bringen Ergötzlichkeit hervor Einsamkeit Gesellschaft -- Scherz -- sein schaffen -- Ehe stiften -- and Paar Fluch Unglücklichen -- Joch ziehen -- laden -- 
  -- wissen -- enden -- 
  warm Brust -- mich_es Punkt brennen -- zuweilen bange -- 
  Glut scheinen innerst Leben angreifen zehren -- gehen herum Tier -- Schusse bluten -- 
  Augenblick fahr Schrecken -- jung Rind -- Löwe brüllen -- 
  Freiheit verlieren -- ermannen -- 
  Kraft anspannen -- Strick zerreißen -- 
  Semirami -- breit Süden Norden Freistatt finden -- 
  Gott Himmel -- Reiz -- wonach gelüsten -- 
  Blitz Auge -- womit niederschmetteren -- 
  Rase -- glücklich -- emporgehob Stern -- 
  Wahnsinn Lage fallen -- 
  sitzen Vatikan -- bequemsten kommen -- 
  Villa Medicis -- befürchten -- Ausbleiben Verdacht schöpfen -- beobachten -- 
  Kardinal Schalk -- o merken -- Bogen Ziel spannen -- Pfeil richten -- 
  Petrus jung hübsch Mohrin Senegal -- Italienisch verstehen -- 
  Fiordimona halten Zucht -- geringsten Untreue befürchten -- Stelle niedergestoßen -- 
  schön Heiteren bring Belveder -- lästerlich -- bloß zerstreuen -- Gedanke -- 
  Apollonius Agesand verstehen Kunst -- allemal früh spät Schönheit Wahrheit locken einnehmen -- 
  O erheben Geist -- Bruder -- 
  ewig -- unsterblich -- bewegen -- schaffen -- Schranke setzen -- 
  Materie -- frei Vogelflug hemmen -- werfen -- -- 
  Schwärme hineingeraten -- -- 
  Rom -- Dezember -- 
  Scirocco -- Regen Wolkenbrüchen ergießen -- klar Tramontana einstellen -- Hügel Täler Gebirg schweben breit lauter erquickend Himmel -- leicht Äther heben Erde -- empor dannen -- 
  letzter Stunde Vatikan -- -- scheiden -- 
  -- scheid Kunst -- Bestimmung -- jugendlich täuschen -- 
  geheim Gefühl -- Endzweck Existenz -- -- Schönheit genießen -- Gott Glückseligkeit -- wähnen -- Beruhigung Malerei finden -- arbeiten herum Traum Schatten -- 
  Herz Geist trachten kräftig Nahrung -- finden lebendig Natur Gesellschaft Mensch -- wirklich Kampf Krieg -- Liebe Friede -- 
  Quintessenz Schöpfung -- Freund Feind -- Beute -- hoch Sphäre handeln -- 
  -- Scheiden eigentlich Tod -- Natur schaudern -- Leben bluten -- reißen -- 
  Künstler Mitgenoß alt Republik -- 
  ausharren -- Schlangenstrom Ewigkeit klar Flut aufnimmen -- Schaum and Ufer Weltall setzen -- 
  golden Zeit Athen -- -- Schatten Erdenrunde finden -- 
  -- sagen -- Mitgenoß alt Republik -- 
  glänzend Zeitalter leben -- worin Sokrat aufwuchs -- 
  Malerei gewiß eher Bildhauerei verlassen -- Spiel -- 
  Plutarch lallen freilich kindisch -- -- -- Umstand -- -- gutartig Jüngling Phidias Polyklet -- -- 
  brennen Pfeil -- Demetri tief Leben abdrücken -- 
  Schlacht Plataia Peloponnesisch Krieg hinein Athen halb Jahrhundert Rom Griechenland -- Bürger Insel Kleinasien schier Fürst Herr -- Kunst unanständig -- Held Staatsmann bilden -- 
  vorher Solon Fünfhundertscheffl -- Reiter -- Halbreiter -- S. f. -- obgleich Lage Sache nötigen -- ärgerlich Maß Gewicht Verdienst einführen -- unedel -- Rente leben -- göttlich Wissenschaft Kunst Unterhalt erwerben -- 
  erhaben Sieger König -- verwünscht Maßstab Hals schaffen -- hernach Senat Areopag bleiben -- 
  hiervon reden -- Lukian -- treffendst Witze Meisterstück -- Zeus Tragikos -- lächerlich -- 
  Lehrer Weltbezwingers weisen alsdann rein Vernunft Künsten Staat Rang -- -- Kunst unedel -- Leib Seele Gewandtheit berauben -- frei regen bewegen -- folglich -- wobei sitzen -- gezwungen Stellung Lage -- 
  bildend Kunst möchten freilich Regel übel wegkommen -- Malerei -- Arbeit -- Michel Angelo behaupten -- Kinder- weibermäßig -- 
  Philosophie -- lesen schreiben müssen -- Stagirit lesen schreiben -- -- Freiheit Seele Leibes übersteigen -- ehrwürdigsten Amt -- 
  Nachbar dreifach Krone Hauptsklave -- binden Wickelkind -- Welt lösen -- 
  gut -- wissen schadlos halten -- verstehen Stunde -- 
  Grieche -- Handwerker erniedrigen -- Kunst bloß Gewinst beliebig Befehl unterwerfen -- 
  Werk behalten hingegen Rang -- Venus Tizian bleiben Weise Venus Tizian -- geraten Wert Erfindung Arbeit hosen Stiefel Schuster Schneidern -- 
  Gesetz hoch Ehre Kunst streng gewaltsam fesseln -- Ziel -- helfen fort Umstand -- gelangen -- einigermaßen herrschen echt Gefühl Haufen Wahn Mode -- 
  Zeile gering Spur glücklich Aufenthalt wahrhaftig Belveder innen außen -- 
  Wehmütig Häufchen Ruine betrachten -- unzählbar Schatz Altertum denken -- 
  hundert metallen Kolosse Insel Rhodos -- hundert Meisterstück Lysipp -- Völkerschaft Statue Delphi Elis -- Pracht Herrlichkeit Athen -- Korinth -- Gnid -- Ephesos -- 
  Grieche Römischen Räubereien heutig Antik insgesamt gleichsam ansehen -- Lucullus -- Tafel aufstanden -- paar verschimmelt Brocken Bettler Sack -- 
  schlagen unser Stolz nieder -- zeigen deutlich Barbarei -- -- übrig bleiben -- 
  begreifen -- alt Kosten Materie hernahmen -- binnen kurz Menge Kunstwerke aufstellen -- 
  groß Monarchie leisten Stand -- Sizilium Sandkorn -- bemerkbar Girgent -- -- 
  Verwunderung Xenophon -- blühend Zeit Kunst -- Grieche streng Lebensart abgewich -- Schwelgerei Perser -- Schlafzimmer Tapete belegen -- unnachgiebig Boden hart weichlich Fuß anstrebt -- einigermaßen Schlüssel verleihen -- 
  hoch Selbstständigkeit Mensch -- Vergnügen Herzens -- Freude Geist Wahrheit Schönheit leer Pracht -- Stärke scheut Kitzel erschlafft Sinn -- 
  klein Republik -- gemeinschaftlich Lust denken Person abbrichen -- Berg versetzen -- Natur schaffen -- 
  Kyropädie 8 B. 8 K -- 
  glänzt -- Ehre Religion -- einzig allgemein Band -- Vergleichung alte -- ärmlich Städtchen Italien himmlisch Bild Raphael Correggio Stern hervor ungeheuer Reiche Norden -- nächtlich Wüsst -- Schönheit erscheinen -- 
  Lysipp -- Apelles Art hoch Gipfel Kunst erreichen -- goß Bild Erz -- Gesang entzückendsen -- Musik Poesie vollkommen -- Sprache merken -- bildend Künste Arbeit Materie -- Zeichen -- 
  feierlich Werk Phidias Polyklet Gold Elfenbein erscheinen Kunst geschmückt unreif Jungfrau -- Praxiteles Lysipp Phryne Bad hervor -- fremd Verdunkelnd abgeworfen -- lebendig Vollkommenheit -- 
  Form -- Wirksame -- gleichsam Seele zaubern -- Wesentliche -- schier unsichtbar Gott -- verbannt Pracht -- Auge abziehen Geist dämpfen -- 
  gebraucht Maler notwendigsten Farbe -- gleich Bewandtnis Reden Demosthene -- selten eitl Wortschwall Cicero entfernen -- 
  finden Sophokle Euripide -- rein Schönheit langten -- äußerst spanisch Pomp -- 
  Meister -- Kunst hoch Stufe setzen -- namentlich übrig -- 
  meister Bild Kopie Lehrling -- Gipfel Tempel Paläste Rom Landhäusern stellen -- Getümmel Krieg Barbarei herunterstürzen -- zerschmettern Schutt verwüstet Gebäude begraben -- 
  lang Jahrhundert gräßlich Nacht -- gegend Menschheit benebelten -- -- Gold Silbermin -- Wünschelrute anlegen -- 
  Kleinodie fast Anfang weggeführen -- schiffbrüch ursprünglich Boden Griechenland mancherlei Zerstörung verschwinden -- 
  -- Geschmack bekommen -- etlicher -- obgleich -- Flasche Rest Lacrimae Christi anderer köstlich Getränk Erdbeben untergegangen Weinlager -- 
  Sache folgend Bewandtnis -- 
  alt Kunst teilen besonderer Klasse Schönheit -- Meister beeifert -- Ideal vollkommen darstellen -- 
  Höchste -- 
  bleiben übrig -- ähnlich nachzumach -- Klasse arbeiten -- 
  sagen -- 
  Phidias Problem Jupiter auflösen -- Bild genoß allgemein Verehrung berühmtesten Schauplatz -- 
  Venus Praxireles Apelles -- berühmt Apollo -- Merkur -- Junos -- Minerva -- amazonen -- müssen Weg einschlagen -- verstehen achten -- übertrafen -- 
  Kopf schauen schwach Nachahmung erhabenen Mann Gefühl Form eigentümlich Schönheit jeder -- 
  Torso -- Farnesische Herkules -- -- borghessisch -- Fechter gewiß hoch Meisterstück -- finden Name nennend Arbeiter alte aufgezeichnen -- 
  -- bloß Nachahmer erfundenen -- bringen neu hervor -- besonderer Aufmerksamkeit erregen -- 
  Rom Geist Phidias -- Polyklet Praxiteles schauen -- -- 
  freilich innig Wollustsinn Unterschied Originale -- 
  Statue Range alt Kunst Belveder -- -- nebst weniger Erdbod -- Apollo -- Torso -- Laokoon -- genannt Antinou -- letzter ehrenrührig Name blind Antiquar aufhängen -- 
  Vers Prosa Ekel beschreiben -- Gipsabguß Apostel Türke Heide versenden -- Ankömmling tragen Anmerkung Tagebuch -- Prediger Dach schlimm -- Leonardo Vinci -- Michel Angelo -- Raphael aufstanden -- 
  anstatt Licht Wegweiser wählen -- Auge verblenden -- 
  groß Aufsehen Laokoon -- Plinius mitten hoch Meisterstück Kunst melden -- 
  Werk -- Malerei Bildhauerkunst vorziehen -- Alles-aus- ab Aufschreiber glauben dürfen -- Lieblingsmeinung -- Stimme damalig Römischen Publikum -- 
  voll Wunder Phidia -- Polyklet Praxiteles gehen -- mutmaßten -- Laokoon Zeitalter Geschichtsschreiber Natur -- Lob gewöhnlich Gelehrtenkompliment -- Augenschein zeigen Erfahrenen -- Gruppe schönsen Blüte Kunst stammen -- 
  Sonderlinge Schwindel Paradoxe -- Vatikan wehe -- bloß Kopie -- Plinius ferner -- vortrefflichst Künstler gemeinschaftlich gepflogen Rate Laokoon -- Kind Drache -- Block Marmor verfertigen -- bestehen offenbar Stück -- Agesand Freund Arbeit vergebens verschwenden -- mehrere -- Sohn linker Seite Taschenspielerei Wille unsinnig Mühe kosten -- 
  Plinius vermutlich Gruppe niedrig Standpunkt -- Fuge verstecken -- Sohne -- hinsteigen -- alt Zeit Mode -- Aufseher Ankommende märch Religion vorschwatzten -- geschichtsschreiber Eile unglaublicher Fabel aufbinden lassen -- Lebensart ausgeschlafen -- 
  inzwischen wack Manne Leib -- Ding göttlich Verstand -- zuweilen erhaben Poesie -- 
  Werk wahrscheinlich Zusammenraff ungeheuren -- wolkenbrüch Feuerasche Vesuv erstickt -- bevor Hand legen -- 
  handgreiflich moralisch Unmöglichkeit -- Künstler -- arbeiten -- kräftigst Leben bloß nachmach Zweck verschwenden -- Kopie -- Original stehen -- Wunder Himmel fallen -- Original verschwinden -- Erörterung sylbenstecherischen Verdacht lang verweilen -- 
  Lob Plinius bloß übertrieben hingesagen halten -- verloren hoch Meisterstück Künstler Phidias Lysipp ungleich vortrefflich Bild vorstellen -- Dichter schön Ausdruck Vaterlieb Gruppe angepriesen -- Haufen Auge Endzweck Vorstellung hohlen -- denken -- 
  unglücklich -- Löwe schlang Welt -- gut Mann Kind Marmor quälen sehen -- 
  erfreulich -- Theorie Kunst -- bloß Nachricht beweisen -- Lob Plinius gerecht -- olympisch Jupiter -- 
  gewiß -- Idee Gruppe Laokoon Seele aufgehen -- Herzen -- Hand Mut Fertigkeit fühlen -- ausführen -- Bildhauer gebären -- Sophokle Dichter -- 
  Psychologe -- erkennen -- Wesen stammen -- Triumvir Geschicklichkeit herliehen -- 
  schön Form Art Doppelgattung menschlich Körper fein Gefühl -- heitersen griechisch Sinn tausend Statue schier erschöpfen -- Götterkraft unser Geist Agesand kühnsen Flug beginnen -- überschweben -- 
  hoch Meister finden herrlichst Vorwurf Kunstwerk griechisch Religion -- umgriff Himmel Erde -- 
  Gruppe Laokoon Gattung Niobe -- atmen tragisch bildend Geist -- 
  Lesen -- Geschichte aufgezeichnen stehen Hygin -- 
  -- Laokoon -- erzählen -- Sohn Aköt -- Bruder Anchises -- Priester Apollo -- 
  wider Wille heiraten -- Kind zeugen -- Alsdann treffen -- Neptu Gestad opfern -- senden Apollo Gelegenheit Tenedo Flut Meer Drache -- Söhne Antifass Thymbraio umbrächn -- 
  Laokoon Hilfe leisten -- umflochten töten -- 
  Phrygier geschehen glauben -- Spieß Trojanische Pferd werfen -- -- 
  Servius gut Erklärung -- -- 
  geschehen -- Frau Unenthaltsamkeit Tempel Apollo beschlafen -- 
  Laokoon zeigen Mensch -- gestraft -- Arm göttlich Gerechtigkeit erreichen -- sinken Nacht Tode schrecklich Gericht -- Lippe herum liegen Erkenntnis Sünde -- 
  Auge weggezuckt Blick hoch Ausdruck Schmerzen -- 
  Körper zitteren beben Brennt schwellend folternd tötend Gift -- Quell verbreiten -- 
  Gesichtsbildung schön gekräuselt Bart völlig griechisch -- täglich Umgange tiefschauend Mensch weggefühlen -- drücken gescheit Mann -- and Gesetz -- Vorteil Vergnügen achten -- Stand bürgerlichen Gesellschaft wählen -- voll Kraft Stärke Leibes Seele -- 
  Bube umbringen -- Sprosse alt Stamm -- Geschlecht vertilgen -- 
  leiden mächtig Feind Rebell Gesellschaft Götter -- schaudern froh Weh fürchterlich Untergange herrlichen Verbrecher -- 
  schlangen vollzieh Befehl Ober feierlich naturgroß Art -- Erdbeben Land verwüsten -- 
  Fleisch wunderbar lebendig schön -- Muskel Inneren hervor -- Wog Meere Sturm -- 
  ausgeschrie -- Begriff -- Atem hohlen -- 
  Sohn -- linker Weile fest halten -- Drache hernach vollends kurz Prozeß -- 
  Schamteil alte richten empor Anspannung -- Hodensack Glied zusammengezogen -- Hand Fuß Krampfe -- 
  linker Seite hoch gehören -- Kunst hervorbringen -- 
  Söhne Ausdruck -- gebühren -- 
  sterben tot -- leiden Gift Wunde -- entsetzt bloß -- 
  Vater ziehen Aufmerksamkeit -- 
  Gruppe fehlen Hauptteil -- Arm Laokoon -- 
  Michel Angelo ansetzen -- Modell -- anfangen -- Marmor auszuhauen -- lebendig warm Fleisch Natur hineinfühlen -- 
  bescheiden -- verwerfen Arbeit -- 
  Jammerschade -- alt Arm verlieren gehen -- Zugs schlang -- Laokoon stark Kraft äußern -- 
  fliegen grimmig Satz rechts herein -- umflocht aufgehoben Arm -- abhalten -- schwingen geschwoll Rücken herum -- Seite linker -- Arm alt lebendig Sohn Ellenbogen -- winden oberer Arm -- schlingen unterer -- schrecklich Knoten -- schießen linker Hüfte Vater kopfe -- mächtig Faust Halse ergreifen -- setzen mörderlich Zahn -- 
  Sträube -- Rettung vergebens -- hören -- 
  geschehen -- vollziehen -- 
  Seite überall Bild nehmen -- 
  Schlange fahren linker Seite unten Bein -- kuppeln Raub Beute -- umschlingen Sohne rechts linker Arm -- Rücken herum -- setzen giftig scharf Zahn jung Herz -- 
  Vater sinken Altar -- halten -- alt Sohn linker Hand stehen Bein -- linker Fuß -- Schlange halten Altar gelehnen aufrecht -- 
  werfen Gewänder -- entfliehen -- 
  Gruppe Zeit -- bestimmen -- betrachten -- 
  müssen stark Wirkung hervorbringen -- Naturtrauerspiel menschlich Geschlecht -- Vater -- Rettung Kind umkommen -- Strafe Götter -- 
  Kunstwerk Rang Klasse streitig -- 
  bleiben Naturtrauerspiel -- Kreatur seufzt innere notwendig leiden gut Gerecht -- schaudern Unvermögen -- Unwissenheit -- 
  Vorstellung -- Körper leiden Leben vergehen -- besonderer Klasse bringen -- 
  Lob -- Plinius Gruppe erteilen -- wenigster bestreiten -- Art Niobe anstehen -- 
  Wunde sterbend Ktesila -- woran sehen -- Seele übrig -- gehören einzeln Figur -- hinkend -- Philoklet -- Leontinisch Pythagoras -- Geschwür Qual Betrachtenden empfinden meinen -- verwundet amazonen -- berühmt Hund Lysipp Kapitol -- voll Schmerz natürlich Todesschreck abgesetzt Lauf Wunde lecken -- Aufseher Leben stehen müssen -- 
  letzter Akt unser Drama hienieden scheinen vorzüglich Vorwurf Malerei -- 
  Apelles hervor -- übertraf Landsmann Pindar Aristide -- 
  König Attalus erkauft kranke hundert Talent -- Alexander lassen Gemälde -- Wunde sterbend Mutter anklammernd Kind Brust abhielt -- Blut saugen -- Geburtsort bringen -- 
  Meister Schlacht Perser hundert Figur Zweifel vortrefflich Art -- 
  Farbe Kleinigkeit -- reißen -- Natur empfinden -- Gewalt Täuschung -- 
  neu Werk Peter Märtyrer Tizian hierin anstehen -- 
  Sultan heilsamen Bild -- zuweilen Menschlichkeit erinnern -- groß Meisterstück stehen Kaiserlichen Bäder Platz -- 
  aufrichtig gestehen -- Bad Schlafzimmer Kunstwerk erfreulicher Art aufstellen -- verstümmelt Herkules -- Phantasie drein schaffen -- 
  beständig gnidisch Venus -- 
  Torso hoch Ringerkörper -- Sohn Wundernacht -- arme dreifach Geryon loswand -- ruhen sitzen Löwenfell -- 
  finden übrig alt Kunst -- Kernstärke schön Vollfleischiger -- lebendigst Form feinst Wahrheitsgefühl abgewogen -- 
  senken Seite -- linker Arm Höhe -- 
  mächtig Brustbein zart gehalt nerviger Fettigkeit überzogen -- merken -- 
  Brust Schulter Mark Rücken herum sitzen schlank Mitte unüberwindlich erdrückend -- 
  Schenkel laut Kraft -- 
  Fluß Bewegung allergelindest Umrissus -- 
  sehen Teil -- Gewalt -- Fieber Regung -- treten weder Muskel Knochen scharf hervor -- 
  hoch Vermögen hoch Bescheidenheit Schönheit -- 
  süß Geschöpf Lust arme wiegen -- tragen -- Zapfenlöcher Stütz Schenkel -- 
  Glückseligste Sphäre Welt Achse Geliebte -- 
  mußtesen Entzück schweben hängen -- Berührung frei -- 
  scherz -- Demetri behaupten -- fromm -- zornig schnellfüßig Achill Homer kommen Held -- 
  Farnesisch Herkules Charakter Faustbalger -- feist breit vollgenähren Form Cestus -- 
  Stärke fallen zentnermäßig Gefühl heutig schwach Römer -- Welt hunden Katze Löwe vollst Kraft -- 
  farnesischen Hof niedrig Standpunkt -- schwellen Brust natürlich Großheit -- Hüft Seite -- 
  Kopf vollkommen Eisen Stahl unüberwindlich Mut -- unerbittsam Zähneinschmeißen -- 
  Künstler -- erfinden -- scheinen Ideal Sophokle bilden -- Held Held Reich verheern -- Jollen Gewalt bekommen -- Vater Brüder ermorden -- Besuch süß Reiz heimlich Beischlafe geben -- Dorf Stadt verbrennen -- Einwohner Sklave gefangen führen -- 
  tobt Liebe -- 
  Gelegenheit letzen unterlassen -- Skizze -- Sonnenmut Lust strahlend -- Lieblingsstück -- tragisch Dichter entwerfen -- Kopie heroisch Gestalt Farnesischen Stier aufzubewahren -- 
  groß Meisterstück Marmor Tier Grieche -- 
  natürlich Ochsenfleisch sehen -- Myron Kuh -- 
  Bein neu -- erhalten -- 
  wahrhaftig wild Stiernatur Stellung -- Bewegung herrlichen Körper -- strotzen Kraft wunderbar Hinteren Königlich Rücken -- 
  Schön Bild Stärke -- Herde Preis tragen -- 
  Skizze stellen göttlich Chor -- Herkules Fluß Acheloos Rind -- Kraft schwellen -- Dejanir kämpfen -- zart Wohlgestalt fernglänzend Ufer sitzen -- Gatte erwarten -- schüchtern Kalb Mutter fern -- Sohn Zeus -- vierfüßig Tier -- indes Löwenwürger -- lang Krieg -- gewaltig Horn ausreißen -- 
  erfreulichst Genuß Werk verschwinden -- olympisch Kampf Sieg sehen -- 
  Athener verherrlichen hoch Muster Vaterstadt -- Apollonius Torso -- Glykon Farnesischen Keulenschwinger -- 
  genannt Antinou -- jung Held -- Meleagros vorstellen -- Bild schließen -- Figur Stellung ähnlich -- unten Fuß wild Schweinskopf befinden -- hauptstatuen meister Wirklichkeit -- 
  echt griechisch jugendlich Schönheit voll geistig Reiz -- süß lieblich Hoheit -- 
  blicken empfindend Erde -- besännen -- Mädchen wollen -- Lippe -- Stirn Wang Kinn sehen kräftig -- zartnervig anhaltend Genuß -- 
  Form unterleibe klar hervor -- Ring zusammengeschlung Natur üben -- 
  Brust -- Arm -- schwellen milchig -- kenn Verführerischer Weib Umfassung -- 
  Wort -- schön jung Mensch alt Statue -- 
  Bauch flach halten -- verhauen -- 
  Weise -- 
  sinnen jung Held -- Kampf Verstand abmachen -- 
  Zug Denken Auge -- wodurch Knochen scharf hervorkommen -- linke -- Heroische sitzen kräftig Stirn -- gefaßt Blick -- Lippe -- Gefühl bewußt Stärke öffnen hervorblüht -- 
  Zeichen -- 
  Sohn Maja vorstellen -- Gesandtschaft überdenken -- 
  himmlisch Bild -- erregen Art entzückend Gefühl -- Schönheit leichtesn sicherst neu Kunst überzutragen -- Poussin kopieren -- 
  Jüngling meister Menschheit grenzen -- hingegen Apollo Gott -- herrschen Erhabenheit -- Kopfe -- niederblitzen -- göttlich Schönheit nachlässig sanftgewundenen Haar schlank behend Schenkel Bein -- geistig Blüte -- irdisch Fülle -- 
  Stand Blick -- Lippe voll Verachtung geben Hoheit erkennen -- 
  Auge selig -- aufzutun schließen -- weit Bogen -- 
  kurz Schlank zart geformt Oberleib lang Bein besonderer Art Wesen -- übermenschlich -- 
  erstaunlich Werk Erfindung Phantasie -- 
  Problem auflösen -- 
  stehen Gott -- Unsichtbarkeit herholen -- weich Marmor festgehalt Melancholischen -- Leben Blick schmachteen -- 
  hoch Verstand hoch Klugheit Zornfeuer Übermacht verächtlich -- zwecken Bildung -- 
  Apollo -- -- lassen Nachahm übertragen -- 
  Altertum antasten -- Kopie -- Werk Kaiser Zeit halten -- Marmor Karrarischer scheinen -- Plinius entdecken -- Parischer -- woraus Grieche meister Bildsäul verfertign -- 
  beweisen -- 
  ausgemachen -- fehlen -- 
  barische -- sichr neuerer Probe lassen -- Marmor Apollo Korn unterscheiden -- 
  ferner zart Karrarische -- Barischen übereinkommen -- 
  übergroß Marmorkenner -- Stück sagen -- woher -- Stein Klima finden -- 
  Apollo gelblich Alter Laokoon -- anderer griechisch Bildsäul -- Witterung aussetzen -- 
  augenscheinlich bestimmt Platz -- Bild tun Wirkung -- linker Seite gehörig Standpunkt betrachten -- stehen Seiltänzer -- gespannt -- Kopf sitzen offenbar Schulter -- Mitte -- 
  Richtung zurecht drehen -- 
  abscheulich -- 
  linker Seite betrachten -- wohin schauen -- 
  homerisch Apollogang -- sehen fortschreiten -- sehen Gesicht -- Kopf Mitte -- 
  wahr Gott Lichts -- Muse -- 
  nähern -- Flecken leiden -- müssen Haarscharf gescheit -- vernünftig aufführen -- 
  erhaben Menschheit -- 
  fassen Schönheit genießen -- hernach herumdrehen -- -- bleiben erstaunlich Werk Vollkommenheit -- 
  lauter Ideal -- destowenig Kopf Natur -- sehen -- Ausdruck verstärken -- 
  außerordentlich Jüngling gewiß Stoff -- Künstler bringen hoch äußerste lebendig Einheit hinein -- 
  stolz Erdensöhne bewunderten schier angebetet Bild Verdruß Widerwille betrachten -- behaupten -- Gefühl empören allezeit -- Gesicht griechisch denken -- 
  Kopf Perikl -- Alexander bloß Porträt göttlicher Art Erhabenheit -- Apollo eher hag ärgerlich -- wottreen Römisch Kaiserprinze -- Neronisch -- natürlich Kraft beruhen -- anderer Beweis -- Marmor -- 
  verschied Meinung Mensch -- 
  Atheist predigen -- mißvergnüg Strafe -- Neid anderer Freude -- 
  gewiß -- Bild verlieren -- vollkommen ausmachen -- wissen -- worüber Gott zürnt -- 
  Gruppe Niobe gehören -- erhoben Arbeit Person Seite Schwester Diana Pfeil abdrücken -- 
  Unzufrieden desto mitleiden unglücklich reizend Familie -- 
  eher wahrscheinlich -- Meister Apollo Leontinischen Pythagoras vorschwebt -- Pythische Drache erlegen -- 
  Zweifel Homerische -- Gipfel Olymp herunter -- Urbild -- 
  Heiligtümer -- 
  eigentlich kernleb Kunst dauern Perikle Tod Alexander -- übrig Nachahmung Treib- Gewächshäuser -- 
  bedenken -- Grieche binnen kurz tun -- tot -- welcher Menge Statue gemäld Gedicht Volk -- 
  welch Menge Held -- Philosoph Redner -- heiterst Gegend Welt Regierung -- 
  Lysipp Bildsäul verfertigen -- neu Bildhauer -- zeigen Mann hoch Schöpfungskraft -- 
  Künstler geläutert Gefühl -- bloß Brot eitl Ehre trachten -- -- befinden Zustande immerwährend Verzweiflung -- sehen Vollkommenheit -- erkennen deutlich Unmöglichkeit -- erreichen -- 
  Wermut Herzen mildern allgemeinst Lob -- 
  tun -- Bildche einzeln schön Natur wegzufangen -- 
  bleiben fremde -- bloß Porträt -- unverständlich -- Saft Kraft genießen -- viel_weniger -- Knie -- Unterleib -- Brust alte wegstiehlen -- gleichsam etlicher Phrase Demosthenes Cicero Sprache sprechen Redner -- Vollkommenheit Nackend Mensch -- hoch Vorwurf Kunst -- mannigfaltig Form Bewegung unser Sinn Jugend Wirklichkeit verhüllen -- zeigen Welt -- 
  Laß frei reden -- 
  Kunst dauern -- Gymnas dauern -- Tanz Spartanischer -- Chiischer Jungfrauen -- Ring Mann -- öffentlich Sitt -- Priesterinne Liebesgöttin Athen Korinth Religion feiern -- 
  Venedig letzter Schatten -- Künstler Menge frisch neu Modell -- Auge Phantasie Zeuxis Girgent weiden -- 
  Maler solch weiblich Fleisch Tizian Paul Verona hervorbringen -- Malernestor leben Grenze hundert -- göttlich Raphael Kosten jung Leben einbüßen müssen -- 
  gotisch Moral gotisch Kunst finden -- 
  sokrat Schule hell Straße reizend Buhlerin ziehen -- Schönheit Augenschein nehmen -- -- 
  klar -- Welt Welt -- häßlich Lebensart erwählen -- 
  reden bitter Kunst -- Demetri Laune -- Wirkung -- 
  schulgerecht Antiquar sprechen berauscht Venus Praxiteles Liebesgott -- Abscheu Phryne Bathylle -- Tor -- wissen -- -- 
  freilich geringst Untersuchung geheuchelen konventionell Geschwätz Vorschein -- innerer geheim Denkungsart -- Drachen Taube paaren -- 
  heilig Katharina spazieren Wirbel Fuß nackend losgebunden Haar Maler herum -- Lucrezia lassen reinst Beleuchtung Pinsel Palettenmann beliebig Stellung legen -- Künstler fest Gletschereis -- Blick Sommersonn schmelzen -- 
  ehrwürdig Herr Menschenverstand Verdacht Einfalt -- Seite züchtig Koer stellen -- bekleidet Venus vorzog kauft -- Wahl nackt Gnidische -- Tröpfe verlachen -- 
  hiermit sehen Nackend -- einzeln geliebter Mensch frech -- unregsam Albernheit -- stark Einbildungskraft veredeln -- frei gebildet Natur alte -- wozu edel weise wohlgebildest Volk alt Ringplätz unaufhörlich neu Abwechslung Modell abgaben -- 
  wunderbar Umlauf Ding irgendwo unser unmündig kindisch Wesen reifen Menschheit gelangen -- Gymnas Grieche -- Spiel Sitte aufkommen -- 
  ehemalig Kunst verlieren bleiben -- 
  dennoch Religion -- fruchtbar Mutter schön Gestalt -- 
  Bekleidung alte -- 
  wirklichen sehen meistens bloß Schneider -- Art Mensch handeln bewegen -- Form Gewächses -- Schönheit erliegen versinken Falte wülste -- Gegenteil Steif gepreßen schnüren eckig häßlich Lappe Zweck behangen -- 
  Lage Unterkleide -- Wurf Mäntel Tog Bildsäul alte nachahmen -- Form Glied -- fehlen Natur -- 
  suchen Amphibia erfunden malerisch Tracht helfen -- 
  bleiben fast bloß Ziererei -- Reiz Wirkung -- Natur Wahrheit verlangen -- Täuschung zuwider -- 
  obendrein Künstler übler dran -- Gang alte einschlagen -- Philosoph -- Redner -- Dichter -- unermeßlich Reich Natur Sprache Mensch -- Gesetz Gewohnheit hemmen minder -- 
  Vollkommenheit Phidias -- Polyklet -- Praxiteles -- Lysipp -- Zeuxis Apelles erreichen -- 
  nackt Mensch Geschichte -- heutig Fabel -- Religion vorstellen -- wahrscheinlich -- erkünsteln bloß erlernt fremd Kram -- 
  hoch allgemein -- ewig einerlei idealisch Gestalt Mann weib alt Zweck Charakter -- 
  nehmen unser Heiland Hauptvorwurf Auszierung Tempel -- 
  menschlich Körper Gott Christ schaffen -- 
  Schönheit Apollo -- Merkur -- griechisch himmlisch Jüngling wirklich Erdensohn -- technisch reden -- außerordentlich jung Jude anbild -- weis Widerspruch geraten -- 
  griechisch Gottheit Ideal besonderer Klasse menschlich Vollkommenheit -- 
  Bild lediglich Werk übernatürlich Ausdruck Gesicht -- Art übrig Schönheit finden -- 
  Künstler leiden -- an Kreuz Herunternehmen richtig ordentlich Leib -- eigentlich Kunst Feld -- hoch Form Natur schöpfen -- 
  gewiß Teil Bestimmung denken -- Mensch umsonst -- wirken -- langsam Reiz alt Künstler bilden -- 
  Gestalt vollkommen frei -- Werk Klasse -- 
  griechisch Fabel Geschichte übergehen -- Vorstellung hernehmen -- 
  erhalten meistens verwirrt Nachklang -- wahres Echo Sinn -- einzeln Silbe wiederholen -- 
  Frech Eitel -- einbild -- gut Apollo vatikanisch -- gut Herkules Torso Farnesischen -- schönern Juno -- Venus erkünsteln -- alte -- 
  Ekelhaft -- einzeln Form ewig kopieren -- angewiesen Platz schänden -- stehen fast allemal hoch strahlend Purpurlappe lächerlich ärgerlich erfahren Harlekinsgewande -- 
  tun weh -- Armut Dürftigkeit einschränken -- 
  bauen gleichsam bildend Künst -- Konstantin mittlerer Zeit -- setzen zertrümmert Tempel Palast zurückgewichenen Erdengötter Säule Ordnung -- fahren neu Mauerwerk kindisch -- verzerren unförmlich -- klar dunkel Idee -- -- -- Schweiß Affenfreude unser Angesicht -- 
  Rom -- Dezember -- 
  Nacht schön Beruhigung Geschäft -- Phantasie freist Flug tun -- Mensch meisten genießen -- 
  ra Villa Medicis Zimmer -- 
  Rom schlafen -- blau unermeßlich Äther schweben Henn Küchlein -- blinkend hell Gestirn erleuchten selig gegender -- 
  still -- plätschern angenehm Springbrunn -- heilig Symbol ewig Leben Natur -- 
  Einbildung überschau alt Campus Martius lieblich Dunkelheit -- fangen Herz stark schlagen -- Feuer rinnen Ader -- 
  balgen Römisch Jugend grün rasen herum Schatten hoch Platanuss -- treiben kriegerisch Spiel -- schwimm schnell tiefwirbelnd Tyberstrom -- Ufer hieben drüben schön Gesträuch bewachsen -- nah Ferne lagern Hügel Mont Mario Pietro Montorio majestätischer Kreis -- edl Gefühl erhebend Schauer Geist Brutusse -- Kamille Scipionen gegenwärtig erkennen -- 
  steigen Sonnenobelisk empor -- prächtig Theater Pompejus Balbus -- traulich Halle -- rund hoch Mausolee -- feierlich Tempel -- 
  Vater volks kühl Hain -- pfleg Rat Erdbod -- 
  prang schön Garten -- 
  schönen -- 
  unaufhörlich Vergnügen Rom -- finden neu -- Gewalt Herrlichkeit alt Volk zeugen -- entzücken erschüttern -- 
  wahr Tiefe Menschheit -- Stadt anpflanzen -- 
  reiz rühren Kapitol ungeheuer Ruine -- Pinie -- Lorbeer -- Zypresse -- beständig grün Eiche ausschmücken -- 
  Vormittag ziehen herum -- Ursprung heroisch Republik -- gelangen Rostri Tempel Romulus Monte Palatino -- Winkel -- Quelle Juturna -- Kristall hell Anfang Cloaca maxima aufsprudelt -- Dahinein ferner Ungebraucht ergießen -- 
  schöpft hohl Hand -- trank erquicken -- müde -- rinne sehen -- 
  heilig Plätzchen -- rundum verbaut eingemauern -- 
  Wand überall breitblätterig Efeu überzogen klein Gesträuch bewachsen -- 
  kennen stolz Wasserleitung -- gewiß Hauptursache -- Romulus -- jung Ausflug Griechen annisten -- jetzig weit Ringmauer Quelle befinden -- 
  schwärmerisch Betrachtung verlieren Wand Hernach Farnesischen Garten Myrtenkranz allerlei Blume -- holt Nachbarschaft Gefäß Milch Honig -- goß -- bekränzen -- singen wehmütig kurz Trauerlied Opfer -- Jahrtausend Genoß -- 
  Zusammenklang lauter rührend Gefühl wandeln Haus übrig Triumphpfort ehemaligen dreißig -- 
  Freudenboge -- auszieren schön Lebensszen -- empfängen -- verliebt Gedanke -- 
  Herzlicher dauerhaft Volk Held Ehre antun -- 
  Kunst bleiben sonderbares Ding -- scheinen Weg -- 
  Vortrefflichkeit Vortrefflichkeit Mensch gleich schließen -- umgekehrt -- Popanze müssen Römer Septimius Konstantin Zeit Trajan -- 
  Kontrast possierlich christlich Kaiser Bogen -- Bildhauer Wechselbälger Geschicht Meisterstück Figur Ruhme Siegers Dazien hineingeflicken -- 
  Alexander -- Homer finden Leben -- Dichter -- besingen -- 
  ferner rückwärts gewiß -- Kunst vortrefflich Mensch Höhe wachsen -- schwer -- Lebendig vollkommen bilden -- -- rühren reizen -- auslassen -- bloß mathematisch Linie Placke hinzustellen -- 
  gewinnen -- Individuelle lebendig geistig bleiben -- Mensch unterscheiden -- 
  ungleich groß Künstler anderer -- klein Mensch -- 
  Jupiter Minerva Phidias wahrscheinlich erhaben Bild -- nachher natürlich Fleisch lebendig Materie -- 
  Kömmt -- unterscheidend wesentlich Zug Ding bestimmen fassen -- Empfind Denker darstellen -- 
  Hauptvergnüg Kunstwerk weisen Beobachter Herz Geist Künstler -- vorgestellt Sache -- 
  Nachmittag Rotunda -- Mann Schlüssel bestellen lassen -- hinauf steigen -- 
  einzig Werk alt Architektur -- Rom -- vollkommenste Verhältnis -- prächtig Säule Erdbod -- Paulskirche erscheinen Flickwerk -- 
  Vorhalle treten -- 
  -- schön Plätzche Wald laut hoch herrlich Stämm kommen -- Gott pflanzen -- 
  breit mächtig innere umfassen bedeckt -- lauter Majestät -- feierlich stehen unten Säule umher -- dämmernd Raum -- allerheilig Gottheit -- 
  Ruhe -- 
  stören -- Rundung Liebesarmen empfängen -- leise Schatten umgiben -- Gebäude merken -- 
  Heiterkeit Freiheit -- unten Schönheit -- 
  überall Tempel schön harmonisch -- hinwend -- -- überall schön Welt Kreis Sonne Mond Stern -- 
  scheinen lebendig -- Kuppel bewegen -- rein süß Licht Himmel weit Öffnung Zeitlang weiden -- 
  still hinsetz Gefühl überlassen -- entzücken -- Brunnquell kühl Baum heißen -- 
  erhabenste Gebäude -- kennen -- Schöpfung bloß Nachahmung -- 
  Schönheit voll Majestät scheinen Barbar Verwüstung zurückgeschreckt -- 
  freilich -- plündern -- Mauer niederzureiß Schutt stürzen -- weggerauben -- 
  stehen Minerva Gold Elfenbein Hand Phidias -- berühmt Venus -- halb Perle Ohrgehenke -- Hälfte Kleopatra trank -- Antonius verschwenden übertreffen -- halb Million Scudi schätzen -- 
  Konstantin schleppen Bild wahrscheinlich schön Statue Syrakus -- Silberplatt samt Bronz- Schmelzwerk herausschlagen lassen -- womit Gewölbe verziern -- 
  ursprünglich Kapital Erz Plinius innerer Säule hernach abnehmen -- weiß Marmor ergänzen -- Giallo antico Schaft lieblich lassen -- 
  Base Gesim -- letzterer Streife Porphyr -- 
  erhalten äußerer Granit -- kolossalisch Säule gehören schön korinthisch Ordnung -- übrig -- freistehend Säule Campo Vaccino Bogen Titus Muster hierin neu Baukunst -- 
  Gebäude Säule -- fehlen gewiß edelst -- stark schön Form -- 
  korinthisch -- Blatt rein arbeiten -- meister Leben groß Reiz -- fugten -- Rinde nachahmen -- erhöhen Natur Leichtigkeit -- 
  Nebst Überbleibsel Griechenland -- -- 
  Plan zirkelrund -- Durchmesser enthalten Dicke Mauer hundert fünfzig Palm -- Umfang hundert achtzig -- 
  Mauer betragen fünfzig Palm -- 
  Höhe Breite Boden -- 
  Bogen innen außen Proportion viereckig Tür Maße -- Bogen -- Hauptaltar -- groß -- wodurch Eingang unmerklich erscheinen -- 
  antike tragen Zweifel Karyatide -- wovon Plinius sprechen -- platt Säule Vorsprung Gesim -- worauf Kuppel ruhen -- 
  glauben Arbeit -- Veränderung Antonin Kaiser Pertinax geschehen -- 
  paradiesisch Zauber Auge Himmel -- 
  ehemalig jung blühend Gesicht reizend Schmuck gewissermaßen Matrone Trauerschleier -- dauern erhaben Form halten Mode Sitte Zeit -- wahr Schönheit -- 
  klar augenscheinlich -- Rotunda anfangs Bäder Agrippa ausmachen -- gleichsam strahlend Stirn -- Ruine angemaueren -- erstrecken -- 
  prächtig Vorhalle hernach hinzufügen -- innerer ausgeschmücken -- Tempel gehören alsdann Jupiter Maximus Kapitol -- Frieden Wundergebäude Rom -- 
  Agrippa Triumphwag Giebel Portikus stellen -- Erz arbeiten -- Löwen Granit Seite -- porphyrin Urne Asche -- unten Halle stehen -- 
  schenken Bäd Garten Volke Einkünfte Unterhaltung -- 
  sogenannter Tempel Minerva Medica -- pittoreskest Ruine Porta maggiore -- Anfang Bäder -- -- Kirche heiligen Bernhard Bäder Dioklezian -- 
  Hauptform Rotunda völlig überein -- 
  überschwänglich Pracht Gott vergessen -- errichten gleichsam wachthäuser voran Beschützer -- 
  Pantheon rächerisch Jupiter -- Ceres -- Götter widmen -- 
  breit Gewölbe weit Bogen leucht Eintritt Erhabenheit Seele -- unermeßlich Peterskirch schmal eng mittlerer Schiff erregen -- eher Sarg Bogen frei schön gestirnt Himmel Gott nachahmen -- weswegen Leute verwundern -- erstaunen -- 
  Römer liebkost Sinn Gefühl Baden -- ungefähr Nase Düft -- Zunge Brühen weine -- 
  fangen heißen -- gehen alsdann Grade Wärme teils Wasser -- teils lau Luft kalten -- Wollust -- verschieden Wärme Existenz nachahmen -- heißest Herzensgetümmel hoch Leidenschaft frisch Besonnenheit -- Grad physisch Gefühl -- Seelenleben -- Geistig -- gewiß Rücksicht vorphantasieren -- weiblich Schönheit Kais -- zuverlässig Domitian -- öffentlich nackend Mann baden -- 
  ahndet Paradiese stand Unschuld -- Buch Mosis lesen -- 
  überdies Fechterspiele Ringplatz -- 
  Therme Italien entstehen Gymnas Grieche -- Leibesübungen vornehm -- Römer Baden -- 
  müssen Architekt Anlage Gebäude richten -- 
  Bäder eigentlich Hauptgenuß -- stolz Enkel Romulus Räuberbande siegen Vorfahre Welt -- Gebäude hoch Architektur -- ägyptisch Labyrinth Tempel Griechen Geschichte Menschheit kennen -- 
  -- Leben freuen angenehm -- beisammen -- 
  -- ungeachtet ungeheuer Ruine -- vorstellen -- Gattung Genuß entrückt -- 
  halb Säkulum alt Römer Römerinnen Jahrhundert erwecken können -- 
  Ekel -- lang Weile Verzweiflung heutig Elend binnen aufhenken -- 
  dachgewölb Rotunda -- starkem Blei decken -- -- -- äußerst flach halten -- steigen weit Öffnung Stufe -- rundum laufen vierzig klein Kreis -- 
  hinein schauen -- innerer -- rund hoch Turm -- 
  stehen -- umsehen -- verkleinerten Leute Straße betrachten -- Demetri gewahr -- rufen -- herauf -- -- 
  Demetri wacker Mann -- Kern Schale -- Mensch durchgearbeiten Reine bringen -- 
  herrschen Rom Geist -- anderer -- genießen hoch Glückseligkeit -- Leithammel Menge jung Leute -- 
  finden voll Lebensmut groß Fähigkeit -- genau Bekanntschaft errichten -- unbeschreiblich Vergnügen Umgang nossen -- 
  jammern -- herrlich Kraft schlecht Regierungsverfassung ungenutzt sauren -- 
  Neugriechischen wachsen -- 
  dunkel Stelle griechisch dramatisch Dichter -- Chör -- klar Licht setzen -- meisterhaft Unterricht unendlich Reiz Silbenmaße geben -- 
  Brotgeschaft alt Handschrift Menge gut Lesart aufgestoßen -- anderer Herkules aldinisch Juntischen Ausgabe ausmisten -- Silbenkrieg Herzen liegen -- 
  halten Ruhm notwendig Übel -- wobei Bildsäule Markt -- fast regen bewegen können -- 
  wirken -- frei mächtig handeln Art Natur -- 
  allererst ursprünglich Glückseligkeit -- 
  Kernmensch gebrauch Ruhm Hilfstruppe -- stoßen -- müssen -- Sphäre schreiten -- 
  Fehler kennen -- -- heillos Labyrinth Metaphysik herumkreuzt -- 
  sollst Unterredung stark Probe sehen -- obgleich Wesen -- richten müssen -- hierin bloß Vernunft Folge -- anderer Hypothese plagen -- 
  mutwillig -- sprechen -- 
  treiben vorzüglich angegeben System herum -- zuweilen verwirrt hochtrabend Ding -- auszuweichen -- vorbereiten -- sehen -- anfehen -- 
  Auserwählten reichen letzt Faden Ariadne -- -- heilig Inquisition -- bedächtig verbergen wissen -- einzig esoterisch Philosophie alt Kirche langsam Glut ausbraten -- Sicherheit scheinen zweifeln -- 
  komisch ernsthaft Behauptung meister Vergnügen -- weißen -- -- Sinn dringen -- 
  -- schauen -- sprechen -- -- gestehen -- -- 
  setzen legen Sonne -- Dach angenehm erwärmen -- sagen alt neu Architektur -- 
  Schluß -- Zweck -- Plan Masse -- auf gering Einzeln Verzierung -- rein hervorleucht -- alt neu Gebäude unterscheide -- bloß nachgeahmt Kunst leer Schönheit -- -- sond Absicht Nutzen -- 
  lassen Bramante -- Antonio San Gallo -- Michel Angelo -- Palladio -- Meister gebührend Lob völlig angedeihen -- Meinung -- alt Architekt heroischeren Palast Cäsar -- Palast Farnese -- lieblicheren glänzender Kleopatra -- Palast Cornaro Venedig erbauen -- 
  -- unser Kirche -- fügen Demetri hinzu -- worauf meister wend -- reizend Mannigfaltigkeit alte -- Tempel Jupiter -- Apollo -- Mars -- Bacchus -- Tempel Juno -- Pallas -- Diana -- Venus -- 
  Plan -- Verzierung Ausschmückung -- Gegend -- -- 
  Meister Heiligen richten -- versetzen -- Kirche weihen -- 
  Papst -- Rotunda Heiligen einweihen -- ehemals Götter weihen -- scheinen Sinn -- 
  sonderbar -- entfahren hierbei -- Grieche -- aufgeheitert Volk -- Fabeln Gottheit ernsthaft -- zuweilen abergläubisch grausam beschäftigen -- -- weise gedenken -- Anaxagora -- 
  -- grausam -- versetzen -- Vergleichung gut Zeit wenigemal -- 
  lassen Meinung -- offenbar Widerspruch -- Gewiß tief verborgen stecken -- wegarbeiten -- 
  halten ausgemachtest Ding schwer -- Haufen Hut bringen -- eingewurzelt Vorurteil sträuben -- spekulativ Satz freiste Nation -- -- 
  -- griechisch Gottheit gewissermaßen Wort Sprache -- deutlich dunkel Sinn -- wissen Ursprung -- herstammen -- Moosen Prophet ägyptisch Zeittiefe -- ehe Trismegist sterblich Buchstabe erfinden -- 
  Homer Iliade ausziern -- Edelsteine -- Gold Perle -- zuweilen laut Schmuck -- Kampf Skamand Vulkan -- -- 
  -- Religion -- dünken -- bürgerlich Gesellschaft bestimmen einführen -- Streit verschieden Verehrung Gottheit Familie verhüten -- 
  Staat Gesetzgeber ergriff Partei Ordnung -- lassen Republik Selbstköpfen natürlich Weise Freiheit -- Weltall denken -- -- Fackel Schwert Verfassung stören -- -- 
  Religion Cicero relegeren -- fleißig Lesen -- Götterdienst festgesetzen -- 
  tun -- hießen religiosi -- 
  -- Grieche mußt arg -- Richter Volk Meinung ahnden -- 
  Aristophanes Witz Götter ausgegossen -- 
  heilig Rom erschrecken Jahrtausend Mutwille -- Phantasie Zeit denken -- 
  Scherze Bewohner Olymp Griechen -- scheinen -- leiden -- Stumpf Stiel ausrotten -- Schwärmer Bildsäul zerschlagen -- Freude -- Zeitvertreib gewähren -- 
  begreifen -- Gefühl Wahrheit Falschheit bändigen lassen -- Bürger bloß Sklave -- 
  Bürgerliche Ordnung Gewalttätigkeit hemmen -- frei Gebrauch Seelenkräft -- bleiben Mensch Mensch -- Tier Herde -- verlieren eigentümlich Glückseligkeit Wetteifer -- tyrannisch Staat sehen -- Natur geistigst Gabe reichlichsen ausspendet -- Gefilde Wahrheit Schönheit Lust schreiten -- hienied hoch Gipfel ersteigen -- Meer Land überschauen -- -- 
  -- meister Streitigkeit Gott -- Laie selten wissen -- -- Philosoph meistens eingeführt Glaube -- sei_es Heide -- Jude -- Christ -- Ideal bilden -- annehmen ergründ suchen -- Natur befinden -- Menge verächtlich -- -- -- -- 
  -- Anaxagora griech Verstandwese folgend Zeit hauptsächlich Anlaß -- 
  System Lehrer Perikl Euripid sinnlich glücklich Zeitalter herrschen -- trotz Schulwidrigen Behauptung groß Scheidekünstler -- erhalten christlich Jahrhundert -- herrschen gewissermaßen Trüb Dunkel -- obgleich Quelle unbekannt -- 
  stattet Weltseele -- Materie Element durchdringen -- Gewalt -- Erde steckendst Wurm himmelhöchst Adler -- Lehre finden beisammen folgend Wort Plato -- την Ton αλλων απαντων φυσιν -- ου πιςευεις Αναξαγορᾳ -- νουν και ψυχην ειναι την διακοσμουσαν και εχουσαν -- Kratylos -- 
  -- Sokrat verwerfen System -- ahnden -- beten heilig Stillschweigen tief Forsche -- verehrt Gottheit Landesgesetze mancherlei Name -- nah bestimmen -- raten Freund -- -- 
  -- Plato -- Aristoteles -- Denker dienen -- gehen -- vermochn -- 
  sprechen Verstand erhaben Dichtung -- kühn Titan Stagira belageren regelmäßig fein Erfindung scharfsinnigsten Taktik -- Anhänger behaupten -- innerst Festung eindringen -- 
  herrlich -- Spitze Menschheit stehen -- gewiß -- -- 
  -- Plato schreiben Gestirne hoch Verstand -- 
  anfangs bedachen Sonne -- Reine -- leben -- hell Geist sähen -- unterging Nacht -- Lebendig erfrieren -- tot Klumpe erstarren müssen -- Strahl zurückblieben -- Winter Bedenklichkeit heben -- 
  schließen ferner -- Licht Feuer Wärme unser Erdboden bloß Materie gefahren Strahl göttlichen Gestirn -- -- gehemmt -- durchdringen -- Regen -- richten -- woher einzeln Lebendig Bildung -- Form -- -- aufnehmen -- absondern Rückerinnerung alt überschwänglich Wonn -- Masse Körper -- meister enthalten -- lebendigsten -- 
  Grundstoff glänzend theologisch System -- worüber Julian abtrünnig -- -- 
  Sieh Kratylos -- 
  -- halten meister alt Philosoph Feuer göttlich Natur -- -- 
  -- Dichter hoch Zeit Menschheit -- fallen -- Stufe natürlichern Metaphysik -- nehmen sinnlicher nähern -- 
  meinen -- schöpft bewegend Kraft Atem -- Luft befindlich -- nannt Zeus -- wörtlich Sinn -- wodurch leben -- Philosoph schlagen Partei -- -- 
  -- Sophokles -- 
  -- Zeus -- fassen -- dringen -- nah verwanden -- Vater -- Mutter -- Bruder -- Schwester -- -- 
  Ort -- -- Mensch Übermut -- o Zeus -- hemmen -- uralt Schlaf ergreifen -- unermüdlich Mond -- 
  unalternd Wechsel nimmst Herrscher strahlend Glanz Olymp -- Augenblick -- Zukunft -- Vergangenheit untertan -- -- 
  -- Euripide -- 
  -- Siehst unermeßlich Äther -- Erde frisch arme umfängen -- 
  Gott -- -- 
  -- Aristophanes -- Antagonist -- rufen -- 
  -- Vater Äther -- heiligst -- Lebengeber -- -- 
  -- Pindar vorher -- singen stolz lyrisch Begeisterung -- 
  -- eins Geschlecht Mensch -- 
  eins Götter -- 
  atmen Mutter -- -- 
  -- alt Meinung Volk glauben Tales Göttlich Wasser finden -- Lebendig nähren -- Same feucht -- 
  Erde bleiben Pflanzstätte -- Himmlische Wind Regen empfangen -- Tier Nahrung biern -- obgleich Mutter -- Geist Leben -- 
  halten Element -- Hesiodo Körper -- 
  -- kehren -- herkommen -- Erde entsproß -- Erde -- Himmlische lustschwebend ätherisch Zärtlichkeite -- -- 
  -- -- gestehen -- tapp Nacht Ungewißheit -- alte -- dreist Behauptung -- 
  bestimmt deutlich System hierüber Sterbliche suchen -- groß weise keins -- klar sehen -- Mensch Welt klar durchschauen -- 
  nehmen gewiß Satz -- bauen -- immerwährend Natur Verwirrung setzen -- -- 
  -- Gefühl sagen -- Getrennt -- suchen -- vereinigen -- 
  Mensch suchen Mensch bewerkstelligen -- Natur leiten Mann Weibe -- Weib Manne -- 
  finden Alsdann -- suchen mehrere Gleich -- 
  Trieb laut wirken -- glückselig Republik -- 
  Mensch frei Vollkommenheit -- finden -- 
  klar -- Tod vereinigen -- nähern -- mancherlei Durchwanderung Körper bringen -- 
  Gefühl sterben Alkeste Gatte -- minder edle -- übergeben Regulus freiwillig Schmach leiden -- 
  Grund sehen mehrere Mensch -- schier Schlag Gehalt -- verständig -- Volk klar ausgemacht Weisheit -- sicherst Gewißheit Gegenteil stärksn Vorsatz Täuschung -- -- 
  -- O leiben -- rufen Demetri lebendiger Auge froh lächelnd -- Funke schlagen -- 
  O können Licht -- Pharo anzünd nächtlich Meer -- Borea Süden Ost West verschieden Meinung stürmisch ungestüm Wog wälzen -- -- Scheues edl Roß fürchterlich Einbildung Seite herumführen -- -- 
  -- König Element -- Luft Feuer -- Streit griechisch Dichter Philosoph -- 
  Höchste Edelste -- Masse durchdringen -- Gewalt -- ketten -- Natur formen -- bewegen -- 
  Grundsatze Dichter Philosoph nachgeben -- lebendig Wesen Art Flamme -- Feuer Luft -- Bewegung Lichts Schall -- -- 
  -- wesentliche alt Religion menschlich Geschlecht Mitte groß Weltteil -- Asien Amerika -- Verehrung Sonne Feuer -- Fromme bemitleideten geistig Blindheit geschlagen -- Finsternis Gespenst herumtappen -- Licht Natur -- Himmel -- lieblich freundlich erwärmend Hell lebendig umstrahlt -- 
  Rom -- edle Weisheit Tapferkeit Senat Erdbod regieren -- bewahren jungfräulicher Hand Glut allerheiligsen -- -- 
  -- Lassen Priester Zeus Pomp Versammlung treten -- Religion Volk behaupten -- erfreulich Schwärme Phantasie -- -- 
  -- Tor -- rufen -- Welt -- halten -- 
  verschieden Urwese Natur göttlich -- jeder ewig -- Kein herkommen -- -- 
  -- rein absondern nennen Element -- vermengen -- Ordnung Schönheit -- nennen Materie -- -- 
  -- Kraft zusammenkommen -- verbind scheid -- allerlei Erscheinung hervorbringen -- menschlich Kopf Sinn Verstand erklären -- -- 
  -- äußerer Flug menschlich Einbildungskraft -- nehmen Anfang -- -- -- 
  -- Stellt Chaos -- Gott -- Mensch -- Tier -- Metall Stein gebar -- unermeßlich heiß Nebel unendlich Raume -- worin Sonn Planet zerstäuben schwimm Meer -- Erde lüften -- -- 
  -- beginnen -- 
  Feuer Lüfte -- Wasser Erde scheiden -- gleichartig Wesen gesellt ewig Natur -- 
  jung Sonn wälzen wachsen -- Sphär -- ewig blendend Gewitter lauter Blitz Wetterstrahl -- wovon unser Wolke zuweilen winzig dunkel Schatten sehen -- zusammengesammeln -- besät Himmel -- 
  gröber Masse sinken -- verschieden Grade -- Planet -- schwebend herumtanzen -- hold Licht vereinigen -- schwer Anflug gelangen -- -- 
  -- Liebe gebären -- süß Genuß Natur -- schön -- alt jung Götter -- Uranie glänzend Jungfrau -- Zaubergürtel Weltall tobendem Entzück zusammenhalten -- 
  lebendig Geschöpf erhascht Getümmel Anfang -- vermehren alt Art Chaos Element -- Anzahl -- Maß Form Zusammensetzung -- -- 
  -- Element -- füllen -- freisn ungebundenst Unermeßlich breiten -- bestehen -- leben -- Feuer -- Luft -- 
  Trismegist Orpheu geben Name Zeus -- stellen Volk Wolk Donnerwage flammicht zackig Keil voll furchtbar Majestät Regenten -- unsichtbaren gelangen -- Gestalt Sinn -- -- 
  -- erstgeboren Sohn -- Licht Feuer -- Apollo -- Sonnengott -- -- 
  -- Beherrscher Wasser -- Zeus Bruder -- Neptu -- -- 
  -- Erde -- Sammlung unzählbar anderer Element -- setzen Heer übrig Gott -- erteilt Bruder Pluto Unterwelt hoch Zepter -- -- 
  -- euer Großväter -- Pythagoras homere -- hernach kühn Erfindung angenehm lieblich erfreulich ausarbeiten -- Phidias Polyklet Siegel aufgedrücken -- 
  urkräft Natur Phantasie ordnen -- Lieblingskinder -- Mensch -- schön Tempel aufstellen -- -- 
  Verwundert -- Freund -- fahren Demetri fort -- Astronomischen Ketzereien -- Priester sagen lassen -- 
  -- Freiheit -- womit Geist anfangen -- Flügel schwingen -- fern -- Sonne Fixstern Mensch erhaben Posten behaupten -- Natur -- Erde Planet Lebendigmacherin herumrollen -- -- klein Nebelster Sonne -- heller unser Kerker einbrechen -- bande abstreifen -- ewig Dasein -- unser Eigentum -- echt Kind Gott genießen -- unaussprechlich Wonne -- sond Grausen armselig Schreckwörter Tod Zerstörung -- 
  System Preußen Kopernikus spätest Kirchenstaat annehmen -- Galilei gebären -- 
  folgend Prophezeyhung halten -- 
  -- Million Sonne -- Zahl nennen -- -- ungeheuer -- 
  Billion Planet verfinsteren -- rasend Maß Feuer verzehren -- 
  Wesen bestehen unergründlich Kleinem -- 
  unendlich klein -- Kraft Bewegung -- 
  frei Gewaltiger -- paart gleich -- vermehrt Sonn Planetensphär -- Himmel wälzen -- schweben unbegreiflich Fülle Wonne -- paart gleich -- Fuhrwerk -- gleichsam Reittier brauchen -- 
  hat_es -- Lust edleren nehmen -- Dienst reichlich versorgen -- 
  Zusammengesetzt Verschiedenem Betrachtung einfach wahr Kleinigkeit -- 
  Vogel -- Tier Fisch unermeßlich Luft -- blendenden Gewimmel Gestirne -- Meer Erde ursprünglich Reinheit -- 
  Zusammengerottet winzig Sonderlinge -- 
  Masse leben schweben ewig angestammt Wonne Glückseligkeit -- Heterogen leiden elend -- plag Erhaltung -- jämmerlich Furcht vergehen -- 
  Mitteldinger Nichtsein -- 
  Zusammengeballte Grenze verschiedener -- 
  Träum plagen -- eigentlich Natur finden -- krank Gewinsel zerrüttet Kreatur horchen -- ewig Licht Auge blitzen -- Meer Ohr rauschen -- augenblicklich streben -- Mächtige vereinigen -- 
  Tor glauben -- kommen Welt -- Sonne -- weder Mond Sterne -- Meer Land -- -- doppelt golden Hüft -- Pythagora -- 
  Philosoph nehmen -- Seele reden -- Erde -- Wasser -- Luft Feuer -- vermutlich -- vergeben -- 
  Grieche -- 
  zuck Achsel -- erhaben Mann -- desto eher Kind Spott -- 
  Demetris Wang röt lyrisch Taumel -- rufen -- 
  -- Mäßigt euren Schwung -- nachfolgen -- -- 
  -- -- adl Mensch -- Alexander gewonnen Schlacht -- fügen leise hinzu -- Freude -- angenehm -- unendlich teilch Erde -- Luft -- Wasser Feuer denken -- 
  jeder einzeln Wesen Existenz bloß gewahr -- Reiner vereinigen -- desto groß wahrscheinlich Glückseligkeit -- 
  Natur streben -- anderer verbreiten -- -- 
  Demetri -- 
  einfach gibt_es Teilche -- jeder -- denken -- gehören -- zusammengenommen besseres -- 
  Teilche -- Teilche -- einer wirken regen -- jeder Gefühl blitzen All -- 
  angehen -- -- einer mächtig -- ungeheuer unermeßlich -- Größe annehmen -- -- 
  Meer Tiefe ursprünglich Element -- woraus neu ström zusammenrollen -- Urnatur unendlich göttlich erhabene -- augenblicklich zusammengeballen Eins verschieden Kraft -- hoch Plato Stockung unsterblich Fluß Glückseligkeit -- 
  Ardinghello -- 
  -- Weltall zusammenhalten -- klar -- unbekannt Ursache -- Wirkung -- Wesen -- Element zusammenbändigen Schlafe Leben -- Existenz -- Harmonie Einheit -- 
  Körper betrachten -- bedenke -- zusammengearbeitet bilden -- wissen -- einerlei -- Menschenpaar tun -- 
  dünken augenscheinlich -- abhangen -- unbekannt Ursache Spiel -- 
  Anfang kein Mensch Kopf -- unbegreiflich -- verschieden lebendig Eins -- 
  offenbar Willkür -- vorher bestimmt Endzweck Sinn -- Forterhalt Gattung -- bleiben unerklärlich -- übersteigen fein Philosophie -- 
  Demetri -- 
  Aufhülle -- 
  erkennen bloß Zusammensetzung -- Wirkung Ursache -- 
  unser Verstand eins -- finden Gezweites -- Ding lassen Sonnenstrahl -- grob Auge blicken -- Verborgenheit -- 
  Rein -- existieren bloß ursprünglich Vortrefflichkeit -- schweben Genuß -- vermischen -- erkennen Vermischung -- 
  lieb Krieg ewig Grenze verschieden Natur -- nennen Ordnung -- Leben -- Schönheit -- Name lauten -- 
  Kind scheuen Tod Vergehen -- beständig Dauer einerlei Zusammensetzung Langeweile ewig Folter liegen Eingeschränktheit -- 
  Natur grundtrieben Spiel Auflös zubereiten -- Gefühl selig fortzuschweben -- Beruf -- erkennen -- glückselig -- 
  Pythagoras -- Welt Musik -- 
  Gewalt Konsonanz Dissonanze verflochtensn -- höchst Leben -- Trost Unglücklichen -- Dissonanz Natur liegen bleiben -- 
  hoch Granitfelse Alpen Kaukasus zermalmen Regen Himmel -- Katarakt Eisdeck Gipfel -- Jahrtausende Moment Ewigkeit -- 
  Mittelpunkt Ozean Erdkugel -- 
  Sonnen Gestirn -- einer -- 
  jeder Element hoch minder Gerade Regsamkeit Eigenschaft leben -- empfinden -- mancherlei Proportion einzeln Ding besonderer Urcharakter -- 
  Affen Licht Luft Urton -- stehen Leiter Schöpfung Homer Zenon -- freilich Alsdann anderer Gestalt -- 
  Gehirn scheinen hoch Rat Republik -- augenblicklich bewegen -- Erscheinung Gefühl Sinn aufnehmen -- sorgen -- 
  Element untersuchen -- Leben denken zuschreiben -- 
  minder fähig -- Natur leben -- denken -- empfinden -- 
  Mensch -- alt Pedanterie -- entgegengesetzen verschieden Hälft teilen -- hernach Tier klein Mück -- 
  Gewohnheit zwingen eisern tyrannisch Herrschaft -- freiwähnend philosophisch Häupt -- träumen -- 
  Ardinghello -- 
  Hieb fallen Baum -- Zeder -- Jahrhundert -- bekannt Zeitalter stehen -- grünend Gipfel Sturm trotzen -- 
  Mensch schwerlich glauben -- gute Sonne -- Planet erleuchten -- stolz -- 
  -- Körper gewiß Ordnung -- Wohnung -- Gasthof Element -- augenblicklich reisen -- Moment aufhieln -- lebendig -- vollkommen Bequemer nachfolgenden machen -- 
  Demetri -- 
  Dümmst auffallen -- Woche and Fleisch Blut -- Magen paarmal Ersatz erinnern -- stündlich sterben auferstehen -- -- Wetter -- sehen einatmet -- 
  bekannt Zeitalter -- Aristoteles lesen -- 
  Ardinghello -- 
  metaphysisch Schrift durchgeblätteren -- teils -- weitläufig -- anfangs Fleiß dunkel rätselhaft schreiben scheinen -- teils -- halten -- Xenophon Eingange Denkwürdigkeit Sokrat melden -- nämlich -- metaphysiker sein vorkommen -- Rasende -- berühmtesten schnurstracks entgegenstehend Meinung behaupten -- 
  Wissenschaft nützen -- verwundern -- offenbar -- Verstand gewisses erfinden -- 
  menschlich Ding machen schaffen -- 
  Demetri -- 
  Sokrat Gold -- 
  zuverlässig Luft sprechen -- hinlänglich Überlegung -- 
  allgemein wissen -- besonderer -- 
  Arbeit Mut Mensch verleihen -- 
  wissen -- Jahrhundert gehören -- ehe Erkenntnis Natur gelangen -- Verstand reichen -- hoch Ziel berühren -- 
  verzweifeln -- wahre finden -- Finster herumtappen -- Augenblick -- erschrecken -- bloß -- Natur denken -- 
  Harmonie Weltall hoch -- Kopf Lebenlang Gesindel gehören -- Wetterfahne Meinung -- 
  -- -- helfen Sträube -- 
  Bestimmung -- -- -- verschieden Natur Weltall Zusammensetzung fassen -- woraus bestehen -- 
  Mensch gleichsam herumwandelnd Metaphysik -- beschäftigen -- 
  hoch Wissenschaft -- 
  -- Schein Wahrheit tragen -- Alkibiad Sokrat Platons Gastmahl erzählen -- 
  hierin -- Orakel -- hauptsächlich -- Denkwürdigkeit anführen -- -- Weisest erklären -- hierin Schuldigkeit beobachten -- 
  stehen einst frei Feld -- -- Nacht -- unbeweglich Fleck allertiefst Nachdenke versunken verlieren -- betet Sonne -- rein voll Feuersphär östlich Gipfel Strahlen Leben wehten -- 
  gering Wissenschaft Künste herrschen verschieden Meinung -- -- hoch meister herrschen -- steil Gipfel -- äußerst Atem Brust -- Stärke Knochen -- ausdauernd Mut Verstand Gefahr -- halsbrechend Pfad lauern -- 
  Nutzen -- Maul Magens -- 
  Erkenntnis Wahrheit glückselig -- 
  hoch Glückseligkeit -- 
  Gehören Vergnügen -- Freude Nutzen -- 
  freilich Weg -- 
  wissen -- Ätna liegen -- ehe hinauf -- 
  Reise Scylla Charybdi kürzeste -- Pferd -- 
  -- ungefähr -- -- ehe System Philosoph vollkommen verstehen -- ferner Seite vollkommen begreifen -- kennen -- ehe Verhältnis einsiehen -- 
  System Aristoteles liegen -- -- Chaos -- binnen tausend gut Architekt zeigen -- 
  tragen philosophisch Reichtum glücklich Zeit -- brüten Gott -- 
  physisch metaphysisch Werk langwierig Studium -- lassen Gespräch Auszug -- 
  müßen lesen -- Lust -- sehen -- Natur herumarbeiten -- klein Bestandteil zergliedert -- Tiefsinn Mensch bewundern sollten -- 
  Rhapsodien -- Laun Einfall -- 
  stellen Universum Laute -- worauf augenblicklich Lust Liebe vorphantasieren -- 
  O reizender Lockender -- 
  schön Gegenstand Poesie Einsamkeit -- 
  O glücklich -- überläufen zuweilen menschlich Schauder -- bedenken -- -- ferner -- 
  -- folgend -- folgend Stunde -- anfangen -- 
  genieß Moment Spanne gegenwärtig leben -- ergeb Kleinigkeit Umwälzung ungeheuer Masse -- 
  Demetri ferner -- Inhalt -- Wort -- fassen -- 
  bleiben Meinung Sokrat -- gut Metaphysik schön Gebäude -- bloß Luft schweben -- beschäftigen müssen -- wissen lassen -- Vergnügen Rücksicht ungestört nachzuhängen -- 
  -- Sinn zeigen -- beginnen -- -- 
  Verstand Wurzel Sinn -- 
  Sinn Verstand Erkenntnis -- finden -- 
  jugendlich Gespräch -- Streiferei Metaphysik damalig -- Aristoteles Throne sitzen -- Zusammenhange auslassen -- 
  -- paar Jahrhundert hoch stehen -- 
  Barbar Pommern -- Themse tiefsinnigst Grieche vergeblich Kopfbrechen ersparen -- 
  kehren -- wunderbar Sicherheit -- Wirklich -- Grund denken handeln -- 
  -- Sonne -- Mond Stern unermeßlich Äther -- Luft Meer Land voll unzählbar lebendig Ding -- 
  Menge Verschiedenheite entdecken Auge -- reichst -- flachst Sinn -- -- tief dringen einfacheren -- Gefühl -- 
  Tier -- Sinn bestehen -- 
  Sinn erkennen -- 
  Warm -- Kalt -- Feucht -- Trocken -- 
  -- 
  übrige fallen Eins -- bestehen unendlich Mannigfaltigkeit Weltall -- 
  mächtig ergreifend Sinn Oberfläche gewahr -- tief Natur Ding eindringen -- -- 
  hören Sinn -- -- schweben Genuß wissentlich Unterscheidung -- 
  Warm trocken Feuer -- 
  Warm feucht Luft -- 
  Kalt trocken Erde -- 
  Kalt feucht Wasser -- 
  Flamm Eis fangen Stockung Zerstörung -- Zeugung -- 
  Feuer Luft verwandeln -- brauchen Feuchtigkeit annehmen -- Wasser Erde -- Trockenheit -- 
  Wasser Luft Wärme -- Luft Wasser Kälte -- 
  Feuer verwandeln Erde Kälte -- Erde Feuer Wärme -- 
  Übergang Natur -- Zeuge -- 
  Feuer Wasser -- Wasser Feuer -- Luft Erde -- Erde Luft -- 
  doppelt Damm stürmen -- Schleichweg finden -- 
  Feuer Luft Erde -- bleiben Übergang -- 
  sonderbaren Erscheinung -- verändern ewig Welt -- begatten -- bringen Geschöpf hervor -- Blume Frucht -- 
  Element -- gemein Menschenverstand Zeit anerkennen -- Grundverschiedenheiten Gefühl -- übrig Sinn -- verschieden abarte -- beruhen -- 
  Luft verschieden können -- Erde erkennen -- leugnen -- Wasser -- Feuer -- Element untersuchen -- wissen Erde -- 
  -- Übergang Element finden -- 
  -- such Vervielfältigung Element -- Philosoph geben -- behaupten -- Weltall -- Name Natur nennen -- Eins -- Evidenz leugnen -- Verstand Mutterwesen weiden -- bloß rein Stoff -- -- kennen -- Punkt -- Mensch schier undenkbar -- -- -- bedeuten -- 
  alt Art bleiben Element -- 
  Heraklit meinen -- Feuer gemeinschaftlich Quell Ding -- Tales Wasser -- heiter Ionie -- Grieche -- sonderbarlich -- Früheste echt philosophisch Kopf anerkennen -- Stammvater eigentlich Weisheit Sprichwort Zeit -- 
  organisch Wasser -- Beispiel Mensch -- ersaufen einfach Wasser -- organisch Feuer verbrenn Feuer -- Lust verlieren -- -- 
  Feuer -- Luft -- Erde Wasser -- Wasser Erde -- Luft Feuer -- Eins -- 
  Feuer heiß kalt -- Wasser naß trocken -- 
  suchen Folge Widerspruch Ausdrucke vermeiden -- setzen Element -- eins -- Eins -- 
  Aristoteles Xenophanes -- Wesen eigentlich Reinheit -- bestimmt -- erhaben Stirn unermeßlich Äther schauen -- -- 
  eins Gott -- 
  Parmenid -- Schüler -- brüten -- suchen beweisen -- Wesen Vernunft notwendig Eins können -- Sinnen müssen Ursache -- Kalt -- Warm annehmen -- 
  Kalt Unwesen -- Warm Wesen -- 
  setzen Dicke Dünne -- nämlich Wesen dehnen -- ziehen -- Zeuge -- Erscheinung -- 
  verdünnen -- Luft Feuer -- verdicken Erde Wasser -- Grund Eins -- 
  Ardinghello -- 
  unendlich Ausdehnung -- einzeln Bewegung -- einzögen -- 
  allergrößt Stein ausmachen -- Welt Diamant leeren Raume hängen -- 
  Demetri -- 
  -- and Gesicht annehmend -- -- 
  wissen -- geschehen -- 
  Ewigkeit -- Kurzweil allerlei Gestalt verwandeln -- 
  Philosoph geben Ursache Veränderung -- lassen Ruhe Bewegung unerörteren -- 
  beweisen -- -- dartun -- Eins -- Chemie bringen -- 
  bloß Eins -- 
  Ruhe -- Reiz Bewegung -- gleichförmig reizen -- -- 
  Element liegen Quelle Bewegung -- 
  -- Kein besonderer Vorzug -- scheinen Feuer hoch Grad Reizbarkeit -- Erde -- Luft -- Wasser -- 
  Natur regen Freiheit -- Erkenntnis Begierde -- 
  -- unvermischten annehmen -- innerlich Eigenschaft -- Wesen unendlich zart -- Verbreit verlieren -- unergründlich unser Sinn -- 
  einerlei Art beisammen -- desto groß Stärke -- Erde -- Luft -- Wasser Feuer überwältigen -- unterliegen Mensch genannt Geist Materie -- 
  Einzel geschehen -- Weltall herrschen Geist unermeßlich Schranke -- 
  Geist bringen Welt Ordnung Schönheit Natur -- fahren -- Mensch Gewalt Erdbod -- 
  Bewegung Wirksamkeit Kraft Gegenstand -- 
  Kraft Gegenstand -- Bewegung -- 
  doppelt Kraft wirken -- 
  lieb Krieg -- Neueswerden -- Abprallung -- 
  Gedanke Anfang Ziel Bewegung -- Anfang -- Bewegung Handlung -- 
  Natur Vermögen -- denken empfinden -- Selbstgefühl Grund Boden -- -- -- Kraft -- wodurch -- -- 
  folglich System Anaxagora gut Grund Natur -- 
  Verstand Welt bilden -- Art -- Verstand prüfend unterscheidend Fassung -- Verstand -- Zusammensetzung -- Meer -- wohin Empfindung laufen -- begegnen -- läutern -- bestehen empfindend Kraft -- 
  eigentlich Kern jeder einzeln Lebendig -- jeder -- schlechterding Empfindung beginnen -- gleichartig Wesen paaren -- Hernach zusammenschaffen bilden müssen -- 
  Verstand ursprünglich Empfindung -- 
  Schöpfer Individuell -- 
  Trieb Lebendig Vergnügen -- vereinzeln -- 
  -- Erkenntnis groß Kraft -- erheben vereinzelt Natur Wurm erhaben -- frei -- vielfassend verbindend klar Mensch -- Sprache Kunst erfinden -- 
  ungeheur -- unglücklich -- Welt erkennen -- -- Tobt dunkel Gefühl -- -- -- 
  Ardinghello -- 
  Erstaune eur kühn Behauptung -- viel nachdenken kosten -- Wahrheit Falschheit finden -- 
  Feuer Luft verwandeln -- bleiben Feuer -- ferner -- gewiß Materie -- Licht -- -- Ton -- 
  geben -- Wort hierbei brauchen -- denken Verstand -- Ursache Bewegung -- wirken leiden -- Gebäude zusammenfällen -- 
  Demetri -- 
  Feuer Luft verwandeln -- 
  entstehen neu Luft Feuer -- 
  verschieden Element -- rein harmonisch verschmelzen -- gesundem Zustande fein Bewußtsein unterscheiden -- 
  Art Element regen bewegen -- 
  Leichnam ewig Mumie -- Wind Osten wehen -- 
  Verstand betreffen -- 
  nehmen Aristotele -- Plato -- Anaxagoras -- Meinung freilich Begriff erklären -- Materie Verstand -- unterscheiden -- sogar Seele -- -- -- Körper befinden -- 
  Seele Auge sehen -- Seele Ohr Hören -- Gefühl fühlen -- 
  Seele Baum -- wachsen Nahrung Wurzel einsaugen -- 
  Lebendig -- 
  Kraft Ausübung Seele -- Körper -- Element Seele -- 
  Verstand Natur -- behaupten -- leiden -- 
  Auge verblenden -- Ohr betäuben -- Verstand hingegen tief denken unbefangen leichtester übergehen -- 
  -- Fürst Philosoph -- 
  Schachspiel setzen -- -- 
  besonderer Teilche -- ausdrücken -- menschlich Seele -- -- -- Ort Form nennten -- denken -- Urteil Aufnehmung -- Schaffung Form -- 
  sinnlich Kraft Seele können Körper bestehen -- Verstand absondern -- Materie -- 
  leidend vergänglich -- insofern denken -- erinneren -- gleichsam Sonnenstrahl -- Ding Farbe -- 
  denken erinnern machen Wesen -- denken -- unsterblich -- 
  folglich Seele -- Verstand betrachten -- unsterblich -- insofern denken -- 
  schwach Seite System -- Vorrang Mensch Tier erklären -- hierin weichen Anaxagoras -- Verstand Lebendig zuschreiben -- 
  Verstand unsterblich -- insofern denken -- 
  Materie Weise unsterblich -- nämlich insofern Zusammensetzung denken -- Verstand Art erklären -- 
  brauchen Gott -- Knoten Drama aufzuhauen -- 
  -- Schlupfwinkel -- worin -- 
  Beweis -- womit Anaxagora -- Plato -- Aristoteles Verstand dartun -- -- 
  Wesen geben -- unvermischt -- durchdringen -- Gewalt -- erkennen -- 
  für jeder Element Reinheit unvermischt -- Haufen Element Reinheit beisammen -- 
  Element ursprünglich Feinheit verschieden -- 
  -- Erfahrung -- wahrscheinlich Feuer -- Lichtelement feinsen -- 
  folglich Feuer Eigenschaften -- Verstand erheischen -- 
  Seele -- -- Begriff -- anderer durchdringen -- 
  mehrere Art Seele annehmen -- 
  Feuer durchdringen Luft -- Luft Feuer durchdringen Wasser -- Feuer -- Wasser Luft durchdringen Erde -- bändig Wohlgefall -- bequem Grundfeste freundlich -- 
  einer -- 
  herrschen Wohltun -- Gewalt Tyrannei -- 
  wissen -- Gegensatz Feuer Erde stark -- Erde grob Feuer fein -- vollkommen wirken -- 
  -- 
  -- Exempel milder Erdstriche -- Griechenland -- Klima Schönheit -- -- 
  -- hoch Vollkommenheit Glückseligkeit -- hoch Fülle -- 
  Zusammensetzung harmonisch -- proportionieren -- jeder Element reg Kräfte -- entstehen hoch Verstand -- einer erkennen Weise reinsten vollkommensen -- 
  aristotelisch Verstand -- fein Röhr menschlich Gebäude Gehirne absonderen -- reinsten Verschiedenheite Feuer -- Luft -- Wasser Erde laut -- göttlich -- unendlich Masse Welt -- Tier rein Fülle Proportion -- Urbeginn Druck umgebend Kraft verhindern -- 
  alt Idee -- Licht kommen Auge -- Luft Ohr -- Wasser Geruch Geschmack -- Erde Gefühl -- 
  Ardinghello -- 
  geschöpf paar Paar -- Tier Mensch -- Gras Baum -- leiten Aristoteles -- 
  Demetri -- 
  Verstand Zusammensetzung Wissenschaft Kunst verschieden Erfahrung Sinn bilden -- Empfindung -- Bewegung Sturm Aufruhr -- Iliade -- Ödipus -- 
  Anbeginn Hilfe Natur Gestalt verschieden Gattung bilden -- 
  Zeugung Untergang allezeit Element -- unzerstörbar -- zusammengesetzen -- 
  erdboden Zweifel -- Vernunft Naturgeschicht -- glücklicher Lage Entstehung Geschöpfe schweben -- -- 
  wissen -- edelst Aufhörung untergegangen -- 
  Geschöpf Natur Land -- wahrscheinlich entstehen -- 
  Aristoteles brauchen gewöhnlich Gleichnis -- 
  Mensch Sonne erzeugen Mensch -- erklären deutlich hierüber Lehre Gott Zeugung -- 
  sehen -- Sonne Ursache Frühling Begattung -- 
  Anfang geschöpf Hilfe -- 
  jeder Geschöpf wachsen Element hervor -- Sonne lösen Wärme Kraft -- frei wirken -- 
  Entstehung Einzel alt weise sonderbarsen Meinung behaupten -- 
  nehmen jeder Geschöpf verschied Element -- jeder Geschöpf -- jeder Glied -- 
  verschieden Element Mensch -- Kopf Hand Fuß abteilen -- zerstreuen Natur liegen -- 
  Weiber sammeln Begattung -- Alsdann vereinigten -- 
  freilich leichtest Art Rätsel auflösen -- 
  Schwierigkeit heben -- 
  -- Weib vollkommen Teil sammeln -- bloß Kopfteil -- Herzteil -- Arm Beinteil -- 
  genau Proportion -- 
  halten Teil Speise -- wovon nähren -- 
  Herz Alexander Tauben Hasen -- Brokkoli Blumenkohl -- Fleisch Gemüse -- wovon Olympia Mahlzeit halten -- 
  Kopf Homer Huhn Gänse -- Fisch Ionischen Meer -- 
  Offenbar Albernheit -- 
  glauben -- Same jeder Individuum Ewigkeit Weltall -- folglich gewiß Anzahl Menschenkern -- Löw Adlerkern -- wiedergeh -- jedesmal vorhanden Materie kleiden -- 
  -- Alkibiad Athen -- andermal Rom -- Konstantinopel -- Lappland -- Peru -- 
  gehören Glück Unglück -- Wind dorthin führen -- Königin Magd auffangen gebären -- Individualität ändern jedesmal Umstand -- 
  Meinung Schwierigkeit -- 
  Same setzen -- erhalten Zusammensetzung unaufhörlich Zermalmung -- einzeln Natur sehen -- 
  finden überall -- Same -- -- 
  Gegenteil wahrscheinlich -- -- -- Erdkugel Mensch -- Mensch -- unzählbar Schar Volk -- Ort -- Planet versetzen -- -- sagen -- übrig bleiben -- Alsdann erkennen -- -- samt Tier -- Pflanze Baum rund Klumpe Kirchhof -- Lebendig tote aßen -- 
  ist_es augenscheinlich -- neu gesund Paar Früchte Hufen Lande Zone bevölkern -- 
  -- jeder Einzeln zusammengesetzt Form -- -- Art Wesen -- 
  Form entstehen innerer Proportion verschieden Wesen Hilfe äußerer Ding -- 
  Ardinghello -- 
  Erdkugel möglich Weise ungeheur Schar Eseln -- Maulwürfen -- unendlich Mückenschwarm -- unzählbar Volk Mensch -- Mann weib Anlaß Mann Weiber -- wozu Element bilden -- 
  Mensch gewiß Proportion verschieden Element -- 
  Knabe dreißig Pfund bestehen ungefähr sechzehn Pfund Erde Salz -- dreizehn Pfund Wasser -- Pfunde Lüften Feuer -- einzig Unterschied Kälbcher -- halb Pfund Lüfte Feuer Bestandteilen -- 
  verändert Form -- Sokrat Platon Kälbern -- Kälber Platon Sokrates -- 
  Schluß -- -- Geschöpfe Gegenstand Form empfinden beurteilen -- vielerlei Wahrheit Ding -- verschieden Gattung Tier -- 
  jeder handeln dächt Form -- Begierd -- geben allgemein Wahrheit -- Welt Tollhaus -- 
  Fabel -- Medea Greis Stück zerhacken jung -- gehörig Grad Wärme treffen -- wodurch harmonisch zusammenzögen -- 
  Demetri -- 
  -- Freund -- gehörig Grad Wärme treffen -- hinzubrächt Augenblick -- gehörig Wesentliche abdünstet -- Mutterleibe geschehen -- vorig Lebenszeit abdünsten -- 
  zusammengesetzt Form -- Wesen erkennen -- Urbeginn -- Wahrheit -- 
  Sinn fassen einseitig -- Verstand -- reinste vollständigsn -- 
  Tier verschieden -- Mensch -- -- vollkommen geläutert minder vollkommen -- besitzen -- 
  gegeben Proportion Zusammensetzung -- 
  Ardinghello -- 
  Gattung Tier Pflanze -- Paar Paar Grashälmchen Mensch -- 
  Männche Weibche -- erklären -- 
  Verstand Element Mann Weib -- 
  -- komisch Einfall Aristophanes Plato -- Mann Weib Gattung wachsen -- bilden -- bleibt_es unerklärlich -- Geschöpf verschieden -- paarweise formen -- 
  Demetri -- 
  gewiß leicht Ding schreiben -- Gespräch führen -- 
  lassen Frage -- weise hierüber Antwort bloß Vernunft finden -- 
  -- einst Platonisch Sokrat -- Löwenhaut umgeworfen -- aushalten -- 
  -- sagen -- fahren lächelnd fort -- folgender -- 
  Mensche Eselelement -- Nasen- Lippe lefzenelemente annehmen Ursache finden -- 
  finden eher notwendig -- männlich weiblich Element Natur annehmen -- 
  Mann vollkommenst -- männlich Element zusammengesetzt -- weib vollkommen -- weiblich Element -- Weib bleiben -- Mann schlecht -- männlich Element -- Mann heißen -- 
  männlich weiblich Element machen begreiflichsn Natur lebendig -- erklären ewig unaufhörlich Bewegung -- wütenden Trieb Begattung -- Aristotele Bestimmung jeder einzeln Ding halten -- -- 
  Liebe -- Hochzeit -- Ehe Ehescheidung -- bestehen Welt -- 
  ferner Rätsel auflösen -- -- wissen -- berühren -- Geschlecht -- fast Tier -- ungefähr gebären -- 
  fallen -- annehmen -- Paar gehören -- Verstand Anfang paarweise hervorbringen -- Zusammengewäch nötig -- bequem Lage Material Schaffung mächtigeren befinden -- 
  Ardinghello -- 
  echt Kretenser -- Zögling Minos -- schön Geschlecht -- 
  glauben -- Mädchen Mann unnatürlich Ding -- tapferst Amazone Phryne stehen -- 
  hierüber Hypothese treiben -- wiederholen eu Hauptstück -- 
  wirklich Abgesondert denken -- Verstand Mensch Mensch hervorbringen -- -- Verstand jeder Ding Ding hervorbringen -- Hilfe Kraft -- Raum schaffen -- Willkür verlangen bewegen -- Sache einigermaßen sinnlich vorstellen -- gewiß Vergleich schwer -- 
  nehmen -- Verstand ungeboren Kind Auge bilden -- einer für -- 
  wozu brauchen Auge -- 
  sehen -- 
  sehen -- -- durchdringt -- berühren gewiß Sonnenstrahl -- Wirkung gewahr Oberfläche -- 
  -- 
  Körper einschließen Öffnung -- 
  -- schließen Körper -- Auge sehen -- demnach Ohr hören -- Zunge schmecken -- Nase riechen -- Finger Glied fühlen -- 
  scheinen -- Herumvagieren müde -- stet Punkt -- Portion Verstand hassen -- Spinn -- verlangen abgesondert Nest -- weder unendlich unendlich klein beisammen bleiben -- bequem Anzahl ergötzlich Maß -- fein Wollüstlinge Grieche Römer Gast Tafel verlangen -- -- Materie Art Zusammensetzung genießen -- hineinstecken -- Schicksal zwingen -- Wesen -- durchdringen -- folglich binden -- ungereimt -- 
  -- -- -- 
  -- größerem Umfang -- Pygmalion -- Geliebte -- 
  euren Begriff freilich Verstand verschieden Gattung -- Element -- König -- 
  menschlich Verstand Bund verschieden Element -- jeder präsidieren Name übrig Gattung -- dringen besonderer Genuß -- 
  Verstand Kind -- fertig -- völlig ausbilden -- gescheit -- Anfang -- 
  Demetri -- 
  -- bleiben -- Stufe menschlich Alter -- Teil -- abgehen -- ersetzen -- bedienen überdies Sinn -- 
  Komposition -- Ursprung verschieden Weise berühren -- freilich Erfahrung erwerben -- 
  Verstand Stehen -- alsdann Ding Gattung gestehen -- ehe vollkommen Sinn durcherkennen -- Ideal bilden -- 
  Griechischen -- Original brauchen -- Schwimme -- 
  alte behaupten -- studieren -- bevor herrlich Mensch ausklügelen -- lassen auffallend Ähnlichkeit -- groß minder Vollkommenheit Teil Tier schließen -- 
  Pythagoreer nehmen Aristotele Grundsatz -- Speise Raub eher -- nähren -- wahrscheinlich -- ausgearbeitet Speise -- desto leicht Übergang höherem Leben -- 
  vernünftig Arzt zweifeln -- Mensch gut Kost Mensch -- 
  wissen -- Welt vollkommen -- -- 
  obgleich ewig -- Kind -- Jüngling Mann -- Jungfrau Matrone Abwechslung -- vollkommen -- Unvollkommenheit darinnen -- 
  Ardinghello -- 
  Menschenfresser eigentlich Verklärung erwarten -- tausendjährig Reich -- stark Kontrast Schule weise -- 
  Demetri -- 
  scheußlich Dünger -- verkehrt Gleichnis brauchen -- wachsen schön Blume Frucht -- 
  schätzen unser Körper -- fühlen -- Händedruck -- Kuß Umarmung schön Person ergreifen -- wohlstilisierte Ciceronianische Brief bloßem Geist -- -- kennen -- 
  Ardinghello -- 
  schweifen -- Sache -- 
  wissen -- Verstand Teil ersetzen -- Körper fest halten -- abgehen -- 
  Demetri -- 
  wissen äußerer gröber Sinn -- dringen -- 
  Ardinghello -- 
  erstaunlich Richtigkeit -- Gefühl Maß -- Goldwaage Centillionenmal übersteigen -- gehören gewiß -- Bein kurz lang Anfang -- -- Arm -- Auge Auge -- Zähne Rippe höchst genau Proportion -- vergrößern erhalten -- 
  grob Sache Insekt -- 
  Demetri -- 
  umsonst fein -- gelingen -- Alkibiad Phrynen Tierart selten -- 
  Ardinghello -- 
  Seite betrachten -- ist_es außerordentlich erhaben -- Aff nachahmen -- er_es finden -- ändern -- 
  alt Schlendrian lieb Gewohnheit versunken verlieren -- 
  Mühe -- neue erdenken -- 
  Demetri -- 
  woher wissen -- 
  -- befinden -- 
  -- Materie auf gut verarbeiten -- -- 
  Natur äußerst langsam bedächtig Fortschritt -- unendlich Jahrtausend -- Augenblick Lebensdauer Komposition -- beobachten -- Ardinghello -- 
  deuchen -- hätten -- Anfang -- 
  Höhe Bogen herunter -- 
  Freund -- Verstand Körper umändern -- ungestalten -- häßlich -- krank -- verjüngen -- 
  Wolke -- Demetri -- Wolke metaphysisch Traum -- 
  nehmen gewöhnlich Meinung -- vorhin verwarfen -- 
  glauben -- -- Mensch hervorbringen -- Ewigkeit hervorbringen -- 
  -- allezeit mächtig Wesen Stoß Bequemlichkeit voll verschaffen -- 
  aristotelischen Element möglich Zusammensetzung aristotelischen Element -- gehören gewiß -- 
  ferner Grund annehmen -- sträuben -- -- erklären -- ferner Grund annehmen -- 
  jeder Individuum Ewigkeit Form Natur -- unterscheiden -- Urform lassen weder schaffen -- zerstören -- 
  gehören hoch Wesen -- Bequemlichkeit setzen -- hoch Fülle verbreiten -- 
  unendlich viele bloß Blüte -- Frucht -- Baume gedeihen -- 
  aristotele undeutlich verstehen -- Meinung Anhing -- menschlich Seele -- Mensch -- Form enthalten -- Ewigkeit fertig Vollkommenheit -- 
  jeder lebendig Ding Form -- Keime unzerstörbar Ewigkeit -- Sonnenwärme -- Gott -- lösen Bande -- setzen frei Wirksamkeit -- genießen leiden -- Umkreis halten -- umgebend Kraft unzerstörbar Punkt zurückdrängen -- 
  Weise -- Mensch -- göttlich Verstand -- 
  gewiß -- -- Urkraft liegen -- Bildung Erziehung geben -- 
  fühlen all Wesen -- ursprünglich Laffe Tor -- 
  Ewigkeit Tor -- weder Sparta Rom Brutus Leonidas umschaffen -- 
  Theophrast neunzigst verwundern -- woher Himmelsstrich -- Erziehung Menge verschieden Charakter herkämen -- 
  annehmen -- hören Verwunderung -- verlieren Unbegreiflichkeit Dasein -- groß Geheimnis -- 
  -- -- -- 
  -- Edel herrlich -- 
  bleiben ewig -- 
  Demetri -- Erhabe -- wenn_es -- Schwierigkeit finden -- 
  Anaxagora klüg Verzweiflung -- Knoch -- Haar -- Nägel -- Klau Ewigkeit fertig Vollkommenheit halten -- Stagirit Seele Sinn kommen -- meinen -- 
  schwerlich Arabischer Hengst Dänemark gebären -- Epaminonder Großmogulschen Serail -- 
  inzwischen bezaubernd stolz Glaube persönlich Unsterblichkeit -- freilich alsdann Wurm Alexander Cäsar zuerkennen -- herrschen -- 
  Dunkelheit aristotelisch Gott -- König Element -- auflösen -- Trägheit Freiheit handeln setzen -- 
  -- Bewegung -- Weise -- -- ewig -- hervorbringen -- 
  bedürfen Regung -- selbständig -- Wirklichkeit -- bloß Möglichkeit -- Grund Leben anderer Bewegung fehlen -- 
  schlechterdings notwendig -- annehmen -- -- 
  -- Bewegung ewig denken -- kreisförmig -- kreisförmig Vernunft -- -- 
  -- bewegen -- bewegen -- begehrlich verständlich -- -- 
  -- schweben Himmel Natur -- 
  Leben gut -- kurz -- bleiben unmöglich -- 
  Wirksamkeit Wollust -- Wachen -- Empfindung -- denken erfreulichsen -- 
  Hoffnung Erinnerung stammen -- -- 
  -- denken gehören -- abgezogenster Vortrefflichst -- 
  Verstand denken Annehmung Verständlichem -- verständlich berührend denkend -- 
  Verstand Verständliche -- fassend verständliche Wesen Verstand -- 
  wirken -- -- Verstand göttlich scheinen -- Betrachtung Erfreulichste gute -- -- 
  -- Vollkommenheit -- zuweilen beschaffen -- 
  Gott verehrungswürdig -- hoch -- Verehrungswürdiger -- 
  verhalten -- -- 
  -- herrschen wahrhaftig Leben -- Wirksamkeit Verstand Leben -- Wirksamkeit -- 
  Wirksamkeit best immerwährend Leben -- 
  sagen -- Gott immerwährend best lebendig Wesen -- Gott Leben beständig immerwährend Dauer -- 
  Gott -- -- 
  -- -- gute Natur Zweck -- 
  gleichen Armee Feldherr -- bestehen Ordnung -- 
  Vogel -- Tier -- Pflanze -- schwimmen -- gewiß -- keins scheinen -- Eins -- wofür geordnet -- -- -- -- -- Natur böse -- insofern Eins -- beziehen -- 
  nehmen Anteil Gott -- -- -- 
  -- -- allgemein Bewegung -- Element Vergnügen Ordnung erhalten -- -- Natur einzeln Form -- mitteilen -- Hausvater Kind -- Sklave -- Tier -- 
  jeder glückselig Art Bestandteil -- tragen Übel Zusammensetzung -- 
  Gott ewig Genuß rein wesen -- jeder weniger Moment hoch Kraft Einheit -- 
  folgeren -- -- Götter -- selbstständig kreisförmig Bewegung -- Fixsternhimmel fassen -- insgesamt -- -- 
  -- Wesen verschieden -- 
  Art gut mächtig -- -- 
  Sonne neigen -- steigen Gewölbe Rotunda hinab -- 
  beschließen Treppe -- verstehen -- Aristoteles verstehen -- wahr erträumt gestirnt Nacht Wort liegen -- 
  Wesen -- Begierde Scheu -- Ruhe Bewegung -- Entstehen Einzeln vergebens Kopf zerbrechen -- erhabensn Mann Schwachheite vorbringen -- 
  Welt begreiflich -- verlangen -- 
  halb glücklich leben -- lang Weile Klarheit Deutlichkeit vergehen -- 
  Wunderdinge -- 
  Rätsel -- Kind -- -- denken -- beschäftigen -- 
  treten Pantheon -- 
  sehen -- still Dämmerung einsenkt -- 
  fühlen unaussprechlich Schönheit -- Maß einfach Auge -- erquicken lieblich heilig -- 
  weit hoch Schönheitsvolle Zauberkreis -- worin Erdgetümmel blauen heiter Lüfte wegverzücken -- schweben -- unermeßlich Umfang Himmel atmen -- befreien Bande -- 
  setzen süßest Punkt nossen -- 
  lang Stille umschlang Demetri zärtlich -- Wort ehemaligen Minerva Phidias -- Tochter Haupt Zeus -- Verstand Wesen -- griechisch Venus -- Lust Sinn -- Wonne Dasein -- -- fahren rühren fort -- -- Gott Natur -- Natur -- Natur bestehen ewig notwendig Bindung Lösung verschieden Wesen -- Gott -- lauter Schicksal -- 
  Gott Natur -- alt Glaube -- 
  Natur -- jung -- edelst gut Leben -- Aristoteles -- Wesen -- -- Einheit -- ausdrücken -- Immerfort bewegen -- Tätigkeit bestehen -- 
  Charakter -- binden -- wollen -- böse freiwillig täte -- zwingen -- böse geben -- 
  vermögen Charakter lösen -- minder regsam Natur binden -- -- unendlich Unruhe unendlichen -- 
  Anaxagoras führen Glaube -- Plato verschönert Dichtungen -- Aristoteles plagen -- vernünftig System bringen -- scheinen einig -- 
  Verstand dünken göttlichst -- kennen -- denken -- zufällig Eigenschaft -- reg Wirksamkeit -- selbständig Leben -- Verstande beschwerlich müssen -- 
  Verstand göttlichste -- selbstständig Wirksamkeit sollen -- 
  Könn -- dünken ferner -- -- denken -- -- dächen -- bloß zufällig Eigenschaft -- denken -- denken -- -- erniedrigen -- 
  sehen -- Gott helfen -- Art bewegen -- Geschöpfe mitteilen -- 
  Materie -- Element -- -- zusammenhäng -- Ordnung Schönheit -- 
  Natur leben wirken notwendig Art -- Einzeln hervorgehen forthilft -- wozu brauchen Gott -- welch Gräuel -- Fall -- hoch Lebendig -- Tod gattet -- 
  Lauter Lück Mangel -- System ausfüllen -- wobei vorn anfangen -- 
  Hypothesen -- Hypothesen -- -- denkbarsen vernünftigst -- -- Lust -- glauben -- -- blind Fenster bloß Ordnung Gebäude vertragen -- gut Licht hereinbrech schön Aussicht -- eher Ruhe finden -- 
  Ardinghello -- -- -- 
  Müdigkeit wird_es lehren -- 
  Demetri -- 
  ewig -- -- -- ferner Grund annehmen -- Grenze -- 
  verschieden -- binden scheiden -- 
  -- -- 
  System kein Philosoph Genüge leisten -- 
  Ruhe Bewegung -- 
  eigentlich Ursache entdecken -- Kapitalschlüssel Palaste Wahrheit innerst Kabinette finden -- 
  Bewegung Streben Genuß -- Flucht Leiden -- 
  Genuß Berührung -- 
  Ruhe -- möglich Fülle -- -- Berührung trachten -- 
  fühlen Wesen -- taumeln Zone Zone -- Himmel Weltall -- 
  nehmen einfach Substanz Leben -- Einheit Element -- denken abgesondern Welt leer Raum -- 
  vorstellen -- -- 
  Innerliches Leben -- Verstand Ausübung -- Gedächtnis -- Einbildung finden -- Teil -- regen -- -- letzter Begriff Tod -- Punkt Selbstbewußtsein stecken -- 
  gesell Substanz -- Ursprung Gefühl -- 
  nehmen Demokrit Urform -- denken Exempel vollkommen -- 
  -- bewegen -- berühren -- 
  Platt eckig -- 
  fest hängen -- Herumkönn -- 
  Eckig beisammen -- 
  Vermischt Empfindung -- Freude Leid -- 
  denken Weltall himmelunendlich Menge Substanz ewig Streben neu Genuß -- Stoff Feinheit Form Centillionenfach verschieden ähnlich -- notwendig Weise gut Ordnung allervollkommenst mannigfaltigst Berührung -- -- glauben -- Erklärung Rätsel nähern -- einigermaßen obenhin begreifen lernen -- Gestirn Flamme wälzen -- Wind rasen -- Meer toben -- Erde fest halten -- Strahl Pulverturm glücklich -- Herkul Liebeshändel -- 
  Weise sonderbar Meinung Xenophane -- Schüler Parmenid Melisso erklären -- Eins -- Eins -- 
  nämlich -- Grundstoff -- Form unendlich wesen verschieden -- 
  Exempel -- wissen Bestimmt hierüber unser grob Sinn -- Sonne -- Luft halbrund -- Meer platt eckig -- Erde platt -- 
  Platt kommen unser Gefühl kalt trocken -- heftig Bewegung heiß trocken -- -- 
  Platte platt eckig -- Erde Meer -- 
  Wasser Ausdünstung wolken Regen -- 
  Runde Halbrunde -- Erde Berg Tal Ebene umänderen -- 
  Runde herrschen leicht Bewegung -- 
  machen Wesen möglichst Lust Ewigkeit kurz -- 
  gewiß bleibt_es allemal -- Verschiedenheit Änderung -- Sinn Wirkliche empfinden -- Qualität -- Organismus nennen -- bloß inner Form bestehen -- Form einerlei -- Wesen denken -- 
  Form fern Wirkung -- -- Wesen notwendig ewig -- 
  eins Formlosigkeit Form kommen -- unendlich Gestalt verwandeln -- 
  -- Streben Genuß -- lebendig -- Ekel Tod -- unendlich lang Weile -- Bewegung -- Ausdehnung Anziehung -- innersten freilich unbegreiflich -- Natur wahrnehmen -- Forscher Embryo verfolgen -- Sinn Erfahrung verlassen -- 
  Anfang annehmen -- 
  gehen Ewigkeit hervor -- Richtigkeit -- 
  Gott schaffen Welt -- 
  Problem auflösen -- Welt Eins -- verschieden -- Ruhe Bewegung Lagerstätte finden -- 
  sinnlich faßlich sprechen -- 
  Anfang Eins -- Wesen zart zerflossen -- fein dünn -- Raum schier -- 
  regen -- Form -- 
  Unvollkommenen Vollkommener hervor -- entstehen Element -- Wasser -- Luft -- Erde -- Feuer -- Pflanze -- Tier -- Mineral -- 
  wechseln -- Eins -- 
  Vater Äther -- Lebengeber -- 
  vergehen ewig -- -- 
  Holz Exempel brennen -- Feuer -- Rauch Erde -- 
  Feuer Rauch Luft -- Luft Wasser -- jeder kehren -- herkommen -- 
  Erde -- Wasser -- Luft Feuer Pflanze -- Pflanze Tier -- Tier Pflanze Herz Victoria Colonna -- Kopf Macchiavell -- 
  Form Wesen -- Wesen Form -- Pole Weltall -- herumdrehen -- 
  bildend Kraft liegen Wesen -- Streben Genuß -- 
  bleiben -- alt Sinn nachsagen -- 
  Gott groß Geometer -- 
  Wesen Wesen fühlen -- entstehen reinst Bewußtsein -- 
  Form bilden -- entstehen abgezogenst denken -- 
  Wesen berühren -- verständig -- verständlich nehmen -- denken -- Aristoteles tiefsinnig -- 
  denken Verwandlung Wesen Form -- Wesen -- denken -- 
  Wesen Ideal formen -- entstehen Phantasie -- 
  Ideal -- Form befestigen -- Gedächtnis -- 
  Sonne -- Planet Komet Welt -- Form Bewegung -- denkmal Leben -- 
  Gefühl -- Art Leidenschaft -- Schmerz Vergnügen verschieden Form Wesen -- 
  fruchtbarst Grundsatz rein Wesen Form -- Kontinuum -- möglich Form -- scheinen Welt -- Zusammenhäng -- Erhalten -- Wachse -- Zeuge -- Vergehen -- Mensch -- denken Empfinden -- Dicht Tracht -- -- Art Verwandlung völlig unerklärlich -- 
  Vollkommenheit Weltall bestehen möglich Art Form -- 
  Geschöpf bloß Gedanke Gott -- hoch Vergnügen Maß fähig -- 
  Gott denken -- 
  Licht -- Licht -- 
  Gott demnach Grieche -- Trojaner -- streiten -- Paris -- schön Helena -- verführen -- Stier -- Hund Zwiebel -- Verächtlichste -- unser Begriff -- -- ißt verdauen -- kümmern -- folgen meister eingeführt System -- 
  alt Ägypter verehren Gott erhaben -- heutig Mensch Verstand reichen -- -- Häuslein Obeliske Pyramid -- 
  Gott unendlich Eins -- Punkt Eins -- ein angenommen Maß -- Verhältnis Bewegung Verbindung Realität Form -- 
  unendlich wirken -- allgegenwärtig -- erhaltend -- Schöpfung erhaben -- wissen Mensch -- 
  -- -- Gewalt Schönheit verschwindend Kleinheit allzu unermeßlich -- 
  erliegen -- Anbet -- Bewunder erstaunen -- 
  Grund Wahrheit Lebendig -- wovon Sinnen Oberfläche einzeln Äußerung empfinden -- Wesen Regel -- verschieden -- 
  Wesen -- -- Form -- Form Bewegung -- denken -- weder Verstand Körper -- Form bestehen -- handeln -- Handlung -- Wesen Form -- Wesen -- 
  jeder Folge Wesen -- Gedanke -- beide -- Gedanke Körper -- samt Bewegung Wesen -- 
  Wesen vollenden zusammengesetzt Folge Handlung -- salaminisch Schlacht -- olympisch Jupiter -- Geschöpf -- 
  Bewußtsein -- Folge fassen -- Einheit -- 
  Gott unendlich Verstand -- unendlich Welt ausmachen -- scheinen Widerspruch -- Form Schranke -- 
  gewiß dünken -- -- Mensch -- jeder lebendig Geschöpf lauter Wesen Form -- 
  Freiheit -- anfangen -- Ursache Wirkung -- Stelle bewegen bewegen -- Form annehmen annehmen -- leugnen -- grundlosen Schicksal gepeitschen handeln -- erfordern rein Wesen Form -- Mittelpunkt Sammlung -- 
  heilig -- alt Feuer -- Ursprung Lebenswärm halten -- Feuer -- Wesen groß Freiheit verbreiten -- wovon lebendig Eins ausgehen -- sinnlich erscheinen -- Liebesschoß einsenkt -- wunderbar Allmacht -- Despotismus allertiefsen Gehorsam Philosophie verstummen -- erkennen -- -- Art handeln ablaueren -- 
  erhaben Beschreibung Aristoteles Gott scheinen hierauf passen -- 
  unbegreiflich göttlich -- lebendig Einzel verdauen -- Körper rein Wesen auflösen -- Form gegenwärtig Eins verwandeln -- Art erzeugen -- groß Vollkommenheit mehrere Freude denken -- 
  eins -- 
  Form ursprünglich frei Handlung -- lassen Grund denken -- Lust -- mancherlei -- 
  Allgenuß Kraft hoch Freiheit -- 
  Wesen Welt Lust erschaffen -- mannigfaltig -- unendlich Form ordnen -- 
  -- -- -- ergründen -- 
  wissen -- Schöpfung immerwährend Erneuerung immerfort erhalten -- 
  -- Form Anfang -- notwendig ewig -- 
  unendliche lassen Wesen denken -- Verstand Ruhe finden -- pro Contra Ding gründlich denkend Mann -- Hauptgeschäft machen -- Klar -- 
  Demetri Idee Xenophanes -- Rom -- scheinen -- ziemlich unbekannt -- längst -- neu Zeit -- Cartesianischen Beweis -- Europa -- bewundert System -- allgemein annehmen -- Art behandeln -- 
  umändern -- roh Entwurf lassen -- künstlerisch Vergnügen -- Geringst Gang wahrnehmen -- 
  wirken Gegenwirke all schön Leben -- 
  Wesen äußern Kraft -- Stern leuchten -- Himmel schweben -- 
  schlafen -- bewegen unser Erdball Sonne -- 
  viele Wesen -- bewußt -- wofür Sinn Sprache -- 
  innig Vereinigung herrschen fort -- Schein -- jeder besonderer Ding Spiel -- Mutwille Wesen -- Augenblick bestehen -- 
  Hoffnung -- Sicherheit Unsterblichkeit -- Stürme Atmosphäre brausen hören -- fühlen -- Wog wälzen -- Meer Kampf -- 
  Adler lüften schweben sehen -- denken -- mächtig Flug Erde hängen -- Komet Himmel schweifen -- Sonne Welt beglücken -- -- stolz Gedanke -- Meer Wesen Wesen einströmen -- 
  verächtlichste -- 
  wissen -- woran Wesen Freude -- offenbar erscheinen unendlich Gestalt -- 
  können Genuß leiden -- Herrschaft kurz dienen -- 
  Eins -- -- Natur entzücken -- -- Schlaraffenleben -- -- vernünftig Weise Erfahrung undenkbar -- bezaubert Phantasie vorstellen -- 
  ewig Natur verehren -- wirksam -- schön gewaltig empfinden -- 
  Ausgesandt -- Diener Gott -- sinnlich vereinig hoch Schwester Brüdern -- 
  Verstand Wenige dringen all prächtig Getümmel Throne Herr -- 
  Welt nehmen -- -- 
  Gegenwart zufrieden -- Wesen trachten Neuem -- -- 
  hartnäckigst Zweifler herausbringen -- -- unermeßlich unser Sinn -- Anfang Realität unmöglich -- notwendig ewig -- Wesen -- Alleräußerste auflösen -- einerlei -- verschieden -- 
  verschieden -- 
  Art -- hoch -- gut mächtig -- -- Art Wesen -- -- Lebendig -- denken Verstand -- 
  verschieden -- 
  -- -- 
  augenscheinlich gering Kleinigkeit Universalwesen Art -- Wesen -- 
  arg -- hoch verehren -- 
  letzter allerreinst Weltmonarchie -- 
  beruhen -- Farbenwechselnde Einbildung hoch Priester Schriftgelehrte bestimmt ansag -- -- jüdisch System -- geheim Ägyptisch -- christlich -- 
  Jesus -- Stifter letzter -- göttlich Natur Symbol unendlich Wesen Form -- unendlich Wesen vollkommen -- Widerspruch -- Mensch Person -- 
  alt Ägypter Verehrung verschieden Geschöpf Gewächse ähnlich denken -- 
  alt morgenländisch Religion scheinen ausgehen -- 
  Intelligibel -- Leibnitz Verteidigung Dreieinigkeit -- per Nova Reperta Logica -- -- Gott Vater Intellectivum -- heilig Geist -- ausgehen -- intellectio -- 
  erster rein Weltaristokratie -- jeder Element nämlich göttlich -- Homer Juno -- Neptun -- Apollo Zeus binden können -- 
  aristokratisch Weltmonarchie -- Element König -- 
  Demokratisch aristokratisch Weltmonarchie -- Tiere Pflanze Form Ewigkeit -- meinten -- 
  Griechen reizend Dichtung schön Göttergestalt schöpfen -- erhabenst Philosoph gefühlvoll Nation -- Aristoteles Plato -- losmachen -- 
  haufen glauben -- gut Mann überwältigen -- 
  Lesung Meisterstücke Poesie Beredsamkeit -- bezaubernden sinnlich Vorstellung -- wissen unser Glaube klug -- 
  Nektar rein unverfälscht athletisch schön Ursprach kosten -- schwerlich Getränk berauschen -- 
  Name Gottheit ertön Lippe Edler aufgeklärt Europa -- erheitern Gesicht Zuhörende -- verhunzen entstellen -- 
  setzen ausschweifendst letzter -- geben Universalwesen -- Welt bestehen laut unteilbar Stäubchen -- Kein -- Gatte scheiden -- 
  müssen billig Hochachtung wiewohl komisch bunt ungeheuer Menge -- obgleich Meinung -- Abgrund Äther anschauen -- fühlen denken -- Ernst -- grillenhaft Nadelspitzensystem -- 
  Weltdemokratie -- eigentlich atheistisch System -- unentschied Anhäng -- Verzweiflung -- Gott freiwirkend vorstellen -- Natur verschieden notwendig Verbindung sehen -- 
  folglich erstaunlich Rätsel vorkommen -- -- bescheiden -- einbild -- Sonne -- Mond Stern -- 
  -- Dasein freuen Form Gestalt -- vervollkommnen -- zernichen -- taugen -- Sklaverei taugen -- Traurigkeit fliehen -- Predigt Natur -- 
  -- unnütz heischen beginnen -- 
  Wesen frei -- frei -- -- handeln -- reißen -- Vergnügen Verbindung -- 
  Tyrannei dauern höchstens überall Grad -- letzter Lust wegfällen -- 
  verlieren Folge Unendlichen -- Wesen Gott vernichten -- 
  Grundpfeiler Adel Stärke tief Gefühl -- 
  Zertrümmre tausendmal Blitz Wetterkeile -- 
  stehen jung -- 
  verlangen -- versagen -- Zuwider -- 
  tun -- tun -- 
  Ardinghello -- 
  Weise göttlich Sicherheit Furchtlosigkeit kommen -- weswegen Lehre Epikur geschwind greifen -- Atomen Zufall -- abwechselnd Lust Unlust hervorbringen zerstören -- Mensch -- Mück Elefant -- Fisch Stern -- womit beschwerlich Herr Aufseher -- beobachten -- Rechenschaft verlangen -- Natur verbannen -- albern Philosoph Physiker -- Bedünk -- Auflösung Knoten herbeirufen -- Niederschlage -- wenn_es anziehen -- aufheben -- wenn_es Höhe steigen -- 
  gute -- Zweifel -- bleiben -- Partei edelst Mensch Nation halten -- 
  alt jünger Glaube -- -- Systemen Vernunft neig -- allezeit meister gegenwärtig Stimme entscheiden -- 
  notwendig verschieden Natur -- zusammengesetzen bilden -- schwer begreifen -- Anfang Wesen -- 
  eu Eins geregen -- vermutlich verschieden -- 
  vorher aristotelisch Bewegung -- Leben Bewegung denken lassen -- 
  irgendwo -- 
  Form -- 
  Form Körper -- müssen wahrscheinlich treffen -- Verstand -- -- Form -- Wesen Bewußtsein vereinigen -- 
  Grenzenlos denken -- unendlich - Realität -- paar Wort -- zusammensprechen schreiben -- denken -- 
  eu formloses Wesen -- fein Äther Raum schier -- müssen Lücke Unendlichen -- Zentner Gold zusammenzögen -- reich Min Peru -- gewiß Sonnensystem Größe Formlosigkeit Grund -- 
  sehen eur Beweis -- Form notwendig ewig -- worauf lediglich eu Eins beruhen -- 
  Frage woh -- bleiben Wesen -- mehrere -- eins notwendig ewig annehme -- Centillion annehmen -- 
  müßt verzweifelt plagen -- ehe mancherlei Qualität Sinn herausbrächen -- wissen -- Geschöpf Sinn -- 
  rednerisch Exempel Holz Feuer -- Rauch Asche -- -- lassen erklären -- täuschend -- wahrhaft Schilderung Regenten ist_es tun -- 
  Verstand -- Wesen betreffen -- denken -- 
  Anaxagora -- feinste Wesen richten -- -- beweisen -- tot -- brauchen -- wissen -- zugeht -- 
  freilich Liebesgeheimnis Innerst aufdecken -- verschieden lebendig Eins -- fortdaueren -- zusammenhandeln -- schwer lassen Wesen -- Gedanke Verstand -- -- Körper -- Eins erklären -- 
  Qualität sonderbares -- bloß verschieden Art Ausdehnung Anziehung überall hervorbringen -- 
  Verstand bleiben Blindgeborener -- trotz möglich Anwendung Figur Dauer -- Gegenstand Empfindung -- 
  voll Majestät ursprünglich Reinheit Substanz Vollkommenheit Natur -- Volk lebhaft Sinn scharf Gefühl -- Vernunft Ursache Auge Ohr Einbildung umtauschen -- göttlich verehren -- Glaube Empfindung Grille -- 
  -- eur Gesinnung verbergen -- Scherz -- 
  beweisen -- -- dartun -- Eins -- 
  Widerlegt Ernst -- 
  behaupten Spötter -- Vorsehung -- Plan allmächtig Regierung Welt auffallend sichtbar -- Prophet -- Apostel Geschichte dawider -- hinterlassen -- 
  stehen -- sein -- möchten Athen Zeit Perikle leben -- alt Rom -- neueren -- frommsten Zuging -- 
  -- Verstand können einzig notwendig unendlich Wesen -- -- Ruhe finden -- wissen -- zugehen -- klopfen Herz Angst -- sausen Ohr -- lang nachdenken -- 
  bleiben einerlei -- -- -- Herr Untertan -- Widerspruch -- Geschöpfen lobpreisen -- bestrafen -- Schicksal gräßlich Einöde entrinnen -- schlimm -- alt Fee Ritterbücher -- widrigen Begebenheite Auge zerwein -- ermorden -- 
  Lust Pracht Herrlichkeit Welt Gaukelspiel -- schwinden -- Unding -- 
  Aristoteles ertrug Wesen -- sträuben Kraft -- dünken -- hoch -- edeln -- 
  fallen schwer -- Betrachtung Weltall Sinn Verstand rein keusch Verbindung bewahren -- 
  lassen lediglich Verstand gelten -- ziehen -- -- Natur -- halt sinnlich Vorstellung -- taumeln Einbildungskraft herum Paradies Hölle -- 
  hoch Schönheit Gewäch selten Boden -- Glücklich Beute -- 
  glücklich Gesellschaft -- freudenreich Glaube Klima Verfassung erdenrund bekommen -- erwählen -- 
  -- befriedigen -- mystisch Komposition Weltmonarchie -- Aristokratie -- Demokratie -- 
  Mann -- Natur Volke gelind umgehen -- Philosoph Hold -- 
  -- vorig Zeitalter barbarisch Begriff -- schleppen -- 
  Mensch Göttlicheres Verstand ergründen -- Schule Anaxagora zugeben -- bleiben Sinn samt Vernunft hoch Regel Wahrheit -- vereinigt Aussprüche gelten weder Verjährung -- Wunder -- Zeugnis -- 
  Weltall Verbindung kennen -- desto vortrefflich Religion -- 
  reizbarsen -- innigst Sinn Schönheit Natur -- geheimst Regung fühlen -- Mangel vertragen -- abhilft Kraft -- üben Religion Wahrst Heiligst -- 
  Tempel unendlich Gewölbe Himmel -- fest schön Sommernacht -- herrlich Aufgang -- bringen Opfer dar Mensch -- Tier -- bedürfen -- Lebendig -- 
  Metaphysik Gott -- Ehrenamt -- Dichter Simonides -- klug Frage -- 
  Gott -- weisen Hieron aufführen -- 
  Aristoteles zugeben -- meinen -- Gott neidisch -- Glorie Mensch -- frei Mann unanständig -- erforschen -- 
  Plato -- stolz leicht geflügelt heilig Dinger -- Dichter nennen -- gestehen -- obgleich Gelegenheit -- demütig -- Simonides selten Unrecht -- verständig göttlich Mann -- 
  Sonnensystemen Orion -- Milchstraße steigen hoch Religion -- 
  Demetri -- 
  solch Angriff fällen -- 
  Gymnastik Verstand -- Seite Gewinn -- geübt nackt gelenker Wahrheit -- Befreiung schädlich Übel Falschheit -- 
  wissen -- Mensch -- -- verwundern weder Ost West -- untersuchen ferner fort getrost -- woraus bestehen -- 
  Ardinghello -- 
  Säule hüllen jungfräulicher Schönheit Dunkel -- Dämmerung -- 
  Pförtner warten -- Tür schließen -- 
  Unrecht -- drücken zärtlich traulich Hand -- letzter Wort behalten -- 
  Demetri -- 
  Hauptpunkt -- übrig andermal -- überdies hauptsächlich Gefühl beruhen -- womit hinüber Herüber Mutwille treiben -- 
  Merk -- Belvedere Abschied nehmen -- 
  inzwischen spielen trefflich Rolle -- Pyramid -- Haus -- einkehren -- 
  Eins -- verschieden Form verwandeln -- bleiben völlig unerklärlich -- wiederholen -- -- 
  -- Gott Mensch -- Anthropomorphit -- müßt eur Menschheit ablegen -- denken -- eure stolz republikanisch Spartanischen Gesinnung -- 
  unser Pünktche -- Plätzch Form Aristoteles -- Idee klein -- irgendwo -- erdenken -- umbilden -- aufbewahren -- neu beleben -- 
  Reines Wesen bloß Bewußtsein harren -- Leben -- Form schaffen sammeln -- Geschäft Lust -- 
  woher -- unendlich -- 
  wüst leer -- 
  Gedanke entstehen -- Körper -- 
  ist_es finst Tiefe -- Abgrund -- versinken -- Abgrund -- 
  Ewigkeit -- 
  Ewigkeit -- 
  Untertaucher -- berühmtesten Schule Syme vermochten entdecken -- 
  Syme Vaterland Untertaucher Levante -- Insel Stadt Rhodi -- Magazin Türkisch Seemacht -- 
  erhalten Bürgerrecht -- vorher Beweis Geschicklichkeit untertauchen geben -- 
  Hernach Hafen breit herum verschreiben -- untertauchen -- 
  gleichsam Akademie Halle Metavhysiker -- gefährlich Kunst glücklich -- öfter verloren ergründ festbacken -- Plato Leibnitz -- 
  aristotele -- Simonides -- 
  Freund -- leben -- selig Stunde -- 
  -- 
  Terni -- Januar -- 
  Neid Eifersucht Dorn Rosengart Liebe -- 
  Rom abreisen -- Herzog rufen Geschäft -- 
  erkennen -- Kardinal fort -- längst Auge -- finden Aufenthalt Rechnung -- 
  Reise vorwärts -- Phantasie rückwärts -- Herz Freude Rom bleiben -- 
  Zähr tief Gefühl rannen unaufhaltbar hervor letzter heiß Seelenblicke -- schied glühend Umarmung -- 
  O lieben -- Edel -- erhaben Wesen -- 
  befind Wasserwelt -- Flut rauschen -- Strom stürzen donnernder Gebrüll Gebirge -- Sinn Taumel gegenwärtig -- 
  Wetter außerordentlich lau warm Jahrszeit -- Schnee Apennin schmilzen -- 
  Nera mächtig angeschwollen -- königlich Velino reißen Sündflut See schräg über Gebirge herab -- setzen Garten Feld Terner Überschwemmung -- verheern Schutte -- 
  Rührend fürchterlich Schauspiel -- hülflosen Mensch freundlich gesellig Not -- erkennen -- vermögen -- 
  schmal Tal -- Nera -- Einschusse Velino -- liegen Dörfchen Haus -- Torrosina -- Kessel -- 
  Lage besehen -- 
  finden -- Terner fast leiden -- Gebirge Velino führen -- Felsenkluft -- Nera furchtsam Hervorschleicht -- Tartar stürzen -- 
  gewänn breit Bett Flusses Meile Waldung -- senkelrecht Sturz Höhe Schönheit gleich Europa -- gemach schräg herab rauschen -- 
  Grund Boden Torrosinern gehören -- 
  müssen abkaufen -- Wert -- lauter Fels -- etwannigen zukünftig Schaden ersetzen versprechen -- entstehen -- Nera Wasser einbrechend Gewalt Velino zurückhalten -- 
  Ratsversammlung Terni -- Gutachten Werksverständiger -- 
  -- ausnehmen -- geben Beifall -- -- längst denken -- 
  sehen -- 
  schicken klug Redner Torrosinern -- Anschlag Kosten genehmigen -- 
  Furcht -- gereuen -- sogleich Hand an Werk legen -- kurz Bett ausgraben -- helfen abstecken -- 
  Sache Verlegung Velinosturzes alt -- Cicero Zeit verhandeln -- 
  scheinen -- Torrosiner Gutherziger -- nachgaben -- Schaden Jammer Terner jemals ergriff Mitleide bewegen -- zukünftig Verlust äußerst klein -- vergüten -- 
  Perugia -- Januar -- 
  streich himmlisch gegender Genuß -- ergreifen Wasserelement Sturm Aufruhr -- Luft Gewitter Wetterstrahl -- 
  Ort enthalten Schatz Gemälde -- -- prächtig gepflastert Straße schön Paläst Tempel zeigen ehemalig Wohlstand Freiheit -- 
  flüchtig Anzeige Raffaele Weg -- 
  Foligno -- wert -- Paradies reisen -- 
  Nonnenkloster dell Contezze Altarblatt -- Madonna vorstellen Himmel hernied schwebend -- heilig Franziskus -- Hieronymus -- Johannes Täufer -- Kardinal anbeten -- 
  Meister gut -- 
  Gestalt -- Charakter -- 
  rein auf Haar bestimmen -- echt klassisch Arbeit -- 
  Kopf Madonna schönsn welsch weiblich Kopf -- 
  klar Stirn -- reizend licht Kastanienhaar Ohr weggelegen -- bräunlich Schleier sanft lieblich -- Holden Hernieder blickend Auge Güte -- schön Augenlider -- voll jugendlich Wang Schamröte überzogen -- jungfräulich süß völlig Mund -- zart Kinn -- Nase Edel herein -- welch schön Oval -- reizend Seite herum Schatten halten -- reizend schwell Brüste rot sittsam Gewand hervor -- 
  welch feurig -- eifrig Frömmigkeit Wahrheit kopf heilig Assisi -- welcher schön kniend Akt -- 
  kräftig Kopf heilig Hieronymus malen -- feierlich Ernste Betrachtung -- 
  Johannes echt wild Eremit -- bürgerlich Höflichkeit verstehen -- dreist -- denken -- 
  Kardinal bloß Porträt voll Bewunderung -- 
  Engel unten Täfelche trefflich malen -- wissen -- -- vergessen -- schreiben -- 
  Kolorit Kopf täuschend abwechseln -- Natur tun -- 
  Figur Lebensgröße -- Madonna -- Person erheben -- 
  lebendigsen -- werfen Glanz -- Sonne -- 
  unten frei Feld Flecken -- heilig beisammen befinden -- anrufen anbeten -- Betrachtung verlieren -- 
  Dom linker Kreuzgang Halbbog -- worin Madonna Christus linken Johannes -- hold nackt Bübch schön Bewegung -- 
  heilig Joseph -- linker heilig Antonius -- Seite Jungfrauen -- 
  kniend Stellung -- Kind -- 
  weiber trefflich Gewänder -- Mädchen linken -- bloß linker Fuß sehen -- wollusterregend göttlich -- zeigen nackend -- schön Form unterleibs -- voll Hüft Schenkel -- Gewand ungekünstelen Falt Schenkel -- ziehen knien -- lüsternen Auge Meister Reiz Natur -- 
  jung Brüstchen schwellen lockend Gürtel hervor -- 
  Kleidung rot -- griechisch -- leicht Hemd -- 
  Gesicht voll Huld -- Madonna mütterlich süß Auge Mund -- blicken still Entzückung nieder -- 
  vertiefen Kind -- kindlich zeigen -- freuen -- 
  Kopf heilig Joseph malen Tizian nebst herrlichen Ausdruck -- 
  heilig Antonius weichen -- mittelmäßig -- weggejagen -- fertig -- 
  Liebe entwerfen -- herrschen still raphaelisch Empfindung -- 
  Rom Raphael Perugia kennen lernen -- 
  meister Kirche heilig Franziskus -- 
  Perugia Stück vorzüglich empfehlen -- eins Knabenalter -- einer Jünglingschaft -- eins -- Tod vollenden -- Nonnenkloster Stadt -- übertreffen -- hervorbringen -- übrige finden -- 
  erster Franziskaner -- jung -- Capella degli Oddi -- stellen Himmelfahrt Madonna -- 
  Luft empfangen Heiland -- Sohn -- Engel Musik -- krönen -- unten stehen zwölf Apostel offen Sarge -- 
  Einfassung -- Altar ruhen -- Gemäldche angebracht -- englisch Gruß -- Anbetung heiligen König -- Beschneidung -- 
  himmlisch Inbegriff Menge schön Gestalt -- Seele aufblühten -- 
  Kopf Madonna heilig selig schauen -- Engelsgestalten süß Anmut -- Handtrommel wahr Volkslust -- 
  wunderbarsen zwölf Apostel -- Charakter Paulus -- Petrus Johannes -- 
  Paulus Aristoteles -- Johannes aufblickenden Jüngling Bramante -- 
  Gemäldche unten erscheinen Engel Madonna korinthisch Tempel -- 
  beten -- blicken erhaben -- ansehen -- landschäftchen zeigen Gott Vater -- heilig Geist Taube -- 
  Anbetung heiligen Könige Menge Figur -- worunter voll Ausdruck erstaunen -- 
  Hütte zerfallen Ruine -- Landschäftchen kindlich angenehm erfreulich -- 
  Beschneidung gut -- 
  Ionisch Tempel -- Priester trefflich Kopf voll Charakter Ausdruck -- Seitenfigur fühlen denken -- 
  freilich äußerst hart -- Form unausgebildet -- Natur arbeiten Bedürfnis -- Gestalt -- -- Wesentliche -- wobei Anfänger übersehen -- 
  Abnehmung Kreuze -- 
  gemäld Figur -- Mann Weiber -- toen Christus Ohnmacht gesunken Mutter -- groß vorig -- ungefähr Drittel Lebensgröße -- 
  Gruppe ordnen -- zweien getragen tote -- Joseph Arimathias -- Magdalena -- hinten vermutlich Johannes -- Mutter Jungfrauen -- Leichnam Bein halten -- verbinden -- 
  hauptfiguren leuchten hervor -- tot Jüngling -- schön Magdalena voll Schmerz -- Mutter -- 
  Gruppe letzteren vortrefflichsen -- 
  Gestalt voll Seele -- leben -- empfinden Charakter -- 
  Mädchen -- Mutter fassen -- griechisch Grazie -- vorzüglich -- Kopf halten -- Gestalt tief Gefühl hoch Schönheit Form Bekleidung -- euripideisch Polyxena brauchen -- 
  Szene verbreiten sanft Abendlicht -- 
  letzter Arbeit -- bevor Rom -- sehen -- Kunst Vollkommenheit nähern -- 
  hoch -- 
  unterlassen -- Gemälde Correggio anzuführen -- Szene vorstellen -- Johanniskirch Parma Seitenkapelle befindlich -- 
  Gefühl übertreffen -- erhalten Preis -- Sophokles -- 
  streng einfach rührend -- Verleugnung sonstigen blühend Farbenpracht lächelnd Manier behandeln Begebenheit -- 
  Erblaßt ausstrecken liegen göttlich Jüngling -- 
  Magdalena sitzen Seite vergießen Wehmut versunken heiß Träne -- untröstlich Geliebte -- Schmerz zärtlichen Mutter Haupt entsetzlich Schicksal grenzen Tod Bitterkeit -- 
  trüb Regenlicht -- Lebensgröße -- 
  Bewunderung schülerhaft ungerecht -- 
  Raphael Märtyrer Amor -- fern Entzück Liebe -- hoch Vorwurf bildend Kunst -- tiefem Seelenklang heiter Phantasie -- ausdrücken -- Lebenstage unberühmt hoch Lombard -- Ariost Nachbar -- Jo -- antik Leda -- Stehen Zeus Schwan begatten -- trefflich wollüstig Gruppe Zeichen eurer frei Denkungsart öffentlich Eingange Markusbibliothek aufstellten -- Anlaß Idee geben -- 
  Hauptgemälde Raphael Perugia Nonnenkloster Mont Luce -- Tod vollenden -- 
  Altarblatt -- Figur völlig Lebensgröße -- 
  stellen Himmelfahrt Krönung Mutter Gott -- Spur Lehrmeister eng schmal Manier verschwinden -- 
  zwölf Apostel stehen Sarg -- Madonna Blume -- Rose -- Lilie -- Nelke Jasmine anfüllen -- blicken erstaunt -- Sohn Wolke emporgetragen Engel empfangen krönen -- 
  Mutter frischesten weiblich Gestalt -- blühend Jungfrau -- voll edl Ernst -- Matrone -- heiß wunderbar Empfindung Seligkeit -- Taumel neu Gefühl -- Erwach -- herrlich schön -- 
  falten Hand kreuzweis Brüste blicken gerührt entzückt Auge Sohn -- 
  Gesicht hingewandt -- sehen Seite -- linker Auge heißen Blick -- schwarz Auge zart Bogen Augenbrane -- dunkelblond Haar lang grün Schleier -- Ohr hinabziehen -- 
  Christus feurig Gesicht -- Sonnenverbrannter Kalabrier stark Bart Kinnbacke -- ausgestreckt Arm voll Kraft Nerve -- womit Kranz aufsetzen -- 
  Engel Blume Kopf voll himmlisch Schönheit -- sonnig entzücken -- scheinen überall Glanz Gesicht hervorzubrechen -- 
  Anordnung reizend -- bilden schön -- 
  Madonna Mitte -- Christus linken -- Jüngling Engel bekleiden -- Zart nackend Bübch -- heilig Geist dicht Duft gelbem Himmelsglanz -- 
  Auffahrt geschehen gemach dunkel dick Wolke licht Saum -- leicht schweben -- Gemälde -- gewinnen Handlung Natur Majestät -- 
  Raphael rein klar Empfindung -- minder fehlen lassen -- anderer scharf Verstand -- 
  lang Christus betrachten -- desto finden übernatürlich göttlich -- gütig herablassen -- demütig Madonna stimmen -- 
  erstaunlich mächtig gebieterisch Wesen -- Ausdruck liegen -- Form -- wunderbar streng Güte vereinbaren -- 
  neu Kunstwerk sehen -- Eindruck Dauer tief tief -- 
  Nachdenkt fühlen Gestalt nachgehen -- desto wahrer finden Christuskopf -- 
  Gemälde wegkommen -- Wonn hängen -- 
  hoh göttlich Jüngling warst -- Raphael -- 
  Unsterblicher -- Empfang heißeste aufrichtigst Bewunderung -- nimm gütig zärtlichen -- 
  gehören hoch -- Malerei aufzuzeigen -- Mutter Sohn -- Engel -- Herz Sinn ergreifend Wahrheit Hoheit wegwenden -- 
  hauptfiguren wunderbar denken -- pindarisch Grazie Thebaner Schwung Phantasie Draperie -- mächtig Falte werfen -- 
  welch Arm -- Christus aufgehabn weit Ärmel -- 
  vollkommen gezeichnet malen -- wetterstrahlend Wirkung tun Gruppierung -- bescheiden zeigen nackend Mutter füllen blau Obergewand -- 
  kräftig malen -- nirgend anderswo Form vollkommen reif -- stark Art Schönheit -- -- 
  Apostel unten schwach matt -- verwelkend sterblich Fleisch -- Kontrast -- vortrefflich Männergestalt -- Petrus anderer Vordergrunde -- Bewegung Leben -- 
  Verklärung Gemälde dreißig Apostel -- sehen -- -- scheinen meister trefflich passen -- 
  Malerei Musik -- Wort Meister -- verschieden Melodie -- Natur gut Grund -- 
  -- Mensch denken -- singen -- 
  nehmen Lied Liebe -- 
  Wort wüten Neapolitaner -- anderer Gletschereis Alpen bleiben gelassen -- 
  lieben übereinstark Person -- lieben blond schwarz -- Sizilianerin zwölf nordisch Patriarchin -- 
  lieben Knabe -- Jüngling -- Mann Greise -- 
  Dichter Maler Tonkünstler nehmen Vollkommenst -- allgemeinsten wirken -- weder Rechenmeister Philosoph Zeitalter bestimmen festsetzen -- 
  Natur weislich einrichten -- Vergnügen einschränken -- -- 
  Kuppel Correggio Parma Johanniskirche -- Christus Himmelfahrt vorstellen -- gehören besonderer Gattung Malertaktik -- Kunstwerk -- Raphael -- malerisch Wirkung betreffen -- vergleichen lassen -- Unrecht -- 
  erstaunt -- Kreis treten -- wurzeln Boden fest -- bezaubern -- sehen -- wirklich Jüngling übernatürlich Gabe fern Höhe steigen dienstbar Sturmwind emporgetragen -- liebkosend weit Purpurmantel spielen -- 
  Apelles Zeuxis griechisch Zunft götterfluge entzückend Bewunderung nachschaun -- Herz -- sagen -- 
  Anch -- io son Pittore -- 
  Florenz -- Januar -- 
  unterwegs lang aufhalten -- -- Cortona verschieden Anstalt Pflanzunge -- gut Einrichtung Gebäude -- 
  Kunstsache -- Rom teils ankauft -- teils Kardinal vorrätig finden -- ankommen -- 
  Herzog empfangen heit freundschaftlich -- bezeugen Alsdann Freude -- bianca -- Dame Herr Hof -- 
  stehen Handel nackend Venus Tizian -- warten Entscheidung -- 
  ungezweifelt Hand -- Kauf -- 
  laß Galerie -- alt Lehrmeister Vasari erbauen -- Zimmer aussuchen vollkommenste zubereien -- gleich Hernach schwerlich Welt -- Belveder ausnehmen -- 
  griechisch Venus unterer linker Arm Ellenbogen abnehmen lassen -- allzuschlecht ergänzen -- Schulter -- warten -- 
  Wunder -- hoch Meisterstück glücklich brechen -- Teil gelitten -- passen -- 
  Figur Göttin dreizehn Bruchstücke -- dreißig Trümmer -- 
  Kopf Hals ansetzen -- klein Proportion -- griechisch weiblich Bildsäul -- Marmor -- Arbeit -- Zug Halses passen trefflich -- harmonieren allerschönst Füßch -- Echtheit Figur Augenblick zweifeln -- 
  Gesicht voll hoch Geist Ionisch Grazie -- 
  Nase schießen klein Stirn -- Strahl Wasser -- 
  Leib frischesen -- kernig -- ausgebildet Wollust -- Brust Schenkel schwellen markichen vorn hinten -- 
  süßest überschwänglich Reiz reif geworden himmlisch Geschöpf Liebesnacht -- Vater Homer Wundergürtel ausdrücken -- 
  Grübch Kinn -- 
  Zeichen Fülle Kraft -- Reifheit göttlich Frucht -- halberöffnet -- zugehalten Auge -- innerer erkennen lassen -- sprödiglich -- 
  -- Erscheinung überirdisch Wesen -- begreifen -- -- hienied leiden ausstanden -- Vollkommenheit ungestören -- 
  schön edelst Jüngling sterblich niederwerfen -- hoch -- verlangen -- Moment -- Huldigung Leben -- 
  Schönheit -- reife gedeihen Gedeihend -- ungenossen -- 
  regend Leben wölben sanft hervor unendlich Form -- entzückende -- 
  Adel -- bestehend -- blicken süß lustselig Auge -- sonnenheißer Blick Liebesfülle -- flammen Stirn herab -- schweben Mund -- Stolz Zärtlichkeit zusammenschmelzen -- 
  Mitte Oberleibs kräftig -- dünn -- Schulter völlig breit Hüft -- hinaus -- Sanft Hals herab senken -- 
  Unterleib zart Einwölbunge Höh Freude heben -- 
  Schenkel steigen Säule hernied -- verbergen Eingang Lust gelind Druck -- 
  waden Strafe voll Kniekehle auszuschweifen -- 
  erscheinen Seite schmal -- Rücken breit -- Fleisch leben -- leer müßig -- 
  sprechen jungfräulich Ernst Stolz -- Lockendes -- Inbegriff hoch weiblich Liebesstärk -- 
  blicken -- Jugendgöttin -- edel angebeten -- 
  erhalten Preis weiblichen antik Schönheit -- 
  Gesicht -- glücklich unversehrt bleiben -- ergreifen unaussprechlich reizend -- -- anderer -- gewiß ursprünglich Natur voll Geist hoch eigentümlich Wesen aufgeblühen -- stammen wahrscheinlich Lais Phryne -- 
  Niobe schön Tochter -- Juno -- kolossalisch Muse Rom Erhabenheit finden -- 
  lauteren Quell Leben -- Durst Art Glückseligkeit Mensch erquickend stillen -- 
  beisammen -- Körperreiz Seelenreiz -- Feuer Schnelligkeit Empfindung -- hell ausgebildet Verstand Vorfall Welt -- 
  -- verschwend Wort -- kommen Sieh -- fühlen -- Traure Herzinniglich -- Mantel umwirft -- begleiten -- 
  Tizian Venus schlimm Nachbarin erhalten -- 
  reizend jung Venezianerin siebzehn achtzehn -- schmachtend Blick -- auf weiß widerstrebend Sommerbett -- frisch Morgenlicht -- faselnackend inner Glut Decke Hülle -- bereit kampflüstern hingelagern -- Wollust geben nehmen -- -- anstatt Hand vorzuhalt -- stechend brennend Süßigkeit Begierde abkühlt -- Fingerkoppe regsamst gefühligst Nerv hoch Leben berühren -- 
  bezaubernder Beischläferin Griechenvenus -- Wollust Liebe -- Körper bloß augenblicklich Genuß -- 
  Form stark Kontrast griechischen -- 
  Leben Muskel regen Sanft hervorquillen Hervortritt -- Venezianerin Leib ausgedehnt Maß -- 
  schier -- schmeichelnd -- ergebend -- süß verlangend Gesicht sehen -- 
  neigen Kopf Seite -- liegen Rücken -- 
  linker Bein schön Form reizend strecken -- erhoben Knie lassen unten süß Fülle Schenkel sehen -- 
  Kopf Gestalt Natur -- -- hingelassen nachdenkend zerfloßen Körper -- matt bilden griechin -- 
  Blume geben Hand Arm Widerschein bezaubernd Farbe -- drücken Leib -- 
  Haar kastanienbräunlich lieblich verstreuen Schulter Streife linker Arm -- 
  Schatten Scham emporschwellenden Schenkel Licht äußerst wollüstig -- jung Brüste -- 
  gräulich-braun Auge breit Augenbraue blicken Feuchtigkeit -- 
  lauter Huld reizend sommerlich Lage -- Preis -- warten gierig verlangen furchtsamlich Kommend -- 
  sehen deutlich -- jungfräulicher gewichen -- scheinen Besorgnis mehrere Eifersucht -- 
  Tizian Venus malen -- Buhlerin -- -- hernach Göttin Liebe taufen -- 
  Fleisch Farbenzauber -- wahr jugendlich Blut durchflossen -- darstellen -- anderer leisten -- 
  Antik -- mitbringen -- himmlisch Bube -- jung Apollo -- stark Göttin wetteifern -- 
  lehnen linker Stamm Kopf geschlagen -- Stellung voll Reiz -- schlank Zug Seite -- 
  Gesicht blühen wonniglich selig Edel Gottheit -- 
  Leibchen äußerst zart halten -- regen bilden -- 
  wahr Wollust -- Venus hinten sehen -- weiblich üppig büblich Gewächses -- Venus Schwall hinten -- speckig -- 
  Apollo lauter süß Kern -- 
  kernfleischig spalten Rücken -- Schenkel vollsen schier Zirkelrund -- 
  Hand ergänzen lassen -- Nase -- 
  Ausdruck bezaubernd -- empfinden -- sinnen Stille -- 
  Ahnung verlangen Ungewißheit -- entzückendst Blick Liebe -- 
  jung Ringer Block Marmor gehören gelehrtest Arbeit -- Altertume übrig -- 
  schön Moment Ringspiel verflocht -- auserlesener Stellung geben -- 
  angestrengt Sehne zeigen Kraft hoch Stärke -- schroff -- erscheinen künsteln -- Meister Körper Ruhe prahlen -- 
  Bruchstücke Merkur -- Hand fehlen -- 
  Gewäch zart schlank -- Kopf voll Schönheit Kraft -- stellen klug sinnreich Jüngling dar -- 
  tragen Helm -- Teller -- Flügel -- Haar abschneiden -- Löckche -- 
  Gemälde -- -- Paar Raphael anführen -- 
  Papst Julius -- 
  Wahres Gestalt sehen -- malen -- 
  halten Tizian -- 
  Erhabenheit Scharfsinn Nachdenken bilden Ideal heilig Vater -- 
  welch gediegen fest Feuer Arbeit -- 
  schön herabfließend Bart herrlich aufsetzen -- 
  Hand -- Stellung Stuhl aufstützen -- vortrefflich -- 
  Natur -- 
  Stirn stark beleuchten -- hervor -- fallen Licht Bart -- Meisterstück hierin -- 
  klein -- Fuß breit -- groß Seltenheit -- Liebe vollenden -- 
  Gott Vater sitzen Adler lüften -- Engel -- wovon Hand wunderschön -- arme halten -- Evangelist Tier -- Wolke -- Erde Bäumen -- 
  Ewig vergehen Glorie anderer geflügelt Buben Glanze -- 
  Kopf lauter Erhabenheit -- Michel Angelo Capella Sixtina -- Sonne schaffen -- 
  nackend Brust bekleideen Schenkel Kleinheit vollkommen schön Antike -- 
  stützen Fuß geflügelt Stier Löwe -- sehen jovialisch stark mächtig Bestie Mensch -- 
  Haar Bart fliegen Wind -- 
  himmlisch Bildche -- reizend apokalyptisch Laune -- 
  Bianca freuen kindlich -- Geschenk -- ich_es erkaufen -- 
  Herzog übergnädig -- drücken eifrig Hand -- 
  Schlaue stellen schwanger -- 
  Palast angenehmst Gegende bauen lassen -- rufen -- besorgen -- 
  Florenz -- Februar -- 
  Florenz fällen -- gehör Hasengeschlecht -- nirgends liebsn -- hecken -- 
  Mann -- Tacitus -- Schlacht Actium Rom Mann Aufstand -- 
  Bürger sagen -- Vaterlandsliebe eitel Ziererei -- 
  Freund Geschäftigkeit -- 
  ekeln bloß Schuster Schneider Tuchknappengeschäftigkeit -- 
  Romulus -- hoch Geist -- verbieten gut Grund Mitgenoss Republik nieder Handwerke -- hernach Sitt -- jahrtausend deutsch Spanier Franzose schier Ruin alt Herrlichkeit treiben -- 
  Sokrat Gefährten durch Leben -- Geld erpichen edler Muße -- stolz Ottoman Überwundene Sklave Schuld auf Schicksal schieben -- 
  Florenz stark Kontrast Rom -- regen bewegen -- laufen Rennt arbeiten -- Volk trotzig übermütig ungefällig Stille -- schön Römer -- 
  Römer gewiß hoch Charakter -- 
  Politiker menschlich Ameisenhaufe rühmen preisen -- Arbeitsamkeit einbilden -- 
  Maul Magen -- dieserweg geschieht_es -- wahrlich -- Mensch Vieh setzen -- 
  gemeinschaftlich Freiheit Person Eigentum -- Rang menschlich Nachbar -- Trieb Hauptband bürgerlichen Gesellschaft -- verachen -- jeder Verdienst kurz Berechnung -- 
  Boden tragen freilich hierzu -- Rom Mark mittlerer Italien -- Toskana Knochen -- alt Sprichwort -- 
  erheben Gegend -- Florenz fehlen majestätisch römisch Ferne -- 
  unser Hof herrschen unerträglich Langeweile -- Ton Monarch stimmen -- 
  Minister geschwind Chamäleon -- nehmen Modefarbe -- 
  verschieden angegeben Einrichtung abgeändern -- nachlässig betreiben -- 
  Heilungsmittel Hippokrat vergeblich -- Natur helfen -- 
  -- verderben Auge ansehen -- 
  besseres wissen -- ertragen lassen -- o Griechenland Rom -- glücklich Phantasie -- elend Leben -- 
  jetzig Italien -- Ausflucht -- Sphär gesund Kopf Arm handeln -- 
  Mut Geschick schmachten überall Gegenstand Ausübung Kerker -- 
  leidig Minister reden -- 
  Fuchs paar bestialisch Grundsatz annehmen -- -- 
  dürfen gescheit scheinen -- Herr -- -- gut Kopf -- Dorn Auge -- Gelehrt -- Ferne halten -- 
  -- Trübe fischen -- macchiavell ausdenken -- 
  meister Hof erkennen -- Philippe -- Alexander -- Cäsar -- Markantonin herrschen -- 
  hoch -- Flügel wachsen -- 
  Florenz -- Februar -- 
  Karneval wirklich ungeheuer Tragikomödie beschließen -- all Eingeweid -- Galle Lunge Leber Herz empört -- bleibend Stätte finden -- 
  bianca -- schreiben -- stellen gehörig Herzoge schwanger -- spielt Rolle meisterlich -- wählen festlich Geräusch -- erkauften Weiber Land Mutterwehe nahe fühlt -- niederkommen -- 
  Woche tragodiert Geburtsschmerze -- Herr zitternd zagend Leben bange -- 
  treten Mitternacht alt abgesäumt Kupplerin Amme geboren Knäblein -- Mund Wach verkleben verbinden -- schreien -- Schachtel Mantel -- Gerät -- Tür Nebenzimmer herein -- winken verabredet Zeichen -- 
  Bianca rufen alsdann Hand Mund Herzoge -- Kopf Arm Fenster stehen -- -- -- -- o Teuerster -- o weh -- fühl Entbindung -- -- 
  freudig fort eifrigst Wunsch -- 
  Komödie -- 
  alt Kind heraus -- übrig Szene täuschend zubereiten Gebärerin laut ächzen -- ziehen Wach Mund -- fing schreien -- 
  eilt eingebildet Papa -- zeigen frohlocken -- 
  -- Löwe -- Löwe gebären -- eu Geprag -- 
  O sehen eur Hoheit derben gewunden Gemächtche -- Heldensamen verkündigen -- -- 
  beschreiben Aristophanisch -- zugetragen -- 
  Götterwonne -- lebendig erblicken -- schaut -- kräht Jubel -- gleichsam Hahn -- Wort hervorbringen -- 
  Pos -- Folge -- heiß Kammerjungfer erfahren -- 
  alte hochstrebenden nehmen -- Styx Phlegethon sied brausen hören -- 
  Auftritt gräßlich -- 
  Don Paolo -- Gemahl Isabella -- Rom -- gewiß Scherz Leichtsinn vorig Aufführung -- täuschen -- froh versöhnen glauben -- 
  Nacht -- Bianca Farce spielen -- wunderbar füg Begebenheit -- führen Schlafgemach -- Anstand -- begleiten -- halten einigemal -- Geist Schicksal voraus ahnden -- 
  folgen ergiebig Geschöpf Händedruck -- halten Racheheißen Liebewärme -- 
  Zimmer umarmt -- küssen -- sinken unenthaltsam auf Bett -- 
  Breite hingestrecken liegen -- hinten Strick Hals werfen gedungen Mörder -- lang Marter erdrosseln -- 
  O Elender -- Gift -- Dolchstich -- Welt schaffen Wolltest -- 
  Nacht Familie Kirche S. Lorenzo begraben -- sprengen -- plötzlich Steckfluß sterben -- 
  schwarz Gesicht -- sehen bekommen -- unverwerflich Zeuge -- 
  verwandter schweigen -- 
  Florenz murren laut -- bejammeren scheußlich blühend Leben -- 
  gleichzeitig handschriftlich Chronik melden -- -- 
  che bisognava av Rimediato prima -- Che Il Padre -- e il Granduca Francesco -- il Kardinal -- & Altri Suoi Fratelli Servissero del Mezzo suo per Cavarsi le lor Voglie -- e con le Altre Donne Della Cita Menandola Tutta Notte Fuori vestita Uomo -- e Voler poi -- ch ' Ella fusse Stata Santa Senza il Marito -- 
  Beschluß -- schier gleich erzählen -- e questo fu il Misero fine delle Figliole del Duce Cosmo de Medici -- 
  März -- Cortona -- 
  Herzog erlauben -- künftig Frühling -- Bedingung -- zuweilen Florenz kommen -- angelegt Palast Bianca besorgen -- 
  Partei zurückgelassen -- Haus leben Hoffnung -- Gemahl Schwiegersohn erhalten -- 
  Polybios Gegend Geschäft -- Abwechslung Bau pflanzen -- 
  deutlich Sinn Wort Taktik alt Grieche Römer anfangs schaffen -- Durchgedrung -- Rand kommen -- 
  geschichtsschreiber -- -- verstehen -- worüber schreiben -- leben -- Mensch Ort kennen -- 
  heldenzügen ergreifen -- Hannibal Italien -- geschehen bloß -- Land Boden Geschichte kriegend Volk kennen -- 
  Alexander Persien romantisch barbarisch Getümmel -- 
  Afrikaner Einheit -- Nerve -- Kernathletengeist -- and Naturschauspiel -- Republik Haaren liegen sehen -- bloß Darius Sohn Philipp -- 
  Satz wild schnellströmenden Rhodan Avignon -- kühn Marsch reißend Wetterbäche -- hundertjährig Schnee schneidend Eis gräßlich tief Täl himmelhoh Alpenklippe -- dünken Schlacht Olympisches Faustbalgerspiel sehen -- 
  Trebbia -- thrasymenisch See -- Aufidus -- packen überall tapfer gebildet Haufen wenden stark ungelenk Gegner -- werfen Boden -- schlagen Zahn Nase Ohr backen blutig Brei -- 
  verstehen Kunst siegen -- -- behandelt Armee hunderttausend mitten Schlacht einzeln Mann -- Fleck -- Schwäche voll Vorsicht -- Bewegbarkeit -- Mut Schlauheit -- Gegenwart Seele -- einfach Grundsatz weitläufig Kriegshandwerk Jugend bringen -- 
  halbgötter erkennen wichtig Zeitpunkt -- 
  Reihe Tat -- 
  Million Mensch -- Leben einzig Stunde -- 
  Heldengedicht singen Pyrenäen Scylla Fuß Apennin rauschen -- 
  echt unbezwinglich rächerisch Löwe streifen Italien -- reißen Rind blökend Herde nieder -- Homer verbrauchen Gleichnis erstenmal -- 
  römisch Volk -- Bildsäul Straße stellen -- furchtbarsn sehen -- hernach seinetweg Mauerstein Karthago ereiferen -- zeigen Mann Feind -- ungerecht Horaces Livius -- Virgil krümmen Überwinder Cannae Hofspötterei Dido Haar -- 
  Ausbund Karthaginens Römischen Staatskörper Herz -- kannen Mensch -- wissen -- groß Feind Nähe -- finden welsch Gallier -- 
  Schlacht See zieren Gegend -- Konstantin Schlacht Raphael Vatikan -- 
  furchtbar Wort -- wunderbar übrig bleiben -- pont Sanguinetto -- Ossaja -- Spelonca -- Brandfackel Seele -- herumreite -- zuweilen Hitze Ungeduld Pferd bleiben -- herunter Wirtshaus -- frisch Zug Römergrimm -- Gras -- Weinfeld düngen -- 
  Blutbrück -- gleichsam Po Tyberbrücke -- 
  Knochenberg -- 
  Mordloch -- 
  Treve -- April -- 
  schreiben Flug -- künftig Sommer -- Schönheit Reiz Gegende zeigen -- genießen -- glücklich -- Lombardei Lago Genoß -- 
  mach Zeit -- kehr Tante Florenz -- treffen -- 
  liegen Passignano -- Wohnung -- fruchtbar Anhöhe -- See überschaut -- hoch Ulme Eiche -- alt Ölbäum Zypresse blühend Wipfel -- Gesang Nachtigalle -- früh -- -- hören betrachten Freude -- Kind Gedanke -- ahndet süß Regung Herz entzückend Ding -- 
  Sieh -- reiten Hohlweg -- Bo voran -- jung Ritter hervor kastanienfarb königlich Roß -- Mohr folgen -- 
  Engelsgestalt Jüngling -- näh rund Hut Federbusch -- kurz spanisch scharlachen Mantel -- Halbstiefel -- voll Schenkel schlanken Leib weich Leder kleiden -- blitzend Schwert Rücken Lend -- Pistole Sattel -- 
  kennen halbversteckt Gesicht -- wissen drein finden -- 
  -- täuschen -- fahren schnell -- reizend Ritter -- 
  erblicken -- halten lächelnd Verwunderung -- springen Pferd -- Fiordimona halten umschlung Wonneglänzend Blick -- gierig Seelenküß -- 
  schreiben Florenz -- begeben Nachricht eins Gut Nachbarschaft -- wovon -- überrasch Lustreise abzuholen -- 
  Perugia -- zuvor eintreffen -- sitzen Dunkelheit -- Stunde -- 
  bleiben Göttertage -- Cortona Liebe fühlen -- geraten vorübergeh Annäherung Feuersbrunst -- plötzlich Stille müssen -- Wohnung Lot Haus belagern -- 
  Fiordimona verändert Kleidung -- Hut Mantel -- bemerken reisen -- 
  scherzt vorig Putz -- Weiber vergessen können -- verkappt Mohrin -- 
  jung treu Schweizer Häl -- Gemsjäger Wallis Quelle Rhodan -- Paar Paar ziehen Nacht -- vorher schreiben Herzog notwendig Lüge -- Tante paar stark Wechsel -- 
  Perugia weideen inniglich -- eingenommen Frühstück -- Raphael -- Liebling -- Werk Lehrmeister -- 
  Ritt Höhen herab anmutig Täler -- Johannisbrücke -- worunter Tyberstrom reißend rauschend wild Flut wegschießen -- halten Mittagsrast schön Hügel Assisi heilig Kloster -- 
  Nacht bleiben Foligno -- 
  ziehen reizend Tal -- malerisch Schönheit Fruchtbarkeit gleich nächst Lombardei Erdbod -- schied Treve abgeredet Maß -- 
  begeben -- liegen -- -- -- 
  Lustörtchen schön Lage Gegend -- rund hoch Berg Hälfte herum bauen -- weiten Olivenwald ausmachen -- 
  Mensch scheinen Vogel Baum Haus obenhin nisten -- 
  übersehen Tal Spoleto Foligno -- Assisi Perugia -- Flecken Redeplatz -- la Ringhiera -- Umbrien -- 
  Fiordimona Aufenthalt üppig Gärt Fruchtbarkeit Lieblichkeit Quelle Clitunno -- le vener -- -- Fuß hoch Berg Umkreis -- Campello -- Fels uralt Feigenbäume bewachsen unzählbar Sprung -- 
  unaussprechlich Vergnügen -- klar -- kristallhell -- frisch gesund Naß aufquillen -- zart Bläsch treiben -- erfreulich Schatten -- innerlich regen bewegen -- Fülle eben Fläche fortrinnen -- 
  Nahe wall Bäche Garten Fiordimonen hinein -- drängen lebendig Teich -- Ufer hoch ahornen -- Pinie -- Lorbeer -- Reb Haselstaude beschaten -- strömen Clitunno ansehnlich Fluß -- voll schnell Forell -- Italien stark Quelle kennen -- 
  tausend Schritt stehen Tempel korinthisch Säule zierlich Ferne -- obgleich spät Zeit -- Flußgott Ehre -- Römer Vieh wissen -- 
  Rind Tal glänzend Silberweiß -- außerordentlich gutartig ungeheuer Hörner -- 
  Strom -- Name geben -- bleiben Tal kristallhell -- 
  geben Wirtshause Maler -- wahrlich mal zeichn Mensch -- Vieh -- Berg herrlichen Form Tint -- übrig bleiben -- 
  nächt steck Fiordimone -- zuweilen unser Brand heißen Witterung lieblich See Clitunno abkühlen -- schwimmen Fisch -- zart Kindheit anlehren -- Schwan Schlummer aufwecken -- Herde -- 
  König Wasservögel Lieblingsvogel -- schöneren -- lockend lebendig Bild Lust -- Häls umflechten -- Entzück leis kreisch zusammengirren -- Flügel schlagen -- Gesang Nachtigall verschwinden -- geschwätzig unaufhörlich Getön -- 
  meisten lassen wild fliegen -- kenn Plätzch -- -- 
  Woche -- -- Himmel schnell -- 
  Halt -- erfreulich -- 
  lassen -- Mohrin -- begleiten -- 
  Übermorgen Nacht brechen heimlich -- streichen -- Haus glauben -- Rom reise -- 
  Terni -- Mai -- 
  Himmelreiche -- 
  paar kühn Adler jagen weit Lustrevier -- 
  Freiheit -- Quellenjugend -- feurig Liebe Zärtlichkeit -- 
  gestern Abend kommen rauh Wald wild Gebirge Spoleto -- Sturz Velino Frühe ausgezogen -- 
  betrachten -- 
  Weg voll reizend Aussicht -- Berg wölben hoch fort gen Himmel -- gleichsam Paradies irdisch Welt abzusondern -- 
  Sonne -- Höhe riten -- Gebirge Felsenriß hinein -- worin herrlich See befruchtend Taunebel Mitte schwamm -- 
  Wasserfall entzückend Vollkommenheit Art -- mangeln -- höchst reizend -- 
  stark Strom -- feindselig unschuldig Völkchen handeln -- bändigen tief Kanal stürmend wild Wog wälzen -- allerlei süßer lieblich Gesträuch umpflanzt -- hoch grün Eiche -- Ahorn -- Pappel -- Zypresse -- Buche -- Esche -- Ulme -- Seekirsch -- gräulich Tiefe senkelrechen zweihunderen Fuß hinab stürzen -- Wasserstaub hoch unten herauf schlagen -- 
  Alsdann toben schäumend Fels fort -- breiten -- rauschen zürnend grün Bauminsel -- hastig schießen Grund dannen -- zauberisch Garten selbstgewachsen Pomeranze -- Zitron -- Frucht- Ölbäum -- 
  Fall dauern Sekunde -- gewöhnlich Pulsschlag Höhe Tiefe -- 
  Aufschlag zurückspringend Wasserstaub heroisch süß Ton -- erquicken gehört donnernd Musik Veränderung Klang Bewegung Ohren -- Auge müde sehen -- 
  Fiordimona jauchzt Freude allgewaltig Leben hinein -- rufen brausenden Ungestüm -- -- Kunstwerk vollkommen Art -- eins Homer -- Pindar -- Sophokles -- Praxitel Apelles -- wozu Mutter Natur Stoff Hand lieh -- -- 
  gewiß lassen vergleichen -- einzig Art -- Natur herrlichen Gebirg herum -- frisch Reiz lieblich Zierde Sturz Fall umfassend Baum -- einfach -- Auge entzücken -- Zerstreuung -- wollüstig verziern -- völlig kunstlos -- nähren Mensch Geist lauter kräftig Kern -- 
  sitzen Alsdann -- ritt Velino entgegen -- Stunde Sturz See kommen -- worin klar waschen -- 
  Mannigfaltigkeit Strom -- langsam schnell Lauf -- schön Waldung eingefaßt Bett überall -- See Rundung Amphitheater nacheinander verlierend hoch Gebirg umlagern -- -- fruchtbar Tal Szene -- ehemalig Streit Nachbar Wasserfall Wunderbarer ergreifend -- 
  Abgemalt zeigen gestern Ankunft Kopie Original -- 
  malen bleiben armselig Fragment Leben -- Anschauer Gemäldes -- Natur -- blühendst Phantasie hinzuzudenken vermögen -- andeuten -- 
  Frechheit Künstler -- vorstellen -- wesentlich bloß Bewegung bestehen -- 
  Tizian zeigen klüglich Wasserfall Ferne -- Bewegung verlieren still stehen scheinen -- 
  Terni -- Vaterland Geschichtsschreiber Tacitus -- liegen äußerst angenehm laut Garten -- 
  Nordseite erheben Bogen Hügel lustig Landhäuser -- meistens Ölbäum -- Wald ausmachen -- 
  Nera -- worin Velino Namen verlieren -- Menge Kanal ableiten -- Stadt Land herum -- lebendig Rauschen -- hoch Fruchtbarkeit bewässern -- 
  Tivoli Reiz alt Römer -- nahe Rom liegen -- weiten Aussicht Ebn herum an Meer -- 
  feierlich -- Terni -- 
  Grund groß Natur -- lassen Fruchtbarkeit Tivoli Vergleichung -- dürr öd Land meistens -- Terni lauter Mark -- 
  Römer verstehen leben -- Genosse wahr Reiz -- wissen wählen tausenderlei Erfahrung -- 
  Scipio jung wählt Terni -- Landsitz zeigen -- alt Cajeta -- erhaben Tochter Cornelia Misenisch Vorgebirge -- letzter Ort Meer freilich -- lebendig Meer -- Mannigfaltigkeit Bewegung -- 
  O freu -- alt glückselig Bajä finden -- 
  Terner erweisen Ehre -- setzen Fiordimone Verlegenheit -- befürchten erkennen -- mutwillig Brüste -- stolz jung Schönheit -- Kunst vollkommen verbergen lassen -- 
  lächeln -- erröten -- 
  begeben platterdings sitzend Gesellschaft -- Abend Wasserfall unten geriten -- eilen -- 
  unten Mutter Natur Schoß -- genießen Höh Tiefen Erde -- schaff wirken -- Fülle Leben -- 
  eng Tal äußerst reizend Kontrast -- welsch Milde Schweizerrauheit vereinbaren -- 
  himmelanstrebend Gebirge -- donnernd Wassersturz -- hereinbrausend wild Flut -- -- zart Pommeranze Ölbäume -- Lorbeerngänge -- süß Reb Feig -- mitten Fels Kapelle heiligen Rosalia -- Bildsäule heilige -- weich Lager ruhen -- Blume bekränzen -- leiseschwebend Engel -- 
  Portici -- Junis -- 
  Freude laufen Glied -- besuchen -- o Götterjahr Leben -- 
  Tant schreiben -- Quartier bereit halten -- Ankunft hoff Florenz treffen -- 
  nächster abreisen -- 
  unser Abenteuer erzählen -- wissen -- anfangen -- verspar Herz Seele mündlich ausschütten -- 
  O welch Jubel -- bezaubernden Platz Umbrien streichen -- 
  Fiordimona völlig Wesen -- zusammengeschmolz tausendfach Entzück -- hoch schön -- kühnen heroisch erduldend menschlich Natur vereinbaren -- 
  Band Ehe bürgerlichen Ordnung tragen -- wahrlich -- halten -- O glücklich Hafen stürmisch Wunsch -- 
  kennen innen außen geheimst Regung -- 
  Reise immerwährend Augenlust -- 
  Weg Mont Cassino nehmen -- 
  fühlen Schönheit Italien -- sinnlich -- Apennin Majestät Mitte lagern -- Erfrischung luftigen waldicht Gipfel Sommer reizend Täler Ebn Meer Winter -- 
  weit Kreis türmen Gebirge -- Farbenspiel unendlich Höh Tiefe Ton süß furchtbar Harmoni -- 
  heilig Benedikt trefflich Schar sorgen -- Mönch Mont Cassino leben Fürst -- 
  bedienter -- Kostbarste Land essen trinken schläft weich Bett Stahlfeder -- 
  übrige verstehen -- Vorsorge bereiten Fiordimona Krankheitsschminke -- Bruder -- Sänger -- Gesundheit Bäder Bajä zöge -- 
  durchkommen -- schelmisch Faune wittert blühend Gesundheit Fleisch Mandelker angestrichen Gelb -- 
  prächtig Kloster liegen steil Absatz hoch Berg -- unten Burg Zeus -- umgekehrt Wetter Jahr paarmal einschlägen -- kurz Ferne stolz Amphitheater Gebirge umgeben -- Sonne Untergang zauberisch Schauspiel hervorbringen -- 
  Neapel aufhalten -- auf Land hierher ziehen -- Land nennen -- Portici gleichsam Vorstadt -- bewohn Garten jung Witwe -- Tarent gebürtig -- lieblich Name Candida Graziosa führen -- Punkt -- wirklich Paradies beschauen -- Neapel göttlich Meer einschließen -- 
  Stadt sehen wahrsten -- Sitz Vergnügen -- voll Adel -- voll lebhaftest Mensch -- rundum Schönheit Fruchtbarkeit -- streng erhaben Weisheit ist_es fast -- gelangen -- 
  linker reizend Küste Sorrent -- Fahrt Elysium Sizilium -- Insel Freude Tiberius -- Capri -- unendlich Gewässer breit -- Auge verlieren -- alt Feuerauswürfe Insel Ischia -- Procida -- entzückend Strich Hügel Pausilipp -- Gebirge Kamaldulenser -- bezaubernd Mannigfaltigkeit -- Gemisch unzählbar Felsenhütt Neapel -- halb Million Mensch gütlich -- -- schüchternen Portici -- schrecklich Majestät Vesuv -- 
  echt Wonneschäumender Becher rundum Meerbusen -- 
  schwimmen schweben Lust -- Wasser -- Ufer -- Straße -- 
  Feuermassum scheinen Land Sonne nah rücken -- sehen -- übrig Welt -- 
  gewiß Planet ehemals Sonn -- ausgebrennen -- Neapel Rest stolz Zeit -- 
  glauben Venus -- Merkur -- hoch Planet wohnen -- 
  Immerwährender Frühling -- Schönheit Fruchtbarkeit Meer Land -- Gesundheit Wasser Luft -- 
  Woche Gegend besonderer Art Mensch -- Vulkan -- nossen Anblick hoch Gewalt Krater -- Erdbod schauen -- 
  Riß unten heraus -- trichterförmig -- Wetterschläg -- auffliegend Pulvertürm Einbrüchen stürmenden Meeres -- 
  Erdbeben -- Land bewegen -- Winde Wasserfläche -- schwach Vorbote -- 
  glauben Wohnung Donnerkeile Schlangennest hineinzusehen -- blitzschnell unergründlich Tiefe gerissen -- Metall bespritzen Schwefel belecken -- 
  entzückend schaurig Bild allerhöchster Wut -- 
  Gipfel bestehen lauter Schlack -- fern haarig Riesengestalt -- 
  wachsen lauter Heide -- Mitte fangen Gärt Baum -- 
  Vesuv augenscheinlich uralt Berg -- Krater einst zusammenstürzen -- wovon Riß Somma sehen -- 
  Alsdann Ausbrüche auftürmen -- 
  vorher einzig Berg -- schön -- desto furchtbar -- 
  -- Schauspiel Aussicht ergötzen -- 
  Aufenthalt Garten Candida Vergnügen gewähren -- Freiheit benommen -- Ursache -- zurückreisen -- -- 
  bewohnen Geliebte Sohns Vizekönig -- reizend Spanierin -- sechzehn siebzehn alt -- sogenannter Gräfin Coimbra -- 
  brennen Leidenschaft Fiordimone -- Candida Geschmack -- besser Instinkt jung Bart vergaffen -- 
  belagern -- 
  Coimbra eifersüchtig -- Candida Fiordimone -- Sohn Vizekönig -- schöpft Verdacht -- 
  Komödie fing -- 
  kauft Ankunft Neapel Laute Zither Zeitvertreib -- Nacht Portici halten Wechselgesang -- 
  Coimbra entzücken Stimme Fiordimonen -- -- sagen -- Arm stark Kehl strömen Geschmeidigkeit Mannigfaltigkeit -- leisen Lispel Sturm -- Läufen erstaunlich Umfang -- Ton Perlenrein Herzig -- 
  Abend hören Lied Nachbarin -- wozu Psalter begleiten -- 
  Stimme schwach -- einfach -- voll Tönen -- silbern süß Empfindung -- singen -- Meisterstück spanisch Poesie -- strophen behalten -- 
  Quando contemplo el cielo -- innumerables Luces Adornado -- y Miro Hazia el suelo de Noche Rodeado Sueño Y Olvido Sepultado -- 
  El amor y -- pena despiertan mi Pecho UN Ansia ardienen -- despide Larga Vena Ojos hechos fueren -- O loaren -- y Digo Al fin con voz Doliente -- 
  Morada -- grandeza Templo de claridad y hermosura -- el Alma -- que tua Alteza Naciò -- que Desventura -- Tiene Esta Carcel baxa escura -- -- 
  Himmel betrachten unzählbar Stern ausziern -- nieder Boden schau Nacht umgeben -- Schlaf Vergessenheit begraben -- 
  erwecken Kummer Liebe Brust heiß Bangigkeit -- Auge -- Quelle -- vergießen Bach Träne -- Oloarte -- sagen klagend Stimme -- Aufenthalt Herrlichkeit -- Tempel Klarheit Schönheit -- welch bös Schicksal halten Seele -- Höhe gebären -- tief dunkel Kerker -- -- 
  Jüngling vermutlich -- Hörte Hernach sprech seufz still Kuß Umarmung dicht Laube -- 
  -- schön Abend -- kühlend Duft senken nieder -- hüllt Gebirge -- verwischen Form dämmeren unten -- indes rein vollkommen Stern blinkten -- 
  meinen -- müssen sogleich Liede holden Spanierin empor heben -- Stelle verlassen -- 
  unten -- klar himmlisch Licht Gestalt empfangen -- 
  still Mond wild dampfend Vesuv -- dunkel liegen Meer Schatten -- erwartet unendlich leise plätschernd Schläg Ankunft -- 
  Mensch kühl Flut -- Chorus -- scherzen genießen weg -- 
  entzückend -- Erde gen Osten unaufhaltbar fortrollen sehen -- Harmonie Weltall fühlen -- 
  -- glücklich Mond -- seufzen Fiordimona -- läufst Bahn ewig fort -- Schicksal entscheiden -- -- 
  -- Gott -- wissen -- Licht -- schön leuchten -- erkennen -- gewiß heilig Wesen -- tot -- schnell fortbewegen -- -- 
  -- O Masse -- Himmel Meer Mond Stern -- Frescobaldi -- liebevoll Herz schweben -- 
  Ruhe Seligkeit -- 
  atmen schöpfen Zug Lust Erquickung -- -- 
  Denke Wonnelaute -- unmittelbar Quelle -- Kuß Blick Umarmung Erhabene -- 
  Coimbra hernach Bekanntschaft -- reden -- Spaziergange begegnen -- gefühlig zart Wesen -- worin kühn Blitz Leidenschaft herumkreuzen -- 
  wörtlich Liebeserklärung erfolgen -- Fiordimona unerfahren Jüngling Händedruck schmachtend Seufzer Blick bezeugen -- 
  Fiordimona spielt Rolle trefflich -- erkennen geben -- Tätlichkeit Fortreise abhalten -- gegend herumgestrichen -- Haus bleiben -- schlafen -- 
  Quartier hoch Notfall ändern -- Anlaß gefährlich Auftritt -- 
  meister Bajä -- Pausilipp -- Küste Sorrento -- 
  Zaubereien mündlich weitläufig -- 
  Bajä Wunder Natur -- alt Römer Zeit Wunder Kunst -- wovon herrlich Ruine Beschreibung Dichter zeugen -- 
  archipelagus -- immerwährend Leben unzählbar Insel herumwallt -- -- 
  Glückliche Grieche -- Drittel bewohnn bewohn schön Seeküst -- 
  Grabmal Virgil -- Echtheit Grund zweifeln -- rührend Winkel -- innerst Punkt alt Parthenop -- Mittelsitz Ruhe See -- Spitze Winkel Bucht -- 
  wünschen Ort Asche -- Pomp -- still -- Gemäuer -- 
  liegen Pausilipp Höhe Alter durchgehauen Grotte Pozzuolo -- 
  Pinie scheinen allemal voll Ehrfurcht Schatten neigen -- leis bewegen -- Schlummer stören -- 
  schön -- Stelle -- Erinnerung Mensch lieblich zusammensammeln -- 
  Denkmal warm hell Empfindung gewählt Stätte mancherlei Gesträuch bekränzen -- Efeu -- wild weinranken schlingen überall herum -- Decke -- Jahrhundert Schicht Erdreich festgesetzen -- grünt dichtesn -- 
  Lorbeer steigen Mitte stolz hervor -- dauern -- reisend -- Dichter -- Prinz Dame abbrechen -- Anteil Ruhm Unsterblich -- 
  genießen Neapel erfreulich Meerbus schönsen Gesichtspunkt -- 
  Sorrent liegen Berg einschließen Tal -- Form Hufeis -- 
  bezaubernd Plätzche weit Paradies Gegend -- wohinein Meer besonderer Bucht -- 
  Ufer hoch senkelrecht Fels -- Bühne zeigen -- 
  See halb Stunde Weg Terrasse hinansteigen -- 
  niedlich Haus Pallästche stecken Gartenwald Oel-Pommeranzen-Zitronen- Fruchtbäume -- wachsen köstlichst Melon -- 
  Vesuv einfachsen -- allergrößt -- furchtbarst Gestalt sehen -- stolz erhaben -- hoch Alpen verschwinden -- 
  sehen Wesen -- -- Kot -- Dampf offen Rachen eigentlichst Verstand entsetzlich schön -- 
  Ort Feuerauswurf betrachten -- wahres Bild rasend Hölle -- 
  unten Fuß Mensch Wohnung unschuldig Lämmer -- Beute herschleppen -- alt Mutter See ziehen vergebens zärtlich rauschend heran -- retten -- 
  entzückend -- Portici hinüber schiffn -- leicht Nebel decken zart Bettdecke -- 
  Gewässer tausend Nachen -- unbesorgt Fisch fangen -- Tiefen Licht nähern -- 
  Leisewallend -- unermeßlich Lebensquell -- verlieren Meer Chaosdunkel -- woraus Capri sichtbar grauem Duft hervortreten -- 
  blass Purpur rötet Apennin Himmel -- Vulkan atmen schrecklich Sonne entgegen majestätisch Ruhe schwer Dampf -- Seite herabwälzt -- 
  steigen empor Strahlenglut vollkommen unveränderlich -- Geist Welt -- Liebe fassen -- Glanze spielen Welle -- 
  Neapel fällen -- -- weder Sonne Mond -- Morge Abendster Meer auf untergehen sehen -- 
  Nachschrift -- 
  fort -- -- 
  Coimbra brennt lichterloh Flamme -- Drang gestern herzbrechend Brief -- Fiordimona sollen entführen -- 
  Candida schlich Nacht -- fein Wendung überdrüssig -- Zimmer schier nackend -- überraschen Fiordimone -- Geschlecht erkennen -- 
  Häl -- treu -- Genuß Kammermädchen Spanierin dran -- verkündigen Mord Tod -- ausgestellt Wacht Posten getäuscht Liebhaber -- 
  letzter Brief erhalten Florenz Tante -- jung Witwe Kind -- voll Geist Anmut Umgang mannigfaltig Reiz -- 
  Ardinghello kommen Ankunft -- erteilen anfangs Ausbleibe zweifelhaft Nachricht fürchterlich Begebenheit -- hernach gewiß bestätigten -- 
  vorher -- Reisegesellschaft -- Briefe weggelassen -- Angelegenheit betreffen -- Geschichte verwickeln weitläufig -- 
  stehen Punkt -- verheiraten -- Geliebte Seuche weggeraffen -- Trient Verona -- Venedig -- hernach Lombardei verbreiten -- 
  folgen Begier Einladung Freund -- traurig Gegenständer entfernen -- Cäcilia -- 
  Ungeduld bleiben -- Reise -- 
  entdecken -- Ardinghello wissen -- scheut Lage -- versetzen -- 
  zuweilen Nachricht -- Verschweigung Liebesgeschicht -- schreiben -- Brief Hand kommen -- 
  wissen -- Wendung brauchen -- stehen -- 
  drein misch -- Taube predigen -- lassen -- gewissermaßen nötigen -- Sache baldigen Ausgang -- 
  Cäcilia bereden Vater Mutter Wallfahrt Loretto -- 
  Brüdern Korfu -- bleiben Haus -- 
  brach Geschwindigkeit -- 
  Söhnche -- Engel -- 
  Vogel -- Frühling zueilen -- -- 
  -- O unser Ardinghello sehen -- -- heißen Florenz -- 
  Gerücht Stadt -- jung Anverwandt Papst ermorden -- Staube -- 
  -- Leidenschaft Verdacht erregen -- 
  -- O Gott -- -- Wort -- blaß Lilie -- verstummend begeben Seite -- 
  Eltern befürchten -- Krankheit -- 
  leiden Todesquale -- ferner erfahren -- Mitternacht Palaste Fiordimona geschehen -- 
  unglücklich lieben wahrhaftig -- Grund Seele -- 
  Sonderbarer Weise halten Gasthofe Fulvia Gemahl -- genua bürgerlichen Unruhe verlassen -- worin verschieden Edle Leben einbüßn -- 
  allgemein Strafgericht scheinen Italien Ausspruch Gottesgelehrt sünd Bosheite verhängen -- 
  führen Söhnche -- voll mütterlich Liebe säugen -- -- 
  wahrhaft Bacchantinfigur -- griechisch Basrelief -- alt Gemm weg wirklich Leben zaubern -- 
  Glut schlagen schwarz Auge -- Lippe scheinen Berauscht dürsten -- 
  müssen Gerücht Ardinghello erfahren -- 
  laufen anderer herum -- Kardinal -- Bruder Großherzog -- Anverwandt Papst ermorden -- Ardinghello -- 
  entwichen vermutlich -- Verhaft nehmen -- Schuld mächtig Kardinal büßen -- 
  schweben Furcht Hoffnung -- 
  Fulvia Rom -- obgleich kurz Kindbette -- Genua Florenz gemacht Reise ermüden -- -- Quelle gelangen -- 
  Demetri -- wissen -- -- Freundschaft Ardinghello deutlich Probe anzeigen -- 
  schlau sicher betragen -- 
  glauben -- Ardinghellos Tante Begebenheit kundig -- lieben schier -- Gefahr behutsam -- 
  Rom erfahren -- Kardinal Nacht -- Anverwandte Papst ermorden -- Hand Arm geschicktest Chirurg verbinden lassen -- stark Wunde sein verhauen -- 
  tags Fiordimona Wache Zimmer bekommen -- befreien -- Papst Untersuchung Fiordimonen Rom verbannen -- Gut verweisen -- 
  Sache liegen vertuschen -- lauren Ardinghello Täter -- Kundschafter Ort ausgesandt -- 
  Gewissere Nachricht erhalten -- 
  reisen Rom Loretto -- halten Sommer Herbst Gebirge Apennin -- Cäcilia tief Trauer Seele -- Kardinal unser Liebling heimlich Weg räumen -- 
  vertraut Punkt -- gestehen Leidenschaft fassen Mut tief Treue -- weint Kind unselig Schicksal -- -- angeschwollen Herz erleichtern -- 
  umschlang Band vertrauen innig Freundschaft -- 
  November empfangen Brief -- August schreiben -- Demetri Tante -- letzter -- verspäten -- 
  dünken -- fürchterlich Traum erwachen -- Glanz Morgenröte schauen -- Zug Hand erblicken -- 
  Brindisi -- August -- 
  widerwärtig Schicksal erheben -- niederschlagen -- stark Widerstand -- desto gedrungen Geschwellter regen -- 
  glauben Genuß Ruhe -- beginnen Arbeit -- 
  sehen neu Leben -- hoch Getümmel ergreifen Sinn -- 
  -- Kind hinein kommen -- 
  Leben Jüngling Liebe -- Leben Mann Verstand -- 
  -- sprechen -- 
  kommen Nacht Rom -- schicken Häle Pferd voraus -- Fiordimone vener nachfahren -- vermähl -- 
  Stadt verschieden besorg Mitzunehmen -- zerstören zerrissen -- 
  versteckt Demetri -- Kardinal wittern -- erzählen -- Liebe verfolgen -- leiden -- 
  Nacht fürchterlich Donnerwetter Regen Rom -- schmettern Schlag Schlag -- untergehen -- 
  Stadt Freude Naturbegebenheit -- hören sehen -- diesmal bingen Herzen -- 
  Mensch sonderbar Wesen -- voll dunkel Gefühl -- Philosoph aufklären -- gewiß Ahnung -- bevorstehen -- 
  werfen Mantel -- bloß Degen Gefahr Arm -- fort -- Fiordimone schrecklich Nacht lassen -- Palaste Sommer paar alt Bedienten Frau zurückbleiben -- 
  Schlüssel Seitentür geben -- 
  eilen -- langsam -- halten Schritt -- 
  gäßch Garten -- Schlafzimmer -- plötzlich angefall Dolchstoß Seite -- 
  springen -- Blitz machen Finsternis hell -- erblickt Mörder -- ausweichen -- 
  rennen -- unterlaufen -- stoßen Stelle nieder -- 
  Wort aussprechen -- indes Donner brüllt -- Erde dröhnen -- 
  vorbei -- Begriff -- Leichnam wegzuschleppen -- 
  treten verkappt Gestalt -- setzen Tigersprüngen -- Not Augenblick erhasch -- Wehr stellen -- 
  -- Vermaledeit Brut -- -- hören Stimme Kardinals -- vorgehalten Klinge Brust laufen -- bepanzern fühlen -- 
  erstaunt erschrocken Folge -- abhalt -- gebraucht Stärke -- glücklich -- Degen herausschlug -- hieb Hand -- womit Raserei Gewehr fassen -- schonen Leben -- laufen -- Nebenweg Demetri -- 
  erzählen -- geschehen -- vertraut hauptsächlich Geschichte Fiordimone -- edl Charakter erhalten Gelegenheit -- zeigen -- 
  verbergen unerforschlich -- helfen folgend Nacht fort -- erfuhren -- Ermordet -- Bandit halten -- Vetter Papst jung -- * * * * -- 
  wütend Fiordimone verlieben -- -- 
  Wunde gestreifen Rippen weg -- Stichblatt Degen Arm halten Stoß -- braucht Chirurg -- 
  Tolomei verkleiden Franziskaner -- pontinischen Sümpfe Fuß -- Capua Kalabrien Brindisi -- 
  Heroen -- echt Theseus Peirithoos -- Orest Pylades -- Demetri -- 
  O Mensch Zeitalter -- edle Natur bleiben irgendwo Erdbod -- 
  Fiordimona dauern -- Feuer -- brennen -- 
  Demetri kurz Nachricht ferneren Erfolg Tolomeie Brindisi geben -- Ding -- melden -- vorbeigehen -- ungefähr Brief auffangen -- Kardinal Mord Arrest bekommen -- 
  -- -- heilig Vater schreiben -- Großherzog -- Kardinal -- Natürlichkeit Notwendigkeit Begebenheit -- Unschuld vorstellen -- 
  hinein Wasserwelt -- o klopfen Herz -- 
  O Vaterland -- Vaterland -- Kette Bande sehen scheiden -- 
  Leb -- schön Italien -- leben -- leben -- Venedig -- Genua Rom -- 
  O warst wert -- stolz Land -- Herrschaft Welt -- 
  Umarme küssen Cäcilia -- himmlisch Geschöpf kein Brust aufheben glücklich -- Freund -- 
  Befürchtet sünd -- groß Halbgötter Jollen empfangen Frucht Liebe Sohne Gattin -- 
  Lucinde -- brennst Herz -- verfolgunger erzürnt Himmel dulden -- ich_es büßen -- 
  Lebt Höh Apennin entzückend Täler -- 
  königlich Po -- Tiber Arno -- -- klar Quelle Clitunno -- 
  günstig Wind schwellen Segel -- flieg Ionie entgegen -- 
  reiß eur Herz -- o all Liebe -- eurer würdig -- 
  Ardinghello -- 
  Fiordimona Schuld -- erkennen -- wohin schön System führen -- 
  vermutlich Neffe Papst Gehör geben -- Kardinal Gehör geben -- suchen -- Ardinghello anderer Lust Freude -- Schönheit Inbrunst fesseln -- lassen jugendlich Taumel überschwänglich Reiz fangen -- 
  Verwegen Reise Neapel wahrscheinlich -- erster Abzubring -- Weg Quelle Clitunno wissen -- Ardinghello möglich Lust ungestört genießen -- 
  weib Natur verleugnen -- folgend Winter Zwilling beiderlei Geschlecht nieder -- finden Stande gemäß -- Vater Gemahl besitzen -- 
  Mohrin müssen heftigst Drohung Zweifel Kardinal Reise Ardinghello anzeigen -- sagen -- wohin -- 
  Rom vener voll Rache Zurückkunft lauern -- 
  Leidenschaft zärtlich Paar Maßregel behutsam nehmen -- 
  Ardinghello allgemein bedauern -- Fiordimone tadelen -- machen vollkommen Paar -- breit finden -- 
  Verständnis letzter Neffe Kardinal lassen Ausgang mutmaßen -- bleiben verborgener -- selten Schönheit -- hoch Naturgaben -- Reichtum sprechen -- Geschwätz Weiber halten Neid gewöhnlich Lästerung -- 
  Triumph Schmählieder Pöbel drein -- Natur -- 
  Mann Purpurhute schweigen hierüber weislich -- -- sagen müssen -- Ohr Richter -- 
  Hernach lauter neu Vergnügen vergessen -- hierüber ausforschen -- 
  Gütern Ardinghello einziehen -- Kardinal mußt finden -- Leben schonen -- Gewalt -- Tante übernehmen Verwaltung -- Schwester Vater -- 
  verkaufen tilgt Schuld -- edel Mann Talent Not helfen -- bequem Verfassung setzen -- -- 
  Frühling erhalten kurz Nachricht -- Brief unterdessen Venezianischen Schiff verlieren gehen -- Sturm Korfu scheitern -- 
  Hafen Scio -- May -- all Wesen Genuß Wirksamkeit -- heit Kopf -- voll hell Gedanke -- reizend Bild bezaubernd Aussicht -- Herz schlagen jung Bacchantin frei Liebestaumel -- 
  Diagoras durchstreichen Archipelagus -- gefährlich Paß Hafen kennen -- 
  Smyrna auslaufen -- lang Golfo -- Mytyleni -- Tenedo -- Dardanell herum -- stalimen -- herrlich Posten Skyro -- ferner gut Hafen Kyklade -- 
  Küste Asien -- Rhodos -- Golfo Makri segeln -- Ägypten -- 
  Arbeit -- alte trefflichst Karte -- woran verbessern -- 
  überall wissen edl Führer -- neu Helene -- Aspasia Phryne stecken -- Korsareneh leben -- Liebesgötter umgaukeln -- einlaufen -- 
  griechisch Hafen Gebrauch -- Engländern Soldatenehen -- 
  Demetri glücklich Geburtsort -- 
  Scio schön Stadt griechisch Insel -- Rebenhügel Täl Garten Gebirge inneren Land -- Pomeranze -- Zitron Granatenhain klar herabstürzend Bach erfrischen beleben -- entzückend bezaubernd -- 
  schön -- längst weißen -- selig Himmel -- fast immerwährend Frühling -- sommerhitz kühl Nacht -- dicht Schatten -- spielend Seelüfte -- Menge Quelle -- Überfluß gesund erquickend Früchte -- 
  Paradies Welt -- Archipelagus -- Morea -- Karien Ionie -- o würdig -- eurer genießen -- 
  Griechen Gehalt Schönheit Mensch Erdbod -- lieb Freiheit -- Haß Art Unterdrückung -- alte -- 
  Luft bekommen ungeheuren Maß Schicksal -- drücken -- regen -- Leben Feuer -- halten -- blitzschnell durchdringen Verstand Gefahr -- übersehen -- schlagen Weg -- 
  Mainott Gebirge Sparta bezwungen -- Montenegriner -- Illyrer Karier Held -- Urväter Plataia -- 
  Kunst mild Sitte Ausbildung -- weder eigentlich Kern Genuß -- 
  Hang Freude -- Lust -- Gesang Tanz -- klopfen dennoch Ader -- mächtig Gefühl Schönheit -- 
  O Cäcilia -- Geliebten -- eilen hervor euren sümpfen -- 
  Ardinghello -- 
  Herbste schreiben sizilien -- Gewässer herumkreuzen reich Beute -- -- Fuß Säule Himmel stürmisch Ätna -- hohl Eingeweide lauterst Quelle unergründlich Feuer werfen -- -- 
  Mazal -- berühmen Kalabreser -- Schrecken mittelländisch See -- türkisch Flotte anführt -- verschieden Mal Spanier schlagen -- Freude aufnehmen -- 
  hervor Verstand Tapferkeit -- bekommen Alsdann Galeere Befehl -- worin meistens Italienische renegat Griechen dienen -- Vermittlung Diagoras -- Sohn Admiral -- Decke treiben -- Glaube abschwören -- geschehen annehmen -- 
  jung Held -- Todesbundesfreund -- streifen Geschwader raublüstern Adler Küst Kalabrien -- Sizilium -- Spanien herum -- 
  Winter machen Anfang Ausführung kühnsen fein Plan -- 
  alt Mazal -- Sohn -- gelten jung Sultan Amurath -- 
  begehrt Insel Paro Naxos -- Italienische Kolonie anlegen -- 
  Krieg schier unbewohnt bleiben -- 
  übrig Grieche reichlich Besitzung entschädigen -- Ort verpflanzen -- -- Abkömmling Religion ausüben verlangen -- weder stören -- stören -- 
  sein Jahrhundert mancherlei Sekte Christ entstehen -- auf Blut haßen verfolgen -- -- Todesleugner nennen -- glauben -- Natur ewig Quell Leben -- Trieb Dasein Freude -- Meinung Lehre Mohammed wesentlich Punkt übereinkämen -- 
  halten edelst reich Jünglinge Frauenzimmer -- hofften Herrschaft Schutz -- 
  Held -- Anführer -- flüchten -- dien -- verricht Grundsätze gemäß tapferst Tat -- 
  Menge nachfolgen -- Sicherheit Person -- Eigentum wüßten -- 
  Vorteil Reich augenscheinlich -- dürfen Muselmänner Feuer Gefecht sogenannter Orthodox -- 
  Amurath Ardinghello sehen -- 
  treten männlich Jugend Schönheit -- kühn -- Sultan -- gefällig -- Semirami -- 
  sprechen Neugriechisch -- Amurath bleiben bezaubern -- schier gleich Alter -- Ardinghello schmeicheln lieblich mächtig geheimst Denkungsart -- 
  erhalten -- -- 
  Ardinghello schreiben Demetri -- Schwäche fassen -- 
  Mensch -- festesen Charakter -- Grad Schwärmerei -- reinste Vernunft -- geringste Insektenseel -- Ebbe Flut Mond -- 
  sandte geheim sichr Werber Venedig -- Genua -- Florenz stark Summe Reisegelder -- 
  kennen vortrefflichst Jugend Stadt -- Name Verführung -- 
  Frühling bewegt lustig Insel -- 
  befestign Hafen Paro -- machen Hafen Naoussa -- groß Flott sicher liegen -- unüberwindlich -- 
  Demetri Schiff voll jung tapfer Römer blühend Römerinn zauberisch gegender Geburt -- Künstler -- Architekt -- Bildhauer -- Maler -- äußerst mißvergnügt vorher Lebenswandel -- Abzug wunderbar Klugheit bewerkstelligen -- 
  brach Marmor reich Gänge Berg Kapresso Tempeln -- öffentlich Palast -- Versammlungshall -- alt Athen Perikles scheinen aufzuleben -- 
  leben verklärt -- 
  Vertrag Übereinkunft Ardinghello Diagoras predigen Demetri insgeheim auserwählt Religion -- meister fallen hernach -- -- 
  Tolomei Wunder Schönheit einschmeichelnden Zunge -- 
  meistens lauter unbefangen Jugend -- 
  neu Pantheon Natur aufführen -- Tempel Sonne Gestirnen -- Tempel Erde -- Tempel Luft -- Vorgebirge See thronend Vater Neptu -- Labyrinth anlegen Zeder Eiche künftig schauervoll Nacht Zweifler unbekannt Gotte -- 
  Tempel Erde -- Tempel Luft -- Labyrinth kommen Naxos -- Tempel Erde entzückend Tal -- 
  Fiordimona groß Gut Gelde -- überraschen Kastor Helena glücklich Ardinghello -- Coimbra begleiten -- List Gewalt Neapel einschiffen -- auserlesen Schar -- 
  Cäcilia lang widerstehen -- Gram Kummer -- 
  scheinen -- Szene Leben -- liebenswürdiger -- 
  Tod Braut Reise glauben Venedig allgemein unser vertraut Umgang -- Bruder Eltern -- vermählen -- 
  verkaufen allerlei Vorwand reichsen Gut -- segeln -- Lustreise -- alt Residenz heilig Markus Ancona -- schifft Smyrna -- kommen -- 
  welch Auftritt -- Ardinghello -- -- 
  Freude Nektarrausch Herz ergossen -- 
  Wunsch -- fulvia unglücklich -- 
  flüchten Schiff Genuese -- nachsetzen -- 
  Golfo Tarent mörderlich Gefecht -- voll Ladung Mörser treffen -- Trümmer zerfleischen -- 
  jung Held schlagen -- langn -- bringen Nachricht -- 
  Lucinde Lissabon -- vermählen Florio Branca -- König oberer Admiral Schiffahrt -- 
  Gabriotto behen Ardinghello -- erzählen -- Portugiesischer Prinz wahr Vater Lucinde -- 
  kurz Thron steigen -- lassen provenzalisch Frucht Liebe aufsuchen -- Gemahlin Kind bleiben -- 
  Lucinde vorher klösterlich Einsamkeit Leidenschaft -- wofür büßen -- lassen größtenteils verstellt Wahnsinn -- 
  Triumph prächtig Schiff Bedeckung abholen -- 
  Reich liegen himmlisch Schönheit Fuß -- edel Herz wählt Liebe -- 
  ehe äußerst glücklich -- zeugen Sohn Tochter -- Vater Held bilden -- Mutter unvergleichlich trefflich Wirtschafterinne -- frommen -- zärtlich keusch Frau -- 
  Ardinghello and bescheiden -- Glückseligkeit -- mancherlei Stürme Gefahr durchwüten -- 
  Mazzuolo bringen stark Trupp Florentiner Emilie arm -- scheinen Mahomed Paradiese lebendig Leib -- 
  Demetri Hohepriester Natur einmütig erwählen -- 
  Ardinghello Priester Sonne Gestirne -- Diagoras Priester Meer -- 
  Fiordimona Priesterin Erde -- Cäcilia Priesterin Luft -- 
  Coimbra pflegen wartet Labyrinth -- 
  Demetri Ardinghello Fiordimona setzen Gesänge Moses -- Hiob -- Psalmen -- Hohelied -- göttlich Prediger -- Homer -- Plato -- Chör tragisch Dichter -- Begeisterung italienischen Priester Priesterinne -- Gemeinde -- erfanden heilig Gewänder echt alt Ionisch Grazie Schönheit -- 
  Feierlichkeit ergreifen Reiz Auge Ohr stark Bild wirklich Natur Mensch -- Nerv harmonisch dröhnt Sait -- Meister spielen -- wohlklingend Instrument -- 
  leer Pöbelblendwerk verwerfen -- wandelt lauter Leben -- 
  richten Staatsverfassung Rom Griechenland -- studieren fleißig Republik Lykurg -- Plato -- Politik Aristoteles -- Fürst Macchiavell -- bewahren -- 
  Platons doppelt Bürgerstand -- Klasse Ehrenstelle -- Ackerbau treiben -- vermeiden weislich -- behielten Gemeinschaft Gut Aristotele -- 
  Haufen Übel -- verbannt -- Allzugroß -- scharfsinnig Prüfer bekannt Republik scheinen hierin Vorurteil Erziehung ablegen -- 
  inzwischen finden Eigentum -- nämlich öffentlich Belohnung -- bleiben -- bringen -- an -- 
  ferner weiber erhaben Schüler Sokrat -- gewissermaßen -- gemeinschaftlich -- Mann -- -- 
  jeder völlig Freiheit Person -- Gewalttätigkeit hart bestrafen -- 
  Ordnung sorgen -- Mann Weiber wohnen absondern -- 
  Weiber Kind überließen Naxos -- schön Perle Insel -- alt Fruchtbarkeit Lieblichkeit Sizilium nennen -- 
  Wein -- Frucht Köstlichkeit gleich weit Erdbod -- 
  Schade -- verführen -- See bringen lassen -- sogleich verderben -- 
  Wahrer Nektar -- Himmel unentwendbar -- 
  scheinen -- Natur -- vorbereiten -- 
  Naxos Hafen Schiff -- Bark Verliebte anlanden -- hingegen Paros -- rundum schön -- 
  Jugend -- bevor mannbar -- Einrichtung treffen -- 
  weiber Stimme Geschäft -- bloß Sklavin behandeln -- pro Cent Vergleich Mann -- 
  Fiordimona -- unbegreiflich -- Mensch Charakter fassen -- Ardinghello treu bleiben -- durchsetzen -- anderer Amazonenhaft Geschlecht -- Schiff ausrüsteen -- Streifereie ausliefen -- 
  Mitglied Staat -- obgleich schwächeren -- bleiben -- heißen -- betreffen -- 
  Hauptunterschied -- Mann erwerben -- bewahrten -- 
  schwingen Liebe allerhöchster Freiheit Flügel -- jeder Beeiferter schön liebenswürdig -- weder Geld -- Pflicht Schuldigkeit verlassen -- 
  Bevölkerung betreffen -- Folge Spartaner richten -- erstaunen Priesterin Delphi wissen -- sterblich Gott begrüßen -- Kind gehören Staat -- Tod dünken weit groß Übel -- 
  -- vermeiden Unbequemlichkeit -- Aristotele -- Aristophanes weiblich Volksversammlung Einrichtung berühren -- 
  Tempel -- Berg Anhöhen -- Aussicht reizend Insel umh -- schön Hain pflanzen -- bestimmen Fest Erziehung Jugend -- 
  führen Gymnasien -- 
  halten Übung Körper Hauptsache -- alsdann Bildung Geist zweckvoll Unterricht Umgange nachfolgen -- 
  Tugend Kunst allemal gegenwärtig Staat richten -- wirken Nutzen bringen -- -- Tugend Person -- 
  binnen Kyklade Besitz -- stark Einfluß fest Land -- 
  Grieche -- fast durchgehends heiter Sinn -- rottet gesellschaftlich Gespräch Aberglaube -- verschafft geistliche anständig Weise Unterhalt -- 
  Türke -- -- mitten Meer -- bekümmerten -- lassen Meinung -- verschieden Tempel verschieden christlich heilige -- heiligen Feuer -- Wasser -- Lüfte -- 
  herrschen Punkt -- Fortpflanzung -- unerhört Verschwiegenheit -- scheinen Orden Tugend -- 
  Fall halten Schutz Sultan versichern -- 
  machen gesellschaftlich Bürde ertragen -- nossen Wonne Leben mild Himmelsstrich ersprießlichen allgemein beliebt Gesetz -- fügen lebendig -- wachsen reifen Schönheit auserwählt Ankömmling -- worunter schön heldenmütigste griechisch Jugend beiderlei Geschlecht befinden -- Behutsamkeit unser Geheimnis einweihten -- 
  kriegerisch Schiffahrt -- Handlung Kleinasien -- schwarz Meer westlich Land -- hoch Freiheit -- süß ergötzen -- froh Geschäftigkeit Inneren -- zwecken -- erhalten Sicherheit -- verdienen Schutz -- beide gewann Sklav sklavinn Überfluß bequemlichkeiter -- 
  Seligkeit glauben -- Erdbod anderer Platz -- Tod scheuen -- 
  Frühling allgemein Versammlung -- worin nötig Einrichtung Abänderung treffen -- feierlich Spiel Lustbarkeit beschließen -- 
  -- kommen -- verschieden vorher denken -- folgend Grundbegriff überein -- 
  Kraft genießen -- einerlei -- Bedürfnis -- Ding -- Stärke Verstand -- Glück Schönheit Besitz -- 
  Stand Natur Stand Krieges -- 
  Interesse -- Gesellschaft vereinigen -- bilden Ordnung -- stiften Gesetz -- innerlich Frieden -- richten -- lebendig -- Umstand -- 
  gut Staat -- vollkommen Mensch Bürger -- folgen -- meisten -- 
  nero gedeihen -- 
  Mensch Bürger vollkommen -- Staat kennen ausübt -- 
  jeder für Bedürfnis essen -- trinken -- Kleidung Wohnung schützen sicheren -- Wahrheit Notwendig einsehen -- mannbar -- Liebe pflegen -- 
  Vermag -- friedlich verschaffen -- 
  Äußerst brauchen -- erhalten weder -- Geschlecht -- 
  gleich Weise hernach Bequemlichkeit Freude Leben -- 
  arm schwach Staat rohen begnügen -- glückseligkeit hinlänglich -- 
  stark tapfer Mehrerem -- Bedürfnis -- 
  gut Instrument gehören Virtuose -- königlichste Roß mutigsen geübtesten Bereiter -- 
  Land Themistoklesse Scipionen -- Praxitelesse Horace Mönch Barbar -- 
  Wirklich -- bloß eingebildet erträumt -- Glückseligkeit bestehen allezeit unzertrennlich -- Kraft genießen -- Gegenstand -- Genuß -- 
  Regierung Erziehung jeder verschaffen -- verstärken Verschöner -- 
  Krieg richten gräulich Verwüstung -- -- bringen wohltätigst Frucht hervor -- 
  gleichen Element Feuer -- 
  -- Mensch Vollkommenheit treiben -- fähig -- 
  golden Jahrhundert Grieche Schlacht Perser -- 
  golden Jahrhundert Römer mitten Bürgerkrieg -- Geist fing erschlaff lang Frieden August -- 
  Florenz ragen neu Zeit hervor innerlich Tumult Aufruhr -- 
  hoch Weisheit Schöpfung -- Natur Feind -- regen Leben -- 
  sterben -- scheinbar aufhören -- Betrachtung -- 
  -- atmen -- Nestor -- ohnedies kurz Reihe -- 
  Ruhe Friede herrlich Stand genießen sammeln -- Mensch -- reizen -- träge -- versinken Untätigkeit -- 
  -- -- Schlummer wecken -- 
  bekriegen -- hoch Geschöpf -- 
  menschlich Geschlecht betreffen -- Meer Gebirge Klima -- Sitte Sprache abgesondern -- Kopf Ordnung bringen -- 
  Natur scheinen ewig Kind Mannigfaltig verlieben -- Erdkugel skyth -- Perser -- Athen Sparta -- 
  besonderer Geheimnis Staatsverfassung -- anvertrauen -- Heldentat Verstand auszeichnen -- bestehen -- Regierung Türke heiter Klima -- Menschheit erheben -- 
  vereitelt selig Zeitraum unerbittlich Schicksal -- 
  Druckfehler Bande -- S. 25 Z. 11 Mensch les Mensch -- 
  -- 28 - 16 -- Lese -- 
  -- 35 - 20 -- Quelle l. M. Quelle -- 
  -- 38 - 9 -- Allegorie l. M. Allegorie -- 
  -- 41 - 2 -- Wirkung l. M. Wirkung -- 
  -- 52 -- 1 -- vollkommen L. M. vollkommener -- 
  -- 56 -- 8 -- lichtem L. M. leicht -- 
  -- 58 - 1 -- schönen L. M. schön Lippe -- -- 
  -- 59 -- 15 - l. M. -- -- 64 - 15 -- scheinen L. M. schier -- 
  -- 67 -- 15 - l. M. -- 
  -- 70 - 10 -- Musik l. M. Musik -- -- -- -- - 12 -- l. M. -- -- 102 - 11 - alte l. M. alte -- 
  -- 105 - 2 -- l. M. -- -- -- -- - 16 -- Unwegsamer L. M. unregsamer -- 
  -- 128 - 20 -- L. M. anderer -- 
  -- 153 - 2 -- Tumult l. M. Taumel -- 
  -- 154 - 6 -- L. M. annehmen -- 
  -- 188 - 20 -- bestehen L. M. Bestünd -- 
  -- 203 - 19 -- l. M. -- 
  -- 218 -- 12 -- Tal Erde l. M. Tal Ebene -- 
  -- 237 - 13 -- herbeigerufen L. M. herbeirufen -- 
  -- 247 - 7 -- denken L. M. denken -- 
  -- 251 -- 12 -- rennen L. M. rannen -- 
  -- 256 -- 14 -- Fulizno l. M. Foligno -- 
  -- 365 - 7 -- wählen L. M. wählen -- 