Band -- 
  tübingen 1799 -- J. G. Cotta'sche Buchhandlung -- μη φυναι -- τον απαντα νικα λογον -- το δ ’ επει φανη βηναι κειϑεν -- οϑεν περ ηκει -- πολυ δευτερον ως ταχισα -- Sophokles -- 
  Hyperion Bellarmin -- 
  leben letzter schön Moment Jahr -- Rückkunft attisch Land -- 
  Bruder Frühling Herbst -- voll mild Feuer -- Festzeit Erinnerung leiden Freude Liebe -- 
  welkend Blatt tragen Farbe Abendrot -- ficht Lorbeer stehen ewig grüne -- 
  heiter lüften zögerten wandernd Vogel -- schwärmen Weinberg -- Garten ernteen fröhlich -- Mensch übrig gelassen -- 
  himmlisch Licht rann lauter offen Himmel -- Zweig lächelen heilig Sonne -- gütig -- niemals nenn Freude -- tiefem Laide Blick geheilen -- Unmut Sorge Seele reinigen -- 
  besuchen liebst Pfade -- Diotima -- entschwunden selig Stunde begegneen überall -- 
  erinnern Mais -- Erde sehen -- -- meinen -- verwandeln -- silbern Wolke Blüten -- freudig Lebensflamm -- entledigen gröber Stoff -- 
  -- 
  voll Lust Hoffnung -- rufen Diotima -- voll unaufhörlich Wachstum mühelos -- seligruhig -- Kind -- spielen -- denken -- 
  -- rufen -- erkennen -- Seele Natur -- still Feuer -- zögern mächtig Eile -- 
  glücklichen Lieb -- zögern -- rufen Diotima -- weisen -- 
  stehen Abends Brücke -- stark Gewitter -- rot Berggewass schoß -- Pfeil -- weg -- grünt Ruhe Wald -- hell Buchenblatt regen -- 
  -- seelenvollen grüne wegflog -- Bach -- schön Frühling still halten -- zahmer Vogel -- dennoch Berg -- 
  lächelt Wort -- wiewohl Trauer nah -- 
  Seligkeit dahingehen -- sehen voraus -- 
  O Bellarmin -- sagen -- stehen fest -- schön Schicksal entgegenreifen -- Göttlich demütigen -- Sterblichkeit sterblichen teilen -- 
  Hyperion Bellarmin -- 
  hold Mädchen Haus zögern -- Licht Nacht ruhig Dämmerung scheinen -- Notaras Wohnung -- gedankenvoll -- voll überwallend heroisch Leben -- -- Umarmung -- 
  Brief Alabanda kommen -- 
  regen -- Hyperion -- schreiben -- Rußland pfort Krieg erklären -- Flotte Archipelagus * -- -- * -- 
  1770 -- Grieche frei -- aufstehen -- Sultan Euphrat treiben -- 
  Grieche -- Grieche frei herzlich -- -- 
  sehen -- -- 
  alt -- kommen -- 
  findest Dorfen Koran -- Weg Misistra kommst -- 
  Wohne Hügel -- weiß Landhause Walde -- 
  Mensch -- Smyrna kennen lerntest -- verlassen -- 
  hattest feiner Sinn -- Sphäre tratest -- 
  verlangen -- Leben wiederzusehn -- Welt -- erkennen geben -- 
  Knechtsdienste mochtesen -- Tatest -- Nichtstun grämlich träumerisch -- 
  mochtesen Sumpfe schwimmen -- 
  Komme -- kommen -- Laß bad offen See -- 
  -- einzig Geliebter -- 
  schreiben -- 
  betroffen Moment -- 
  brannt Gesicht Scham -- kocht Herz -- heiß Quelle -- Stelle bleiben -- schmerzen -- überflog Alabanda -- überwinden -- 
  begierig künftig Arbeit an Herz -- 
  -- müßig -- rufen -- friedenslustig -- himmlisch -- träg -- -- 
  Alabanda sehen Welt -- edl Pilot -- Alabanda fleißig suchen Woge Beute -- schlafen Hand Schoß -- -- Wort möchtest ausreichen -- Zauberformel beschwörst Welt -- 
  Wort -- Schneeflock -- unnütz -- Luft trüb zaubersprüch Fromme -- Ungläubig hören -- -- 
  -- sanft -- -- schön -- sanft -- Unzeit -- häßlich -- feig -- -- 
  Harmodius -- myrt gleich -- Myrt -- worin Schwert verbergen -- 
  umsonst müßig gehen -- Schlaf -- Öl -- Flamme darein -- 
  zusehen -- gelten -- umhergehn Neuigkeit erfragen -- Alabanda Lorbeer nehmen -- 
  Hyperion Bellarmin -- 
  Diotimas Erblasse -- Alabandas Brief lesen -- Seele -- 
  drauf fing -- gelassen ernst -- Schritt abraten sprechen -- 
  O Gewaltsamen -- rufen -- schnell Äußersten -- denken Nemesis -- 
  Äußerstes leiden -- -- Außerst -- 
  Wenn_es -- -- gebären -- 
  scheinen -- -- säumen -- 
  O Atlas laden -- Schuld Jugend abzutragen -- Bewußtsein -- Bleiben -- 
  O Laß -- Diotima -- 
  -- Arbeit erbeuen -- 
  eitel Übermut -- rufen Diotima -- neulich warst Bescheidener -- neulich -- sagtest -- ausgehen -- lernen -- 
  Liebe Sophistin -- rufen -- Rede -- 
  Olymp Göttlichschönen -- ewigjung Quelle wahr gute entspringen -- Volk führen -- schicken -- 
  Schwert brauchen -- lernen bedürfen -- 
  Geisterbund Luft leben -- heilig Theokratie schöne Freistaat wohnen -- Platz Erde Platz erobern gewiß -- 
  erobern -- rufen Diotima -- vergessen -- wofür -- -- -- Freistaat erzwingen sagen -- wofür bauen -- -- verzehren -- schön Leben -- regen -- verbrauchen -- 
  wild Kampf zerreißen -- schön Seele -- altern -- selig Geist -- Lebensmüd fragen -- -- Ideal Jugend -- 
  grausam -- Diotima -- rufen -- Herz greifen -- Todesfurcht -- hoch Lebenslust festhalten -- -- -- -- Knechtsdienst töten -- gerecht Krieg Seele lebendig -- 
  Golde Farbe Sonne -- Feuer werfen -- 
  -- Mensch Jugend -- Fessel zerreißen -- 
  retten -- aufmachen Natt zertreiten -- kriechend Jahrhundert -- schön Natur Keim vergiften -- -- 
  Alter sollen -- Diotima -- Griechenland befrei -- Alter -- ärmlich -- gemein Mensch -- 
  O schal leer gottverlassen -- Athenerjüngling -- Siegesbothe Marathon Gipfel Pendele hinabsehen Täler Attika -- 
  -- 
  -- rufen Diotima -- still -- 
  sagen Wort -- 
  Sollst -- Sollst -- stolz Mensch -- 
  -- -- -- -- 
  weinen bitter stehen -- Verbrecher -- -- 
  Vergib -- göttlich Mädchen -- rufen -- niedergesunken -- o vergibn -- -- 
  wählen -- Sinn -- 
  wissen -- -- Schritt treiben -- 
  voll Seele gebieten dir_es -- antworten -- 
  folgen -- führen Untergange -- -- folgen -- -- 
  gut -- gehst -- groß -- 
  Handle -- tragen -- 
  Hyperion Bellarmin -- 
  Diotima wunderbar verändern -- 
  Freude sehen -- Liebe verschwiegen Leben aufgegang blicken lieblich Wort genialisch Ruhe glänzend Begeisterung entgegengekommen -- 
  fremd schön Seele -- Aufblühn -- Lauf hinauf Mittagshöhe -- 
  kennen fast selig Kind -- erhaben leidend -- 
  O manchmal liegen trauernd Götterbilde -- wähnen Seele hinwegzuwein Schmerz -- stehen bewundernd selber voll allmächtig Kraft -- 
  Flamm Auge steigen gepreßt Brust -- 
  eng Busen voll Wünsch leiden -- Gedanke Mädchen herrlich kühn -- 
  Größe -- sichtbar Gewalt -- fühlen -- herrschen -- 
  hoch Wesen -- 
  gehören sterblich Mensch -- 
  O Diotima -- denken -- wohin -- 
  Hyperion Bellarmin -- 
  klug Notara bezauberen Entwürf -- versprechen stark Partei -- hoffen Korinthischen Isthmus besetzen Griechenland -- Handhabe -- fassen -- 
  Schicksal Arbeit unnütz -- ehe an Ziel -- 
  raten -- Tina -- Pelopones hinab reisen -- unbemerken -- -- 
  Vater unterwegs schreiben -- meinen -- bedächtig alt leicht geschehen Schritt verzeihn -- ungeschehen erlauben -- 
  Sinn -- opfern Gefühl -- Ziel Auge stehen -- 
  zweifle -- fahren Notara fort -- dein Vater Hilfe Fall rechnen -- 
  geben -- -- nebenbei nötig -- Fall leben wirken -- 
  einst -- zahln -- -- -- 
  Schäme Geld -- setzen lächelnd hinzu -- Roß Phöbus leben Luft -- Dichter erzählen -- 
  Hyperion Bellarmin -- 
  Abschied -- 
  Notaras Garten bleiben -- frisch Winterluft -- immergrün Zypresse Zeder -- 
  fassen -- 
  Kraft Jugend halten aufrecht leiden -- ahnen -- tragen -- Wolke -- hoch -- 
  Diotimas Mutter Notara Freund bitten -- letzter Leben möchten -- 
  gut Diotimas gefreut göttlich Liebe verlieren bleiben -- 
  scheiden segnen -- 
  Hinab -- 
  finden teuer Mädchen Herde -- 
  scheinen heilig priesterlich Geschäft -- Haus besorgen -- 
  -- Haus verschönert helfen -- 
  Blume -- übrig Garten -- eingesammeln -- Rose frisch Traube spät Jahrszeit zusammengebrachen -- 
  kennen Fußtritt -- heraufkommen -- treten leis entgegen -- bleich Wang glüht Flamm Herz ernsen großgeworden Auge glänzt Träne -- 
  -- mich_es überfiel -- 
  Gehe hinein -- -- -- Mutter drinnen Folge -- 
  hinein -- 
  sitzen edel Frau strecken schön Hand entgegen -- kommst -- rufen -- kommst -- Sohn -- 
  zürnen -- Kind nehmen -- Vernunft ausgereden -- tun -- gelüsten -- hesen -- vergeben -- himmlisch Mächt -- Unrecht vorhaen -- -- o zögern eurer Hilfe Liebe -- 
  reden -- Notara übrig Freund herein Diotima -- 
  schwieg Weile -- 
  ehrt trauernd Liebe -- -- fürchten -- überheben Rede stolz Gedanke -- 
  weniger flüchtig Wort bitten Diotima -- Agis Kleomenes erzählen -- Seele feurig Achtung nennen -- sein Halbgötter -- gewiß -- Prometheus -- Kampf Schicksal Sparta heroisch -- glänzend Mythos -- 
  Genius Mensch Abendrot griechisch Tag -- Theseus Homer Aurore -- 
  erzählen fühlen stark hoch -- 
  glücklich -- rufen Freund -- Leben wechseln Herzensfreude frisch Kampf -- 
  -- rufen anderer -- ewig Jugend -- Kraft Spiel erhalten Lust Arbeit -- 
  O -- rufen Diotima -- 
  -- bleibst -- Diotima -- -- 
  Priesterin Tempel -- 
  Bewahrst heilig Flamm -- bewahrn stille schön -- wiederfinden -- 
  -- -- -- -- Stimme zittert Ätheraug verbergen Tuch -- Träne -- Verwirrung sehen lassen -- 
  O Bellarmin -- Brust zerreißen -- Schamrot -- 
  Freund -- rufen -- erhalten Engel -- 
  wissen -- wissen -- 
  O Himmel -- 
  denken -- wozu fähig -- vermissen -- 
  ruhig -- Hyperion -- fallen Notara -- 
  Ruhig -- rufen -- o gut Leute -- 
  sorgen -- Garten blühn Ernte -- euren Weinstock bet Wunsch scheid Einzig -- Seele dienen -- 
  -- o -- rufen Notara bewegen -- -- Wünsche sollst scheiden -- -- Götterunschuld eurer Liebe -- Segen gewiß -- 
  Mahnst -- rufen schnell -- 
  segn -- teuer Mutter -- zeugen -- komm Diotima -- unser Bund Mutter heiligen -- schön Gemeinde -- hoffen -- vermählen -- 
  fallen Knie -- groß Blick -- errötend -- festlichlächelnd sinken Seite nieder -- 
  längst -- rufen -- o Natur -- Leben himmlischjugendlich -- Götter -- Welt Liebe -- 
  dein Hain wandeln -- fahren Diotima fort -- -- -- deinen Quelle sitzen -- -- Berg gehen -- dein Kind -- Stern -- -- 
  fernen -- rufen -- -- Harfengelispel -- kommend Entzück tönen -- finden -- Schlaf Ton erwacht Leben voll Akkord -- göttlich Natur -- -- -- scheid Freude sterben -- -- -- voll leiden -- rein Mund zeugen -- Liebe heilig ewig -- -- 
  Zeug -- sprechen Mutter -- 
  Zeuge -- rufen -- 
  Wort übrig -- 
  fühlen höchstes Herz -- fühlen reif Abschied -- 
  fort -- Liebe -- -- Leben schwehen II. Bd. -- Gesicht -- 
  Diotima stehen -- Marmorbild Hand sterben fühlbar -- 
  töten -- einsam schwindelen grenzenlosen Stille -- überwallend Leben Halt finden -- 
  -- rufen -- ist_es brennendheiß Herz -- stehen kalt -- Liebe -- gött Haus neigen Ohr -- -- 
  Diotima -- 
  -- Still -- siehst -- -- o -- siehst -- 
  gehen -- seufzen -- -- gehen -- teur Herz -- 
  O süß Ton Wonnelippe -- rufen -- stehen Betender -- hold Statue -- süß Ton -- 
  wehe -- -- lieb Augenlicht -- 
  Rede -- -- rufen -- reden ernst -- red größerem Herz -- 
  halten -- Traume -- 
  Wehe -- rufen -- Abschied -- wiederkehren -- 
  töten -- rufen Notara -- 
  sehen -- sanft -- -- 
  Träne stürzen brennend Auge -- 
  leben -- Diotima -- rufen -- Himmel Liebe -- leben -- -- 
  Lasst stark -- teuer Freund -- teuer Mutter -- Freude Leid -- 
  Leben -- leben -- 
  wanken fort -- 
  Diotima folgen -- 
  Abend Stern gehen herauf Himmel -- 
  stehen still Haus -- 
  Ewig -- -- 
  zart -- Äther -- umwand Diotima -- 
  Törichter -- Trennung -- flüstern Geheimnisvoll -- lächeln Unsterblichen -- 
  -- -- wissen -- Traum -- Leiden Freudigkeit -- 
  beide -- erwidern -- beide -- 
  vollendete -- rufen -- sprechen -- 
  Sternenhimmel erkennen -- 
  Zeichen -- Lippe verstummen -- 
  -- sprechen langsam niegehört Tone -- letzter -- 
  dämmerlichter entschwinden Bild wissen -- -- letztenmal umwand erlöschend Gestalt Augenblick Auge zückt Nacht verschied -- 
  Hyperion Bellarmin -- 
  erzählen wiederhol leiden rege ruhelos Jugend -- 
  Ist_es -- Sterbliche durchwanderen -- bleiben Frieden Geist stillen -- 
  -- Bellarmin -- 
  Atemzug Leben unser Herzen wert bleiben -- Verwandlung rein Natur Schöne gehören -- 
  Seele -- sterblich Erfahrung ablegen leben heilig Ruhe -- -- unbelaubt Baum -- haupt Locken -- 
  Bellarmin -- weile geruhen -- Kind -- still Hügel Salami leben -- vergessen Schicksal Streben Mensch -- 
  Auge -- Frieden -- ruhig bleiben -- Blick menschlich Leben -- 
  O Freund -- söhnen Geist -- 
  wirsts glauben -- -- 
  -- solltest sogar Brief ansehn -- Seele täglich still Stiller -- 
  künftig sagen -- glaubst -- 
  Brief Diotima -- Abschied Kalaure schreiben -- 
  lieb -- vertrauen -- 
  wärm Bild Leben -- 
  Kriegslärm sagen -- 
  Desto eigeneren Leben ist_es -- -- 
  sehen -- lieben -- 
  sagen -- Diotima -- 
  Hyperion Diotima -- 
  erwachen Tod Abschied -- Diotima -- stärken -- Schlafe -- richten Geist -- 
  schreib Spitze Epidaurischen Berg -- 
  dämmern fern tief Insel -- Diotima -- dorthinau Stadium -- siegen fallen -- 
  O Pelopones -- o Quelle Eurota Alpheus -- 
  gelten -- 
  spartanisch Wälder -- -- Adler -- alt Landesgenius stürzen unser He -- rauschend Fittichen -- 
  Seele voll Tatenlust voll Liebe -- Diotima -- griechisch Täler blicken Auge hinaus -- magisch gebieten -- steigen empor -- Stadt Götter -- 
  Gott -- fühlen Trennung -- 
  selig Schatten Lethe -- leben Seele himmlisch Freiheit Schicksal walten Liebe -- 
  Hyperion Diotima -- 
  mitten Pelopon -- 
  Hütte -- worin übernachen -- übernachten einst -- -- beinahe Knabe -- Adamas Gegenden durchzog -- 
  sitzen glücklich Bank Haus lauscht Geläute fernh kommend Karawane Geplätscher nah Brunnen -- blüh Hand Akati silbern Gewässer Becken goß -- 
  glücklich -- 
  wand Land -- Dodona Hain -- Eiche tönen ruhmweissagenden Sprüche -- 
  sehen Tat -- -- künftig -- Abend frei Himmel wandre -- 
  Glaube -- Land durchreist -- Joch Halse dulden -- Pelopidas -- herzleer -- fehlen Verstande -- 
  Schlief -- schlich -- Höllenfluß -- Trüb Stumm -- ödem Müßiggange vorüber -- 
  liegen bereit -- 
  Voll rächerisch Kraft Bergvolk Hierherum -- liegen -- schweigend Wetterwolke -- Sturmwinds warten -- treiben -- 
  Diotima -- laß odem Gott hauch -- laß Wort Herz reden -- Diotima -- 
  Fürcht -- 
  wild -- 
  kennen roh Natur -- 
  höhnen Vernunft -- stehen Bund Begeisterung -- 
  Seele wirken -- irren -- 
  bedürfen Klügelns -- wider -- 
  Hyperion Diotima -- 
  Alabanda -- 
  Lust -- Weg Koran erfragen -- Frage öfter -- nötig -- 
  Flügel Sonne nehmen zaud gerne Frage -- -- 
  königlich Jüngling -- gebären -- springen Wiege -- 
  Unterschied leiden -- -- O leben -- müßig Hirtenknabe -- Tina -- träumen seinesgleichen -- lebendig Arbeit Natur erprüfen Meer Luft Element rang -- Trip Tatenwonne -- 
  einholen -- schnell -- 
  Himmel -- 
  überreif Arbeit -- 
  Seele toben -- lebendig Geschäft befreien -- 
  Hohes Mädchen -- 
  -- bestehen -- 
  dir_es -- tatlos Wesen lieben -- 
  Hyperion Diotima -- 
  -- teuer Diotima -- 
  Brust schnell sehnen -- ha -- Zukunft reizen -- klar Wassertief reizen -- hinein springen übermütig Blut frisch Bade kühlen -- 
  Geschwätz -- 
  -- -- Alabanda -- 
  frei umeinand ist_es Fülle Tiefe Leben -- -- 
  O alt Tyrann -- Freundschaft -- -- verbieten -- 
  stark -- Halbgott -- dulden Unverschämt Bezirk -- 
  -- Abends -- Zimmer treten -- 
  Arbeit Seite legen -- sitzen mondhell Ecke Fenster pflegen Gedanke -- 
  stehen Dunklen -- erkennen -- unbekümmert -- 
  Himmel wissen -- halten -- 
  -- -- rufen -- 
  ziemlich -- -- 
  Heucheln umsonst -- 
  Stimme voll geheim Frohlocken -- 
  -- fahren -- du_es -- 
  -- Blinder -- rufen -- fliegen Arm -- 
  O -- rufen Alabanda -- -- Hyperion -- 
  denken -- schüttelen freudig Hand -- 
  Kennst -- fahren Alabanda fort Weile -- alt fromm Glaube Alabanda -- 
  Großmütiger -- nimmer indes gehen -- Licht Liebe fühlen -- 
  -- rufen -- fragen Alabanda -- 
  stolz sprechen -- Alabanda -- 
  Zeichen -- alt Heroennatur Ehre betteln -- lebendig Menschenherz -- Waise -- Tropfen Liebe kümmern -- 
  Junge -- rufen -- alt -- 
  schlaff Leben überall Geschichte alte -- Smyrna Schule bringen -- 
  O bitter -- rufen -- wagt Todesgöttin -- namenlose -- Schicksal nennen -- 
  Licht bringen sehen neu Leisem liebend Forsche -- 
  Gestalt Teuren Hoff Nung -- 
  mittagssonne bleich Himmel -- funkeln ewiglebend Auge abgeblüht Gesicht -- 
  -- rufen Alabanda freundlich Unwille -- ansehen -- laß Wehmutsblicke -- Junge -- 
  wissen -- herabgekommen -- 
  O Hyperion -- 
  sehn Großem Wahrem hoffen finden -- 
  Kopf wachsen -- frei stark -- ehemals sehen -- 
  freuen herzlich -- 
  dürr Land kommsen -- glücklich Gewitter -- o herrlich -- -- 
  Stille -- -- nimmsen Sinn -- sprechen -- Leben -- Tat -- 
  -- rufen Alabanda freudig -- -- Jagdhorn schallen -- fühlen Jäger -- 
  Wird_es angehen -- -- 
  -- rufen Alabanda -- sagen -- Herz -- ziemlich Feuer -- 
  Ha -- mag_es reich Spitze Turm Fahne schmelzen wüten Wog -- bersten stürzen -- -- 
  stoßen unser Bundsgenossen -- 
  wissen -- gut Russe möchten gerne -- Schießgewehr -- brauchen -- 
  laß -- kräftig Spartaner Gelegenheit erfahren -- -- Pelopones erobern -- lachen Nordpol Angesicht bilden Leben -- 
  Leben -- rufen -- neu -- ehrsam Leben -- 
  -- Irrlicht Sumpfe gebären stammen siegern Salamis -- 
  ist_es -- 
  Magd -- griechisch frei Natur -- herabgekommen -- väterlich Geschlecht -- Götterbild Jupiter Apoll einst Kopie -- -- 
  hören -- Jonien Himmel -- hören -- Vaterlandserde -- halbnacken -- Bettlerin -- Lappe alt Herrlichkeit umkleidest -- lang dulden -- 
  O Sonne -- erzogen -- rufen Alabanda -- zusehen Sollst -- Arbeit Mut wachsen -- Schlägen Schicksal Entwurf -- Eisen Hammer bilden -- 
  entzünden -- 
  Flecken hängen bleiben -- rufen -- Poß -- womit Jahrhundert -- Pöbel Wand -- Bemalt -- 
  O -- rufen Alabanda -- Krieg -- -- Alabanda -- rufen -- Arbeit -- Mensch Kraft Geist Krücke wächsern Flügel helfen -- 
  legen Sklavenkleid -- worauf Schicksal Wappe drücken -- 
  gelten eitl Anerzwungen -- rufen Alabanda -- schmucklos -- fessellos -- nackt -- Wettlauf Nemea -- Ziel -- 
  Ziel -- rufen -- jung Freistaat dämmern Pantheon schöne griechisch Erde heben -- 
  Alabanda schweigen Weile -- 
  röte steigen Gesicht -- Gestalt wachsen -- erfrischt Pflanze -- Höhe -- 
  O Jugend -- 
  Jugend -- rufen -- trinken Quell -- leben lieben -- 
  freudig -- Himmel Nacht -- fahren -- trunken -- fort -- Fenster treten -- Rebenlaube -- überwölbest -- Stern hängen -- Traube -- herunter -- 
  Hyperion Diotima -- 
  Glück -- voll Arbeit leben -- 
  müssen Torheit fallen -- voll Seele -- berauscht Mensch -- wunderbar -- stolz -- lieben -- Demut -- -- häufen -- 
  O Diotima -- Alabanda geweinen -- -- Kind -- mir_es abgeben -- Smyrna tun -- 
  -- Liebe -- nennen -- sagen -- -- -- Eroberer -- stehen -- Beute -- umfaß -- 
  O Diotima -- o Alabanda -- edeln -- ruhiggroß Wesen -- 
  vollend -- flieh Glück -- -- 
  -- schreiben -- erhalten deinen Brief -- lieben -- 
  Traur -- holder Wesen -- trauren -- 
  Spar -- unversehren Gram -- künftig vaterlandsfester -- 
  Diotima -- glüh Festtag Natur -- sparen all heiter Ehrentag Götter -- 
  Siehst Griechenland -- 
  O siehst -- -- froh Nachbarschaft -- ewig Stern lächeln unser Stadt Hain -- alt Meer -- Volk lustwandelnd Ufer sehen -- schön Athener gedenken Glück bringen -- Liebling -- fröhlich Woge -- 
  Seelenvolles Mädchen -- schön -- -- echt Klima nähren -- entzückend Glorie blühn -- 
  Diotima Hyperion -- 
  meister einschließen fort -- Hyperion -- 
  draußen -- 
  hold Februarluft Leben sammeln bringen gesammelte -- 
  wohlgetan -- frisch Erwarme Himmel -- mitgefühlen -- Wonne Pflanzenwelt -- rein -- immergleich -- trauern freuen -- 
  Hyperion -- o Hyperion -- still Lebensweg -- 
  heilig Name -- Winter Frühling Sommer Herbst -- kennen -- 
  sünd -- trauern Frühling -- dennoch -- 
  Vergib -- Kind Erde leben Sonne -- leben -- Freude -- Wunder -- Trauer -- 
  trauern -- -- 
  Mutiger -- -- welken -- glänzest -- Herz ermatn -- Siegslust sehnen erwachen -- 
  -- Mals gehören -- griechisch Jüngling machen -- Volk Schmach ziehen -- mütterlich Schönheit -- entstammen -- bringen -- aufgestaunt Traume Kindheit dürsten Bild Teure -- -- -- weinen -- o albern Mädchen -- -- herrlich -- -- o Schatten selig -- traun Erinnerung -- 
  -- ge Stern -- Zauberabend -- heilig Fremdling erstenmal begegnen -- -- trauernd Genius -- hereinglänzen Schatten Wald -- Jugendtraume unbekümmert Mädchen sitzen -- Mailuft -- Jonien zauberisch Mailuft blühend -- locken Haar -- entfalten -- Blume -- Lippe -- lösen Lächeln Wehmut o Strahl Himmel -- leuchteten Auge -- berauschend Quelle -- Schatten umschirmend Bogen ewig Leben schimmeren wallt -- -- 
  Gott -- schön Blick -- 
  Jüngling -- Spanne groß -- leicht Nerve dastehen -- lieben Arm bescheiden Niedersank -- sein -- drauf emporsah Entzück -- gen Himmel entflogen -- -- Herzensanmut lächeln errötet -- gewahr dämmernden Träne Phöbusaug durchstrahlen -- fragen -- du_es -- -- 
  begegnet fromm Sinn -- voll lieb Aberglauben -- II. Bd. C locken Haupt senken -- Götterjüngling voll Sehnen Trauern -- 
  Genius selig -- bleiben -- arm Welt -- fassen -- 
  O lieb Bild -- geweben Größe leiden -- 
  ist_es -- leiden ist_es -- 
  bekommen -- kranke -- -- 
  voll Seufzen -- Anfing schreiben -- Geliebt -- 
  lauter Freude -- 
  sprechen glücklich -- 
  sehen -- 
  soll_es bleiben -- 
  Leb -- 
  Hyperion Diotima -- 
  gut Fest feiern -- schön Leben -- -- Lärm beginnen -- 
  himmlisch -- 
  Holde Frühjahr wehen glänzt Orient -- entlocken deinen Name -- Baum Blüte entlocken -- selig Geheimnis Liebe entatmeten -- 
  Liebe -- -- Freund erscheinen -- entzückend -- stolz Mensch aufmerken Auge Geist glüht -- Bild -- Wesen fassen -- 
  O -- rufen -- ist_es Mühe wert -- Griechenland streiten -- Gewächs tragen -- 
  -- Alabanda -- -- heit Kampf -- treiben himmlisch Feuer Tat -- Geist Bilde Natur verjüngen -- laufen Ziel -- sorgen künstelt -- Geist achtend -- außen Trinkt Kelch Wille Wein -- ruhn -- Alabanda -- Genius Wonne Geheimnis -- -- Auge all Triumphbog wandeln -- Menschengeist -- langabwesend -- hervorglänzen Irr leiden siegesfroh väterlich Äther grüßt -- -- 
  Ha -- Fahne künftig Volk erkennen -- verjüngen -- Grund -- voll Ernst Lust heit Arbeit -- -- klein -- alttäglichst Geist Götter -- 
  lieb Haß laut gemein Welt befremd Augenblick mahnen platt Vergangenheit -- 
  Hyperion Diotima -- 
  Vulkan brechen -- 
  Koran Modon Türke belagern rücken unser Bergvolk Pelopones hinauf -- 
  Schwermut -- Diotima -- Geist fest schnell -- lebendig Arbeit sieh -- 
  Tagesordnung -- 
  Sonne Beginn -- -- 
  gehen hinaus -- Schatten Walds Kriegsvolk liegen grüß tausend hell Auge -- wild Freundlichkeit auftun -- 
  erwachend Heer -- 
  kenn gleich Leben Stadt Dorf -- Bienenschwarm -- -- 
  Mensch kann_es verleugnen -- einst glücklich -- Hirsch Forst unzähligen klimmen Sehn Urwelt -- Erde durchstreifen -- Gott -- ehe -- wissen -- Mensch zehmen -- -- Mauer tot Holz -- Seele Welt -- heilig Luft allgegenwärtig umfing -- 
  Diotima -- geschehen wunderbar -- unbekümmert Volk durchgehen -- Erde wachsen -- aufstehen Morgenlicht -- entgegen dehnen -- Haufen Mann knatternd Flamm emporsteigen -- Mutter sitzen frierenden Kindlein -- erquickend Speise kochen -- indes Rosse -- witternd -- schnauben Schrein -- Wald ertönen schütternd Kriegsmusik -- ring Waffe schimmeren rauschen -- Wort Lust Leben erzählen -- 
  sammeln Hauf -- Lust -- wunderbar -- Ältesten Trotzigst Jugend ehren -- 
  Vertrauter erzählen weisen ergehen Leben Herz schwellen mancherlei Schicksal -- 
  fingen -- gut reden -- glänzend Auge -- Bundes gedenken -- -- stolz Bild werdend Freistaat dämmern -- 
  -- 
  freudig Geist Wort greifen Mensch -- Göttergebot -- 
  O Diotima -- sehen -- Hoffnung Starre Natur erweicht Puls mächtig schlag Entwürf verdüsterte Stirn entfalten glänzt -- stehen Sphär Mensch -- umrung Glaube Lust -- -- Erde Himmel Meer Glorie schaun -- 
  üb Waffe Märschen Mittag -- 
  froh Mut gelehrig -- Meister -- 
  stehen dichtgedrängen makedonisch Reih -- reg Arm -- fliegen -- Strahl -- auseinander gewagter Streit einzeln Haufen -- geschmeidig Kraft Stelle ändern Feldherr -- sammeln sicher Punkt -- -- stehen Waffentanze -- schweben Bild Tyrannenknecht ernst Wahlplatz Auge -- 
  drauf -- Sonne Heißer scheinen -- Rat halten innerer Wald Freude -- still Sinn Zukunft walten -- 
  nehmen Zufall Kraft -- meistern Schicksal -- 
  lassen Widerstand unser Wille entstehen -- reizen Gegner -- worauf rüsten -- 
  sehen scheinen furchtsam lassen nah -- Haupt Schlag reichen -- nehmen Schnelle Fassung Panazee -- 
  halten erfahreneren Arzt allesheilende -- 
  abends Alabanda -- Lust munter Rosse Sonnenrot Hügel umschweifen -- Gipfel -- weilen -- Luft Mähn Tier spielen -- freundlich Säusel Gespräch mischen -- indes hinaussehn fern Sparta -- Kampfpreis -- zusammensitz lieblich Kühle Nacht -- Becher duften Mondlicht spärlich mal bescheinen mitten lächelnd still Geschichte alte -- Wolke aufsteigen heilig Boden tragen -- selig ist_es -- Moment Hand reichen -- 
  sprechen Alabanda -- Langeweile Jahrhundert peinigen -- wunderbar krumm Bahn -- Leben brechen -- gerad Gang hemmen -- fallen Adamas -- Reise -- Sehnsucht innerer Asien hinein -- Notbehelfe -- Alter -- rufen -- kommen -- bau Welt -- 
  -- 
  Welt -- 
  -- Diotima -- Kopie -- 
  O -- Elysiumsstille -- können schaffen -- -- 
  Hyperion Diotima -- 
  dreimal fort siegen Gefecht -- Kämpfer durchkreuzn -- Blitz -- verzehrend Flamm -- 
  Navarin stehen Fest Misistra -- Überrest alt Sparta -- 
  Fahne -- albanisch Horde entriß -- Ruine pflanzen -- Stadt liegen -- Freude türkisch Kopfbund Eurota werfen Trag griechisch Helm -- 
  sehen -- o Mäd chen -- 
  sehen Hand nehmen Herz drücken -- Freude -- -- Woche befreien -- alt -- edl -- heilig Pelopon -- 
  O -- teuer -- Lehre fromm -- Lehre überwallend Herz Gebet -- 
  schweigen -- tun -- 
  -- tun -- wovon sprechen -- wieviel dennoch übrig -- 
  -- Gedanke schnell -- -- 
  -- umgekehrt überflöge Gedanke geflügelt Sieg übereilt Hoffnung -- 
  Alabanda blühen -- Bräutigam -- 
  Blick lachen kommend Welt -- still Ungeduld ziemlich -- 
  Diotima -- 
  werdend Glück schön Lebenszeit alt Griechenland vertausch -- klein Sieg -- Marathon Thermopylä Platea -- 
  Ist_es -- 
  herzen genesend Leben wert -- rein -- Krankheit kennen -- 
  Jugend -- lieben -- -- verloren wiederkehren -- beglücken Tiefe Seele -- 
  Eurotas stehen Zelt -- Mitternacht erwach -- rauschen alt Flußgott mahnend vorüber -- lächelnd nehmen Blume Ufer -- streu glänzend Welle sagen -- Nimm Zeichen -- Einsamer -- 
  umblüht alt Leben -- 
  Diotima Hyperion -- 
  Brief erhalten -- Hyperion -- unterwegs schriebst -- 
  ergreifst gewaltig -- sagen -- mitten Liebe schaudern -- sanft Jüngling -- Fuß weinen -- rüstig Wesen verwandeln sehen -- 
  Liebe verlernen -- 
  wandeln -- 
  Folge -- 
  glauben -- hass Könntest -- sogar nachempfind -- Mühe geben -- hassen bleiben Seele eitelübertrieb Wort -- Hyperion -- 
  -- -- 
  mangeln heit Blick Welt frei Lust Lebendig -- 
  Feld Stern ziehen Auge -- 
  denken Geist Vorwelt enden Erde -- hoch spartanisch Frau Herz gewinnen -- 
  vergesse Kämpfer -- kräftig -- Stunde kommen -- hören Siegslärm Pelopones herauf nah brausen nah -- sehen -- Katarakt -- herunterwog Epidaurischen Wald Waffe fernh glänz Sonnenlicht -- -- Herold -- leiten -- o Hyperion -- Kommst geschwind Kalaur herüber grüßest still Wald Liebe -- grüßest -- fliegst Arbeit -- -- denken -- fürcht Ausgang -- 
  Liebster -- manchmal will_es überfallen -- groß Gedanke halten -- Flamme -- Frost -- -- lebe -- vollend -- Geist gebieten -- 
  laß Krieg dauern -- Frieden Wille -- Hyperion -- schönen -- -- golden Frieden Wille -- -- sagtest -- einst Rechtsbuch einschreiben Gesetz Natur -- Leben -- -- göttlich Natur -- Buch schreiben -- Herz Gemeinde -- 
  Leb -- 
  Hyperion Diotima -- 
  Hättest besänftigen -- Diotima -- Hättest sagen -- übereilen -- Schicksal Sieg abnötigen -- karg Schuldnern Summe -- 
  O Mädchen -- Still stehen -- schlimm -- -- 
  trocknen Blut Ader -- dür -- Weiterzukomm müßig stehen -- belagern belagern -- -- -- 
  Volk stürmen -- aufgeregt Gemüt Rausch erhitzen wehe unser Hoffnung -- wild Wesen aufgären Zucht Liebe zerreißen -- 
  wissen -- dauern -- Misistra ergeben -- -- sein -- 
  Lager ist_es -- gewitterhaft Luft -- 
  ungeduldig -- Leute fallen -- 
  furchtbar Mutwille -- 
  klug -- Laune machen -- 
  alt Lakedämon ist_es wert -- Sorge leiden -- ehe -- 
  Hyperion Diotima -- 
  -- Diotima -- Leute plündern -- morden -- Unterschied -- Bruder erschlagen -- Griechen Misistra -- Unschuldige -- irr hülflos herum tot Jammermiene rufen Himmel Erde Rache Barbar -- Spitze -- 
  hingeh gut Sache predigen -- 
  O flieg Herz -- 
  habe_es klug -- 
  Leute -- 
  -- außerordentlich Projekt -- Räuberbande Elysium pflanzen -- 
  -- heilig Nemesi -- gescheh will_es dulden -- dulden -- Schmerz letzen Bewußtsein zerreißen -- 
  Denkst -- tobe -- 
  ehrsam Wunde -- getreue schlagen -- Greuel abwehren -- 
  toben -- riss Binde -- ränn Blut -- wohin gehören -- trauernd Erde -- 
  trauernd Erde -- nacken -- 
  kleid heilig Hain -- schmücken Blume griechisch Leben -- 
  O schön -- Diotima -- 
  Nennst mutlos -- 
  Liebes Mädchen -- Unheil -- 
  Enden brechen wütend Haufen herein -- Seuche -- toben Raubgier Morea Schwert ergreifen -- verjagen -- schlachten sagen rasende -- fechten Freiheit -- 
  roh Volk Sultan bestellen Treiben -- -- 
  hören -- ehrlos Heer zerstreuen -- 
  Feig begegnen Tripolissa albanisch Haufen -- Hälfte gering Zahl -- 
  Weil_es plündern -- laufen Elend -- 
  Russe -- Feldzug wagen -- vierzig brav Mann -- halten -- finden Tod -- 
  Alabanda einsam -- zuvor -- 
  Treue fallen bluten Misistra -- vergessen -- Hoffnung -- Siegslust -- Verzweiflung -- 
  Ergrimmt -- Plünderer stürzen -- strafend Gott -- führen sanft Getümmel -- Träne netzt Kleid -- 
  bleiben Hütte -- liegen freuen -- 
  fortgezogen -- liegen Tripolissa Staub -- 
  -- wissen -- 
  Schicksal stoßen Ungewisse hinaus verdienen -- verbannen Scham wissen -- -- 
  -- 
  Griechenland versprechen bekommsen Klaglied -- 
  Trost -- 
  Hyperion Diotima -- 
  bring Mühe Wort -- 
  sprechen gerne -- plaudern -- Vogel -- Welt -- Mailuft -- anwehen -- Mittag Abend -- verlieren -- 
  Glaube denken -- sag tief Seele -- Sprache Überfluß -- 
  gute bleiben ruhen Tiefe -- Perle Grund Meer -- -- 
  eigentlich schreiben -- Gemälde Rahmen Mann Tagwerk -- Zeitlang Dienst nehmen russisch Flotte -- Griechen -- 
  O teuer Mädchen -- finster -- 
  Hyperion Diotima -- 
  zaudern -- kämpfen -- 
  -- 
  sehen -- notwendig -- sehen -- -- 
  Mißdeute -- verdammen -- 
  raten -- verlässen -- Diotima -- 
  -- holder Wesen -- 
  Herz versiegen -- Auge sehen Lebendige -- 
  O Lippe verdorren -- Liebe süß Hauch quellen Busen -- 
  Jugend nehmen -- Eurota Leben müde weinen -- -- Eurota -- rettungslos Schmach Lakedämon Schutt vorüberklagen -- Welle -- 
  -- Schicksal abernten -- 
  -- Liebe -- almose -- besitzen -- -- 
  -- ruhmlos -- ärm Knecht -- 
  verbannen -- verfluchen -- gemein Rebell Grieche Morea unser Heldentat -- Diebsgeschicht -- Kindeskinder künftighin erzählen -- 
  -- 
  verschweigen -- 
  Feierlich verstassen Vater -- verweisen Rückkehr Haus Jugend -- nimmer sehen -- -- Leben -- -- 
  lauten Antwort Brief -- worin Beginn schreiben -- 
  Laß Mitleid nimm Irre führen -- 
  Glaube -- bleiben überall II. Bd. D Freude -- 
  echt Schmerz begeistern -- 
  Elend treten -- stehen hoch -- 
  herrlich -- leiden Seele Freiheit fühlen -- 
  Freiheit -- Wort verstehen -- tief Wort -- Diotima -- 
  innigst angefochten -- unerhört kränken -- Hoffnung -- Ziel -- gänzlich ehrlos -- -- Unbezwinglich -- Gebein süßen Schauer durchdringen -- regen -- 
  Alabanda -- 
  gewinnen -- -- 
  Schaden behalten -- 
  -- 
  königlich Jüngling verdienen -- 
  sanft still -- 
  Herz zerreißen -- 
  erhalten -- 
  sagen -- sagen -- Segen Liebesdienst -- leisten -- 
  schläft lächeln genügsam -- mitten unser Schicksal -- 
  -- 
  wissen -- tun -- 
  dulden -- 
  Diotima schreiben -- Gebot -- sagen -- Aufmacht -- leidlich Land fliehen -- 
  wissen -- Herz -- verzweifeln lernen -- -- geliebter -- 
  -- -- 
  fändest ewig Frieden Hyperion -- müßtesen untreu ersparen -- 
  leben -- süß Mädchen -- leben -- 
  sagen -- gehen -- gehen dorthin -- rausch Quelle Leben -- 
  frei Land -- Land voll Schönheit voll Seele zeigen sagen -- Rette -- 
  o Himmel -- -- anderer müssen Abschied nehmen -- Abschied nehmen -- 
  -- 
  wissen -- tun -- 
  wähnen fassen -- besonnen -- 
  schwindeln Herz werfen umher -- ungeduldig kranke -- 
  Weh -- 
  richten letzter Freude Grund -- 
  -- 
  Natur umsonst -- 
  schuldig -- ohnedies gebären -- heimatlos Ruhestätte -- 
  O Erde -- o Stern -- nirgends wohnen -- 
  wiederkehren dein Busen -- -- 
  Ätheraug -- 
  begegnen -- deinen Lippe hängen -- Liebliche -- Unaussprechliche -- trinken entzückend heiligsüß Leben -- hören -- 
  bitte -- -- 
  sagen -- Verführer -- Hörtest -- 
  Kennst -- verstehst -- 
  weisen -- tief achtest -- Bedauerst -- Hörst -- 
  -- -- Priester leben -- Gott -- 
  O Genius Volks -- o Seele Griechenland -- 
  hinab -- Totenreich suchen -- 
  Hyperion Diotima -- 
  warten -- gestehen -- sehnlich Abschiedswort Herzen hoffen -- Schweigst -- 
  Sprache schön Seele -- Diotima -- 
  -- heilig Akkorde hören -- -- Diotima -- Liebe sanft Mondlicht untergehen -- hoch Stern Himmel leuchten -- 
  O lez te Freude -- unzertrennlich -- laut -- Schatt holden Jugendtage zurückkehren -- 
  schau hinaus abendrotlich See -- Strecke arm Gegend -- fern lebst Seele erwarmen Freude Liebe Jugend -- 
  O Erde -- Wieg -- Wonne Schmerz Abschied -- nehmen -- 
  lieb Ionisch Insel -- -- Kalaur -- -- Tina -- Auge -- fern Geist fliegen Lüftche regen Gewässer -- Seite dämmern -- Ufer Teos Ephesus -- einst Alabanda Hoffnung -- scheinen -- -- hinüberschiffen an Land Boden küssen Boden erwärmen Busen -- süßen Abschiedswort stammeln schweigend Erde -- ehe aufflieg freie -- 
  Schade -- Schade -- zugehen Mensch -- bleiben gut Stern -- 
  Erdenrund entbehren -- -- -- geben -- 
  Laß Sonnenlicht -- o Kind -- Knechtschaft dulden -- Polyxena Mutter -- Lebensliebe schön sprechen -- 
  Sonnenlicht -- widerraten Knechtschaft -- lassen entwürdigt Erde bleiben heilig Strahl ziehen -- Pfade -- Heimat führen -- -- 
  lang Majestät schicksallos Seele gegenwärtig -- -- herrlich Einsamkeit manchmal selber leben -- bin_es gewohnt -- Außending abschütteln -- Flocken Schnee -- sollt -- scheuen -- sogenannter Tod suchen -- tausendmal Gedanke befreien -- anstehn -- -- 
  -- leibeigen Knecht -- Boden fesseln -- pflügen -- -- zahm Geflügel -- Hof laufen -- weil_es füttern -- 
  -- jung Adler -- Vater Neste jagen -- hoch Äther Beute suchen -- 
  schlagen Flotte Kampf heiß -- 
  betracht Schlacht -- Bad -- Staub abzuwaschen -- finden -- wünschen -- Wunsch -- -- gewähren Ort Stelle -- 
  Feldzug erreichen sehen -- Mensch Mühe vergebens -- 
  fromm Seele -- 
  sagen -- denken -- Grab kömsen -- 
  Meersflut werfen -- sehen gerne -- Rest untersinken -- Quelle Strom -- lieben -- versammeln -- Wetterwolke aufsteigen -- Berg tränken Tale -- lieben -- 
  -- o Diotima -- 
  Diotima -- sehen -- 
  unmöglich -- innerst Leben empört -- denken -- verlören -- 
  Jahrtausend Stern durchwandern -- Form kleid -- Sprache Leben -- begegnen -- 
  denken -- -- finden -- 
  Seele -- finden kön Abschied laß wandern -- 
  grüß Mutter -- 
  grüß Notara Freund -- 
  Baum grüß -- erstenmal begegnet fröhlich Bach -- gehen schön Gärt Angel -- laß -- Liebe -- Bild begegnen -- 
  Leb -- 
  Buch -- 
  Hyperion Bellarmin -- 
  hold Traum -- Brief -- einst wechseln -- abschreiben -- 
  schreiben -- Bellarmin -- führen Hinab -- hinab tief tief leiden -- -- letzter Liebe -- kommen heraus Stelle -- neu anglänzt -- 
  Schlacht -- wovon Diotima schreiben -- beginnen -- 
  Schiff Türke Kanal -- Insel Chio asiatisch Küste hinein -- flüchten -- stehen fest Land hinauf Tschesme -- 
  Admiral verlassen Schiff -- worauf -- Reihe -- heben Vorspiel Schiff Türke -- 
  grimmig Paar Angriff Taumel erhitzen -- rachetrunkn schrecklich Getümmel -- 
  Schiff hing Tauwerk aneinander fest -- wütend Gefecht eng eng -- 
  tief Lebensgefühl durchdrang -- 
  warm Gliedern -- 
  zärtlichscheidend -- fühlen letztenmal Sinn Geist -- 
  -- voll heiß Unmut -- Besseres wissen -- schlachten lassen Gedräng Barbar -- zürnend Träne Auge -- stürmen -- Tod gewiß -- 
  treffen Feind nah Russe -- Seite fochten -- Augenblick übrig -- 
  stehen -- voll Stolz -- werfen Leben -- Bettlerpfennig -- Barbar -- -- 
  sehen -- -- versündigen fürchten -- Schicksal scheinen Verzweiflung -- 
  hoch Notwehr hieb -- treffen -- stürzen -- 
  bewußt -- Paros -- wohin übergeschiffen -- erwachen -- 
  Dien -- Schlacht tragen -- hören nachher -- Schiff -- Kampf beginnen -- Luft Geflo gen -- Augenblick -- Wundarzt Boot weggebrachen -- 
  Russe Feuer türkisch Schiff werfen -- festhing -- brennen -- 
  fürchterlich Schlacht -- -- 
  strafen Gift -- rufen -- erfahren -- Russe türkisch Flotte verbrennen -- Rott Tyrann -- 
  Hyperion Bellarmin -- 
  Schlacht liegen Peinlich todähnlich Schlaf -- 
  Leben -- Nacht -- Schmerz -- zückend Blitz -- unterbrechen -- 
  -- erkennen -- Alabanda -- 
  -- erfahren -- Augenblick gewichen -- fast bedienen -- unbegreiflich Geschäftigkeit -- tausend zärtlich häuslich Sorge -- woran Leben denken -- Knien Bette rufen gehören -- o leben -- -- leben -- 
  glücklich Erwach -- Bellarmin -- Auge Licht öffnet -- Träne Wiedersehen Herrliche stehen -- 
  reichen Hand -- Stolze küssen Entzück Liebe -- 
  leben -- rufen -- o Retterin -- o Natur -- 
  -- heilenden -- arm Paar -- vaterlandslos -- Irre -- verlässen -- 
  O vergessen -- Hyperion -- Schiff Auge Feuer aufgehen -- donnernd -- rasend Flamm Schiffer hinaufriß -- weniger gerettet Hyperion -- 
  Sinn grimmig Schlachtlärm stilln -- 
  hören Flog -- Feind vollends fertig -- 
  -- hüten -- liebend Vorsicht gefangen halten Zauberkreis Gefälligkeit -- -- Wort -- Ruhe lehren -- frei Lauf Welt neidlos männlich verstehen -- 
  O Sohn Sonne -- freier Seele -- verlieren gegang Alabanda -- 
  suchen umsonst fleht Leben -- fort -- solcher Römernatur nimmer finden -- 
  Sorgenfreie -- Tiefverständige -- Tapfer -- Edle -- 
  Mann -- er_es -- 
  freundlich fromm -- war_es -- Abendlicht Dunkel majestätisch Eich spielen Blatt träufeln Gewitter Tags -- 
  Hyperion Bellarmin -- 
  schön Herbst -- Wunde halbgenesen erstenmal an Fenster treten -- 
  still Sinn Leben Seele aufmerksam -- 
  leisest Zauber weht Himmel -- mild -- Blütenreg -- fließen heit Sonnenstrahl herab -- 
  -- still -- zärtlich Geist Jahrszeit -- Vollendungsruhe -- Wonne Zeitigung säuselnd Zweig umfing -- erneuert Jugend -- alt Elysium hoffen -- 
  rein Seele nossen -- kindlich Leben Welt -- Auge Freude Wiedersehen selig Natur wandellos schöne bleiben -- 
  Träne fließen -- Sühnopfer -- -- schaudernd steigen frisch Herz alt Unmut -- 
  O heilig Pflanzenwelt -- rufen -- streben Sinn -- 
  ring sterblich Kraft Schöne baun -- wachsen sorglos -- -- Alabanda -- Not sorgen -- Mensch -- übrige selber -- 
  -- vergessen -- -- 
  Laß -- -- -- rufen Alabanda -- stören still wirken Trauer -- 
  ruhen -- -- 
  O Entwurf -- Foderung -- Schuldbriefe -- zerreißen -- 
  rein erhalten -- Künstler halten -- lieben -- harmlos Leben -- Leben Hain Quell -- Ehre -- o Sonnenlicht -- still -- schön Äther -- Stern beseeln -- Baum umatmet innere Brust berühren -- o Eigensinn Mensch -- Bettler -- Nacke senken sehen schweigend Götter Natur Gabe -- 
  -- Lächelst -- Alabanda -- o -- unser Zeit -- lächeln -- Knabe plauderen -- trunken Jugendmut -- indes -- still Tempelsäule -- standst -- Schutt Welt -- leiden mußtest -- wild Ranke Liebe umwuchsen -- sieh -- Binde fallen Auge alt goldenen lebendig -- 
  -- rufen -- Ernst -- leben Lebenslust -- 
  jagen Forst -- rufen -- Meersflut badeen -- singen tranken -- Lorbeerschatte Sonne Wein Auge Lippe glänzen -- einzig Leben Geist umleuchten -- glänzend Himmel -- jugendlich Glück -- 
  lassen -- Alabanda -- 
  O schwer Bekenntnis ablegen -- -- 
  glauben -- fort -- 
  -- gewaltsam Tod suchen -- herzlos -- rasend -- Diotima -- lassen -- schreiben -- drauf Brief -- Abend Schlacht -- II. Bd. E schriebst -- rufen -- Schlacht finden wolltest -- o Hyperion -- 
  letzter Brief -- 
  eilen -- schreiben -- lebst -- 
  Bester Alabanda -- rufen -- Trost -- 
  schreiben schick Diener fort -- 
  O -- -- bieten -- eilen Kalaure -- 
  -- Brief -- Entsag Rede -- verstehen -- vergiben Seele -- setzen hinzu -- 
  vergeben -- rufen -- o Hoffnung -- -- glücklich Engel -- 
  glücklich -- rufen Alabanda -- schön Lebenszeit übrig -- 
  Held Jüngling -- Mann Gott -- er_es erleben -- 
  dämmert wunderbar Seele Rede -- 
  Baum Gipfel schaueren leise -- Blume dunkel Erde -- sproßten Stern Schoße Nacht Himmel Frühling glänzt -- heilig Freude -- 
  Hyperion Bellarmin -- 
  Augenblick -- Diotima schreiben -- treten Alabanda freudig Zimmer -- 
  Brief -- Hyperion -- rufen -- schrak fliegen hinzu -- 
  -- schreiben Diotima -- leben Zeichen -- 
  schriebst Schicksalstage Misistra antworten schnell -- erhieltst Brief -- 
  schriebst -- düster -- sagtest -- Seiest gesonn -- russisch Flotte -- antworten -- Brief erhieltsen -- harren -- vergebens -- Mai Sommers -- Brief -- -- entsagen -- -- 
  rechnen -- mir_es zutrauen -- Brief beleidigen können -- 
  Freute herzlich -- mitten Betrübnis -- 
  Unglücklicher -- hoch Geist -- fassen -- 
  O -- nimmer lieben -- groß Wunsch verschmachten -- 
  Speis verschmähen -- -- Durstes sterben -- 
  wissen -- -- 
  Bande Sterblichkeit lösen -- Flamm Brust stillen -- Quell fließen Weinstock wachsen -- Freuden Welt Schal reichen -- 
  -- 
  bedarfst -- -- 
  grenzenlos Unmacht Zeitgenosse Leben bringen -- 
  -- -- -- Seele beleidigen -- ruhen einzeln Freude -- -- -- fade fühlen -- erheiteren hoch Geist -- Tod erfahren -- -- erholen Götter -- 
  glücklich -- verstehen -- 
  verstehen -- Größe teilen Verzweiflung -- 
  finden -- -- 
  Leben Neugier treiben wunderbar Wesen -- 
  Unaussprechlich ziehen zart Seele kindischfurchtlos spielen gefährlich Flamme -- -- 
  schön Freude Liebe sänftigen -- bös Mann -- -- wild -- 
  besänftigen -- trösten -- machen vergessen -- Grund trostlos warst -- fern -- -- geliebt Herz -- 
  Athen -- Trümmer Olympion ergreifen neu -- 
  leicht Stunde denken -- Jüngling Trauer ernst unerbittlich -- 
  selten -- Mensch Schritt Leben -- klein Punkt -- schnell -- tief Schicksal empfinden -- unaustilgbar haften -- Gefühl -- rauh -- ausstoßen -- schwach -- auszuweinen -- -- Teurer -- selten -- fast unnatürlich dünken -- 
  -- Schutt heiteren Athen -- mir_es nah -- Blatt wenden -- tote Erde Lebendig -- Göttermensche drunten -- ich_es wörtlich auf Angesicht schreiben -- ewig -- 
  Erschienst groß -- 
  Wesen voll geheim Gewalt -- voll tief unentwickelt Bedeutung -- einzig hoffnungsvoll Jüngling schienst -- 
  laut Schicksal sprechen -- lauter sprech Schicksal -- -- unergründlich leiden -- unergründlich mächtig -- 
  -- hoffen Genesung -- 
  reisen -- 
  wirken -- 
  O Verwandlung -- 
  stiften -- grünt Akademus Hain horchend Schüler heilig Gespräch hören -- einst -- Ahorn Ilissus -- 
  Ernst alte gewinnen Schule Genius Jünglinge -- vergänglich Spiel unsterblich -- schämen -- halten Gefangenschaft Schmetterlingsflug -- 
  -- -- -- Roß lenken -- genügen -- Feldherr -- 
  Allzugenügsam eitel Liedche singen -- Künstler -- 
  Kraft Held -- Kraft Welt hattesen aufgetan offen Kampf -- Rätsel dein herzen hattest lösen geben -- lernn Jüngling vereinen -- lernen verstehen Spiel Natur -- seelenvoll -- vergaß Scherz -- -- 
  Hyperion -- 
  Hyperion -- -- Unmündig -- Muse -- 
  ergiengs -- 
  -- 
  verlassen gesellig Mensch -- Sand Sturme Wildnis irren untereinander -- höhnt Jugend Alter -- fehlen Gastfreund Fremden Vaterlandsgenosse sonderen nimm Liebende entleideten nimmer -- deinen Quelle -- Natur -- erfrischt -- -- heilig Freude -- geheimnisvoll Tiefe quell Geist erneuen -- Götter erheitern verwelklich Seele Mensch -- bewahrt herzerhaltend Götter jeder freundlich Bündnis -- 
  -- Hyperion -- hattest dein Grieche Auge heilen -- Lebendig sehen -- -- Feuer Holze schlief -- Begeisterung hattest entzünden -- fühlen still stet Begeisterung Natur rein Kind -- 
  -- 
  nehmen Mensch schön Welt -- Laien Künstler Gedicht -- Wort loben Nutzen ersehn -- 
  zauberisch wurdest -- lebendig Natur -- Grieche -- entzünden ewigjung Gott Glück menschentun -- einst -- fest -- Tat geleitet -- schön Kriegsmusik -- jung Held Helio Licht -- 
  still -- still -- 
  schönst Traum -- letzter -- 
  stolz -- bübisch Geschlecht lang befassen -- 
  Tust -- 
  führtest Freiheit denken Raub -- 
  führst siegend alt Lakedämon Ungeheuer plündern verflucht Vater -- Sohn -- Wildnis -- Höhle sicher griechisch Erde -- -- Heiligtum -- achten -- -- -- gelieben -- 
  O Hyperion -- 
  sanft Mädchen -- wissen -- 
  Entrüstung treiben aufwärts -- Erde sehen unablässig zittert beleidigt Herz -- 
  trennen -- 
  -- 
  Kind -- gönn Sklavenwelt -- arm Pflanze welkt Dürre Auge weg -- 
  Leb -- 
  teuer Jüngling -- gehen -- Mühe wert scheinen -- Seele hinzugeben -- 
  Welt Wahlplatz -- Opferstätt -- entledigen -- 
  Schade -- gut Kraft -- Traumbild -- vergingen -- 
  nimmst -- kehrest Götter -- kehrst heilig -- frei -- jugendlich Leben Natur -- wovon ausgiengst -- verlangen -- 
  schreiben -- 
  erschüttern Mark -- voll Schrecken Lust -- suchen fassen -- Wort Antwort finden -- 
  Willigest -- Diotima -- schreiben -- billigest Entsag -- konntest begreifen -- -- 
  Treue Seele -- darein Konntest schicken -- 
  finsteren Irr konntest schicken -- himmlisch Geduld -- gabst -- Verdüstertest Liebe -- glücklich Schoßkind Natur -- wurdest heiligtest deinen Beitritt Trauer -- 
  schön Heldin -- Krone verdientest -- 
  Trauern -- Liebe -- 
  nachgefolgen Nacht -- kommen -- laß Licht folgen -- Anmut laß wiederkehren -- schön Herz -- o Ruhe laß wiedersehen -- selig Natur -- Friedensbilde Übermut entschlummern -- 
  -- Teur -- Rückkehr spät -- nimmst lieben -- -- -- Glück vergangen verlieren -- 
  auf äußerste treiben -- 
  undankbar mütterlich Erde handeln -- Blut Liebesgaben -- geben -- Knechtlohn -- weggeworfen -- tausendmal undankbar -- heilig Mädchen -- einst Frieden aufnehmen -- -- scheu zerrißen Wesen -- tiefgepreßt Brust Jugendschimmer Stahl -- hie Grashalm zertretenen -- 
  Hattest Leben rufen -- -- 
  ' -- o weisen -- hoffen -- -- Unglücksbrief Hand -- letzter Schlacht schreiben -- 
  sterben -- Diotima -- glauben -- heilig Werk -- 
  heilig -- Liebende trennen -- heilig -- unser Leben fromm Glück zerrütten -- -- 
  Diotima -- schöngeboren Leben -- 
  Eigenst ähnlich -- lernen -- bewahren lernen -- innig Erde -- O landen glänzend Insel Himmel -- fänden -- Diotima finden -- 
  Höre -- Geliebte -- 
  Griechenland Bleibens -- 
  weisen -- 
  Abschied Vater Überflusse schicken -- hinreichn -- heilig Tal Alpen Pyrenäen flüchten -- freundlich Haus grün Erde kaufen -- Leben golden Mittelmäßigkeit bedürfen -- 
  -- kommen führen -- treuem arm Mutter küssen Kalaurea Ufer trockn Träne -- eil Isthmus hinein an adriatisch Meer -- sicher Schiff bringen -- 
  O kommen -- Tiefen Gebirgswelt Geheimnis unser Herzens ruhn -- Edelgestein Schacht -- Schoß himmelragend Wald -- -- Säule innerst Tempel -- Götterlose nahen -- sitzen Quell -- Spiegel Welt betrachten -- Himmel Haus Garten -- 
  heiter Nacht Schatten unser Obstwald wandeln Gott -- liebend -- belausch -- indes Pflanze Mittagsschlummer sinken Haupt erheben Blume still Leben erfrischen -- Tau zart Arm baden -- Nachtluft kühlend umatmet durchdringen -- blühen Wiese Himmel funkelnden Blume seitwärts ahmt Mondlicht westlich Gewölk Niedergang Sonnenjüngling -- Liebe schüchtern -- morgens -- -- Flußbett Tal warm Licht füllen -- still golden Flut Baum rinnen -- Haus wallt lieblich Zimmer -- Schöpfung verschönen -- Sonnenglanze gehst Grazie segnest -- Liebe -- 
  -- indes Morgenwonne feiern -- Erde geschäftig Leben -- Opferbrand -- unser Auge entzünden -- hingeh -- Tagwerk -- steigend Flamm werfen -- sagen -- glücklich -- -- alt Priester Natur -- heilig froh -- Fromm -- ehe Tempel stehen -- Hab -- -- entscheid Schicksal -- teuer Mädchen -- -- -- 
  Glück -- halb kranke -- letzter Schlacht -- Dienst entlassen -- bleiben -- müssen fort -- müssen fragen -- -- heißen bestürmen -- -- 
  Diotima -- bange töricht Gedanke fallen auf Herz -- denken -- Hoffnung scheitern -- 
  -- wiederzukehr Glück Erde -- verzehren heftig Geistesflamme -- leiden entzünden -- verzehren Sterbliche -- 
  wissen -- Welt entzweien -- versöhnen leicht -- 
  -- Kinderstille -- -- glücklich einst hoch Demut -- Diotima -- 
  versöhnen -- Schicksal empört -- 
  Liebes Leben -- Heilkraft -- Herzenslauten rufen -- menschlich Leben -- einst lieblich gesenkt Flug verweilen -- o kommen -- o bleiben Dämmerung -- 
  Schattenland Element Liebe rinnen Wehmut still Tau Himmel Auge -- 
  denken goldenen -- Holdselige -- Göttlichmelodische -- säuseln Hain Kalaur -- 
  sieh -- 
  untergegangen -- Hoffnung -- 
  Bild Himmelssinne -- -- Hausgott -- Brand retten -- 
  Leben -- unser unverletzt -- 
  Hingehen begraben -- 
  ruhelos Ziel hinaus -- Fremd -- Hab -- lieben lernen -- 
  O -- 
  letzter -- 
  warst -- bleiben -- 
  Hyperion Bellarmin -- 
  sitzen Alabanda Hügel Gegend -- lieblichwärmend Sonne -- spielen Wind abgefallen Laube -- 
  Land stumm -- hie ertönen Wald stürzend Baum -- Landmann fällen -- murmelt vergänglich Regenbach hinab ruhig Meer -- 
  ziemlich sorglos -- hoffen -- Diotima sehen -- still Glück leben -- 
  Alabanda Zweifel ausgereden -- sicher hierüber -- 
  heit -- Sinn -- 
  Zukunft -- 
  O wussen -- Freude -- Welt -- siegrisch Natur unnütz -- wirkungslos einsam -- lieser ge schehn -- zeitverkürzend Spiel verlieren -- 
  Bote -- 
  bringen Entlassung Kriegsdienst -- Russischen Flotte bitten -- -- Mühe wert scheinen -- 
  Paros verlassen -- -- 
  Reise gesund -- 
  Diotimas Antwort warten -- fort -- -- Gott Kalaure trieben -- 
  Alabanda hören -- verändert Farbe wehmütig -- 
  wird_es Hyperion -- rufen -- Alabanda verlassen -- 
  verlassen -- -- -- 
  O Träumer -- rufen -- siehst -- trennen -- 
  ich_es sehen -- erwidern -- sagen -- hie erscheinen -- Abschied deuten -- gerne Laune -- Herzensüberfluß -- 
  O kennen -- rufen -- Götterspiel reich Liebe -- selber Not schaffen -- Fülle entladen -- -- -- 
  ist_es Ernst -- 
  Ernst -- rufen -- -- 
  -- Hyperion -- sanft -- künftig Glück gerne stören -- Diotimas Nähe fürchten -- 
  Glaube -- gewagt -- Liebende leben -- tatlos Herz -- -- halten schwerlich -- 
  Alabanda -- lächelnd -- mißkennst -- 
  wächsern fest Seele springen Grenze -- 
  erstenmal Leben grillenhaft -- 
  Machtest Krankenwärter sehen -- gebären -- 
  Stillsitze scheu -- Siehst -- rufen -- ist_es -- 
  tätig leben -- -- Diotima -- -- halber Seele fühlen -- -- innig -- göttlich ungeteilt Leben -- 
  Glaube -- kindisch Versuch -- Wesen sehen Liebe -- 
  blicksen -- Kenntest -- 
  II. Bd. F fremd -- letzter -- Wesen lebendig -- 
  O schenken -- rufen -- 
  Laß -- -- 
  Tröste -- trösten -- 
  einsam -- einsam -- Leben -- Sanduhr -- -- 
  Seele -- rufen -- -- 
  zufrieden -- -- 
  fing welken -- Smyrna finden -- 
  -- 
  Schiffsjunge stark schnell Geist Glied rauh Kost -- mutig Arbeit -- 
  heiter Luft Sturmnacht Gipfel Masts hing -- wehend Flagge -- Seegevögel hinaussehen glänzend Tiefe -- Schlacht zornigen Schiff See durchwühln -- Zahn Eber Erde Hauptmann Seite stehen hell Blick -- leben -- o leben -- 
  nachh -- jung Tiniot Smyrner Strande begegnen -- Ernst -- Liebe -- verhärtet Seele aufgetaut Blick Jüngling lieben lernen heilig halten -- -- beherrschen -- neu Leben beginnen -- seelenvoller Kraft keimt Genusse Welt Kampfe -- hoffen -- -- hoffen -- ketten -- reißen -- Gewalt Schicksal ziehen -- verlieren -- finden -- Freundschaft Welt -- Wert -- Ruhm -- ist_es -- all vergebens -- 
  -- erwidern Seufze -- 
  -- Sonne -- rufen -- Laß -- 
  sorgen -- 
  -- Alabanda -- -- 
  Laß erzählen -- -- 
  gewiß Sache sprechen -- 
  -- stillen -- sprechen Vergangenem -- 
  einst hülflos Hafen Triest -- 
  Kaperschiff -- worauf dienen -- zuvor scheitern -- Wenig an Ufer Sevilla retten -- 
  Hauptmann ertrunk Leben triefend Kleid -- bleiben -- 
  ziehen ruhen Sonnenschein trocknen Kleid Sträucher -- 
  drauf Straße Stadt -- 
  Tor heit Gesellschaft Garten -- hinein -- singen griechisch lustig Lied -- 
  traurig kennen -- 
  glüht Scham Schmerz -- Unglück Schau tragen -- 
  achtzehnjährig Knabe -- wild stolz -- hassen Tod -- Gegenstand Mensch -- 
  vergebt -- -- fertig Liede -- kommen Schiffbruch wissen Welt gut Dienst -- singen -- 
  -- -- spanisch Sprache -- 
  Mann ausgezeichnet Gesicht treten näh -- Geld -- Sprache lächeln -- -- Kauf Schleifstein lern Messer schärfen Wandre durch fest Land -- 
  Rat gefallen -- 
  Herr -- -- erwidern -- 
  reichlich Übrig beschenken -- Mann geraten -- treiben Spanien Frankreich herum -- 
  erfahren -- Knechtschaft tausendfältig Gestalt Freiheitsliebe schärft hart Not Lebensmut klug Sinn erwuchs -- Freude -- 
  treiben wandernd schuldlos Tagewerk Lust -- verbittern -- 
  Maske -- gemein aussehn -- bilden -- treib stille gefährlich Geschäft -- zweimal Verhaft nehmen -- 
  bewegen -- aufgeben treten Gelde -- gewinnen -- Rückkehr Heimat -- einst entlaufen -- 
  Triest Dalmatien hinunter -- 
  befiel hart Reise Krankheit Reichtum -- 
  helbgenesen traurig Hafen Triest -- 
  stehen Mann -- Ufer Sevilla einst annehmen -- 
  Freute sonderbar -- sehen -- -- erinnern fragen -- mir_es indes ergehen -- 
  -- 
  sehen -- rufen -- umsonst -- Schule Schicksal schicken -- 
  dulden lernen -- sollst wirken -- -- 
  Rede -- Ton -- Händedruk -- Miene -- Blick -- treffen -- Gott -- Wesen -- leiden entzündbar -- -- -- -- 
  Mann -- Hyperion -- sprech -- -- Smyrna sahsen -- 
  führt Nacht feierlich Gesellschaft -- 
  Schauer überlufen -- Saal treten Eintritt Begleiter ernsen Mann weisen -- Bund Nemesis -- 
  Berauscht Wirkungskreis -- Auftat -- übermachen feierlich Blut Seele Mann -- 
  nachh Versammlung aufheben -- anderswo erneuern treten angewiesen Weg -- Welt -- 
  beigesellen -- Smirna nachher Fandst -- 
  Zwang -- worin leben -- foltert -- Wirkung Bund Tatenlust finden kahl Nahrung -- 
  reichen -- Abfall vermögen -- 
  Leidenschaft verleiten -- 
  habe_es -- Luft Sonne -- fort warst -- Wahl -- müssen aufgeben -- Bund -- 
  erwählen -- siehst -- 
  Mensch Strafe -- Gott Kind treffen Nemesis -- 
  ziehen Götterrecht Herzens -- 
  Liebling Wille brechen Eid -- 
  billig -- edelste Sehn freisten -- -- 
  Herz Wort nehmen -- Freiheit siehsen -- brauchen -- 
  huldig Genius achten sterblich Hindernis reißen Bande Leben entzwei -- 
  Verpflichtung brechen Freund Wille -- Freundschaft brechen Liebe Wille -- 
  Diotimas Wille betragen Diotima morden -- sein -- 
  Gang -- büßen -- -- Freiheit -- Richter wähl -- fehlen -- -- 
  Sprichst deinen Bundesbrüder -- rufen -- o Alabanda -- tun -- 
  nehmen -- Blut -- erwidern -- 
  fassen sanft Hand -- 
  Hyperion -- rufen -- -- übrig bleiben -- edles -- 
  Laß -- machen klein fasse Glaube Wort -- 
  wissen -- -- erkünsteln -- -- Leben Mal verzehren -- Brosame spielen -- Sache -- -- 
  Brauch sagen -- 
  sprech Seele -- 
  dür Luft -- Kühlung -- Hyperion -- 
  Seele wallen halten alt Kreis -- 
  schön Wintertage -- dunkel Erde -- Folie leuchtend Himmel -- -- blinken gastfreundlich Insel Lichts -- 
  -- wunderen Rede -- 
  Liebster -- scheidend sprechen -- Trunken -- nehmen gerne festlich -- 
  Baum welken anfängen -- tragen Blatt Farbe Morgenrot -- 
  Seele -- rufen -- Mitleid tragen -- 
  fühlt Höhe -- tief litt -- 
  weh Leben erfahren -- 
  -- o Bellarmin -- 
  fühlt Größe Freude -- solch Götterbild Auge arme -- 
  -- stirb -- rufen -- stirb -- 
  Herz herrlich -- Leben reif -- Traube Herbsttag -- 
  Gehen -- Vollendeter -- 
  gehen -- Diotima geben -- Hab -- erwidern Alabanda -- sprichst -- 
  tief -- seelenvoll -- Hyperion fassen -- 
  schmeicheln -- rufen -- unbesonnen Wort zweitenmal abzulocken -- Götter -- Erlaubnis gewinnen Reise Blutgericht -- 
  schmeichlen -- erwidern Ernst -- -- -- verhindern -- gemein -- ehren -- 
  Feuer Auge -- -- Göttergebot -- niederschlagen schämen -- Wort sagen -- 
  -- denken mitunter -- -- 
  sinnlos -- solch herrlich Leben hinzuschlachten -- Opfertier -- Glaube ruhig -- 
  Gewinn -- hören -- Nacht -- Reise sorgen -- Tagesanbruch hinausgehen -- -- 
  Weist -- -- Tod achten -- 
  fühlen Leben -- Gott schaffen -- Sterblicher zeugen -- 
  glauben -- selber -- frei Lust innig All verbinden -- 
  gehören -- erwidern -- 
  -- fahren fort -- Welt -- Einklang frei Wesen -- 
  eigen froh Trieb Lebendig Anbeginn zusammenwirkt vollstimmig Leben -- hölzern -- kalt -- 
  welcher herzlos Machwerk -- 
  hoch Sinn -- erwidern -- Freiheit tot -- 
  -- rufen -- wachsen Grashalm -- Lebenskeim -- -- 
  -- -- 
  frei hoch Sinn -- anfangslos fühlen -- glauben -- endlos -- unzerstörbar -- 
  Töpfer Hand -- Gefäß zerschlagen -- fällen -- 
  leben -- unerzeugt -- göttlich Natur Keim -- erhaben -- Kunst -- unverletzlich -- ewig -- 
  Mysteri -- Hyperion -- geheim Gedanke -- -- denken -- 
  leben -- unvertilgbar -- bleiben tief Knechtsform frei -- bleiben Eins scheidest Grund -- bleiben unverwundet Mark zerschlägst Wesen entfliegen siegend Hand -- -- 
  Morgenwind regen -- Schiff wach -- 
  O Hyperion -- 
  überwinden -- vermocht -- Todesurteil Herz sprechen trennen -- Liebling Leben -- Schone -- erspar Abschied -- laß schnell -- kommen -- 
  -- fliegen kalt Gebein -- beginnen -- 
  O Treue Wille -- Alabanda -- rufen niedergeworfen -- -- -- 
  übertäubtest unredlich Weise -- Rissest Taumel -- 
  Bruder -- Besinnung ließest -- eigentlich fragen -- wohin gehst -- 
  Ort nennen -- lieb Herz -- erwidern -- sehen dennoch -- 
  wiedersehen -- erwidern -- Glaube reich -- reich reich Glauben Glaube -- 
  -- rufen -- Laß still -- Wort helfen -- laß männlich enden -- 
  derbst letzter Augenblick -- 
  Hafen nah kommen -- 
  -- -- Schiff -- 
  grüß Diotima -- 
  Lieben -- 
  glücklich -- schön Seele -- 
  O Alabanda -- rufen -- Stelle -- 
  Beruf schön -- erwidern -- behalten -- 
  Gehörst -- hold Wesen Welt -- -- 
  Glück Opfer -- nimm Opfer -- o Schicksal -- -- laß Liebenden Freude -- -- 
  Herz fing -- überwältigen reißen springen Schiff -- Abschied abzukürzen -- 
  fühlen Augenblick -- Wetterschlag -- Nacht Totenstille folgen -- mitten Vernichtung raffen Seele -- halten -- teuer scheidend Arm zückten -- 
  Weh -- 
  Alabanda -- 
  Alabanda -- rufen -- dumpf Lebewohl hören Schiff herüber -- 
  Hyperion Bellarmin -- 
  zufällig halten Fahrzeug -- Kalaur bringen -- Abend -- Alabanda Weg gehen -- 
  bleiben Ufer -- blicken still -- Schmerz Abschied müde -- See -- Stunde -- 
  Leidenstage langsamsterbend Jugend überzählt Geist -- irr -- schön Taube -- schweben Künftigen -- 
  stärken -- längstvergessen Lautenspiel hervor -- Schicksalslied singen -- einst glücklich unverständig Jugend Adamas nachgesprochen -- 
  wandeln drob Licht weich Boden -- selig Genie -- 
  Glänzende Götterlüfte Rühre -- Finger Künstlerin heilig Sait -- 
  Schicksallos -- schlafend Säugling -- atmen himmlisch -- Keusch bewahren bescheiden Knospe -- Blühet ewig Geist -- selig Auge blicken still Ewiger Klarheit -- 
  geben -- Stätte ruhn -- schwind -- fallen leidend Mensch Blindling Stunde -- Wasser Klippe Klippe werfen -- Ungewisse hinab -- 
  singen Sait -- 
  enden -- Boot einlufen -- Diener erkennen -- Brief Diotima überbrachen -- 
  Erde -- schreiben -- siehst Tageslicht -- 
  denken anderswo finden -- -- 
  -- nachher wünschtest -- Brief erhalten -- Schlacht Tschesme schriebst lebt Woche Meinung -- habest Tod Arm werfen -- ehe Diener ankommen froh Botschaft -- lebest -- 
  ohnedies Schlacht gehören -- Schiff -- worauf wissen -- Mannschaft Luft fliegen -- 
  o süß Stimme -- hören -- rühren -- Mailuft -- Sprache Lieb -- schön Hoffnungsfreude -- hold Phantom unser künftig Glück -- Augenblick täuschen -- 
  Träumer -- wecken -- sagen -- kommen -- machen Schöne -- verheißen -- 
  spät -- Hyperion -- spät -- 
  Mädchen verwelken -- fort -- Feuer mählich verzehren -- Rest übrig -- 
  Entsetze -- 
  läutern Natürliche -- überall winden Blüte Leben frei frei gröber Stoff -- 
  Liebster Hyperion -- 
  dachtesen -- Schwanenlied hören -- 
  Fortsetzung -- 
  -- fort warst -- Abschieds fing -- 
  Kraft Geist -- erschrak -- innerer Leben -- Leben Erde -- erblassen -- Schwand -- Nachtlampe Morgenrot -- ich_es sagen -- 
  Delphi Gott Begeisterung Tempel bauen Fels alt Parnaß -- -- Pythia -- schlafen Volk Göttersprüch entzünden -- Seele wissen -- Gottverlaßenen jungfräulicher Mund Auge öffnen dumpf Stirn entfalten -- mächtig Geist Leben -- 
  müd müd sterblich Glied ängstigend schwere ziehen unerbittlich hinab -- 
  -- still Laube Jugend Rose weinen -- 
  welken welken -- Träne färben dein Mädchen Wange rot -- 
  vorig Baum -- vorig Laube -- stehen einst Diotima -- Kind -- Hyperion -- deinen glücklich Auge -- Blume Blume Kraft Erde Himmel treffen friedlich -- -- Fremdlingin Knospe Mais -- vertraute -- lieblich Pflanze -- nickn freundlich -- trauern -- II. Bd. G vorüber -- Abschied all Jugendgespiel -- Hain Quelle säuselnd Hügel -- 
  -- schwer süß Mühe -- ich_es -- Höhe gehen -- Notara gewohnen -- Freund sprechen -- leicht Sinn -- -- schreiben -- -- Herz laut -- schlich Heuchlerin hinaus Garten -- Geländ -- Fels -- einst Hinab -- hinaus offen Natur -- -- stehen -- dein Hand halten -- dein Auge umlauscht -- schaudernd Erwarme Liebe überwallend Seele auszugießen wünschen -- Opferwein -- Abgrund Leben -- wanken umher klagen Wind Leid -- scheuer Vogel -- irren Blick wagen -- schön Erde ansehen -- scheiden -- 
  Fortsetzung -- 
  ist_es Mädchen -- Hyperion -- 
  Frage -- erklär Tod -- 
  solch Schicksal ergründen denken -- Flucht -- Seele Schuld -- 
  sagen -- Gram töten -- o -- o -- 
  willkommen -- Gram -- Tod -- tragen -- Gestalt Anmut -- liebling Ehre stirbst -- sagen -- 
  -- Seele reif all Begeisterungen Liebe halten -- übermütig Jüngling -- bescheiden Heimat -- sprich -- Herzens Üppigkeit -- entzweit sterblich Leben -- Natur -- Herrlicher -- stolz -- sich_es lang gefallen lassen mittelmäßig Stern -- 
  fliegen lehren -- lehrst Seele -- wiederzukehren -- 
  ätherliebend Feuer anzünden -- hütetest -- -- 
  Höre -- -- schön Seele Wille -- klag Tod -- 
  Konntest halten -- Schicksal Weg weisen -- -- Hättest Heldenkampf dein Herzens predigen -- laß genüg -- Kind -- Schick -- Wärst eitel eitlen -- 
  Fortsetzung -- 
  sagen -- glauben -- 
  Feuer leben -- Geist übergehen -- schwerlich schaden -- Schicksal neu Leben tödlich -- 
  mächtig Seele -- stillen -- 
  entzogst Leben Erde -- hättest -- Erde fesseln -- Hättest Seele -- Zauberkreis -- umfangend Arm bannen -- -- 
  Herzensblicke fest halten -- Liebesreder froh gesund Kind -- Schicksal Geisteseinsamkeit -- Wasserflut Bergesgipfel treiben -- o -- vollends meinen -- Wetter Schlacht Kerker sprengen Hyperion auffliegen alt Freiheit -- entscheiden enden -- 
  Wort -- stillschweigend sterben Römerin -- Todeskampf Brutus Vaterland ringen -- 
  besseres letzter Lebenstage -- -- 
  treiben mich_es -- mancherlei sagen -- 
  still Leben -- Tod beredt -- 
  -- 
  Fortsetzung -- 
  sagen -- 
  Müßtest untergehen -- verzweifeln Müßtest -- Geist retten -- Lorbeer tröst Myrtenkranz -- Olymp wird_es -- lebendig -- gegenwärtig -- ewig Jugendlich Sinn blühen -- 
  schön Welt Olymp -- leben -- heilig Wesen Welt -- Götter Natur -- freudig -- 
  O willkommen -- Gute -- Treu -- Tiefvermißte -- Verkannt -- 
  Kind Altest -- 
  Sonne Erde Äther lebend Seele -- spielen -- umspielt -- ewig Liebe -- o nehmen allesversuchend Mensch -- nehmen Flüchtling Götterfamilie -- nehmen Heimat Natur -- entwichen -- 
  -- kennst Wort -- Hyperion -- 
  anfangen -- 
  wirsts vollenden -- Ruhn -- 
  -- freudig -- griechisch Mädchen sterben -- 
  arme -- kennen -- dürftig Machwerk -- Not dienen Genius verschmähen -- Ehre -- kindlich Leben Natur -- Tod fürchten -- 
  Joch Welt -- Besseres -- Knechtsdienst -- kennen -- scheu Götterfreiheit -- Tod -- 
  -- 
  Stückwerk überhoben -- Menschenhände -- fühlen -- Leben Natur -- hoch -- Gedanke -- Pflanze -- Schade -- -- 
  -- 
  verlieren Sphär Leben -- worin ewig Liebe -- gemein -- Natur zusammenhalten -- 
  sollt scheid Bund -- Wesen verknüpfen -- 
  brechen -- lose Bande -- 
  -- Markttag -- Volk zusammenläuft lärmen auseinandergehen -- 
  -- Geist -- einiget -- Gottesgeist -- gemein -- -- -- Bund Natur Treue Traum -- 
  trennen -- innig einig -- göttlich friedlich -- -- 
  sterben -- leben -- 
  -- fragen -- -- 
  -- leben -- -- Ehre Götter -- -- Leben -- göttlich Welt -- Herr Knecht -- 
  leben umeinander Natur -- Liebende -- gemein -- Geist -- Freude ewig Jugend -- 
  Beständigkeit Stern wählen -- still Lebensfülle wallen stets kenn Alter -- 
  stellen Wechsel vollendeter dar -- wandelnd Melodie teilen Akkorde Freude -- 
  Harfenspieler Thron Ältestus -- leben -- göttlich -- still Götter Welt -- flüchtig Lebenslied milderen selig Ernst Sonnengotts -- 
  Sieh Welt -- 
  -- wandelnd Triumphzug -- Natur ewig Sieg Verderbnis feiern -- führen Verherrlichung Leben Tod -- golden Kette -- Feldherr einst gefangen König führen -- -- Jungfraue Jünglinge -- Tanz Gesang -- wechselnd Gestalt Tön majestätisch Zug geleiten -- 
  Laß schweigen -- 
  sagen -- -- 
  begegnen -- 
  -- Trauernd Jüngling -- -- glücklicher -- Lorbeer gereifen Myrt verblühn -- Priester sollst göttlich Natur -- dichterisch Keim -- 
  O sehen künftig Schön -- 
  Leb -- 
  erhalten Brief Notara -- worin schreiben -- 
  -- letztenmal schreiben -- ruhig -- sprechen Wort -- -- Feuer Erde scheiden -- begraben -- asch Urne sammeln -- Wald stellen -- Ort -- -- Teurer -- 
  begegnen Wärst -- 
  -- Anfing -- dunkel -- Nacht -- schlafen -- schlagen Arm schön Haupt -- hören atmen -- 
  Still hören -- lauschen -- 
  O Hyperion -- sagen -- 
  Klage wecken -- 
  furchtbar Geheimnis -- Leben sterben gestehen -- selber weder Sinn Glaube -- ansehen -- 
  schön Tod -- Hyperion -- 
  solch schläfrig Leben -- -- 
  Fliege abwehren -- künftig Arbeit nagen Ding Welt -- Kind dürren Feigenwurzel -- Freude -- 
  alt jugendlich Volk -- scheinen Lust -- alt -- alt -- scheinen schlimm -- -- -- 
  fast raten -- Hype Rion -- hierher kommst -- 
  kennen -- 
  Sinn nehmen -- 
  überdies sicher -- 
  Teurer -- denken Diotimas Mutter -- denken Schone -- 
  gestehen -- schaudern -- Schicksal überdenken -- 
  -- brennend Sommer trocken tief Quelle -- seichen Regenbach -- 
  Augenblick sehen -- Hyperion -- hoch Wesen schienst -- 
  Probe -- zeigen -- -- 
  Leb -- 
  schreiben Notara -- Fragst -- Bellarmin -- 
  -- erzählen -- 
  Bester -- 
  ruhig -- besseres -- Gott -- 
  leiden -- 
  Trefflicher -- tief -- 
  Leidet heilig Natur -- 
  O Gottheit -- trauern Könntest -- selig -- fassen -- 
  Wonn -- leiden -- Schlaf -- Tod Leben -- 
  Solltest ewig -- Kind schlummern -- -- Sieg entbehren -- Vollendung durchlaufen -- 
  -- -- wert Schmerz -- Herz Mensch liegen -- Vertrauter -- o Natur -- 
  führen Wonne -- anderer Gefährte -- -- -- 
  schreiben Notara -- Anfing aufzuleben -- Sizilium -- wohin Schiff Paro bringen -- 
  gehorchen -- Teurer -- Nachricht geben -- schwer Wort -- gestehen -- 
  Selig -- Diotima -- sprechen -- Nacht -- tief Traurede -- Rede -- 
  schön Tod Diotima sterben -- -- ist_es -- aufwecken -- Seele wiedergeben -- 
  vorig Welt -- wiederkehren -- 
  Fremdling -- Unbegraben -- herauf Acheron -- heimatlich Insel -- Garten Jugend -- Vater verschließen -- -- dennoch -- dennoch -- Erde Fremdling Gott knüpfen an -- 
  -- 
  vorbei -- 
  sagen -- Seele binden -- ruhig bleiben -- erhitzt ungereimt kindisch Versuch -- 
  vorbei -- wein -- schön Gottheit -- Adonis einst weinen -- kehren Diotima Herzen Wort Kraft verlieren -- hören Lüfte -- 
  O Gott -- -- gemein Handarbeit sagen -- tun -- -- tröst -- Geistesarme -- lächeln Träumer schelten -- Tat reifen -- Arm frei -- wütenden Prokrust gleichen -- Mann -- fing -- Kinderwieg werfen -- paßt Bett -- Glied abheiben -- 
  trostlos -- närrisch Menge werfen zerrissen -- Müßt -- Edel Blut schämen -- Knechtsblut mischen -- o gäbe Fahne -- Gott -- Alabanda dienen -- Thermopylä -- Ehre verbluen -- all einsam Liebe -- nimmer brauchbar -- 
  freilich -- leben -- leben -- Tempel -- neuversammelen Agora unser Volk Lust Kummer stillen -- Schweig -- wein Kraft vollends -- denken -- 
  Notara -- ist_es -- verleiden Seele -- ihrs vorwerfen -- Diotima tot -- Gedanke Jugend -- achten -- gelten -- 
  Diotima vergiften -- 
  sagen -- Zuflucht -- 
  -- Gestern Ätna droben -- 
  fallen Sizilianer -- einst Stundenzählen -- vertraut Seele Welt -- kühn Lebenslust hinabwarf herrlich Flamme -- kalt Dichter Feuer wärmen -- Spötter -- 
  O gerne Spott laden -- hoch -- -- ungerufen Natur an Herz fliegen -- heißen -- -- -- Name Ding ungewiß -- 
  Notara -- sagen -- Zuflucht -- 
  Kalaurea Wälder -- -- 
  -- grün Dunkel -- Baum -- vertraute Liebe stehen -- -- Abendrot -- sterbend Laub Diotimas Urne fallen schön Häupter Diotimas Urne neigen -- mählich alternd -- zusammensinken geliebt Asche -- -- -- ' Sinn wohnen -- 
  Rätst -- wegzubleiben -- Meinst -- sicher Kalauer -- 
  wissen -- Alabanda verweisen -- 
  hören -- zertrümmeren -- verwittert fest -- schlank Stamm -- -- Buben Span auflesen lustig Feuer -- 
  fort -- gewiß Freund -- erleichtern -- eigentlich geschickt -- abhelfen -- Leben schwer aufliegt -- Besuch gehen -- -- -- -- wissen -- Leidenschaft Herzen nagen -- weisen -- 
  Diotima -- Leben glauben -- vermählen glücklich -- arm Alabanda -- gehören -- 
  fahren Osten hinaus -- schiff Nordweste -- Gelegenheit -- 
  -- leben -- -- Teure -- Herz liegen -- Freund Jugend Eltern lieben Grieche -- Leidende -- 
  Lüfte -- nähren -- zart Kindheit -- dunkel Lorbeerwald Uferfelsen majestätisch Gewässer -- ahnen Geist lehren -- -- Trauerbilder -- -- Schwermut anheben -- heilig Mauer -- womit Heldenstadt umgürtet alt Tor -- manch schön Wanderer durchzog -- Tempelsäule Schutt Götter -- -- o Diotima -- Täl Liebe -- Bäch -- selig Gestalt sehen -- Baum -- erheiteren -- Frühlinge -- leben -- Holde Blume -- scheiden -- scheiden -- -- -- süß Angedenk -- erlöschen lassen -- Mensch ändern Licht Leben scheiden -- -- 
  Hyperion Bellarmin -- 
  deutsche -- 
  fordern fassen -- finden -- 
  Demütig -- heimatlos blind Ödipus Tore Athen -- Götterhain empfangen -- schön Seele begegnen -- -- 
  Barbar Alter -- Fleiß Wissenschaft Religion barbarisch -- tiefunfähig jeder göttlich Gefühl -- verdorben Mark Glück heilig Grazie -- Grad Übertreibung Ärmlichkeit beleidigend gutgeartet Seele -- Dumpf harmonielos -- Scherbe weggeworfenen Gefäßes -- -- Bellarmin -- Tröster -- 
  hart Wort dennoch sagen ich_es -- Wahrheit -- 
  Volk denken -- zerrißen -- Deut schen -- 
  Handwerker siehst -- Mensch -- Denker -- Mensch -- Priester -- Mensch -- Herr Knecht -- Junge gesetzt Leute -- Mensch -- -- Schlachtfeld -- Hand arm Glied zerstückeln untereinander liegen -- indessen vergoßen Lebensblut Sand zerrinnen -- 
  treiben -- sagen -- sagen -- 
  Seele treiben -- Kraft ersticken -- Titel passen -- karg Angst -- buchstäblich heuchlerisch -- -- -- Ernst -- Liebe -- -- leben Geist -- Fach drücken -- Geist leben -- Stoß er_es Verachtung weg lerne pflügen -- 
  deutsche bleiben gerne Notwendigste -- Stümperarbeit Freie -- Ächterfreulich -- 
  verschmerzen -- müssen Mensch fühllos schön Leben -- ruhen überall Fluch gottverlaßen Unnatur Volke -- -- 
  II. Bd. H Tugend alt glänzend Fehler -- -- wissen -- böse Zunge -- selber Fehler Tugende -- leben kindlich -- schön Geist -- Seele -- tun -- tun -- 
  Tugende deutsche glänzend Übel -- Notwerk -- feig Angst -- Sklavenmüh -- wüs Herz abgedrungen -- lassen trostlos rein Seele -- Schönem nähren -- -- verwöhnen heilig Zusammenklang edler Natur -- Misslaut ertragen -- schreiend all tot Ordnung Mensch -- 
  sagen -- 
  Heilig -- entheiligen -- ärmlich Behelf herabgewürdigen Volk -- wilde göttlichrein meist erhalten -- treiben alberechnend Barbar -- Handwerk treiben -- -- menschlich Wesen abgerichten -- dienen Zweck -- suchen Nutzen -- schwärmen -- bewahren Gott -- bleiben setzen -- feiern lieben beten selber -- Frühling hold Fest -- Versöhnungszeit Welt Sorge lösen -- Unschuld zaubern schuldig Herz -- Sonne warm Strahle berauschen -- Sklave Kette froh vergessen gottbeseelt Luft besänftiget -- Menschenfeinde friedlich -- Kind -- -- Raupe beflügeln biener schwärmen -- bleiben deutsch Fach kümmern um Wetter -- 
  richten -- heilig Natur -- 
  -- bescheiden sein -- Mensch -- Gesetz machen Besseren -- Lästerte -- -- möchten lästern -- Göttlich höhnten -- -- 
  göttlich -- höhnen seellos nennen -- 
  -- eu Geschwätz -- Luft -- trinken -- Sonne Strahlen -- edl -- Klug -- Erde Quelle Morgentau erfrischen euren Hain -- -- -- töten -- lebendig -- Liebe tun -- -- erfun -- 
  sorgen sinnen -- Schicksal entlaufen begreifen -- eure Kinderkunst helfen -- indessen wandeln harmlos droben Gestirn -- 
  entwürdiget -- zerreißen -- dulden -- geduldig Natur -- leben fort -- unendlich Jugend -- Herbst Frühling vertreiben -- Äther -- verderben -- 
  O göttlich -- zerstören -- dennoch alteren trotz schön schöne bleiben -- -- 
  herzzerreißend -- eur Dichter -- eur Künstler sehen -- -- Genius -- schön lieben pflegen -- 
  gute -- 
  leben Welt -- Fremdlinge Haus -- -- Duld Ulysses -- Bettlersgestalt Türe sitzen -- indes unverschämt Freier Saale lärmen fragen -- Landläufer bringen -- 
  Voll Liebe Geist Hoffnung wachsen Musenjüngling deutsch Volk -- heran -- siehst -- wandeln -- Schatten -- still kalt -- -- Boden -- Feind Salz besäte -- nimmer Grashalm treiben -- sprechen -- wehe -- verstehen -- stürmend Titanenkraft -- Proteuskünst Verzweiflungskampf sehen -- gestört schön Geist Barbar kämpfen -- -- 
  Erde unvollkehmen -- alt Lied deutsche -- 
  Gottverlaßene -- unvollkommen -- Reines unverdorben -- Heilig unbetasten lassen plumpen Hand -- gedeihen -- Wurzel Gedeihen -- göttlich Natur -- eigentlich Leben schal sorgenschwer übervoll kalt stumm Zwietracht -- Genius verschmähen -- Kraft Adel menschlich -- Heiterkeit Leiden Liebe Brüderschaft Stadt Haus bringen -- 
  fürchten Tod -- leiden -- Austernleben Wille -- Schmach -- Höher kennen -- Machwerk -- stoppeln -- 
  O Bellarmin -- Volk schön lieben -- Genius Künstler ehren -- wehen -- Lebensluft -- allgemein Geist -- öffnen scheu Sinn -- Eigendünkel schmilzen -- fromm Herz Held gebieren Begeisterung -- 
  Heimat Mensch Volk -- gerne Fremde verweilen -- 
  beleidigt göttlich Natur Künstler -- -- Leben gut Lust hinweg -- Stern -- Erde -- 
  Wüster -- öd Mensch -- schöngeboren -- Knechtsinn wachsen -- grob Mut -- Rausch wachsen Sorge -- Üppigkeit Hunger Nahrungsangst -- fluch Segen jeder Jahr Götter fliehen -- 
  wehe Fremdling -- Liebe wandern -- Volke -- dreifach wehe -- -- -- groß Schmerz treiben -- Bettler Art -- Volke -- -- 
  -- Kennst -- aufnehmen -- Bellarmin -- 
  sprechen Name -- sprechen -- Land leiden -- gelitten -- 
  Hyperion Bellarmin -- 
  Deutschland fort -- 
  suchen Volke -- kränken -- unerbittlich Beleidigung -- -- Seele vollends Mensch verbluen -- 
  himmlisch Frühling halten -- einzig Freude -- übrig -- letzter Liebe -- Ding denken Land verlassen -- -- 
  Bellarmin -- 
  erfahren -- alt fest Schicksalswort -- Seligkeit Herzen aufgehen -- aushalten Mitternacht Gram durchdulden -- -- Nachtigallgesang Dunklen -- göttlich tief Leid Lebenslied Welt tönen -- 
  -- Genie -- leben blühend Bäume -- klar Bach -- fließen -- säuselten -- Götterstimme -- Kummer Busen -- 
  geschehen überall -- -- -- Grase ruht -- zart Leben umgrünen -- hinauf -- wild Rose Steinpfad wachsen -- warm Hügel -- Strom Gestade -- luftigen umschiffen Insel -- zärtlich hegen -- 
  morgens -- kranke Heilquell -- Gipfel Gebirges steigen -- schlafend Blume -- süß Schlummer sättigen -- lieb Vogel busche fliegen -- Zwielicht taumelnd begierig -- reger Luft Gebete Täl -- Stimme Herde Ton Morgenglocke herauftragen -- hoch Licht -- göttlichheiter gewohnt Pfad daherkommen -- Erde bezaubernd unsterblich Leben -- Herz erwarmen Kind fühlen -- o Mond -- Himmel bleiben -- Lust Tags teilen -- stehen Einsamer Ebn weint Liebesträne Uf hinab glänzend Gewässer Auge wenden -- 
  Abends -- fern Tal hinein geraten -- Wiege Quell -- ring dunkel Eichhöhe umrauscht -- -- Heiligsterbend -- Frieden Natur begrub -- Erde Schatte -- unsichtbar Leben Zweig säuselt -- Gipfel -- Gipfel still Abendwolke stehen -- glänzend Gebirg -- wovon herab Himmel Strahl -- wasserbäche fließen -- durstig Wanderer tränken -- O Sonne -- o Lüfte -- rufen -- leben Herz -- Brüdern -- 
  selig Natur fast endlos -- 
  gerne Kind -- nah -- wissen -- rein Lichtstrahl -- nah -- o Augenblick Frieden -- schön fühlen -- gelten -- voll Gedanke -- Versuch allesversuchend Mensch -- 
  Eis -- zerschmolz -- lernen -- tun Leben -- Entwurf Jugend verhallten -- o Lieben -- fern -- tote lebend -- innig -- 
  einst sitzen fern Feld -- Brunnen -- Schatten Efeugrüner Fels überhängend Blütenbüsch -- 
  schön II. Bd. I ste Mittag -- kennen -- 
  Süß Lüfte wehten morgendlicher Frisch glänzt Land still heimatlich Äther lächelen Licht -- 
  Mensch weggehen -- häuslich Tisch Arbeit ruhn -- Liebe Frühling -- unbegreiflich Sehne -- 
  Diotima -- rufen -- -- o -- 
  -- hören Diotimas Stimme -- Stimme -- einst erheiteren Freude -- -- rufen -- -- Deine -- irr Menschengeist mißkennen -- 
  sanft Schrecken ergriff denken entschlummeren -- 
  O lieb Wort heilig Mund -- rufen -- erwachen -- lieb Rätsel -- fassen -- 
  kalt Nacht Mensch schaueren weint Freude -- selig Wort sprechen -- dünken -- -- Feuer Rauschen -- auffliegen Asche lassen -- -- O -- denken -- dein Götter -- Natur -- 
  austräumen -- Menschending Traum sagen -- lebst -- Friedenslose erzwingen -- erdachen -- schmilzen -- Perle Wach -- hinweg deinen Flamme -- 
  ist_es -- entbehren -- o ist_es -- Menge schilen -- gemein nennen Götter -- Lebendig -- Seligstill -- 
  fallen Mensch -- faul Frucht -- o laß untergeh -- kehren Wurzel -- -- o Baum Leben -- grün Gipfel umatme all dein knospend Zweig -- friedlich innig -- wachsen golden Saamkorn herauf -- 
  Quelle Erde -- Blume -- Wald Adler brüderlich Licht -- alt neu Liebe -- -- 
  frei -- gleich ängstlich außen -- wechseln Weise Leben -- 
  lieben Äther innigst Innerst gleichen -- 
  -- scheiden -- Diotima -- Träne verstehen -- 
  Lebendige Ton -- stimmen Wohllaut -- Natur -- reißen -- Liebende scheiden -- -- 
  O Seele -- 
  Seele -- 
  Schönheit Welt -- unzerstörbar -- entzückend -- ewig Jugend -- -- Tod Wehe Mensch -- -- 
  -- leer Wort Wunderlich -- 
  Geschehen Lust -- enden Frieden -- 
  Zwist Liebenden -- Dissonanz Welt -- 
  Versöhnung mitten Streit Getrennt finden -- 
  scheid kehren Herz Ader -- ewig -- glühend Leben -- -- 
  denken -- 
  Nächstens -- 