Beitrag Geschichte Konvenienz Vorrede Herausgeber Vorrede Herausgeber Luisen Geschichte -- Alltäglichkeit schrecklich traurig -- -- lesen -- wiederholt beteuern -- 
  elend Roman -- lehrreich Geschichte -- 
  indessen Leser Not -- ehe -- Ding unterrichten -- nämlich schreiben -- 
  herausgeben -- 
  Erzählung -- fast Ausnahme -- Werk Heldin -- entstehen folgendermaßen -- 
  achtungswürdig Arzt -- fast hoffnungslos Zustand Gesundheit Rat fragen -- Erfahrung belehren -- gebildeter empfänglicher Mensch Körper aufzuhelfen -- Seele freundlich Hand bieten -- glauben finden -- Anriet -- Geschichte leiden Unglück aufzuzeichnen -- 
  Fantasie unmöglich -- schwarz Bild Vergangenheit trennen -- glauben gewiß Schranke bannen -- Verstande anstrengen -- schwankend Vorstellung wirklich zusammenhängender bilden -- 
  glauben -- Luise Schicksal erträglich -- Wunde unheilbar ansehen -- ungeheuchelt Rechenschaft -- betreffen -- ablegen -- 
  berechnen -- schlagen hartnäckig Übel -- -- Erinnerung unglücklich Leben -- vorschriftsmäßig tief verwundet Seele -- beschäftigen -- verzweifelen jemals -- diesseits Grabe Ruhe finden -- 
  Arbeit grub vielmehr Gedanke Erwartung Tode tief Herz -- einzig Ziel -- Denkmal errichten -- -- verlassen glauben -- sagen -- litt sterben -- Freund zurufen -- 
  -- ruhen -- -- fremde -- -- Lasst einsam hülflos verschmachten -- leiden einst litt -- -- 
  Grabstein schweben Friede Verzeihung -- Stimme Todes regen Leidenschaft -- fried Verzeihung erwartet Luise -- lebendig tot halten -- Blatt händ Mann liefern -- persönlich kennen -- vertrauen Achtung -- Herausgabe auffordern -- 
  scheinen Heiliges -- Wunsch grenzenlos Unglücklichen unerfüllt lassen -- 
  indessen Geschichte auftretend Person einzig kenn -- Stande urteilen -- klar Überzeugung -- luisen Unglück betreffen beweiset -- Wort glauben -- vieler getan Unrecht anbelangen -- kompetentest Richterin annehmen -- 
  geschehen -- arm schrecklich Epoche Verstandesverwirrung überstehen -- Meinung -- Vernunft herstellen -- -- schwach Genesung heftig wirken -- Entschlüß hervorzubringen -- -- hell Bewußtsein -- Person umgeben -- wiederum Vorurteil bestärken müssen -- 
  ähnlich Fall unleugbar -- Unrecht leiden zweifelhaft -- Unrecht -- 
  Labyrinth treiben grausam Schicksal Mensch -- angingen -- unaufhörlich herum -- 
  Szene Verzweiflung -- -- Geständnis Gemahl enthüllen -- Gewohnheit -- brüten unglücklich Frau -- 
  brüten -- litt -- weinen -- schwerlich glücklich -- Art -- Stimmung Charakter fühlen -- Antrieb toben -- Weise Veranlassung Unglück zerstreuen -- rächen -- Luise gleich -- wiewohl unvermeidlicher Egoismus fortfuhr -- Kummer ausgehen -- -- Einfluß Charakter -- nächster Ursache Mißverhältniss -- 
  behandeln dacht Mensch -- erblicken fühlt nämlich Mensch schlimm -- güt Kraft -- Zügel halten -- hinweggesetzen -- anderer Handlung Motiv peinlich grübeln -- stoßen schwärmerisch Kleinlichkeit -- unaufhörlich gewöhnlich menschlich gesellschaftlich Kleinlichkeit -- 
  oberflächlichst psychologisch Kenntnis hinreichend -- -- Held verfaßt Biographie -- gewiß allgemein Vorsichtsregel anwenden -- Unglücklich -- Erzählung Leben -- fast einzig Krankheitsgeschichte vortragen -- besonderer Rücksicht nehmen -- wiefern Vorstellung -- Mensch Ding -- Einfluß individuell Zustand notwendig unterworfen müssen -- 
  Arzt -- Fieberkranke besuchen -- Heftigkeit versichern hören -- eisern Band Schläfe legen -- boshaft Weise Kehl zudrücken -- 
  -- erfahren Art Aussage Tatsache annehmen -- -- -- verdrießlich Beteuerung Wärterin -- Fieberwahn -- schlechterdings verlassen -- vielmehr untersuch -- kranke Kopfzeug fest schläfe binden -- sorgen -- Kissen unterlegen -- peinigend Zufluß Blutes kopfe lindern -- 
  wund Gefühl Leidende -- erzählen erduldet -- müßig Weisheit verwerfen -- sagen -- 
  -- traurig physisch Anlage -- unglücklich Zufälle -- zerrüttet Körper -- angegriffen Geist -- -- begegnen -- urteilen -- -- Menschenfreund Klagende verstehen -- verstehen -- einzig möglich Trost gewähren -- Menschenkenntnis erweitern fühlen -- helfen -- -- helf kranke -- heilen vermögen -- -- Keim ähnlich Unglück ähnlich Schuld -- Menschenzirkel verbergen -- Zeit auszurotten verbessern lernen -- 
  Luise beklagen Vollem -- verkennen -- verkennen -- mißhandeln -- freilich verkannen -- erscheinen Rettung -- Verwirrung Schicksal -- 
  aufgehend Rechnung Fehler Vorwurf -- Mensch leben -- hoch Richterstuhl abschließen gelten -- gesund kranke -- Älteren junge -- Vernünftig Schwärmerin -- Stark schwache -- Mann Weibe -- schuldig -- -- 
  Tod unglücklich Gläubiger hinweggenommen -- -- Schuld abtragen -- -- trotz Umstand erklären -- entschuldigen -- rechtfertigen -- Alsdann drückend fühlen -- 
  gegeben Winke gelingen -- Nutzen vorbereiten -- Herausgabe Luisen Geschichte stiften hoffen wünschen -- 
  indessen erlauben -- Gesichtspunkt berühren -- -- dünken -- folgend Blatt betrachten -- 
  traurig -- Matte grell Gemälde -- einzeln Blatt unselig Geschichte Konvenienz -- 
  -- Durchbrecht Schranken Konvenienz -- -- -- -- lauter Räuber Mörder -- -- 
  Wort -- -- Reißt Larve herab -- sittlich Herabwürdigung bedecken übereinkamen -- sehen -- -- 
  Elend -- vertraute Luise Leser -- rührt Naturnotwendigkeit -- eisern Bande sterblich Bruder erlösen vermögen -- Unvermeidlichkeit liegen lediglich -- konventionell Kreis -- Gesellschaft ziehen -- Schranke einzeln Kopf zerstoßen -- kämpfen Schicksal -- 
  hundert Familie stehen ähnlich Verhältnis -- ähnlich Verbindung -- -- gleichgültig Publikum -- ähnlich Schein Wohlstand fein Sitte -- Luisen Haus -- indessen ähnlich Gewühl Schwäche kämpfend Leidenschaft verschließen -- -- leise gehren -- hie Schlechtigkeit hervorbringen -- öffentlich ansehen schmälern -- Bedingung genießen -- -- lebhaft organisiert Sittlicher Mensch -- Raserei Verbrechen entzünden -- einstimmig Proskription Unglücklichen herabziehen -- Gewohnheit -- sanft ruhen -- aufschrecken -- 
  gut strafen Konvenienz -- strafen unerbittlich -- schnell -- ungehört -- Quelle Übel unaufgesucht -- Heiligtum Verderbnis unangetastet erhalten -- 
  Verhältnis -- Alsdann traurig -- schrecklich -- unsittlich -- ärgerlich ansehen -- Familie offenbaren anfangen -- erstaunt -- zischeln -- stellen Sache waltenden Schicksal Anheim -- 
  -- Gegenstand Gespräch Teetisch -- Interesse -- 
  -- diskret Behandlung -- Publikum kommen -- Mademoiselle N. sterblich Herr N. N. verlieben -- Eltern Neigung mißbilligen -- lebhafte Auftritt -- Mademoiselle rotgeweinten Auge Gesellschaft kommen -- Verstand verlieren -- Mann -- Überredung Familie nehmen -- bekümmern -- Wärterin überlassen -- Rut peitschen -- verhungern lassen -- u. s.w -- -- 
  empfinden Familie -- Unschuldige Schuldige -- gewiß nachteilig Wirkung Gerücht öffentlich Meinung -- versöhnen indessen unfehlbar -- einzig -- sobald geschehen Übel äußerer Anstand vergraben wissen -- rettungslos austoben -- dahingegen möglich Schritt -- verbessern -- allgemein Skandal vermehren -- -- Konvenienz -- wesentlich unwirksam -- 
  einzeln fein Seele entsetzen -- Mensch Greuel vorgehen -- Schein Schwärmerei Bizarrerie -- Don Quixottismus -- trotzen helfen -- finden -- Schein umsonst Bestrebe werfen -- -- unmöglich -- Ding -- 
  klein Anzahl vertraut Freund angehörige Haus -- Publikum zugestehen -- Angelegenheit bekümmern -- -- o Konvenienz Vorteil verstehen -- beschränken verklausulieren -- Herrschaft gefährlich -- 
  schwerlich unbefangen Leser folgend Geschichte entbrechen ausrufen -- 
  Mensch barmherzig -- luisen Hand Henker erlösen -- 
  Mutter -- alr Zärtlichkeit Tochter Stolze aufgeopferen -- Rut fühllos Mietling zerreißen lassen -- Zustand Nachsicht -- Pflege Säuglinge versagen -- bedürftig -- Pflicht streng Ernst vorhalten -- 
  einfach vernünftig Weib vorher -- -- luisen sagen -- -- jung Frau -- romanhaft Zärtlichkeit -- Ebbe Flut Gefühlen -- fesseln junge unbärtig Liebhaber -- beglücken Ehemann -- Sonn Festtagskost -- Haus täglich behaglich physisch moralisch Existenz suchen -- fordern -- -- 
  -- platonisch Vertrag Luisen Gemahl kennen -- drein sprechen -- Entschuldigung -- jemals zugaben -- 
  Blachfeld eingehen -- -- fühllos Wild -- tun -- Tor -- -- platonisch Begriff Verdienst Überwindung setzen -- höchst verdienstlose -- -- Wort -- sicher rechnen -- Natur Liebe Pflicht Ablauf Frist lossprechen -- 
  Veranlassung Vertrag unwiderruflich Luisen Charakter -- physisch Anlage gründen -- Ehe Bestimmung -- müssen verheiraten -- bloß Geburt überspannt Gefühl -- verkehrt Begriff Liebe Glück -- falsch Besorgnis Gesundheit -- müssen unerfahren Mädchen Besseren belehren -- ehe erlauben Pflicht übernehmen -- schwer heilig -- weder Neigung Vernunft -- Eitelkeit Konvenienz Heirat schließen -- weder Kopf Herz -- kahlen dürr Buchstabe bürgerlich Pflicht -- Glück Ehe wachen -- 
  ansehen -- Luise meisten ehren -- mischen Hierin -- Stimme Freundschaft -- -- Leidet Konvenienz Freundschaft -- 
  Jüngling treffen zuweilen Spur Urbilde Freundschaft -- gegenseitig mitteilen -- Beistehen Geist Herz Beutel -- reifere Alter -- Ziel Weisheit anrühmen -- Konvenienz Grab schön Menschlichkeit -- trennen Band -- 
  vernünftig Mann Freund -- Kollege -- standesmäßigen Umgang -- Frau barmherzig -- Tisch Trinkgenosse -- Freund -- -- welcher Romanenbegriff -- 
  weib Kind -- vergehen -- 
  Weiberfreundschaft tragen Jugendblüte -- Geburt elterlich Druck -- Eitelkeit -- Gewohnheit -- leeren Empfindelei -- öfters Intriguensucht -- größ Ort -- hoch Stand -- reif Alter -- desto seelen- Herzloser -- 
  Tribunal gut Gesellschaft empört -- wohlmeinend Weib Luisen Heirat annehmen -- -- 
  -- Prüfen -- finden stark -- Mutter Mißfallen ertragen -- finden -- bloß Vorurteil Hochmut -- Wahl Herzens entgegen setzen -- bleiben -- beweisen Glück Ehe -- Verdienst Weib -- Eltern irren -- zwing Mutter -- Glückes erfreuen -- -- Ernst Kraft jeder erforsch anwend -- Verhältnis unglücklich -- leiden -- Mutter opfern wähnen -- Märtirerthum Zwang -- Antat -- strafen -- -- 
  Wehe Kühnen -- Alternative aufstellen -- Stab brechen -- 
  Luise Heirat bereden -- richtig Begriff Autorität Mutter -- Einfluß übrig Familie -- beibringen -- 
  belehren -- Gattin Mutter Gemahl -- Vater Kind -- -- Ehe betreffen -- Familie Angehört -- 
  Mut geben -- ehrwürdig Vorurteil kindlich Liebe Fackel wahr Sittlichkeit beleuchten -- -- -- 
  Begriff -- Freund -- längst verzehrend Hauche Konvenienz unterliegen -- Wort Trümmer Sache herrschen lassen -- 
  -- -- 
  bleiben alte -- 
  lassen -- -- 
  -- alt alt -- 
  -- jeher -- bleiben -- 
  -- Gegenteil behaupten -- kühn überlassen -- beweisen -- 
  Zuverlässig leiden -- Unglückliche betreffen -- einzig -- abwenden -- Kreis Indolenz -- Rücksichte -- Furchtsamkeit -- Verneinung Tugende -- Name Konvenienz gesellschaftlich Menschheit oberst Gesetz aufgedrungen -- umschlossen -- 
  Leser Luisen Geschichte veranlassen -- finden -- Verschanzung Konvenienz durchzustehlen -- zahllosen Übel verhüten -- Herausgabe Blatt -- 
  [ Luise ] 
  [ Luise ] 
  Luise Tochter Mannes -- Residenz Fürst * * -- Hauptstadt S .. s -- ansehnlich Stelle bekleiden -- 
  Vater Mensch -- Natur selten hervorbringen -- 
  Bedürfnisse unterwerfen -- bleiben Geiz Habsucht entfernen -- ausschließend abstraktest Wissenschaft beschäftigen -- widmen -- Amtspflicht übrig lassen -- 
  Enthusiasmus -- kalt Temperament -- kennen weder Eitelkeit Ehrgeiz -- jeder gespannt fein Gefühl unfähig -- 
  Tochter glich Unglück -- betet Vater -- sagen -- mitteilend -- bieten Gelegenheit -- ungeachtet tief Menschenkenntni -- bleiben Herz Tochter verbergen -- 
  Glück -- verfehlen -- 
  Furcht Ansteckung Zeitalter -- schließen Umgange jung Leute -- 
  hoch Alter schwach Gesundheit dienen Vorwande -- Besuch annehmen -- obgleich Geschmack Frau Stück seinigen abging -- vernünftig -- finden -- beschäftigen einzig Wirtschaft -- 
  Weise bleiben Luisen Gesellschaft -- Büch Sammlung Vater -- Wahl heiß Eifer durchlas -- 
  Natur Schwermut geneigt Charakter -- ergriff Melancholie nähren -- 
  Young Nachtgedank -- Heloisen Brief Abälard -- Clarisse -- Sethos -- Lieblingsschrift -- bringen Chaos kopfe hervor -- einzig fest Begriff entspann -- Tugend Welt Glück rechnen -- 
  Gefühl führen Frömmigkeit -- heilig Trieb -- Schöpfer Trost -- Erleuchtung Mensch Herz legen -- Feuer -- Seele nagen -- erhellen -- 
  Führer zartest Gewissenscheu -- verschieden streng Religions-Bücher lesen -- Reue peinigen -- ehe Seele Schuld kennen -- Ruhe Unschuld reinsten Herz fern -- 
  Mutter -- Hauswesen Geschmack vollkommen Sachkenntnis vorstinden -- lassen Luisen helfen -- Vater -- entfernt Geschmack Wissenschaft abzubringen -- vielmehr Freude -- 
  Luise Fortschritt -- Gesundheit nachteilig -- angeboren Hang Schwermut vermehrten -- 
  glauben -- unglücklich Fall -- damalig -- Grund nachherig schrecklich Krankheit -- erfolgt Elend Leben legen -- 
  stürzen nämlich fünfzehnt rückling Treppe herunter Keller -- Kopf Stein -- Vater besorgt -- obwohl sichtbar Beschädigung zurückbleiben -- obwohl Krankheit entstehen -- Empfand -- anhaltend Beschäftigung Geist -- äußerlich Erschütterung -- z.B. Fahren -- Schmerz -- Fall ausgestandenen ähnlich -- 
  Luisen Vater nötigen -- hoch Alter -- Amt aufgeben -- persönlich Zutraue gütigen Herr beehren -- bleiben Nähe -- überlassen einzig Lieblingswissenschaft -- 
  eingeschränkt häuslich Umgang vermehrt Mann -- erledigt geistlich Stelle berufen -- Familie Luisen interessieren müssen -- 
  Mann sowohl Gattin zeichnen Geist Kenntnis -- beschäftigt Erziehung Kind -- Luise zärtlich hing -- Natur Mutter -- 
  beschäftigen -- Spiel teilen -- liebkose -- süßest Freude liebend Seele -- Bestimmung entdecken -- 
  Kind gefiel -- unterrichtet Eltern -- versäumt Gelegenheit sehen -- 
  jung Herz schmeicheln -- Mensch reiferem Alter -- anerkannt Verdienst -- Freundin aufnehmen sehen -- 
  Reize widerstehen Jugend -- reinste -- entzückend Empfindung -- ungetrübt bleiben -- Luise sog Gastfreien Dach langsames tödlich Gift -- 
  Glück Gatten stellen erstenmal -- rührend wahr Gestalt -- Bild ehelich Verbindung Auge -- 
  sechsjährig Ehe Mann Liebhaber Frau -- 
  weder Ehrgeiz Eigennutz Band knüpfen -- finden Ursache Wohlgefallen -- überd -- meister Mann -- Gestalt Verdienst -- vorzüglich -- einnehmen -- gestehen -- Mann -- glänzend Eigenschaft möchten -- Weibe schuldig -- gering Talent -- Leben kleinlich Beschäftigung widmen -- Suppe kochen -- Wäsche -- Kleidung sorgen -- Kosten Gesundheit Genuß verschaffen -- Kind liebkosen -- schön Augenblick sehen -- indes Mutter Sorge -- Last -- Gefahr erträgen -- Lage unzertrennlich -- 
  Betrachtung bewog Luisen Freund -- Frau Achtsamkeit Sorgfalt behandeln -- Liebhaber tun -- -- pflegen sagen -- tun -- lassen -- gefallen -- Eigenlieb -- setzen lachend hinzu -- Verlust Freiheit bedauern lassen -- 
  Wort machen tief Eindruck luisen -- unwillkürlich wünschen -- Schicksal Freundin gleichen -- Unmöglichkeit -- Wunsch erfüllen sehen -- bringen schmachtend Stimmung hervor -- Seele Untätigkeit entnervt -- geliebt Hirngespinst streben -- Wirklich umgiben -- Widerwille erfüllen -- 
  Luise Alter erreichen -- jung Leute Religion gewöhnlich Kommunion empfangen -- 
  Freund Lehrer Beichtvater -- vorzüglich Gabe Unterricht Jugend -- 
  Kunst Fassungskraft richten -- besitzen glücklich Gabe hinreissendst Überredung -- 
  Schüler ehrt Ebenbild Gott -- predigen -- lieben Vater -- 
  Näher Amtsgenossen menschlich Schwäche -- bezeugt Teilnehmung -- 
  denken erhabensten Tugende Religion Manne vorgetrag -- wichtig Einflusse Glück heilig überzeugen -- Leben Wahrheit Beleg dienen -- denken -- sagen -- Wirkung lebendig Unterricht Luisen Herz müssen -- 
  rein Glück bescheiden -- 
  Mutter Bruder Enthusiasmus -- Freund sprechen -- aufzog -- versetzt Ruhe tödlich Streich -- mißtrauisch unschuldigst Leidenschaft -- Frieden weichen Secle -- 
  Vorfall tragen -- unglücklich Irrtume bestärken -- 
  Luise Freund Pastell malen -- Tag zeigen Bild bekannte -- Frau Geist -- einzig Vater gestatten umgehen -- 
  Gesellschaft Bemerkung -- Schade -- Art Malerei schnell verlösch -- nähert Madame E * * -- Gemälde zeigen -- Luisen Ohr -- -- -- wissen -- Bild vermögen -- Liebhaber -- hoffen -- -- 
  Luise schlagen errötend Auge nieder -- Moment lassen schrecklich Blick Innere werfen -- 
  Ruf Vater ziehen jung Leute Haus -- luisen schmeichelhaft Auszeichnung behandeln -- äußerst gleichgültig -- rühmen -- glaubt Ursache erraten -- schaudert Schrecken -- 
  finsterst Gedanke stürmen -- Auge Gattin Lehrers aufschlagen -- Kind liebkosen -- Kain fliehen Mensch -- Ruhe -- 
  Anschein fließen Luisen Leben Bach blühend Ufer -- traurig Stimmung ungerechnen -- nagend Kummer -- 
  Mutter -- herrschend Hang Mitleid Wohltun -- Weib aufnehmen -- falschest Herz Fehler niedrig knechtisch Erziehung verbinden -- 
  Person Vertrauen Madame N. einzuschleichen -- unentbehrlich wissen -- Wohltäterin Seite Betrog -- 
  Luise Alter erreichen -- Eltern Auge öffnen -- Weib fürchten haßt gleich Grade -- finden Interesse gemäß -- luisen vertrauen Mutter -- teuer besitzen -- entziehen -- 
  denken Handlung -- unermüden Luis verfolgt -- fehlt Verstand -- fühlen -- satanisch Betragen -- 
  gescheut Leute manchmal Böse -- inne halten -- 
  dummköpfe blicken -- übel übersehen -- veranlassen -- 
  böse Weib -- arme -- Nackt sehen -- beizusteh -- kleiden -- 
  luisen Zustande sehen -- letzter Rock geben -- Lage -- eher Neid Mitleid verdienen scheinen -- glauben Kummer Verdruß antun -- 
  Talent -- Kind pflegen -- Wirtschaft vorzustehn -- fünfzehn Haus erhalten -- Luisen Kummer -- Alter treten -- furchtsam -- beklagen -- Erfahrung -- wissen -- bösen gut Ziel setzen -- 
  spät Luise Genugtuung -- Mutter -- Geständnis Frau Totbette -- mißtrauen zurückkommen sehen -- 
  sterbend klagen Härte Verfolgungssucht -- groß Verbrechen Leben -- Luise genoß Vergnügen -- Mutter besänftigen -- Begriff stehen -- hart Vorwurf -- 
  Kummer Verfolgung -- nagend Zahn Gewissen -- 
  Luise naht Augenblick -- Schoß Kirche -- Gemeinschaft gläubige aufnehmen -- durchdrang zutrauen zärtlich gehorsam Kind -- Schrecken schuldige -- Gnade unwert fühlen -- Richter verheißen -- 
  feierlich Handlung -- sterben vornehmst Schullehrer Ort Luise leben -- 
  tüchtig Mann Besetzung Stelle ländchen finden -- laden Fürst Mann * * -- achtungswert Person empfehlen -- 
  Herr Eifer Erziehung Untertan -- Fürst * * -- 
  finden gegenwärtig Geschlecht -- Unterricht nächstfolgenden -- Milderung Sitte sorgen -- 
  Ort erregen Aufmerksamkeit -- 
  Nachricht Ankunft Schullehrer beschäftigen -- 
  Dame -- erwähnen -- lesen Luisen Brief erwartet Fremden Mann -- 
  schön schreiben -- 
  Luise bringen Abend Freund -- sprechen Beifall Brief -- 
  -- Frau -- -- bemerken -- Nähe Mann finden -- liebenswürdig Luise verdienen -- 
  schmeichlen fast -- Fremde Ausnahme -- -- 
  Luise antworten -- erröten -- 
  Gedanke Gatte zwingen Unschuld Röte -- 
  beständig Furcht -- strafbaren Neigung bemeistern lassen -- ergriff Luise eifrig Zerstreuung -- ungeachtet Denkungsart Vater Gelegenheit Darbot -- 
  einzig Haus -- besuchen -- Madame E * * -- Familie geistlich Lehrer -- 
  verdankt Erziehung -- Mutter lieben -- 
  gewiss Rücksicht harmoniert Charakter sogar -- Luise werfen -- Gesellschaft fremd Mutter vorziehen -- 
  Haus anziehend -- 
  Vater -- -- ungeachtet hoch Alter -- abstraktest Wissenschaft beschäftigen -- sprechen -- Familie Gewohnheit beibringen -- 
  Luisen Brüder unähnlich -- Hang lärmend Freude Grenze überschreten -- Schwester Neigung Melancholie -- 
  Ding traurigen Seite -- -- Bruder faßen lächerlich -- luisen schonen -- machen Fest -- unbarmherzig aufziehen -- 
  Auftritt endigt Luisen Seite Träne Gewissensvorwürfe -- Veranlassung -- ungeachtet zärtlichster Liebe Bruder -- hart Wort weh -- sagen -- 
  Bruder lieben -- kennen -- Mühe geben -- Charakter erforschen -- unerklärlich halten -- treiben Scherz -- 
  kannt Leben lachend Seite -- 
  Vater -- Welt bestimmt -- frühzeitig Unabhängigkeit gewöhnen -- späterhin Missbrauch machen -- 
  laufen Freund umher -- 
  Mutter beten -- dienen Vater Dolmetscher -- Mut -- törichn Einfall vorzutragen -- 
  glücklichst natürlich Anlage Lernen Mühe -- füllen desto kleineren -- 
  Rest körperlich Übung anwenden -- 
  gehen -- Luise Fenster -- Pferd sattelen einspannt -- unbestimmten Unruhe verzehren -- blicken sehnsuchtsvoll Gegend -- Auge entschwanden -- 
  -- Mädchen Einsamkeit erziehen -- lehren -- Gefallen finden -- Endzweck Aufhör beschäftigen -- möglich häuslich Freude erheitern -- -- Wahl Abwechslung Beschäftigung -- Überdruß schützen -- 
  unannehmlichkeiten häuslich Lage -- Luise -- Zurückkunft Freund -- Vorteil nachdachen -- Verbindung Schullehrer finden -- 
  Zucht alt böslaunig Magd befreien -- Hauswese vorstehen -- Aussicht müssen tätig Geist schmeicheln -- 
  Spitze Republik -- 
  Betriebsamkeit -- Manne Annehmlichkeiten Leben verschaffen -- Kunst gefallen sogar verfeinern -- Notleidende helfen -- Glücklich -- 
  welch Glück Luisen -- 
  studiert Manne -- besuchen Eltern -- Frauenwürde Luisen Range Freundin Vater -- Mutter erheben -- liebkoste -- führen Kind -- nossen teilen Glück -- 
  mehrere Woche verfloss süß Träum -- 
  Abends -- geistlich Frau Luisen Eltern speisen -- melden Besuch angekommen Schullehrer -- treten -- Luise stehen begrüßen -- blicken -- -- Traum verschwinden -- 
  finden kalt -- abgemeßen Wesen -- unregelmäßig Zug -- -- Bild entsprechen -- Fantasie vorgeschweben -- 
  setzen Platz -- kaltblütig beobachten -- fallen Urteil günstig -- 
  Art Welt -- Mann Reise erlangen -- Luisen ziemlich unbekannt -- lehrreich Unterhaltung -- angenehm -- Frauenzimmer sprechen -- unterrichten wissen -- demütigen -- 
  Abend verstreichen Luisen Augenblick -- Mann -- äußerer Widerwille heiraten -- scheinen dennoch liebenswürdig -- 
  Luise häuslich Verdruß -- Auge Wei geschwollen -- verwundern -- Eindruck Herr O. -- 
  suchen fallen -- geistreich Gesicht beleben -- 
  sehen nachmals -- Aufmerksamkeit anziehen -- indessen Gesellschaft -- kommen -- -- Auszeichnung begegnen -- 
  Herr O. -- wissen Bemühung Wendung geben -- -- Mädchen Luisen zart Gefühl -- schmeichelhaft -- 
  angenehm Ding -- anbringen -- geistreich -- 
  behandeln hübsch Mädchen -- vernünftig Wesen -- Unterhaltung schätzen -- Unterschied Luise wissen -- 
  morgens -- Gattin Freund Besuch abstatten -- finden Familie Herr O. Begriff * * * Madame R. fahren -- 
  schlagen -- Gesellschaft -- worauf Notwendigkeit Eltern Erlaubnis erhalten einwenden -- 
  Herr O. eilen fort -- bringen Erlaubnis -- 
  Dienst Wirkung -- 
  anderer fad Bemerkung begnügen -- Eltern freuen -- Gesellschaft wissen -- liebenswürdig Tochter schätzen -- Vergnügen versagen -- dergleichen -- 
  fahren -- Herr O. -- Frauenzimmer Wagen belästigen -- Fuß voraus -- 
  langen -- spazieren -- Herr O. bieten Luisen Arm -- 
  furchtsam Mädchen schlagen -- 
  erstaunt -- beleidigen -- -- Wort -- 
  -- hoffen -- Weigerung erfahren -- -- 
  lassen Luisen Strafe Prüderie Sand waten -- 
  Unrecht -- Prüderie -- 
  jung Gesellschaft -- bescheiden -- fürchten -- Auge übrig Frauenzimmer lächerlich -- Herr O. Weise Beschlag nähmen -- 
  Furcht beleidigen -- beunruhigen indessen -- 
  fühlt Welt fehlen -- ahndet -- kindisch Auge erscheinen müssen -- überlegen -- 
  hergehen -- Anstand Gestalt bemerken -- umhin -- schmerzlich nachdenken -- 
  bauen -- -- Vorteil Weibe Begriff -- Schutz Verteidigung Manne finden -- 
  Herr O. Munter -- geltend -- gelingen -- 
  Nachmittag streifen umher -- 
  Luise Arm -- verirren -- bleiben unterwegs -- 
  Herr O. Unterhaltung unendlich abwechselnd -- interessant -- Sprache schön -- Stimme wohlklingend sanft -- finden schwach Seite Luisen Herzen -- 
  Gewissensbiß Neigung Freund verschwinden -- fing -- lieb Freundschaft unterscheiden -- ahndet -- Erkenntnis Ruhe Leben kosten -- 
  -- wissen lieben -- 
  -- Herr O. Nachforschen bemerken -- gewiß -- halten -- Aufschluß geben -- 
  Luise verstellen -- Eltern Neigung gewahr -- 
  stehen Familie -- 
  Vater setzen streng Mutter Heftigkeit -- Bruder greifen bittersen Spott -- 
  väterlich Haus Hölle -- 
  furchtsam Gewissen verraten jedesmal -- Herr O. sehen -- -- Schwelle -- 
  furchtsam zärtlich Liebe -- Luise Mutter -- müssen unendlich weh -- Neigung hartnäckig Streit wünschen Madame N. finden -- 
  las Tom Jones -- Stelle -- Madame Miller erstenmal Freude -- Tochter Mistreß Nightingal begrüßen -- 
  Fielding schildern Empfindung zärtlich Mutter -- unnachahmlich Wahrheit -- luisen erwacht peinlich Erinnerung -- Mutter -- triftigeren Grund Verbindung -- entschieden Abscheu Name Mann -- Luisen Herz begünstigen -- 
  stellen -- Mutter Freude -- Kind verheiraten sehen -- Umstand verbittern -- 
  bitten Gott kniend Träne -- Gemüt Gegenstand abzulenken -- Mutter unangenehm -- verbrannt Schattenriß Mannes -- Wissen besitzen -- ernstlich jemals -- Absicht Eltern willfahren -- 
  Herr O. suchen -- -- wich Gedächtnisse -- 
  indessen Luisen Heiratsvorschlag -- Erwartung -- Mutter gefielen -- 
  kommen Manne -- luisen mißfallen -- lieben Herr O. -- würdigen Vorschlag Aufmerksamkeit -- 
  Mann bekleiden ansehnlich Stelle -- Aufwand Gewißheit reich Erbschaft bestreiten -- 
  Luisen Mutter verzieh Weigerung -- werfen -- Rücken Vater -- Beweis romantisch Neigung Herr O. -- 
  Luise bereute indessen -- 
  hernach erhalten Herr O. auswärtig Ruf -- reist -- Luise Verlust empfinden -- Tod Vater -- wirklich Kummer -- eingebildeen erlosch -- 
  Luise Vater zärtlich lieben -- Heirat scheinen vorteilhaft -- -- leben -- versagt Freier -- 
  Mutter denken -- 
  fürchten -- Luise romantisch Denkungsart nennen -- Wahl Konvenienz beleidigen -- herzlich wünschen -- Sorge -- schicklich Heirat -- entledigen -- 
  ihretwill begünstigt Luise zuweilen Antrag -- Vater Rat -- Herr O. Andenken nachmals verwerfen machen -- 
  väterlich Haus Mißfiel indessen -- wagen gestehen -- wünschen heraus -- 
  Familie bringen -- Vater Amt abgeben -- Monat Jahres Dorfe -- Mann nähern -- Freund Luisen Brüdern hinkamen -- treiben Spiel -- Luise teilnehmen -- machen weit Spaziergäng -- unmöglich folgen -- 
  Tisch -- zuweilen witzig Einfäll Neckereie belustign -- sobald Unterhaltung lärmend -- pflegen Vater Stillschweigen gebieten -- 
  traurig Luisen Einsamkeit -- scheinen -- Schicksal -- Manne -- schätzen -- Hand geben -- 
  Gedanke quälen -- Begriff Mutter -- Punkt -- ihrigen verschieden -- 
  Tag -- traurig Bild beschäftigen -- erhalten Brief Manne -- Hochachtung -- 
  wissen -- Eltern ebenfalls außerordentlich schätzen -- Mann bitten Hand -- 
  jung -- anstatt erschrecken -- danken Luise Vorsehung glühend Eifer -- wunderbar Furcht erlösen -- 
  Triumphierend bringen Mutter Brief -- Erwartung täuschen -- Madame N. ungefähr Antwort -- Gelegenheit Herr O. gehören -- 
  -- -- lieb Mutter -- -- rufen erstaunt Luise -- -- ehemals sagen -- -- liebtest -- verzeihen -- -- 
  -- -- -- -- antworten Madame N. -- -- Umstand verändern -- 
  reich -- Bruder sehen -- -- 
  Luise unterwarf Wille Mutter -- Nachgiebigkeit rühren -- -- Rat Arzt -- Manne Vorschlag -- luisen Bad schicken -- Hypochondrie -- Herr O. Abreise leiden -- heilen -- 
  Luisen Vater trennen ungern -- Nachmittag Haus wissen -- 
  Mutter Bruder -- L .. Bade Gesundheit verdanken -- fordern Luisen Erlaubnis reisen -- 
  Eltern bemüht Reisegesellschaft finden -- besuchen verwandte Vater -- -- .. leben -- 
  Frühjahr zurückkehren -- Dame -- Schwester Land verheiraten -- Vorschlag -- begleiten -- verwandter Gelegenheit Besuch abzustatten -- 
  sprechen Gegenwart Luisen Mutter Plan -- Arzt vorher äußern -- Reise Luisen Vorteil bringen Gebrauch Bade -- überreden -- Gelegenheit Tochter benutzen -- 
  arm Mädchen gewagt denken -- 
  Vorschlag Entzück -- 
  Reise beschließen -- zeigen neu Freier Luisen -- 
  Eigenschaft -- Luisen Mutter Schwiegersohn wünschen -- Reise rückgängig -- Veranlassung unternehmen -- Arzt unentbehrlich Luisen Wiederherstellung ansehen -- 
  Luise freuen -- Mutter schmeichelhafen Aussicht Heirat Wünschus geben -- versichern -- Reise herstelln -- Frau Mann Blachfeld -- Vermögen -- krank Frau sorgen -- ernsthaft denken -- 
  Mutter fürchten -- Luise Reise Herr O. sehen -- wünschen herzlich -- Abreise verloben -- 
  jung Mädchen unüberwindlich Abneigung Schritt -- 
  Antritt Reise ungebunden -- alt Tante bestärken -- -- -- Lieb Kind -- Welt durchziehen -- frei Vogel -- -- 
  Luisen Mutter edelst Eigenschaft -- reinst Herz -- mildtätigst -- mitleidigst Denkart -- Fehler -- Geschlecht vorwerfen -- 
  drehen beständig -- tausenderlei weise -- Gedanke herum -- 
  Familie versammeln -- erklären Feierlich -- Manne versprechen -- Luise zwingen -- Wahl frei -- Tochter -- wiederholen unaufhörlich -- 
  -- widerwillen -- solltest sagen -- Reise beruhigen -- einigermaßen bänd -- abspenstig -- -- 
  -- -- desto -- lieb Mutter -- abspenstig -- Zeichen -- nachher Sinn ändern -- frei -- billig -- bleiben -- -- 
  beschuldigt Mutter -- Herr O. begegnen -- Liebe gewinnen hoffen -- grausamst Vorwurf -- -- heiraten -- Mutter Leben kosten -- 
  Zeit schimpfen Luisen Freund -- beschuldigt -- romantisch Grill -- Widerwille Blachfeld -- Schuld -- 
  Luise Unschuld Freund bewußt -- grämt Verdacht -- bestehen Abreise unerschütterlich Entschluß -- 
  hierauf schreiben Mutter rührend Brief -- Herz aufschloß -- fügen abgesondert Zettel hinzu -- worin Blachfeld Hand versprechen -- erklären -- -- Madame N. Beruhigung Gewissen verlangen -- -- zwingen -- 
  Luise -- .. angelangt -- verwandte Vater kennen lernt -- ansehnlich Familie Lande gehören -- verschieden vorteilhaft Vorschlag tun -- 
  Manne -- Herz auszeichnen -- 
  einzig Sohn -- besitzen artig Vermögen -- höchst interessant Gestalt -- vortrefflich Herz -- häuslich leiden bilden -- 
  Jugend unglücklich Luisen früh -- Unglück Erfahrung kennen -- flößt lebhafteres Mitleid -- 
  Blachfeld hingegen väterlich Haus fremd bleiben -- Wiege Herr -- Herz Kriegs-Handwerk verhärten -- kennen weder leiden fühlend Seele -- Bande häuslich Leben -- 
  Freund Luisen aufmerksam -- bitten Eifer -- missverstanden Heroismus unglücklich -- 
  stellen -- Mann -- Blachfeld Umgang Frau gewöhnen -- Gesellschafterin Magd leben -- Achtung finden -- Weibe Luisen Erziehung schuldig -- 
  Herr -- -- wirken Bedienten -- Ehrfurcht verschaffen -- Haus Platz anzuweisen wissen -- gebühren -- 
  luisen schwer -- Entschluß fassen -- 
  geschritt -- Furcht hoch Strafe zurückbringen -- 
  Versuchung Wort zurückzunehmen -- indessen -- Aufenthalt -- .. -- nah Gegenwart liebenswürdig Mann stark -- Festigkeit bedürfen -- Wunsch zurückweisen -- 
  Spaziergang -- schön sommerabend Herr * * Freundin -- führen Rückweg Dorfkirchhof -- 
  still Nacht -- zauberisch Mondlicht -- Schatten schwarz Kreuze läng grün Rasen hinmaln -- weiß Grabstein zitternd Laub Lindenbaum abbildet -- blühend Zweige Luft süßest Duft erfüllten -- Ruhe Natur schweigen Tod vereinen -- ergriffen Luisen gefühlvoll Herz -- 
  Begleiterin äußern kindisch Furcht schauerlich Aufenthalt -- eilt Haus -- jung Mann -- zurückführen -- Augenblick Einsamkeit öffnen plötzlich Luisen Auge Gefahr -- Ort Schwäche Herzen bedrohten -- 
  erschrak Unvorsichtigkeit -- sogleich Freundin folgen -- fallen Knie -- fest gelobt -- künftig ähnlich Gefahr meiden -- fleht Himmel Beistand -- diesmal überstehen -- 
  Überraschung Sinn -- rein Herz fürchten -- zittert Augenblick -- Liebenswürdigkeit Mannes -- werben -- Heiligkeit Versprechen vergessen lassen -- 
  Blachfelden hoffen erlauben -- -- arme Liebe Gewisse vergiften -- 
  Herr * * gelingen -- Luisen Freundin zurückzubringen -- -- luisen flehend Stellung finden -- knien nieder -- 
  verbergen Ursache Bewegung -- 
  -- Träne -- Anderer Mädchen entrissen -- Anspruch -- glauben -- 
  -- -- Ehre Spiel ziehen -- antworten Herr * * sogleich Aufstand -- gelingen -- 
  Möchten glücklich -- 
  Art denken fühlen -- scheinen Umstand Glück versprechen -- -- -- Wohlan -- unterbrechen Luise -- unglücklich -- Glück Kosten Mann erkaufen -- -- Welt gelingen -- 
  Freiheit wählen -- jung -- warten -- 
  -- sagen -- Talent Erziehung -- versprech Tochter -- 
  -- -- einzig Weib -- Leben weihen -- überspannen -- Gewissen Ungeheuer schaffen hernach bekämpfen -- zeihen Ruhe Befriedigung Wunsch -- 
  Trost verschonen -- setzen stolz lächeln hinzu -- Luise N. Gattin -- Blachfeld Tochter -- -- 
  B. mehrere Veranlassung -- Standhaftigkeit zeigen -- 
  lieben Landlebe -- verwandte reisen -- führen Schönes -- Eigentümer -- versprechen übertragen -- Gattin -- 
  jung -- -- Grundsatz -- Unwandelbarkeit Neigung verlassen -- Krankheit Zug entstellen -- -- Liebe aufhören -- Pflicht halten -- Wunsch zuvor -- 
  -- -- Luise lachend -- Gotteswill lieben -- -- 
  -- Scherz verwunden zarter uneigennützig Herz -- Luise büßen hart -- Blachfeld lassen erfahren -- glücklich -- -- Rausch Leidenschaft verrauchen -- bewegen lassen -- Gotteswill lieben -- 
  -- -- fad Geschichte aufnehmen -- luisen Rückkehr Heimat folgen -- 
  Luise Romanhaft -- aufopfern -- -- Aufopferung kosten -- täuschen -- -- errötet Schmerz -- führen -- schön Handlung bereuen -- 
  Weg führen M Blachfelds Garnison -- 
  wohnen -- seufzend -- redend Bild traurig Kriegszucht -- leer Straße -- geschmückt Kaserne -- Fenster elend Lump Bewohner behangen -- 
  Mauer einschließen -- menschenleer Straße ungesund Haus bewohnen -- -- frei stehen reizendst Wohnung wählen -- auserlesenst Bibliothek -- paar Tröster herumlieg -- angenehm Zirkel Haus Mann -- Name Schwiegertochter anbieten -- Gesellschaft Gesind einschränken -- wichtiger Geschäft -- Mann Mittagsessen kochen -- Widerwille verzehren -- 
  traurig Betrachtung halten Wagen Haus Freundin -- 
  Hoffnung Wiedersehen vergessen -- 
  Blachfeld reichen Aussteige Entzück Leidenschaft Hand -- 
  blicken -- Gesicht flammen -- Luise schlagen Auge nieder -- beschuldigen Undankbarkeit -- 
  schuld Heuchelei vermehren -- Wort -- eilen vorbei arm Freundin -- 
  finden -- Schwester -- Begriff Mutter -- 
  Anblick Luisen Mut vermehren -- 
  Aufenthalts bemerken -- schwer Weibe Zustande -- wirtschaftlich Geschäft vorzustehen -- Gemahl Freundin dennoch -- Vergleich Blachfeld -- reich Mann -- 
  Madame E. Unbequemlichkeit Zustand beklagen -- erwähnt Sorgfalt Mannes -- beständigen Rücksicht Gesundheit -- Eifer -- Hilfe Kunst -- Bequemlichkeit Leben versammeln -- rühmt -- Betrag glücklich Leben verschaffen -- Gesundheit erhalten -- 
  Luise -- Gesundheit reizbar -- Freundin -- berauben -- versichern -- Mann Liebe ersetzen -- Bemerkung enthalten -- lieb Gatte gewiß -- dahingeg Monat weit hinreichten -- Treue Liebhaber Zweifel setzen -- 
  -- -- Liebhaber -- Mann -- erwidern Frau -- Monat atmen -- denken leben -- weder Abwesenheit -- Kälte gestrig Empfang -- abschrecken -- schätzen ungewissest Aussicht glücklich -- sagen zufrieden -- -- 
  -- Luise antwortet Kopfschüttel -- 
  bürgen Zukunft -- 
  einstens jetzig Unentschlossenheit -- rechtfertigen -- schwer büßen lassen -- 
  einig -- Gesellschaft lieben -- groß Opfer schadlos halten -- Blachfeld hochschätze -- Anspruch Dankbarkeit -- lieben -- 
  -- -- einst lieben -- antworten Madame E -- 
  -- Mann -- lieben -- Herz gewiß sein -- -- Leidenschaft erwiderten -- vorziehen -- -- sagen -- -- Dankbarkeit wirken -- sicher sein -- hingegen wüßten -- vermöchte -- 
  Blachfeld -- verkündig Abneigung -- 
  entfernt -- Heirat wider Wille wünschen -- unmöglich -- Dolch redlich Mann Brust drücken -- -- 
  Luise fähig -- 
  Mann Freundin Gelegenheit Blachfeld sprechen -- 
  erklären vieler Festigkeit -- Empfindung -- Achtung Ruf verdienen -- Charakter unmöglich -- Mann fein Stand glücklich -- 
  wiederholt Furcht -- Hypochondrie einst völlig Verstandesverwirrung ausarten -- schreiben -- bitten ernsthaft -- Bemühung einstellen -- 
  erstaunt Luise -- hören -- D. -- Hauptstadt Luisen Mutter Tod Mann aufhieln -- Wohnung mieten -- Stadt Luisen künftig Gatte ansähen -- Luisen Mutter verwandt Mitglied Familie aufnehmen -- 
  bereut Luise Mal -- Abreise Festigkeit zeigen -- 
  Reichtum Mann -- B. Hand anbieten -- leid -- Land gefallen -- Mann -- obschon Stimme Provinz -- Kindheit kennen -- 
  Blachfeld Urteil Stadt aufweisen -- bewohnen -- lauten verschieden -- 
  schrecken Luisen -- 
  redlich Mann Feind -- obschon Zeugnis sprechen -- launig Jähzornig -- lassen stets Rechtschaffenheit Gerechtigkeit widerfahren -- 
  Eigenschaft entzückt Luisen -- bleiben Taub Vorstellung Freund -- versicheren -- Blachfeld rauh tapf -- Schonung unfähig -- Frau Luisen Gemütsart Erziehung fordern dürfen -- 
  Luise -- allemal Blachfeld -- wiederholen Beschuldigung -- Verteidigung -- Übertreibung -- 
  Mäßigung gefallen jung Mädchen -- Blaß -- zitternd -- fähig Träne halten -- bleiben männlich -- -- erbettelt günstig Antwort -- äußern -- Gegenteil betrüben -- begnügt Bitte -- Luise übereilen -- Hoffnung nehmen -- 
  rühren -- Unterhaltung endigen -- 
  Luise wissen Mutter Kleidung gewogen -- Anzug Bäuerinn Gegend B. -- Luise zurückkommen -- 
  Freude ergreifen -- Mutter Auge liebenswürdig -- vollständig Kleidung Art lassen -- überraschen -- 
  Blachfeld bitten Erlaubnis -- Zeuge Zusammenkunft -- 
  Luisen Brüder -- M -- -- Blachfelds Garnison Wohnort Freundin -- entgegen kommen -- speisen -- scheinen abschlägig Antwort unanständig -- 
  fahren D. -- Stunde entfernt -- 
  Beweis Herzlichkeit -- Luise Ungeduld Bruder -- M -- entgegen -- finden glauben -- nahe Aussicht Mutter sehen -- entzücken hoch Grad -- 
  lebhaft Besorgnis -- -- gelieben -- Furcht widersprechen scheinen -- seligste Empfindung -- 
  lassen Wagen Schritt Haus halten -- Mutter Freude Überraschung genössen -- erkennen Luisen -- scheinen Verkleidung -- Tochter auffiel -- unangenehm Weise befremden -- 
  Luise Anzug Rolle vergessen -- stürzt Mutter Füßen -- rühren -- Wort hervorzubringen -- 
  Madame N. erfreuen Tochter sehen -- heftig Rührung völlig unverständlich -- rufen unmutig -- 
  -- -- -- 
  -- Blachfeld heben Luisen -- rufen -- 
  O -- verlieren -- bleiben -- verstehen -- anbeten -- 
  luisen schmeichelt Wort -- Mutter Mißfallen weh -- eilt Anzukleid -- 
  -- finden alt Bruder -- entgegen -- 
  Hals Gefühl fast ersticken -- auslassen -- weinen -- entfernt Empfindung verspoten -- drücken schluchzend Herz -- 
  Augenblick ausgewechselt Gefühl glücklichste Luisen Leben -- 
  wiedersehen anderer Freund folgend paar süß Moment -- verfließen angenehm Art -- 
  verwandter versammeln -- bemerken -- Blachfeld Mensch demütigend Rolle spielen -- 
  scheinen Absicht unterrichten -- bemühen -- Achtungsbezeugunge trösten -- Hoffnung hegen -- 
  Luise -- Dienst lassen -- entschließen -- Abschied geben -- verhindern wissen -- unmöglich treten -- klar -- künftig Gatte ziemen -- Auge Familie Rolle unglücklich Liebhaber spielen -- 
  Liebe vorzugeben -- Herz fremd -- Abrr öffentlich erklären -- Gemahle wählen -- deutlich -- Geschlecht vorzögen -- einzig Möglichkeit -- Blachfelden Gesellschaft Familie angenehm -- 
  sicher -- Achtung Dankbarkeit alsdann fesseln -- Liebe verrauchen -- scheinen finden -- Resignation -- hindurch ungewiss Hoffnung befriedigen -- mißbrauchen -- 
  erklären Abend -- Entschluß fassen -- 
  Anfangs verstehen -- werfen Fuß -- Aufschub Endurteil erbitten -- 
  anderer Mädchen Unruhe Liebhaber Genuß finden -- 
  Luise werfen -- veranlassen -- eilen verständlich -- 
  setzen einzig Bedingung -- ableben Vater -- Schwester -- Fall ledig sein -- Haus nehmen -- begnügen -- Pension geben -- 
  Luise glücklich Ehe Klatschereie alt Jung fern stören sehen -- Herz antrieb Schwägerinn aufnehmen -- sd Verbot Klugheit -- Denkart Lebensweise Frauenzimmer gänzlich unbekannt -- 
  Blachfeld versprechen unverzüglich -- setzen hinzu -- Einwilligung Verdienst -- -- verheiraten -- Wille -- Schwester leben -- 
  Luise Glückliche -- entfernen -- 
  selig Augenblick -- Mutter Segen empfangen -- Freude Auge blitzen -- fähig -- tun -- lohnen -- 
  fürchten unaufhörlich redlich Blachfeld betrügen -- 
  glauben Torheit Jugend -- Versuchung erzählen -- Reise bekämpfen -- 
  Mutter warnen -- Bräutigam Verdacht erregen -- Hochzeit hart büßen -- Furcht Unglück schrecken zaghaft Gewissen -- zitteren bloß strafbar -- 
  Nacht verfließen grausamst Unruhe -- fürchten -- Stande -- Mann -- Hand versprechen -- beglücken -- treten -- Augenblick Feder -- neu Geständnis Irrtümer niederzuschreiben -- eilt Blachfeld -- auf Glück -- gestern verheißen -- danken -- 
  rühren -- elende Mensch -- Aufrichtigkeit mißbrauchen -- Mädchen unglücklich -- vertrauen setzen -- 
  -- Fürcht -- setzen hinzu -- geheim Schwermut -- vorwerfen -- Glück zerstören -- 
  unermüden suchen zerstreuen -- gelingen -- ertragen -- Brief suchen -- Stimmung schwärzesten Farbe schildern -- elend -- Besitz -- elend -- ehe kennen -- -- 
  Luise überlassen Glücke -- Mutter Bruder zufrieden sehen -- hoffen genießen -- Mutter Träne Auge erklären -- nötigen sehen Versprechen nehmen -- Luisen Abreise B. geben -- 
  Wort -- Schwiegersohn -- Regiment jährlich Hauptstadt zubrachten -- Haus nehmen -- 
  -- Einrichtung fiel söhn Last -- -- Welt leben -- nötigen sein Gesellschaft Haus sehen -- alt fürcht Zuwachs Last Sorge -- herzlich freuen -- Luisen Kind -- Mutter -- sehen -- Unbequemlichkeit geschehen -- Anwesenheit Mann zöge Ungelegenheit -- fordern gut Tisch -- Besuchzimmer -- dergleichen -- bieten Pistole jährlich -- Versprechen entschädigen -- geben bereute -- 
  Luise Mutter weinen -- Versprechen sogleich -- Herz Innerst verwunden -- 
  Entschädigung Aussicht -- reizendst Luftschlösser bauen -- Hoffnung -- M. wohnen -- Entschluss beitragen -- 
  Mann Zirkel Familie leben -- Vorteilen Tochter Haus Vorrecht verheiratet Frau genießen -- Mann froh -- liebenswürdig Gesellschaft Bruder ausbilden -- hingegen männlich Tugende Muster nehmen sehen -- welcher glücklich Zukunft -- 
  Luise lassen Blachfeld Verdienst Gerechtigkeit widerfahren -- betet Bruder -- 
  Liebe arge Probe stellen -- 
  Absicht Vater -- gewiß Summe Ausstattung Vermögen abziehen -- 
  gewissermaßen schuldig -- Versicherung -- -- gut Heirat verhindern -- Einkommen hinreichend -- Aussteuer Tochter bestreiten -- 
  Sohn -- -- Universität erhalten -- ungeachtet Kapital vermehren -- 
  Totbette fordern Frau söhn Versprechen -- Wille Punkt Tod befolgen -- sein Kind -- billig -- -- 
  Luise Güte rühren -- Großmut Mutter Brüder -- Summe eigen Antrieb tausend Taler bestimmen -- 
  Mutter -- Sohn zärtlich lieben -- erzählen großmütig Kondolenz-Besuchen -- führen Tochter Grund -- Heirat eingehen -- Brüdern zuwider -- -- -- erklären -- tausend Talern doppelt geben möchten -- gewiß können -- Schwester romanhaft Grill verführen lassen -- Gatte wählen -- Schande -- 
  Luisen Stolz empört Rede -- weh -- Mutter Gehör -- überzeugen -- wahr Seelengröße gering Auszeichnung bestehen -- kleinlich nichtsbedeutend -- lieb Bruder gewinnen Oderhand -- bedacht Jugend -- überredet -- vernünftiger -- billig Art denken beibringen -- fühlen -- jung -- gewinnen -- fühlen -- Liebe uneigennützig -- freuen -- 
  Summe -- Vater bestimmen -- vollkommen zufrieden -- erkennen Brüder Großmut -- Bewegungsgrund billigen -- -- 
  lieb Mutter beschließen -- sobald Gelegenheit darböen -- Bruder -- Meinung glücklich Heirat beruhigen -- 
  Zeit Ort müßig Mensch geben -- leer Gehirn Haus Haus schleppen -- Armseligkeit anfüllen -- aufstoßen -- 
  Geschöpf -- Erklärung Luisen Heirat Blachselt -- Bruder -- versichern -- Aussteuer Tochter jeher Kapital abgezog -- Unrecht -- Ausnahme Gunst Schwester -- 
  Erinnerung Vater Tod -- Luise Wahl bestimmen -- Eindruck -- mächtig Einfluß -- 
  Luisen Brüder erinnern verworren -- Vater -- bemühen -- Schwester mißfällig Heirat abhalten -- Stand setzen -- Wohltat entbehren -- 
  wissen -- erwählt Schwager arm -- wissen Schwester -- zuzusetzen -- Schwager Glück -- denken -- -- sobald bringen -- Gattin vernachlässigen -- -- ungeachtet gering Vermögen wählen -- Versorgung -- müssen Vorteil denken -- -- fangen -- Frage kaltblütig untersuchen -- endigten -- ungeachtet Sanftmut -- Schwester letzter Wille Vater berufen -- Luise zerreißend Vorwurf -- eigennützig handeln -- 
  Luise entfernen -- Mutter beschwören -- Aussteuer geben -- 
  hing Ding -- Glück Ehe entbehrlich scheinen -- wissen Blachfeld Wert verbinden -- Herzen Verzicht -- glauben -- Pflicht künftig Gemahl erlauben -- Vorwissen Schrift unterzeichnen -- eingestehen -- Familie tausend Taler schuldig -- -- Ausstattung Geschenk verstorben Vater -- 
  Luisen Mutter hingegen -- Sache weh -- wünschen -- Blachfeld unterrichten -- 
  Wäsche Bett -- -- Wirtschaft unentbehrlich -- Hausgerät anbetriffen -- Mann Sache -- Stand setzen -- Ausgabe bestreiten -- nehmen Monat eurer Hochzeit Tisch -- Einkauf Ding -- worauf gewiß verstehen -- Betrüg lassen -- Geld geben -- 
  Hierdurch Luise Verlegenheit -- 
  erkennen Einrichtung Weisheit Güte Mutter -- falsch Scham wagt Blachfeld sprechen -- müssen groß Leidwese wahrnehmen -- -- anstatt streng wirtschaften -- Frühstück Kollation Wirtshause halb Pistole verzehrn -- Luisen Mutter kosten -- 
  sparsam halten -- diestr Hinsicht Geschenk -- -- ablehnen -- 
  Reise zurückkehren -- Luise Gutherzigkeit -- Anteil Reisekosten -- Hälfte Anteil Person bezahlen -- Augenblick Ausgabe unerwartet -- Anschlag vorher -- Person frei gestehen -- Reise mitmachen -- Kosten beklagen -- erstenmal Leben Notwendigkeit -- Geld aufnehmen -- 
  bloß Gedanke Schuld erschrecken -- stellen Anweisung Summe -- Murter Ausgabe erhalten -- Monat zubrachten -- Groschen Tasche -- 
  indessen Gefühl -- Liebhaber Verlegenheit merken lassen -- einst -- Pistole Sofa ersparen -- bitten -- Geld Notwendigerem aufheben -- -- genau betrachten -- Sofa fertig -- Stuhl -- 
  erstaunt Luise -- Bräutigam Monat erklären -- -- anstatt Pistole zuzulegen -- sogar ausgeben -- 
  bereute -- Rat Mutter befolgen -- 
  freut -- einzig Tochter Wohnung einrichten -- Luise Herz sagen -- Blachfeld anschaffen -- 
  gegenwärtig Verlegenheit -- Luisen quälen -- umhin -- natürlich Berechnung -- Mann -- tausend Talern auskommen -- Wohnung -- Bedienung Tisch Mutter -- Pension Frau Kind ernähren -- auskommen -- 
  Luise stellen vieler Sanftheit -- bitten Aufschub Heirat -- Vermehrung Einnahme -- 
  Erwähnung Aufschub Blachfeld wütend -- stoßen kopf Mauer -- werfen Blut -- 
  luisen gleichgültig -- vorher -- Mangel Ordnung -- übel Wirtschaft -- Unkunde Geschäft -- Kind grausamst Verlegenheit setzen dürfen -- ärgern Mutter -- gering Anmerkung -- 
  wünschen -- vollkommen halten -- Gegenwart Fehler Mann reden -- Ehrfurcht Gehorsam versprechen Begriff stehen -- 
  liebt Uneigennützigkeit -- Nichtacht Geld -- sehen -- Fall kommen -- uneigennützig Leute mißbrauchen -- 
  Mensch -- Vermögen besitzen -- steinreich Mann meublirtn -- Torheit gewahr -- Möbel -- Mode kommen -- versprach Entschädigung -- halb Vermögen hineingestecken -- werfen Auge Blachfeld -- einigermaßen Gelde -- lockte Haus -- Erbot -- bloß Freundschaft -- alt Möbel Kaufpreis überlassen -- 
  Blachfeld -- väterlich Haus bewohnen -- Schule Erzog -- Sodann Garnison versetzen -- anderer Bett Pritsch -- anderer Hausgerät kennen -- hölzern Tisch Feldstuhl -- bemerken -- Handel vorschlagen -- bar Geld geschmacklos Trödelwar austauscht -- einzig tauglich -- Wirtschaft notwendig Stück befindlich -- 
  luisen versprechen -- edl Einfalt sehen -- Geschmack Lage angemessen -- rein vergessen -- Rate ziehen -- tausendmal zusagen -- Hauseinrichtung überlassen -- Unfähigkeit Geschäft eingestehen -- Handel -- Schlaukopf Mensch -- altväterisch Arglosigkeit Landpfarrer Wakefield Sohne -- Moses -- besitzen -- Flasche Wein schließen -- 
  Verkäufer voraus -- Braut verderblich häßlich Handel unzufrieden -- fordern Blachfeld Offizierswort -- heilig halten Ruf -- Blachfeld -- denken -- Taler Bezahlen -- 
  Umstand Verkäufer Sorge -- sicher -- Luise bezahlen -- kränken -- 
  Luise stellen Bräutigam -- Augenblick -- Mangel Notdürftigst verheiraten können -- -- lauter überflüssig Ding Wille Schuld -- 
  Ankaufe rechtlich Stuhl -- Schrank -- Tisch -- Spiel Marmortischen -- Luise bequem Großvaterstuhl -- Teetisch -- Ruhebett kranke -- 
  patriarchalisch Einfalt zurückführt Geschmack -- Bräutigam finden hoffen -- 
  Blachfeld wütend -- werfen Hut Boden -- treten Fuß -- beging tausend Ding -- Luisen überzeugen -- Ansehung Ungestüms Wahrheit -- 
  Zurücktret denken -- -- Fehler -- Charakter -- gefallen -- 
  Luise versprechen Name Geld borgen -- Blachfeld -- Mensch Vermögen -- ungeachtet allgemein anerkannt Redlichkeit -- Kredit -- 
  Fürst -- Dienst Luisen Vater stehen -- Lebzeiten versprechen -- Tochter Mitgift sorgen -- zufolge schicken tausend Taler -- Brief Blachfeld beigefügen -- -- -- nah Beschaffenheit Lage eingehen -- Summe Hochzeitseyer bestimmen -- 
  Blachfeld verstehen gütig Meinung Fürst -- Edel -- bescheiden -- reißen -- überlassen Luisen Summe Aussteuer -- behalten Pistole Kleide -- 
  Luise Betrag rühren -- Pistole -- Abzahlung Schuld übrig geblieben Spargeld -- tausend Taler öffentlich Kasse niederlegen -- vorfallend Gelegenheit Notpfennig Vorrat -- 
  Freude -- 
  folgend Blachfeld -- bitten Hälfte Summe -- Lösung Möbel gegeben Ehrenwort -- fordern Hälfte -- Ankaufe Feldgeräts -- Kriegszurüstung Rede -- 
  Fall sorgen Landesherr Feldgerät -- Blachfeld Sonderbarkeit -- Abscheu ausstehend Kapitali -- indes Luise notwendige versagen -- Geschenk edel Gönner angreifen -- Blachfeld Seite -- -- 
  Weise Luise -- tausend Taler reich -- Pistole arm -- häuslich Einrichtung bleiben übrig -- 
  Blachfeld indessen zusehends -- beteuern -- Leben nehmen -- Luise Abreise Hand Altar geben -- 
  schworen -- Zeremonie -- Sicherheit -- entreißen -- ford -- Gebrauch -- zugeständen -- 
  Mutter -- Freund reden -- Unentschlossenheit -- Luise bestimmt Hochzeittag -- Bräutigam feierlich Versprechen erhalten -- Freund leben -- vertrauteren Umgang -- 
  Luise entdeckt Mutter Geheimnis -- 
  Blachfeld natürlich Weise Vertrag ansehen -- ausschließlich Eigentum Liebe -- 
  beschließen -- Hochzeit Mutter feiern -- jung Ehepaar -- Blachfeld Abreise Armee -- bleiben -- 
  Einrichtung schlagen Bräutigam -- Anstalt auszuweichen -- Beutel wachsen -- 
  Zustand Finanz Lust künftig Schwiegermutter entdecken -- -- Gelegenheit Schwierigkeit -- Bewerbung Tochter entgegen setzen -- versichern -- brauchen Vermögen -- Mann Ehre -- Frau nehmen -- Unterhalt sorgen -- 
  Geschenk gütigen Fürst -- Anfangs freiwillig Verzicht -- Gebrauch verwanden -- fürchten Schwiegermutter -- brauchen Luisen Mittelsperson -- Anliegen -- 
  Verfahren ziehen arm Mädchen Verdruß -- 
  Tag -- anberaumt Hochzeitsfeier -- Familie befinden -- Mutter Bemerkung -- Schade -- schön Frühlingstage zuzubringen -- gewiß ungenützt verfließen -- Verbindlichkeit -- Blachfelden Kost -- Weg stehen -- 
  Luise leiden schmerzlich Wort -- antworten -- bereit folgen -- Blachfeld -- Hochzeit wohnen gedächen -- Mutter erwidern -- Ursache -- Vergnügen leben Verzicht müssen -- Garten Trupp unnütz Reitknecht verwüsten -- Blachfeld Abreise Armee festgesetzen -- Sommer Hals liegen -- 
  Luisen Brüder stimmen Grund Mutter -- beweisen -- Einrichtung erlauben -- Fremd beherbergen -- Mann -- verheiraten -- Haus einrichten müssen -- Schwäger Freude können -- sagen -- 
  gehen Frau Schwester -- 
  Bitterkeit Luisen -- Mutter führen -- Gegenwart jung Leute -- Blachfeld schonend gütig Versprechen hypochondrisch irrend Braut -- Bewegungsgrund -- Hochzeit trennen -- Besuch verstatn -- 
  Luise fühlt unschicklich Äußerung -- fürchten Blachfeld unbändig Hitze -- Entdeckung Auftritt notwendig auflodern -- fallen -- -- Wahl Gemahl Geschmacke Familie unterwerfen -- bitter Sorge gewart -- Stimme Herzen Gehör geben -- Mutter übl Stimmung -- häuft Unangenehme schwach Mädchen -- Unmut unterliegen -- Unglück -- Mutter Weise antworten -- Kind geziemt -- 
  traurig Auftritt Gesundheit Beider nachteilig -- Durchdrang Luisen Hetz nagend Reue -- Blachfeld nächster Stunde Veranlassung Streit unterrichten -- erklären -- teuer Mutter Liebe beleidigen -- strafen -- wollen trennen -- 
  Blachfeld erblaßen -- unerschütterlich -- beteuern alt Bruder -- -- Entschluß beharrn -- Dienst verlassen -- ewig vaterlande scheiden -- 
  Heinrich -- alt Bruder -- Einfluß Schwester -- gebrauchen geschickt -- Gewissensbisse Fehltritt Mutter besänftigen -- Blachfeld Wiederaufnahme bewerkstelligen -- 
  Blachfeld schließen entzücken Arm -- Träne männlich Wang benetzten -- rufen -- 
  -- Geliebter Engel -- brauchst Geld -- 
  arm Wasser Feuer tragen -- Hand ernähren -- schweiß angesichts arbeiten -- glücklich -- nennen -- -- 
  Luise innigst rühren -- glauben lieben -- 
  Madame N -- Auftritt Sohn erfahren -- versprechen -- Schwiegersohn offen arme aufnehmen -- 
  -- meister betagt Leute -- Grille bitten -- 
  Blachfeld nachgeben -- stolz halten -- nämlich Stolz -- sonderbaren Widerspruch -- -- weisen Wirtschaftlichkeit entschließen -- unabhängig -- 
  betreiben Hochzeit groß Eifer -- bekümmeren ungeachtet Ding -- Luise Hausgesinde Mutter -- arme -- geistliche u. s.w -- Name üblich Geschenk müssen -- -- erkaufen Mann -- alt Kokette Liebhaber erkaufen -- halten Blachfelden jeder Preis wert -- 
  Fehler -- hervorstehend Tugende -- 
  Blachfeld Denkungsart edel -- Schatten Einbildung Vorzug vornehm Geburt -- 
  tapf Prahlerei -- vernachlässigt Geschäft -- großmütig -- indessen luisen schön Beweis uneigennützig Denkungsart -- 
  gestehen nämlich -- ziemlich ansehnlich Summe verbürgen -- Familie bedrängt Lage reißen -- entfernt tadeln -- bezeugt lebhaft Beifall -- 
  Blachfeld gehören -- heilsamerer Hypochondrie geben -- Reise -- schlagen Frau Heirat Reise Bad -- Vater -- Wien -- 
  Luise wenden Kosten Unternehmen -- Delikatesse vorzuschützen -- Gesundheit erfordern -- Ausbruch Krieg Plan vereiteln -- bitten Luisen kniend -- Bad -- Vorwissen berühmt Arzt Rate ziehen -- Luisen unentbehrlich ansähen -- 
  legen sogar vierzig Pistole Absicht Hand Schwiegermutter nieder -- Luise Rück -- versichern lächelnd -- Frau -- Baden Wille Bad besuchen -- anderwärts ausgäbe -- 
  Luise beweisen Reise -- 
  wandt Summe -- Anteil Verkaufspreis zurückgelaßen Bibliothek Vater lösen -- 
  Umstand -- Kindheit herschreiben -- Reise wünschenswert -- einigermaßen Entschuldigung dienen -- Entschlossenheit -- Mann Feld begleiten -- 
  Entschuldigung -- Auge rechtfertigen Selbstsucht -- Gesundheit Erwägung ziehen -- Pflicht Mann -- sehen Unglück -- entstehen -- wohlverdient Strafe Selbstsucht -- vorzüglich beweisen -- Blachfeld nachherig -- wiederholt Bitte -- Hauptquartier -- erfüllen -- 
  -- Luisen Mutter Müttern Schwäche gemein -- anderer jung Mädchen Talent -- Fleiß -- Ordnung -- Geschmack Anzuge -- Kosten Tochter loben -- 
  Tages Kopfputze Gespielin bezaubern geschien -- Luise vornehmen -- Mutter Gefallen -- nachzuahmen -- -- folgend -- nämlich Kindermagd -- bös Gemüt traurig Einfluß Madame N. Anfang Geschichte erwähnen -- Anlag -- helfen -- 
  zurecht -- Luise fertig suchen -- 
  Magd finden beleidigen -- jung Mädchen geschickt halten -- fing Streit -- nachher Madame N. falsch hinterbracht -- luisen härteste Anfuhr -- 
  Luise unternehmen rechtfertigen -- bringen Mutter -- Buch werfen -- schwer Seite Brust fallen -- Verhärtung lassen -- niemals verlieren -- 
  -- Luise Blachfelden verloben -- Frauenzimmer Familie Unglück -- Krebs Brust bekommen -- gefährlich Grade -- grausamst Operation unterwerfen müssen -- 
  Chirurg Gelegenheit Luisen Gegenwart -- Dame Rate folgen -- * * Bade gehen -- Unglück vermeiden -- 
  Wort vermehrt Luisen Unruhe -- Schonung Mutter unterdrücken -- -- Blachfelden entdecken -- fest vornehmen -- Fall Gelegenheit Reise Bade benutzen -- 
  Reise Wirkung -- versprechen -- geringfügig Vorfall Schuld -- Luisen Abreise zutragen -- übertrieben Sparsamkeit ziemlich lang Weg Eile -- zart Gesundheit leiden müssen -- 
  Abreise Luise Gesellschaft geehrtesten bekanntest deutscher Gelehrt * * * reisen -- vertrauen Freundin Abschied nehmen -- 
  Rückweg Kutscher Unvorsichtigkeit -- gepflügt Feld fahren -- Bauer anhalten -- 
  Luisen Begleiter steigen -- Leute sprechen -- Kutscher -- Menge Mensch Wagen versammeln -- Folge Unvorsichtigkeit fürchten -- Augenblick -- Pferd antreiben gaffend Haufen Auge -- 
  Luise fühlen -- beschwerlich Herr * * * -- Fuß Stadt -- fühlt verdrießlich Lage Haufen aufgebracht Bauer -- rufen umsonst Kutscher -- still halten -- 
  Bedient Herr * * * abgestiegen -- Luisen Furcht -- sogar Schlag öffnet -- Wagen springen -- gewinnen -- betrunken Bursche herbei machen -- Hineinzusteig -- 
  kommen Stadt -- Lehnkutscher Haus Mutter wissen -- fahren verschieden Straße -- langt Mitternacht erschöpfen -- 
  Mutter Gesinde -- Luise Besuch Freundin Stadt -- finden Mensch Hanse -- aufgestört Reizbarkeit besänftigen -- unangenehm Brief -- zufällig folgend erhalten -- nährt Verdruß Ankunft Mutter -- Familie gestrig Vorgange unterrichten finden -- bitter Vorwurf erhalten -- Rang Mann -- Freundin Liebe aussetzen -- 
  Luisen Gemüt Sache Abreise drücken -- tief betrüben Weg -- 
  Umstand -- Bade -- Mißmut zerstreuen -- Augenblick sprechen Aussicht nahe Schlacht -- Blachfeld Luisen Dankbarkeit Anspruch erwerben -- Herz teuer machen -- 
  Trauung Auftritt -- -- heftigsen Ungestüm -- Rückgabe schonend Versprechen fordern -- Luise bestehen Erfüllung -- gelingen zärtlich Ungeduld siegen -- 
  heilig Wort halten -- rechnen Entsagung großr Tugend -- Einbildungskraft Licht Geschlecht erhaben Wesen betrachten anfehen -- 
  stolz -- Name tragen -- Hypochondrie führen -- unwert halten -- schreiben offenherzigst Bekenntnis Fehler -- sprechen zärtlich Weise Mut -- gelingen -- Mensch vermochen -- scheu Gewissen arm Weibe beruhigen -- 
  fühlen -- -- fragen -- verheiraten -- antwortet Herzensgrund -- Monat sein -- vorkäme -- glücklich -- -- 
  finden Luise Tag Tanzgesellschaft -- Belustigung -- sich_es Verbrechen anrechnen -- tanz -- indes Leben teuer Blachfeld stündlich Gefahr schweben -- 
  Einladung entgehen -- setzen Pharaotisch -- vorschlagen -- Pistole auf Spiel setzen -- -- gewinnen anfangs -- Glück ermuntern -- spielen -- 
  Brief Blachfelden bekommen -- Drang -- Hauptquartier -- brauchte Geld Reise -- beging Kleinheit -- Erreichung Endzweck elende ergreifen -- 
  Glück wenden -- verlieren -- 
  Freund Vater -- gegenwärtig -- erriet Verlegenheit -- bieten Feinheit -- edl Seele -- Geld -- -- -- Mann zuweilen Fehler -- Weiber Ausgabe halten -- -- 
  Luise versichern errötend -- bedürfen -- Gemahl überflüssig versorgen -- fühlt begangen Torheit schmerzlich -- schmerzlich -- Mann -- ausgezeichnet schätzen -- falsch Scham unangenehm Lage verschweigen -- 
  Zeuge -- 
  drückend Umstand erhalten Nachricht -- völlig niederschlagen Mutter melden -- lieb Bruder gefährlich krank -- 
  heftig erschüttern -- Augenblick treffen mehrere Umstand -- doppelt niederzuschlagen -- 
  -- Abreise -- häuslich Angelegenheit Zwist -- Trennung kaltsinnig -- Mutter Streite nehmen -- Gedanke -- Bruder unversöhnt sterben sehen -- quälen peinigend Gewissen heftig -- folgend Krank -- 
  anfangs hitzig Fieber -- völlig Verstandesverwirrung überging -- indessen Freude Brief Gemahl -- 
  schreiben Sprache -- kurz beschäftigen -- Frau freut Beweis Talent -- 
  Kammerfrau lebhaft Wirkung Brief -- Vorwande -- nachteilig -- unselig Vorsicht -- luisen Gewalt entreißen -- 
  arme sinken sogleich vorig Zustand -- vernünftig Augenblick -- fordern Brief Mann -- benetzen Träne -- trennen -- 
  -- umgaben -- Menge Briefe Blachfelden unaufhörlich Feder -- ungeduldig -- Augenblick glauben -- ankommen -- verhehl Gegenwart -- 
  Sir -- Hoffnung vergeblich -- bilden -- tot -- verbärg Nachricht -- Schwiegervater bringen -- Blachfeld letzter Brief melden -- Fried -- bitten -- -- Vater reisen -- 
  Glück -- mitleidig menschlich Arzt wohnen -- Gefälligkeit -- Fantasie eingehen -- Rolle Schwiegervater spielen -- einzugestehen -- Blachfeld ankommen -- ermüden -- anempfohlen -- Ruhe begeben -- 
  lieben Luisen Kind -- Ruhe verschaffen -- entfernt Kammerfrau -- Verdruß Krankheit -- mißfällig Ort zurückhieln -- arm Herrschaft unaufhörlich widersprechen -- Sinn fahren -- 
  wachten abwechselnd Kind -- Frucht frisch Blume Garten -- bearbeiten -- bringen -- 
  heftig Luisen Schmerz -- bleiben Gefühl Schönheit Natur lebhaft -- 
  Fenster reizend ländlich Aussicht -- Genoß -- Kraft erlauben -- Kammerfrau finden Freude -- unaufhörlich Fenster wegzuschaffen -- erbittert gut Arzt -- Name Xanthippe beilegen -- 
  Zufall Dame Luisen Ort führen -- -- kennen -- großmütig -- zärtlichster Teilnahme bezeigen -- las -- trösten -- ermahnen -- Luise gütigen Mensch umgeben -- zerrütten Phanthsie glauben -- Himmel -- 
  dachen Engel umgeben -- hören Symphonien -- leicht Tänze -- blendend Gewänder -- danken Gott -- selig Aufenthalt führen -- Kampf Tod überstehen -- wünscht Blachfelden rein Glück nehmen sehen -- 
  -- führen geflügelt Ros Himmel -- Durcheilt brennend Zone -- langt Pfort Paradiese -- fordern -- Freund vergessen -- Erde lieben -- Begriff religiös Gegenstand ihrigen abgingen -- Name Feuer werfen -- zauderen -- gehorchen -- Zwang -- verschieden Person entziehen -- Name Flamm verzehren -- zumuten -- Mann verleugnen -- verweigert Entschlossenheit -- 
  Vater drang -- verweisen Schwester -- Blachfelden herzlich gewogen -- 
  -- Vater -- -- schmeichelst -- tot -- Religion annehmen lassen -- 
  -- rufen Schwester -- wiederkommen -- Pforter bleiben ewig verschließen -- 
  Blachfeld erhalten Nachricht Krankheit Frau -- Geschenk alt Beschützer Luisen Vater -- gütigen Fürst * * setzen Stand -- Frau Hilfe eilen -- 
  fliegen -- -- 
  finden Weib -- finden glauben -- Hoffnung -- Gatte empfangen -- Wach -- kleiden täglich Sorgfalt -- traurig Sinnlosigkeit verfiel -- bleiben Kammerfrau überlassen -- äußer vernachlässigen -- 
  unselig Augenblick Blachfeld -- finden Blaß -- erloschen Auge -- abschreckend Bild Blödsinn -- 
  Abscheu -- 
  Luise erkennen -- Empfindung Entging -- Gram versetzen Zustand Dumpfheit -- Schmerz Fahren unterwegs machen -- 
  Blachfeld Wahl Reisewagens vorsehen -- Luisen gut englisch Reisewag verkaufen -- Art Karriole eingehandeln -- Achse stehen -- 
  Luise wütend Kopfschmerz -- Stoß Wagens entreißen lauten Schrei -- 
  Kammerfrau -- stolz -- Hintergrunde Wagen Herr sitzen -- bereden -- schreien Raserei -- 
  arm Weib -- Blachfeld Schoß sitzen -- wissen -- Kopf ruhen lassen -- Küsse -- Stahlknöpfe Mann Rock -- Ausdruck Gesichte Blick -- werfen -- abschreckend -- anfing Herz hart halten -- Metall -- glühend Stirn verletzen -- 
  Schrecken Angst werfen Zustand -- Schmerz herausgerissen -- 
  überzeugen -- geheilen -- Blachfeld Wagen -- flehen -- Augenblick anhalten -- Tropfen Milch Wasser geben -- 
  kranke bedürfen Reise Erquickung gesunde -- -- verlassen Blachfeld feil -- selbstsüchtig Geschöpf -- Luisen bedienen -- Wagen Augenblick anhieln -- Blachfeld Wirtshaus -- verzehrn Luisen Auge Eßwaren -- Wagen befinden -- schützt Verordnung Arzt -- Krankheit weder essen trinken geben -- 
  Luisen Raserei dauern ununterbrochen fort -- 
  glauben Räder verurteilen -- Pflug -- Feld erblicken -- scheinen Werkzeug Hinrichtung -- halten Postillion Henker -- 
  Blachfeld unglücklich Härte unendlich Jammer Ausdruck verschloßen Verzweiflung -- bilden -- Rad folgen -- retten -- fleht -- Henker lang aufzuhalten -- Zuzugeben -- Rad legen -- unleidlich Schmerz -- 
  Augenblick überredet Hitze -- Innere verzehrt -- verurteilen -- lebendig gebrat -- Blachfeld Schoß halten -- Flamm abhalten -- 
  Einbel -- Dungskraft schmücken schön Farbe -- wütendem Blick ruhig halten befehlen -- schreiben Heftigkeit Schmerz -- ihretwill leiden -- 
  langt Mutter -- 
  Luisen Bewußtsein kehren -- Kraft erschöpfen -- Kopf schwächen -- 
  Freut -- Mutter -- Bruder sehen -- begreifen weder unruhig Wesen -- Eifer -- Gläser -- Messer -- Tasse -- -- zerbrechen -- womit Schaden -- Hand nehmen -- erschreckt Zeichen Winke -- Gegenwart -- 
  wissen -- empfindlich Betrag Einbildungskraft kranke verletzen -- arm Gehirn Bemühung spannen -- Bedeutung geheimnisvoll Wesen enträtseln -- Vorsichtiger -- 
  Mutter -- überzeugen -- Luisen Krankheit Folge langwierig Kummer -- reizbaren -- gekränkt Empfindlichkeit -- unaufhörlich -- 
  -- laß -- lieb Kind -- denken Vergangenheit -- -- rufen Vergangenheit jedesmal Luisen geschwächt Gedächtnis -- vereitelt einzig Vorteil Krankheit -- alt Vorfall vergessen -- 
  Geist hell -- fühlen -- benutzt Augenblick -- Manne -- kniend -- tun -- danken -- innigst Zuneigung versichern -- Erbot -- Garnison folgen -- 
  -- 
  hoffen -- Herzenserleichterung glücklich -- hoffen Lohn leiden finden -- wissen -- traurig Krankheit lieb Herz vertilgen -- 
  beschäftigen -- verfehlen Feldzug -- auszuzeichnen hoffen -- geschloßen Frieden schmerzlich -- 
  Mann -- Monat Kriegsgefährt gestehen -- nähm Waffe erstenmal widerwillen Hand -- Weibe trennen -- 
  luisen Veränderung neu -- Zutrauen -- Hoffnung Gatte setzen -- Gelegenheit -- Bitte vorzutragen -- Sehnsucht erwarten -- 
  unbegreiflich vorgekomm -- glühend Fieber -- Nacht verzehren -- Pflege Kammerfrau überließe -- Müdigkeit Wachen erschöpfen -- hart übel Laune Herrschaft rächen -- 
  Luise Todesangst Bette verlassen -- werfen Weib Gewalt -- verletzen zart Körper -- Schmerz mitnehmen -- Falt Bettuch Hemde verwunden -- 
  Rücksicht leiden -- Andenken Luise schaudern -- reißen brennend heiß Lager -- zwingen trocken Badwann steigen -- sogleich Höllengeister nähern -- -- Arm aufheben -- hell Wasser Eimer Kopf herunter schütteten -- 
  Behandlung verursacht kranke rasend Kopfweh -- Verstand verlieren -- ohnehin längst zerrütten -- 
  berühmt Arzt -- -- Kurart angeben -- barbarisch Weise -- benehmen -- gewiß Vorschrift begriffen -- 
  Luise Zimmer treten -- Marter zubereiten -- Augenblick Aufschub Erholung bitten -- reißen eigensinnig Gewalt fort -- freiwillig bequemt -- 
  zerrüttet Einbildungskraft zeigen -- umgaben -- Henkersknecht -- Tortur strecken -- 
  Umsonst rufen Blachfeld Hilfe -- anderwärts Beschäftiget -- Plan Einnahme Festung entwerfen -- verweilt Gedanke Leiden Gattin -- 
  rührten Träne Bitte -- führen Garnison -- 
  Pein Körper Seele genoß Luise vollkommenst Ruhe -- 
  freilich grenzt Ruhe einigermaßen Stumpfsinn -- Geduld Sanftheit gewiß kurz natürlich Stimmung geben -- glücklich -- -- 
  gestehen -- glücklich Zeitpunkt Leben -- 
  Gedächtnis Hypochondrie verschwinden -- Kreis traurig Idee -- Gehirn lang umschlossen halten -- froh Bild Eingang versagen -- zerrissen -- erblickt gegenwärtig Augenblick -- Genoß vollkommen Ruhe Heiterkeit -- 
  Blachfeld schön gegender Garnisonsstadt spazieren -- glaubt Gatte elysäisch Gefilde versetzen -- Diskretion weniger bekannte -- begegnen -- vermeiden anzureden -- bestärken Träumerei -- Luise Schatten ehemalig Freund halten -- 
  Haus lesen Luise Blachfeld alt Geschichte -- ehemalig quälend Bild erlöset -- ergötzen Luise Beschäftigung -- 
  Beschreibung jeder vorzüglich Held -- deutet zärtlich Blachfelden -- Urbild vollkommener -- scheinen schmeichelhaft Anwendung fühlen -- glücklich Vorzeichen Weibe gänzlich Herstellung finden -- 
  Geduld -- Luise Leben zurückgegeben -- Gatte weihen -- Heilung verdanken -- 
  Blachfeld Freund zerstören süß Aussicht -- 
  rieen -- zerstreuen -- Haus entfernen -- 
  Zerstreue -- wovon -- heilig Pflicht -- Schwor -- Weib verlassen -- auferlegt -- Schöpfung -- Güte zerstören Gehirn Weibe hervor rufen -- -- Erde Stütze -- 
  Kriegsstand bringen Unannehmlichkeit -- -- zart Jugend weihen -- Friedenszeite Hilfsmittel Ausfüllung -- 
  gewohnen -- Zimmer beschäftigen -- Offizier Haus Last -- Vorwand umherzuschweifen -- willkommen -- 
  Blachfeld vergessen Luisen Lage Aufopferung -- fordern -- Vorwande außerordentlichen Kosten -- Krankheit verursachen -- Luisen Mutter Geld -- 
  Dirs glauben Luisen Aussteuer vorfallend Bedürfnis sorgen -- Mann aufzubringen -- Tochter Wehe Hand -- Luisen Kapitali -- bezahlt Arzt Bade -- übermacht Rest -- 
  sobald Blachfeld Geld -- Vorbereitung Reise -- 
  Luise -- bitten rührendst Ausdrückus -- verlassen -- stellen -- Gegenwart Mißhandlung schützen -- 
  Körper geschwollen -- Verstopfung Leber -- empfindlichst Schmerz leiden -- machen peinlich -- fest Leib binden tragen -- 
  Kammerfrau schreiben Reizbarkeit Tollheit -- bestehen unbarmherzig -- Röck fest -- gesund -- zuzubinden -- Luise Gewalt widersetzen -- -- schlagen -- 
  Luise Behandlung Manne klagen -- Mädchen -- sein Vorspiegelung verrückt Gehirn -- 
  Blachfeld trefflich Soldat -- -- menschlich Herz betreffen -- völlig Fremdling -- lassen Mädchen -- vertrauen gewinnen wissen -- völlig leiten -- 
  leichtgläubig Schwäche reißen -- Tag -- arm Luise arm flüchten -- Hand festhieln -- unbarmherzig Backenstreiche -- 
  übereilen -- Last Fehler fühlen -- gestenden Freund -- Handlung ewig Seele drücken -- 
  -- -- -- -- -- schändlich betragen -- Gesetz Ehre Menschlichkeit verletzen -- -- 
  -- Gesinnung -- Fehler -- vergrößeren -- -- schicken Luisen Mutter -- Brief bitter Vorwurf -- trostlos Mutter unglücklich Kind reizen -- Linderung Elend bewegen müssen -- 
  Zimmer -- Luise Vater Haus bewohnen -- Fremde vermieten -- 
  Luise -- unterrichten -- eilen sogleich Ankunft -- erinnern Bildnis Vater gelassen zäh -- 
  Leute -- Luisen Zimmer bewohnt -- Gesellschaft versammeln -- 
  stellen arm verrückt schwach Geschöpf -- Mann Haus verstoßen -- Gewalt Wagen schaffen -- Reise ermüden -- wohlbekannt Zimmer treten glauben -- plötzlich paar Dutzend fremd Gesicht umgeben finden -- 
  Bildnis Vater -- verlangt Umstehenden -- geben -- sanft Ursache Veränderung erklären -- reißen gewaltsam Zimmer -- 
  Umsonst verlangt Mutter sehen -- -- beföhlen Bett -- führen Kämmerchen Küche -- einschließen -- lassen -- toben -- 
  Luisen Brüder jung -- lieben Freude -- 
  müssen befremden -- Schwager traurig Anblick -- ertragen eher Pflicht -- ihrig -- Auge stellen -- 
  Mutter verbergen unglücklich Weib -- Luisen Kammerfrau leiden -- anfangs Abschied -- kranke schlecht bedienen -- jemals -- 
  Madame N. Luisen Abwesenheit Gesinde verändern -- finden lauter unbekannt Leute umgeben -- Zahl Mägde einschränken -- angewiesen Arbeit -- Zuwachs Mühe Luisen Wartung -- zumal Lage Lohn erwarten stehen -- liegen -- 
  überredeter Mutter -- Manne bewachen müssen -- 
  Luise Sinnen -- Verstand verlieren -- 
  -- Soldat scheuen -- Unteroffizier -- Hetzpeitsch Hand -- unaufhörlich Bette -- 
  Mensch böse -- dumm -- Luise Hand Decke hervorziehen -- schlagen -- beträchtlich aufschwollen -- einbilden -- bettwärm Genesung notwendig -- 
  arm Luise -- Ursache Behandlung erraten -- Instinkt lehren -- Hand verstecken -- 
  Augenblick kehrt Bewußtsein völlig -- Zustand verzweifelt -- 
  leidend -- jech Bequemlichkeit gewöhnt -- Schonung bedürfend Körper -- reizbaren -- Liebe dürstenden -- Teilnahme Liebe beruhigend Herz -- -- Kind Haus -- Schritt Mutter entfernen -- Dache wissen -- -- besuchen -- Mitleid Gesind überlassen -- elend Kammer eingesperren -- Wachtstube glich -- 
  Mutter Kammerfrau Zimmer -- Köchin führen Leute -- sprechen -- Behältnis -- Luise liegen -- 
  wärmen -- Markt -- reinigen Gemüse -- treiben Küchengeschäft Kammer -- 
  männlich Bedienten Haus -- Kammer unter Dache -- finden unbequem -- jedesmal Herrschaft schelln Treppe herunter steigen -- halten gewöhnlich nämlich Behältni -- Tobakrauch Zeitungs-Lesen vertreiben -- 
  letzter Umstand Luisen unendlich Vergnügen -- hoffen geliebt Blachfeld hören -- Sinn -- Ursache Feldzug entfernt halten -- 
  luisen -- Angewohnheit -- Bedient bett Tobakrauche sehen -- meister auffiel -- Weib -- Pfeife Mund sitzen -- gemacht Feldzüg sprechen -- 
  weib siebenjährigen Krieg Marketenderin -- behaupten geheim Kurart Tollheit besitzen -- 
  Madame N. Schwachheit -- betören lassen -- dankt Unteroffizier -- übergeben Luisen Wartung Weibe -- Trunk ergeben -- Branntwein kaufen -- Geldverdienst ausgehen -- 
  Luise übleren Hand -- Soldat Träne entwaffnen -- Weib unerbittlich -- 
  Luise trinken -- zitteren -- Trunk boshaft -- prügelen luisen -- Stück Holz -- 
  müssen Unglückliche dringend Bedürfnis entbehren -- Glase Wasser -- Löschung brennend Durst -- umsonst flehen -- 
  einst erbat Bedienten Bruder -- reichen metallen Becher -- stark -- Augenblick -- Zahn Kinnladen-Krampf sperren -- Mund setzen -- 
  Mensch halten Zaudern Eigensinn -- stoßen Gefäß heftig Zahn -- anfangs fürchten -- zerbrochen -- 
  wärterin bereiten Luisen bitterer Augenblick -- 
  Krankheit Mißhandlung ausgemergelt -- sehnen -- 
  kranke lang Bisse Fleisch -- 
  Mutter erfahren -- schicken Stück Braten -- greifen gierig -- Augenblick wütenden Kopfweh befallen -- unmöglich fallen essen -- Bedient bitten -- Teller Ofen setzen -- 
  Stube -- Wärterin Braten -- verzehrt hohnlachend Luisen Auge -- müssen folgend Fast -- 
  Mittag Tag erhascht Augenblick -- Aufsicht -- stahl Mutter -- 
  finden -- 
  lang schmutzig Winkel sperren -- det arm verwirrt Sinn Unglücklichen Aufputz schön Zimmer verblenden -- freuen Fußteppich -- leise Schritt -- lauten Tritt Bedienten Kammer -- verursacht unsäglich leiden -- 
  werfen Mutter arme -- bitten rührendst Art Erlaubnis -- bleiben -- unzählig Mißhandlung Ruhe lassen -- 
  Blick wenden ängstlich Türe -- Furcht -- Henker auffinden -- 
  Sprache schnell bänglich -- Rede Mensch -- kurz Augenblick benutzen -- 
  Mutter scheinen Gegenwart fürchten -- 
  Mutter -- unglücklich flehend Kind fürchten -- 
  Augenblick treten Wärterin herein -- 
  Luise ahnden geschehen -- suchen Mutter Zeichen bittend Winke sprechen abhalten -- umsonst -- 
  Mutter fragen sogleich -- 
  -- lieb Frau -- gründen -- Luisen schlagen -- -- 
  arm Rache Furie aussetzen -- Hoffnung -- Bruder teilnehmend finden -- bitten inständigst Erlaubnis -- Familie Mittage essen -- 
  Mutter -- Hastigkeit Furcht entstehen -- 
  reichen Apfelsine -- Art Kind beschwichtigen -- 
  Geschöpf -- zermartert Körper fast unterliegen -- stehend Qual bitten -- reichen Apfelsine -- 
  Wärterin verstehen Luisen Absicht -- lächelen höhnisch Irrtum Mutter -- hüten berichtigen -- Stelle kosten -- 
  decken drn Tisch -- Bedient bringen Brot herein -- 
  lang Luise weiß Brot sehen -- fallen gierig -- Stunde gegessen -- 
  neu Zeichen Tollheit -- Bruder -- eintraten -- Schwester Anwesenheit Speisezimmer verwundern scheinen -- winkt Bedient fortführen -- 
  faltet bittend Hand -- werfen Knie -- umsonst -- 
  bewirken -- Gewaltsamer Verfuhr -- Bedienten Brust verwunden Bursche -- jung Bruder bedienen -- groß Menschlichkeit bezeigen -- 
  scheinen Empfindung -- Stand erheben -- 
  bitten Gelegenheit wehmütig Verzeihung -- Befehl Herrschaft vollziehen müssen -- 
  schicken Luisen -- 
  Mutter bereden Abreise -- Vorwande -- Art Wärterin befreien -- 
  Preis Luise Sibirien reisen -- 
  niemals betrügen -- zutrauen ungeschwächt -- setzen arglos Köchin Wagen -- führen -- 
  Zufriedenheit wirken wohltätig -- selten gebraucht heilsam Luise abgereisen -- finden Bewußtsein -- 
  blickt Vergnügen Gegend umher -- Weg M. führen -- 
  bitten Köchin bringen -- erinnern -- gewohnen -- schmeichelt Gemahl finden -- 
  Begleiterin spiegeln -- -- M. führen -- 
  Luisen Idee hell -- 
  Freut innigst sehen -- hoffen zärtlich ehemals finden -- entgegen -- -- lieben -- 
  -- Verstandes-Verwirrung hypochondrisch Zufall aufhören -- 
  fühlen glücklich -- glauben -- sein Hindernis heben -- verhindern -- Pflicht Stand erfüllen -- 
  Mutter Haus bemerken -- Missbräuch entstehen -- Hausfrau Krankheit Führung Wirtschaft verhindern -- 
  tausend Betrügereie -- tausend unnütz Ausgabe bemerken -- -- Kraft erlauben -- Mann Haushaltung streng Ordnung führen -- Stand setzen -- unehelich Sohn -- Heirat zeugen -- erziehen -- 
  Herz Gelübde ablegen -- Kind zärtlich sorgsam Mutter -- 
  halten Pflicht Frau -- Platz -- Gewissen laut vorwerfen -- Ungerecht anmaßen -- 
  bitter Gedanke leiden verfolgen -- göttlich Strafe ansehen lassen -- 
  glauben strafbar -- Mutter Kind handeln -- -- handeln -- 
  gesund Blachfeld Sophismen beruhigen -- Zeit Verbindung Sohn vorstellen -- umarmt Träne -- bitten Mutter nennen -- beschwören Blachfelden nehmen -- 
  Blachfeld gestehen -- bitte Glück krönen -- ausbrechend Krieg zerstören Luisen Glück -- Gatten Vorsatz -- 
  Bild erneuern Luisen Phantasie -- glauben gelitt -- Schuld büßen -- beschäftigen auf Aussicht Glücke Wunsch Herzens -- 
  hofft Kind erziehen -- Dankbarkeit Mutter -- Liebe Gemahl erwerben -- 
  Wagen -- anstatt Blachfeld finden -- Wärterin empfangen -- -- gierig Beute -- schnell Wagen angelangen -- 
  sperren -- Furie -- Peitsche Hand legen -- verhindern Luisen Zimmer verlassen -- Furcht -- Bauer -- beliebt -- beschweren -- Peitschen-Hiebe zwingen Luisen Bette -- gewacht -- aufzustehen -- liegen bleiben -- 
  Peitschenhiebe nötigt Furie -- essen Hunger -- durst trinken -- 
  nachts müssen Seite schnarchen hören -- zittert Anbruch Tag -- Brandweinflasch Kraft schöpfn -- gefangener peinigen -- 
  Schluck -- luisen erstarren -- nüchtern -- schlagen -- 
  Abscheu -- Luise unverhohlen zeigen -- -- heucheln -- Verstell lernen -- verachten Kunstgriff -- -- bringen -- 
  versuchen Luise entwischen -- arm Vogel zerstieß Kopf Eisen Käfig -- Freiheit finden -- 
  Viertelstund M. -- Blachfeld Garnison glauben -- gehen -- einholen -- 
  schlagen Herz -- verdoppeln Eile -- 
  Furcht Schwäche lähmt Fuß -- Schritt niederfiel -- 
  denken -- Ursache Krankheit Tod Mann Freund abhielte erlösen -- 
  beten Nächte Knien Erhaltung -- ziehen Schwäche höchst peinlich Stellung -- Geschwulst Füße -- morgens zwei Mensch bedürfen -- aufheben -- 
  Gedanke -- Mann erreichen -- Mut entfliehen -- entwischen Pfarrer Dorfs -- 
  Haus treten -- Müdigkeit Mangel Atem Hinsank -- 
  Güte -- lassen Ofen sitzen -- pflegen -- bieten warm Bier -- 
  Anblick versammelt Familie -- friedlich Ofen sitzen -- goß Ruhe Luisen verödet Geist -- gut Behandlung wirksam -- -- 
  bitten einzig Nacht Bette -- arm Leute furchtsam -- bitte gewähren -- 
  versprechen -- Blachfelden Garnison bringen -- führen Vorwande -- 
  Luise mußsich bezauberen halten -- -- trotz Bestreben entfernen -- trotz Versprechung Seite geben -- Gefängnis zurückführen -- 
  Wärterin -- Bosheit Spielwerk dienen -- fragt Tag -- Lust Mutter -- 
  Luise Vorschlag freudig -- überzeugen -- gelingen -- Mutter sprechen -- gewiß verlassen -- 
  Wald kommen -- Weg führen -- bleiben Wärterin stehen -- lachend -- 
  -- Haus -- 
  Verzweiflung bemächtigt arm Weibe -- 
  entschlossen erklären -- eher sterben -- Gefängnis zurückkehren -- 
  werfen Tyrannin Boden -- Augenblick umbringen -- Gedanke Reue -- ewig verfolgen -- abhalten -- 
  weib überwältigen -- Dorn Sträucher Blute färben -- Schlägen Luisen Schulter fließen -- 
  müssen Rückweg antreten -- Schritt Schwäche fast Niedersank -- Metzger begegnen -- unterstützen -- 
  Luise bieten Manne fünfhunderen Taler Golde -- Hand Wärterin befreien -- Wort halten -- nötigen -- Schmuck Kleid verkaufen -- Mensch einfältig -- Gelegenheit unbenutzt lassen -- bringen Umstand -- 
  Qual Anfang -- 
  Wärterin -- Luise umbringen -- rufen Weiber Hilfe -- Strick banden -- nackend Auszog -- 
  Schrecken verlieren Luise Verstand neu -- 
  glauben schwanger -- Weiber -- Haushälterin -- 
  -- Mann strafen -- Kind umbringen -- -- 
  Unglücklicher Weise Weib Jugend verführen lassen -- gut Ruf erhalten -- Schwangerschaft vorsätzlich hintertrieben -- 
  glauben -- Nachdruck Luise Wort legen -- Geschichte unterrichten -- bös Gewissen lassen Vorwurf finden -- 
  bringen schlecht Mensch -- verdienen Vorwurf -- 
  Mädchen -- alt Jungfer -- Dorfen Teufel Bosheit -- Seite gut Name verlieren -- 
  zerriß Luisen nackt Leib Rutenstreiche -- Blut Seite herablief -- fahren fürchterlich Behandlung fort -- Schlachtopfer sinnlos Niedersank -- 
  halten tot -- bringen voll Schrecken Bette -- Wunde verbinden -- Narbe achtzehn Monat sichtbar -- 
  Woche Freund Luisen Brüdern -- zeigen -- Sittsamkeit erlauben -- Mahl erlitten Mißhandlung -- 
  schauderen -- luisen völlig verstand finden -- unterrechter Mutter -- Freude glücklich Nachricht weinen -- 
  sobald Luise Kraft Feder halten -- Geschäft Testament -- Freund Bruder -- Henker befreien -- fünfzehn hundert Taler gering Zeichen innigst Dankbarkeit zusicheren -- 
  Luise Gelde -- Wahl Gatten beweisen -- Krankheit Wert kennen lernen -- 
  Stande -- Wärterin -- abfordert -- befriedigen -- gewiß ruhig Stunde verschaffen -- Blachfeld Vorsicht brauchen -- Abreise Geld aushändigen lassen -- Krankheit -- lang -- Pfennig schicken -- 
  befremdlich -- Abreise Geld Händen -- Volljäh Rigkeit erhalten jährlich vierzig Pistole willkürlich Ausgabe -- übl Gebrauch -- 
  benachrichtigen Blachfelden Wiederherstellung Frau -- 
  lang weigern leben -- Liebe erloschen -- 
  Luise begeben M. -- Mann gewöhnlich leben -- erkennen Zug Veränderung Gesinnung -- 
  Blachfeld häuslich Einrichtung traurig Umstand ehelich Leben -- letzter ziemlich eingeschränkt unbequem Zustand Junggesellenzeit geraten -- 
  heizt Zimmer -- erklären -- Frau Wille heizen -- 
  Luise stellen Sanftmut -- Gegenwart -- Bedienten Offizier -- früh Morgen besuchen -- Ankleid aufstehen -- 
  stampfen Fuß -- rufen -- reich -- doppelt Heizung bestreiten -- 
  arm Weib gelieben ehemals -- fühlen -- Fall natürlich -- Besuch kalt Zimmer annehmen -- Krankenlager verlassend -- schwächlich Frau -- geheizen überlassen -- 
  Luise alt bekannte sehen -- 
  sehnt Freundin M. -- regnen -- bestellt Mietwag -- Blachfeld bezahlen -- zürnend vorwerfen -- unnütz Ausgabe -- 
  entbehrlich Ausgabe -- Vergnügen -- bittersen leiden -- fühlend -- denkend Wesen befallen -- 
  Luisen Vernunft geheilen -- Körper schwach -- vermissen Arzneimittel -- Abreise vergessen -- 
  Auskunft wissen -- verschaffen -- entbehren -- Blachfeld Bedienter -- voll Mitleid hinfällig Zustand Herrschaft -- erbon -- hinüber reiten -- holen -- 
  Freude -- entschuldigt Mann Nachhausekunft -- Bedienten Vorwissen fortgeschicken -- 
  Blachfeld ungerecht -- hart Vorwurf -- setzen hinzu -- Herr Haus -- 
  -- Luise Magd -- Miete -- Lohn bestreiten wissen -- 
  Blachfeld Bedienten -- Ankunft Nähemädchen -- Mutter schicken -- Luisen Aufwartung -- Freund Anfangs Notwendigkeit eingesehen -- Dienstmagd verschaffen -- Mädchen Blachfeld vorstellten -- schicken fort -- Vorwande -- Frau Magd gebrauchen -- 
  Luise Entbehrungen -- sobald Herz angingen -- gefallen lassen -- krank -- bequem Stuhl -- auszuruhen -- Kanapee -- liegen -- 
  Blachfeld Zimmergerät Luxus Glanze -- keineswegs Bequemlichkeit einrichten -- Luise Ausstattung zubrachen -- Krankheit verkaufen -- 
  essen Speisehause holen -- Luisen Gesundheit hinfällig -- befinden Lebensart -- einst -- Blachfeld teuer Speisewirt klagen -- bitten -- Geld Führung Wirtschaft geben -- 
  ausgereden -- lassen Wagen fahren weg -- 
  luisen Betrag Manne -- Ungeschicklichkeit Haushaltungsgeschäft eingestehen -- unbegreiflich -- 
  ehemals bitten -- Ausgabe übernehmen -- Summe Taschengeld vorbehalten -- 
  Einrichtung nichtswürdig Klatscherei unvorsichtig Frau -- Luisen damalig ansehen Gemahl -- Ordnung finden Gemütskrankheit -- wahrscheinlich Neid eingeflößen -- zerstören -- 
  Blachfeld Ding -- Frau verstehen -- frei Hand lassen -- 
  nachdenken jetzig Betragen tröstlich Weib -- ausgehen -- 
  Angewohnheit frei Luft ziehen grausam Zahnschmerz -- Nächte Auge schließen -- 
  Blachfeld fahren Begleitung bedienter D. -- lassen Nähemädch -- 
  -- Garnison fremd Luise -- schlecht Krankenwärterin -- glücken -- luisen Chirurg verschaffen -- 
  Blachfeld -- treten Mädchen -- putzen Operntänzerin herein -- Frau Köchin vorstellen -- 
  Luise erkennen sogleich -- 
  Abreise Mutter anbieten -- Luise -- ungeachtet Vorstellung Mann annehmen -- -- Mädchen schlecht Haus leben -- 
  Blachfeld Betrag luis deutlich -- 
  Geschmack Mädchen blühend schön -- halten -- arm Weib krank verkümmern aussehen -- Mädchen anderswo unterbringen -- berechtigen -- Frau zwingen -- Nebenbuhlerin Dienst Nähme -- 
  Luise Gegenvorstellungen -- bündig Antwort helfen -- geschehen schlecht Sache verteidigen -- falsch Ausflücht -- obgleich Veranlassung Streit geben -- klagen Widerspruchsgeist Frau -- wünschen hundert Meile hinweg -- 
  Luisen Gefühl zart -- Mann Wohnung wider Wille teilen -- 
  entschließen Neuangekommen Platz überlassen -- bitten Blachfeld Mutter schicken -- Monat sehen -- 
  erhalten Einwilligung Abreise -- liegen -- Luisen Mutter sowohl Brüdern Ankunft Gehör -- Kutscher heimlich Befehl -- D -- führen -- 
  schreiben Familie -- suchen möglich Weise überreden -- Frau Sinn vorher -- Zustand machen unmöglich leben -- 
  finden Glaube -- sogleich sehen -- 
  Luise verlassen -- Überzeugung Mutter umarmen -- Garnison -- Verzweiflung vorstellen -- Kutscher anhalten -- ankündigen -- bleiben -- 
  Anfangs aussteigen -- 
  Ort grausamst Mißhandlung erleiden -- Abscheu -- bringen Gewalt Wagen -- Familie -- Blachfeld Bericht Irre leiten -- lassen Einsamkeit -- fürchterlich -- wissen -- ewig verdammen -- 
  ältest Bruder abzuholen -- Erlösung geschehen Art -- schmerzlich betrüben müssen -- Rede merken -- hartnäckig bestehen -- wahnsinnig halten -- 
  -- Bauer erlauben fortführen -- Bedingung -- Anzeichen Tollheit Obhut übergeben -- 
  leiden drücken -- antworten Luise -- begnügen Glück -- Gefängnis befreien -- 
  Ankunft Stadt Luise Kirche fahren -- 
  verweigert Pferd -- Vorwande -- erschrecken -- 
  Umsonst versichern -- Besuch annehmen -- Mann Brief wirken -- gehören -- 
  müssen heimlich entwischen -- Lenker Schicksal wiedergeschenkn groß Gut Mensch -- Freiheit Vernunft danken -- 
  ältest Bruder zärtlich lieben -- elend krank Bade zurückkehren -- leiden weinen -- sogar Violine Bett -- versuchen -- Zauber Musik verwirrten Geist Zurückriefe -- 
  Mann -- Herz stählen -- 
  Konntest Untersuchung -- Bericht Mensch -- Frau Krankheit Güte beweisen -- Schwester hartnäckigst mißtrauen behandeln -- 
  Wußtest -- kalt Mitleid beleidigend tröstend -- 
  Luise traurig Lage -- 
  Gemahl -- seinetwill Vorteil verlieren -- väterlich Haus darbieten -- 
  Zimmer Madame N. besetzen -- zurückzugeh -- begnügt Luise dunkel Kammer -- Mangel Luft fast ersticken -- 
  Jahreszeit herankommen -- Mutter müssen -- persönlich Aufsicht Arbeiter führen -- Luise Platz -- Magd Aufwartung -- Kränkung vollenden -- treffen -- einzig Bedient Bruder -- Mitleid Essen Garküche holen -- glücklich Ehe Blachfelden dienen -- Stockschläg mißhandelen -- Beschuldigung -- bestohlen -- fortjagen -- 
  Luisen Bruder Dienst nehmen -- Art arm Leute -- Erziehung -- Gefühl berichtigen -- lassen Mann Härte entgelen -- verweigert Dienst -- müssen anhören -- Kamerad -- 
  -- vorbei -- Mann Herr -- -- 
  Geld Herz gewinnen -- stehen Luisen Gewalt -- Bestreitung Unterhalt Taschengeld -- Mädchen aussetzen -- Manne Pfennig vermehren -- 
  Winke -- Luisen -- -- einsam fast Mangel kämpfen -- Lustbarkeit Wohllebe hinbrächen -- Grund -- müssen ehemals edl Gefühl ausgeartet -- 
  Betragen Luisen älterem Bruder tadelhaft scheinen -- entstehen menschlich Schwäche -- 
  fortwährend Furcht Anfall Wahnsinn halten -- Schwester speisen -- liegen Herz -- -- Damengesellschaft -- einladen -- 
  Bewarb reizend Frauenzimmer -- Zerstreuung Plan -- tragen -- Teilnahme Schwester schwächen -- glauben -- Vereinigung Luisen Gatten Glücke Wille notwendig -- hoffen Kränkung Vernachlässigung bringen -- verlangen -- 
  Luise verzärteln -- 
  Bruder täglich glänzend Kutsche Lakaien begleiten ausfahren -- indes -- arm schwach Bein fortschleppten -- Fuß ausgehen -- schön Wetter einsperren bleiben müssen -- steigen Bitterkeit Herzen -- 
  enthalten denken -- leiden -- weigern -- Neigung euren Vorurteil opfern -- 
  indessen zürnen Bruder -- 
  ehemals Beweis Zärtlichkeit -- unbegrenzt Zutrauen geben -- 
  Liebe beschäftigen -- denken -- 
  Blachfeld -- opfern -- Leben Seligkeit geben -- -- schreiben Wort -- 
  -- Fürst Auftrage verschicken -- schreiben halten -- 
  indessen Grundsatz -- Ehe Freiheit Neigung äußern -- luisen Schlag bedrohen -- vorbereiten -- 
  Mensch Grundsätze brüsten hören -- glauben -- Mann -- hartnäckig zahllos Mittel Hand Frau bemühen -- verstoßen wünschen -- 
  erhalten Brief -- Gott -- Brief -- 
  fordern Scheidung -- legen Zettel Mutter -- Luise Herz abgeben -- 
  wissen -- wohlmeinend Frau höchst Glück Ehe setzen -- wissen -- übl Erfolg Plan leiden -- 
  unmöglich -- Botschaft bringen -- völlig Vernichtung Hoffnung enthalten -- 
  Luise erfahren -- Mann D. ankommen -- 
  schlich Wirtshaus Wirtshaus aufsuchen -- 
  Hitze erschöpft Ohnmacht -- nötigen Mietswage nehmen Nachforschung fortsetzen -- finden Gasthof -- Blachfeld abgestiegen -- 
  ausgehen -- 
  lassen Zimmer führen -- fürchterlich Stunde Spannung zubrachten -- Feder beschreiben -- 
  Zustand unerträglich -- Buch fordern -- zerstreuen -- elend deutsch Übersetzung Heloise -- Hand -- Blachfeld Hereintrat -- 
  Bewegung fliehen -- halten -- bitten Gehör -- 
  Buch fallen Hand -- Blachfeld heben -- Titel erblicken -- Gelegenheit Verweis geben -- -- 
  Buch verdrehn jung Leute Kopf -- ihrigen verdrehen -- 
  vergessen -- ehemals Anlag -- Werk lesen -- 
  Luise Vater Aufsicht lesen -- lieb Tugend -- Abscheu Laster schöpfen -- 
  Blachfeld -- beweisen Luisen -- irren -- Hoffnung -- bringen -- Irrtümer Quelle fließen -- 
  hören geduldig Ergebung -- Vorwurf -- 
  erlaubt Magd Miete -- bitten -- Mutter -- Garnison abholen -- danken sogar -- Brief Mutter zurückbehalen -- 
  Luise eilt Wunsch nachkommen -- Mutter günstig Wendung Angelegenheit mitteilen -- 
  Blachfeld kehren indes M. -- -- gegeben Versprechen bereuen -- 
  Waffenbrüd -- meister brav Hausväter -- überflüssig Ausgabe -- unnütz Lustbarkeit versagn -- gute Familie sorgen -- 
  Einschränkung mißfiel -- zumal achtzehn Monat -- Unterhalt Frau kosten -- entwöhnen -- Reise Geschmack Zerstreuung bekommen -- 
  schreiben Folge Schwiegermutter -- Luise Brief aufhalten -- sprechen -- Vorwurf erbittert -- 
  Luise Aufsicht Madame N. -- Umstand arm Weib aufbringen -- Mutter Herz -- einzig letzter Stütze verlieren -- 
  Umsonst beteuern Luise Unschuld -- überzeugen -- Blachfeld letzter Zusammenkunft Untreue vorwerfen -- falsch -- Blachfeld Freund rühmt -- stolz Seele demütigen -- 
  -- harmlos Geschöpf Schoße Überflusses reißen -- tausend schön Raisonnement -- tausend angebracht Anmerkung Fehler anderer Ehemänner -- Zutrau truglosen Herzens erwerben -- müssen -- Annehmlichkeit Leben -- Gesundheit -- Vernunft Glück opfern -- verstoßen -- 
  fühlen lassen -- gering letzter Knecht achten -- 
  Dienst erkranken -- Blachfeld verpflegen -- 
  Anblick mütterlich Kummer zerfleischen Luisen Herz -- 
  wagen Versuch -- schreiben Blachfeld -- 
  Antwort beweisen -- vergeblich Hoffnung -- 
  fahren fort Schwiegermutter bitterst Vorwurf -- Zeit entdecken -- Luise Gemütskrankheit aussetzen -- Bewußtsein Bewerbung abhalten -- 
  Luise Gegenstand -- schreiben -- erfahrensen Arzt sagen -- 
  umständlichste Beschreibung Schwermut -- gewöhnen -- Leidenschaft beherrschen lassen -- Anfall Laune Weibe -- Opfer -- 
  langen Brief Mutter -- worin Blachfeld fortfuhr Tochter gehässig Licht darstellen -- Zusammenkunft bitten -- Bedingung -- -- Beweis gut Sache traut -- Luise gegenwärtig -- 
  Madame N. Schwäche -- verstehen -- 
  Zusammenkunft finden -- Blachfeld legt Bedingung -- Frau aufnehmen -- 
  unglücklich Weib nämlich Fuß Haus wohnen -- Mätressen gefallen lassen -- 
  Luise demütigend Vorschlag erfahren -- stürzt Mutter Füßen -- gelobt -- Magd dienen -- Preis Mann Haus leben -- 
  Blachfeld schwor Weigerung rächen -- 
  Abgrund Abscheulichkeit öffnet Luisen -- 
  Blachfeld schleppt Gerichtshof Gerichtshof -- setzte bitterst Kränkunge -- 
  lesen öffentlich Brief -- schreiben -- Redlichkeit unerschütterlichst Stütze vertrauend -- geheimst Gedanke -- sogar Traum -- furchtsam Gewissen Vorwurf -- mitteilen -- 
  Abscheu Mitleid bemächtigt Richter -- machen Verteidiger -- 
  Blachfeld Frau verhören -- 
  Blachfeld erblicken Luisen -- Träne fließen -- 
  Rührung -- vergessen -- 
  werfen Arm versprechen Vorschlag eingehen -- Blachfeld großmütig -- Luisen Bedingung annehmen -- feierlich unterzeichnen -- 
  Luisen Ruhe Augenblick begründen -- Einmischung Kummer zubereiten -- 
  Blachfeld Sachwalter Rabulist -- beschuldigt -- gütlich Verein Eheleute verhindern -- 
  gelingen Blachfeld Sache -- legen Luisen Schrift Unterzeichnung -- Blachfeld Vorteil abfassen -- 
  Luise gestehen -- Mann unverträglich Laune Trennung zwingen -- -- Ding Punkt kommen -- Verbindlichkeit freisprechen -- 
  Luise finden Klausel höchst abschmacken Klage Mann führen -- Unverträglichkeit übel Laune mitbegriffen -- sogar mehrmals -- Eigensinn Laun frei -- 
  Luise Augenblick beschließen -- 
  Blachfeld halten arme -- bitten unterschreiben -- Wohnsitz Schikane schnell verlassen -- 
  Luisen Advokat Ohr -- 
  -- unterzeichnen -- 
  Zeuge gegenwärtig -- Fall Not beweisen -- überreden -- -- 
  Luise unterschreiben Name -- Friede schließen -- 
  ängstlich unsich Friede -- abhängig Laun Mann -- Härte Wankelmut deutlich kennen lernen -- 
  -- Unschuld geltend -- 
  land Gerichtshof -- unbestechlich Unparteilichkeit Tribunal Muster dienen -- appellieren stehen luisen frei -- Mutter hing fest hergebracht Vorurteil -- 
  zittert -- gut Ruf Tochter lang Rechtsstreit leiden sehen -- Aussöhnung überreden -- beschwören Luisen -- hoch Instanz melden -- 
  Bitte wirken mächtig Zwang -- Aussöhnung Stande bringen -- Mutter neu Hoffnung -- Ehe Tochter glücklich Wendung nehmen -- 
  Blachfeld indessen Schuld -- 
  mehrere Leichtigkeit bezahlen -- verstehen Madame N. -- Tochter Monat Haus nehmen -- Blachfeld lassen bewenden -- Kleinigkeit Holz Wohnung zahlen -- 
  Luise Rechtshandel bedrohen -- 
  Bürgschaft -- melden -- Heirat leisten -- erfordert schleunig Zahlung -- Verlegenheit vermehren -- äußern Mutter -- vieler Sanftmut -- Blachfeld vorgestreckt Summe wünschen -- 
  bleiben peinlich Lage -- zutrauen ergreifen -- 
  schreiben Fürst -- Dienst Vater gestehen -- erinnern Versprechen -- Vater geben -- Tochter -- einzig Kind -- Talent Broterwerb dienen können -- vorzüglich sorgen -- entdeckt jetzig Bedürfnis -- 
  Fürst schicken erforderlich Summe -- Anweisung jährlich Pension dreihunderen Talern -- 
  weib Gelegenheit eifrig ergreifen -- Manne unabhängig -- luisen Wunsch fremd -- unverzüglich eilt -- Blachfeld unumschränkt Herr Pension -- Kapital vorbehieln -- Blachfeld Schuld bezahlen -- 
  Eindruck günstig vorfalls Uneigennützigkeit Blachfeld auszulöschen -- müssen unglücklich Mißverständnis Weg stellen -- 
  Luise vorher zärtlich Brief schreiben -- Unvorsichtigkeit begehen -- fein Art aufzuziehen -- -- versichern -- allenthalben behaupten -- Stelle ausschlagen -- Einfall anbieten -- 
  Scherz Verhältnis Eheleute gewiß unschicklich -- Mann übel angebracht -- Blachfeld ungestüm Verdruß straft Luisen hart verdienen -- 
  schicken zerrissen Stück Brief Rück -- 
  Härte verhindern luisen -- Beweis Gnade Fürst Opfer bringen -- 
  liegen Charakter -- sanftest nachgebendst -- Glück lächelen -- 
  Blachfeld indes fühlen -- Luisen übereilt Scherz hart Strafe verdienen -- schreiben Brief -- Verzeihung bitten -- melden -- Dienst -- Aussöhnung versiegeln -- 
  Zufall Brief spät Luisen Hand -- Blachfeld Abreise antworten -- 
  Blachfeld halten Luisen Brief -- Geschenk Fürst melden -- Antwort reuig schreiben -- finden Großmut Verdienst -- obendrein empfindlich -- bevorstehend Besuch Freude bezeugen -- 
  Luise erwarten indessen Ungeduld -- Ankunft eilig entgegen -- straucheln -- Fall -- -- schmerzlich verwunden -- gefährlichst Folge zuziehen -- Anfang Schwangerschaft befinden -- 
  Blachfeld -- ungestüm -- Idee vermeintlich getan Unrecht beschäftigen -- überhäufen Vorwurf -- kosten groß Mühe -- ständ Pension erhalten -- zufrieden stellen -- 
  Luisen Mutter raten Zeitpunkt benutzen -- Mann bitten -- künftig Wirtschaft Magd -- bevorstehend Wochenbett unentbehrlich -- halten -- 
  Forderung bringen Blachfeld neu -- behaupten -- machen Weiber -- Forderung hoch spannt -- zugeständen -- 
  scheinen -- einzig Magd Küche Pflege Kinde völlig hinreichend -- Luise Weiber Mann nähen -- 
  finden Mensch -- Brdienter Aufwartung Besorgung Pferd hinreichte -- 
  luisen fallen Augenblick Schleier Auge -- wogegen verblenden -- deutlich -- Blachfeld Egoist -- 
  ehemals -- Woche Ehe -- Tisch Schwiegermutter -- Vorwurf -- Köchin Kammerfrau halten -- weigern früh morgens aufzustehen -- Herr Kaffee -- 
  Blachfeld -- Begriff stehen Armee -- Bedient -- Dienst verrichten -- 
  indes werfen -- Magd -- bekannte ihrigen -- bezahlt -- Grund -- ihrig desto arbeiten -- äße -- Gehör geben -- 
  Luise fing fürchten -- Geiz -- Lebensfreuden zerstörend -- alt wachsend Laster -- Anteil Mann Charakter -- 
  erfolgen -- bestätigt traurig Ahnung -- 
  Fürst notwendig außerordentlich Ausgabe nötigen -- Auszahlung Luisen Pension suspendieren -- 
  ungeachtet Zustande -- Luise befinden -- hören Blachfeld plötzlich besuchen -- fing neu -- Schwiegermutter Art schreiben -- Tochter entzweien -- Brief Lesen wert halten -- 
  Vorsicht treiben -- Tochter sagen -- Verdruß erbittert Gelegenheit -- luisen süß Traum -- wiegen -- Entdeckung vergiften -- 
  glauben nämlich -- Blachfeld bloß besuchen -- Verkehr abbrechen -- Entschluß leben beschleunigen -- 
  begeben -- übel empfangen -- Geduld -- zärtlich herzlich Wunsch fallen -- gewann Herz -- schenken glücklichst Zeitpunkt Ehe Leben -- 
  gestehen Versöhnung -- romanhaft Forderung Feier Hochzeit -- Freundin -- Gattin leben -- Keim Bitterkeit legen -- -- Fehlgeschlag -- Entschluß wankend -- wachsen -- 
  Luise fügen Verhältnis -- Natur Gesetz ehrwürdig -- Gatte gänzlich Umschaffung belohnen -- 
  Haus beständig vorgezogen Aufenthalt -- treiben Sorgfalt Weib -- Anzug helfen -- 
  früh Abends lesen -- beschäftigt Erziehungsplane künftig Kind -- 
  gestehen -- luisen -- ungeachtet körperlich leiden -- übellaunig mürrisch sehen -- 
  ausschließend Pflicht beschäftigen -- Blick Blachfelden Beifall -- lohnen überschwenglich -- 
  Ausbruch Kriege zerstören Luisen häuslich Glück -- 
  Blachfeld verlassen -- Punkt stehen -- Mutter -- Hilfsmittel Bedürfnis Kindbett -- klagen -- 
  Mann setzen jährlich Gehalt -- nämlich Fuß verheiratet Kriegskamerad -- außerordentlich Ausgabe -- 
  Luise dacht Wagen verkaufen -- Mann bitten -- Reise gebrauchen -- fehlt Auskunft -- 
  anscheinend Unruhe Zustand Abschied -- versprechen Mutter bitten -- Kindbette nehmen -- 
  Laufbahn führen ehrgeizig Plan -- Gefühl Gatte Vater schwiegen -- Bitte Madame N. vergessen -- 
  Frau Luisen einladen -- Tochter Gespräch Furcht entdecken -- Garnisonstadt nieder -- Krieg geschickt Wundarzt abgerufen -- sagen -- Besorgnis -- wünschen -- Zimmer Wohnung D. einräumen -- 
  Haus wohnen Luisen Brüder -- fürchten -- Anwesenheit Kranken Lebensart Last fallen -- wagen Vorschlag -- 
  Luisen Rat -- schreiben -- Besorgnis Zustand entdecken -- Fürsprach Mutter Gunst bitten -- Mutter sehnlich gewähren wünschen -- 
  Luise versteckt Plan abgekartet Anschlag Abscheu -- Ursache Gegenstand weitläufig Brüder auslassen -- 
  betreffen -- -- Sprache -- Brüder vorwarfen -- Zudringlichkeit Mutter Last aufzubürden -- Alter Kränklichkeit scheut -- Einwilligung geben -- -- Forderung Weise -- 
  luisen schwer -- unverdient Zudringlichkeit -- Selbstsucht zeihen lassen -- Mutter bloß stellen -- müssen geduldig leiden schweigen -- 
  Bruder rieen -- Blachfeld schreiben -- erlauben -- Wohnung Stadt mieten -- 
  -- setzen hinzu -- Punkt ständ Vater -- sorgen -- Frau nötig Hilfe gebräch -- 
  Rat -- Rücksicht Blachfelden übel angebracht -- 
  Luise wissen -- Gemütskrankheit weigern Wohnung bezahlen -- Mutter D. verdienstvoll Frau mieten -- Herz leiden -- unbarmherzig Art erfahren -- Luisen begegnen -- äußern -- Drittteil gefordert Preis nehmen -- voraussehen -- 
  Erfahrung wagen Luise -- Manne ähnlich Vorschlag -- quäln ängstlichst Besorgnisse -- 
  Unruhe wirken sichtbar -- Freund Mutter benachrichtign -- Söhne sprechen -- bringen -- Luis einstimmig Dienst einluden -- 
  Innigst Güte Mutter Nachgiebigkeit Brüder rühren -- beschließen Luise Gebrauch -- froh Leben jung Leute Krankenbett stören -- 
  schieben Reise -- verhehlen sogar Anfang Schmerz -- Mutter Tochter Kindbett -- 
  gehören leiden Vernachlässigung gewöhnt Geschöpf -- Unannehmlichkeit -- rer Lage ertragen -- 
  Bett D. zurecht -- unbequem Schlafbank -- Zimmer stehen -- Rücksicht verhaßt müssen -- qualvollen Epoche Gemütskrankheit verleben -- 
  Zimmer befinden Vorsaal Vorratskammer -- Bedürfnis Haushalt aufbewahren -- Hausgesinde Augenblick Durchgang dienen -- 
  treten gering Vorsicht -- Fußboden zitteren -- werfen Tür -- Luise erschrocken Schlummer Auffuhr -- 
  Nerv -- Krankheit schwächen -- Niederkunf angreifen -- Stunde leiden -- ehe Hilfe begehrn -- Umstand erholen -- 
  Mutter -- herzlich meinen -- glauben Luisen Schwäche Mangel Nahrung entstünd -- zwingen unaufhörlich Speis nehmen -- jedesmal Luise Ekel überweanden -- Mutter Vorstellung -- fa Eigensinn -- benehmen -- aß -- ergriff heftig erbrechen -- Kraft vollends unterlagen -- 
  fühlen Weib lebhaft Luise Glück Mutter -- liebenswürdig Kind scheinen Liebkosung süß lächeln erwidern -- 
  drückt Brust -- brennend Wunsch nähren -- streng Verbot Mutter verhindern -- schwach -- heißen -- 
  grausam Vorurteil -- Natur Kraft schaffen -- fehlen Kraft ernähren -- 
  Luise Schwangerschaft schonen -- heilig Mutterpflicht erfüllen -- 
  gelingen Überfluß Milch -- rein -- gesund -- -- umsonst -- vertreiben Gewalt -- 
  Luise leiden unsäglich -- Milch treten Blut -- werfen Nerv -- verursacht Fieber -- Kraft Monat verzehren -- 
  Niederkunft glücklich -- glaubte sorgen -- beobachtet Art Schonung -- 
  Stunde Niederkunft lesen Brief Bruder -- 
  glauben Glückwünsch rutaln -- -- schreiben -- Fieber -- Mutter verlangen -- äußern Unzufriedenheit -- Schwester Wochenbett gewöhnlich Gange bringen -- 
  Mutter weinen -- sprechen nah Tod geliebt Sohn -- Luise bitten eifrig eilen -- Hand pflegen -- 
  reisen -- nehmen Kammerfrau Köchin -- lassen Luisen Wärterin -- Haushalt versehen -- unerfahrenen Amm -- 
  verkehrt Geschöpf Untreue Liebhaber -- verführen -- Verzweiflung -- benetzen Säugling unaufhörlich Träne -- 
  Luise zittert geliebt Kind -- beschwören Amm -- Augenblick Gemütsbewegung Brust legen -- 
  weib bestehen eigensinnig -- geraten heftigste Wut -- 
  Luisen Angst Unruhe steigen -- Gefahr stehen -- Verstand auf verlieren -- 
  wissen Kind -- Milch Wasser aufziehen -- Furcht gut Mutter -- Vorurteil Punkt kennen -- wagen Veränderung -- 
  Kind retten -- bleiben Luisen anderer -- Laun Drache nachgeben -- sobald Amme Gewalt Luisen furchtsam Mutterlieb sicher -- legen Leidenschaft Zügel -- 
  Seite Angewohnheit müßigen -- weichlich Lebensart übermütig -- reizt Mißhandlung brutal Liebhaber täglich Ärger -- Mißhandlung scheinen täglich fesseln -- 
  unleidlich Geschöpf -- Luise nötigen Kind überlassen -- ungewöhnlich Lohn groß Sorgfalt Säugling bewegen -- schlagen Luisen -- einzig Magd unterhalten -- jung Mädchen -- ergeben -- lieben -- abschaffen -- 
  grausam -- fordern -- einzig Geschöpf -- fremd -- entfernen -- Mutter lieben -- Krankheit Sohn -- 
  wohlmeinend Frau Luisen zart Gefühl verwunden -- merken lassen -- Krankheit Last fiele -- gütig -- diesmal Tochter Bitte nachgeben -- 
  erlaubt Magd behalten -- obschon persönlich zuwider -- Luise Unglück -- Mensch lieben -- Mutter mißfielen -- -- sogar Blachfeld Maße Luisen Herz Fortschritt -- unangenehm anfangen -- 
  Luise Ungemach Lage Freude ertragen -- Blachfeld minde Teilnahme bezeugen -- Luisen Prophezeiung Heirat treffen -- Geräusch Waffe übertäuben Herz -- Vaterfreude überd neu -- Gefühl -- wildesten Sinn bezähmen -- Glitt seinigen vorbei -- 
  schreiben Weibe -- Geschenk -- Kind -- danken -- 
  kalt Antwort Brief -- Gelegenheit Schwiegermutter bekommen -- enthalten Wort -- 
  -- bitte -- Frau Liebe versichern -- -- 
  Blachfeld Luisen fühlen -- Liebe letzter Empfindung -- fordern -- Teilnahme wünschen -- 
  schreiben -- 
  befinden Luise -- Krisis Wirkung Gesundheit -- gewinnen Freude Mutter Überhand gewöhnlich Schwermut -- 
  Bedenken -- lieb Mutter -- schädlich Gemütsbewegung -- 
  kenn Reizbarkeit Nerv -- zart Gefühl -- 
  Beschwöee Nücksicht nehmen -- ewig Dankbarkeit versichern -- u. s.w -- schreiben -- Luise zufrieden -- 
  drohend Folge Luisen Kindbett -- Vertreibung Milch entstehen -- Madame N. -- Furcht beunruhigen -- vorübergegangen Gefahr schreiben -- 
  Antwort berührt Umstand Silbe -- Vergangenheit -- beklagen Beschwerlichkeiter -- vorig Winter häufig Reise Garnison D. erleiden -- 
  völlig vergessen -- damalig Einrichtung Beifall treffen -- 
  Luise bleiben Winter Mutter -- -- Tisch General -- Wirtschaft bedürfen -- Abtragung Schuld erleichtern -- 
  Wankelmut Laune scheinen Betragen Frau Oberhand -- Bemühung Unmut entwaffnen -- bleiben vergeblich -- 
  Luise -- Anrat Arzt -- Ortsveränderung einzig Rettungsmittel Nervenfieber drohend Auszehrung halten -- Stadt ziehen -- 
  Wunsch -- Mann häuslich Umstand strengster Sparsamkeit völlig Reine bringen -- vermögen -- sobald Gesundheit herstellen -- rauh Jahreszeit Trotze -- Anfang Winter -- Kind Mutter beziehen -- 
  Opfer groß -- Umgang -- 
  Nachbarschaft bieten -- Ort -- Gesellschaft dar -- Mutter bringen Winter Dienst -- 
  Schwäche erlauben Spaziergäng Fuß -- Pferd mieten lassen Grenze -- Ausgabe vorschreiben -- 
  vergnügen Zweck erreichen -- Summe abzahlten -- Blachfeld aufnehmen -- Witwenkas einkaufen -- 
  schuld scheinen Ehrenmann drückend -- Gläubiger Großmut treiben -- Interesse Kapital nehmen -- 
  Gesundheit leiden Lebensweise -- ununterbrochen Einsamkeit stürzen alt Schwermut -- 
  Mühe belohnen -- Mann Herz heißen Wille nutzen erkennen -- 
  Chef Blachfeld dienen -- Großmut -- Offizier erlauben -- Frau Winterquartiere lassen -- 
  Blachfeld einzig Erlaubnis benutzen -- 
  luisen Zerstreuung notwendiger -- -- 
  -- Blachfeld Hand bewerben -- reizend Bild wiedersehen -- späterhin fordern -- Umgang Bekanntinne abbrechen -- Frau getrieben Gefälligkeit Offiziersweiber -- Mann Winterquartiere folgen -- spotten -- 
  Luisen Abreise ausdrücklich versprechen lassen -- Fall besuchen -- Frau Stand Reise -- 
  schweigen ehemals gewünscht Zusammenkunft -- Luise Lust -- Einladung reisen -- Mutter ermuntern -- 
  bieten -- Kind behalten -- Luise zärtlich Mutter -- Hand geben -- Liebkosung geliebt Geschöpf Reiz -- Manne teilen -- Mutter Kind gleichgültig scheinen -- 
  Tag -- gewöhnlich tausend traurig Bild beschäftigen -- empfangen Brief Blachfelden -- Sehnsucht Frieden sprechen -- verlangen -- Herde wiedergeben -- Gesellschaft Frau leben -- Liebkosung Kind -- Freude wissenschaftlich Beschäftigung genießen -- 
  Luisen Herz richten Wort -- welke Blume Haupt erheben -- erquickend Tau baden -- 
  gründet lachendst Hoffnung Gesinnung -- übelbedacht Dienstfertigkeit Freund bitter Kummer zurückstassen -- 
  teilen gerichtet Brief Mann Monatstage -- Widerspiel Empfindung enthalten -- äußern -- 
  sprechen Enthusiasmus blutig Gewerbe -- ziehen ungebunden unstät Lebensart süßesien häuslich Bande -- 
  Luisen Schicksal -- Herz unangenehm Gefühl bestürmen sehen -- wenigster bekämpfen fähig -- 
  Augenblick heitersen Aussicht beschäftigen -- Bild geliebt Mann Seele einnehmen -- sprechen Brief -- erhalten -- 
  verlangen -- wissen ausdrücken -- verlangen Freude -- lesen -- fordern Mitteilung -- finden Grab kurz Glück -- 
  äußer Gewalt -- Gegenwart Zeuge Gemütsbewegung siegen -- Schmerz überwältigen -- Strom Träne erleichtert Herz -- 
  bringen tief Kummer -- neu Brief Mann Hoffnung einflößen -- 
  schreiben zärtlichst Ausdrücken -- leben vermöchter -- Drang eifrig -- Schlusse angegangen Feldzug sogleich eilen -- 
  Luise vergessen leiden -- überlassen blindling Aussicht froh Zukunft -- Natur lebt Blick -- 
  glauben Mann Herz besitzen -- anderer Geschöpf Wohltat Gott -- Freuden Gesellschaft genießen -- 
  Mutter -- kurz Stadt wohnen -- weint Freude -- Tochter Auge Träne benetzen -- Kummer erloschen sehen -- Bruder wünschen Glück -- 
  Haus teilen Zufriedenheit -- Geschöpf froh sehen -- wissen -- Stunde Genoß -- 
  Blachfeld Gelegenheit hervor -- 
  Fürst -- Veranlassung Verdienst belohnen Eifer ergreifen -- vorzüglich Beweis Beifall -- 
  benachrichtigt Frau gut Glück -- schreiben -- Geschenk sogleich höchst nötig Ausgabe aufgehen -- Aufenthalt Winterquartieren kostbar -- bät -- Wohnung Meile entfernt Stadt aufzuschlagen -- 
  Vorschlag Seite Mann -- schädlich Einfluß Einsamkeit Luisen Gemüt kennen -- zärtlich -- 
  Heirat -- Reise begleiten -- Bestrebe -- schwermütig Gedanke lassen -- 
  Luise Verdacht -- Blachfeld neu Plan Ursache -- Lage Umstand ökonomisch Rücksichte -- 
  antworten einfach -- erwähnt Landstadt einrichten -- Ort einerlei -- sobald nah Brächt -- 
  Luise väterlich Haus gelten -- Lebzeiten Herr N. -- mehrmals Lauf Geschichte abnehmen -- 
  alt Bemerkung -- Mann herrschen Weiber Regiment führen -- umgekehrt -- lassen meistens Zirkel Familie anwenden -- 
  Vater leben -- bemüht suchen -- Tochter fallen -- bleiben Frau Tod unverheiraten -- schmeicheln Söhne -- nunmehr aufgehend Sonne -- 
  Stadt Herr -- herrschten mehrere Luisen väterlich Haus -- obschon Magd Kind Wohnung brauchen -- Bedient Bruder gehörig Zimmer Besitz nehmen -- Freundin -- Luisen Besuch -- bewohnen -- -- müssen Magd Kind aufhalten -- 
  drückend Hitze beständig Wartung -- Gesundheit erfordert -- Einrichtung höchst lästig -- 
  Luisen Mutter versprechen Zimmer bedienter einräumen lassen -- Sohn widersetzen -- schlagen Weg -- gewöhnlich -- Wort halten gedenken -- erzürnt Person -- geben -- 
  lassen Luisen merken -- genau halten dürfen -- Gefälligkeit Haus aufnehmen -- 
  mehrmals Kostgelde erbon -- 
  Mutter wissen -- -- kurz vorgenommen Meublirung Blachfeld Wohnung M. -- Schuld geraten -- hören -- 
  wiederholen Brüdern Anerbiet -- antworteten -- Mutter fürchten -- Forderung möchten Einrichtung hoch steigen -- 
  kennen Luisen -- 
  Kostgängerin begnügen -- Kind Haus wehe -- Demütigung aussetzen -- 
  hausgesind kennen eingeschränkt Umstand -- scheinen Mitleid aufzuwarten -- 
  Tisch -- Bruder -- Mutter -- bedienter -- übergangen -- fehlen -- 
  Bruder -- Mutter meinen herzlich -- Kränkunge bemerken -- Luise -- errötet hinweisen -- leiden stillschweigend -- 
  Luisen Brüdern -- Sache meister Eifer wider beweisen -- Bewegungsgründe anregen -- Redlichkeit Ruhm gereichn -- 
  Mutter Geschäftsmann -- persönlich Vorteil betreffen -- gewiß nachsichtslos Schwester -- 
  Gelegenheit -- luisen Summe vorwerfen -- ehemals Entschädigung zugestehen -- Mutter Blachfelden Tisch nehmen abschlagen -- 
  Vorwurf äußerst ungerecht -- Heirat Wunsch Familie -- Zuschuß Blachfeld damalig Lage unmöglich -- 
  ältest Bruder -- Edelmut Charakter -- Schwester eifrig -- -- Mensch -- unangenehm Lage versetzen -- heraushelfen müssen -- 
  bringen Sitte -- Tochter -- Verheiratung -- väterlich Haus entfremden -- Vorteil Kind verlieren -- 
  Luisen Brüder Talent Stande -- Brot verdienen -- Tisch -- Wohnung -- Wäsche -- Aufwartung Mutter -- Luise Heirat Stücke versorgen -- scheinen Gnadenbrot Mutter essen -- 
  Vorwurf jährlich Zuschuß kränken Luisen tief -- suchen -- Veranlassung heben -- 
  bitten Blachfeld Brief Erlaubnis -- Summe Verzicht -- versprechen -- Unterhalt hoch -- Aufenthalt Stadt -- angewiesen -- Wohlfeil -- wenig auskommen -- 
  Blachfeld Antwort voll Ungestüm Zorn -- 
  befehlen -- eher abzureisen -- Pension versichern -- Rede -- Gewalt nehmen -- 
  schreiben -- Ort leben gleichgültig -- vorschreiben -- rien -- Wohnplatz fremd Ort aufzuschlagen -- 
  Luise Unglück -- ziemlich ansehnlich Summe bestohlen -- 
  wohlmeinend Mutter schreiben Schwiegersohn -- Furcht -- luisen beschuldigen -- Verlust Nachlässigkeit verschulden -- 
  wüthel Antwort Frau -- werfen -- letzter Geschenk Fürst -- Bitte Bezahlung Bürgleistung -- behalten -- erinnern -- Gegenwart Familie Anteil ablehnen -- -- Luise Tilgung Schuld anwenden -- 
  Mutter -- meister Mutter Umstand -- Kind ungern abreisen -- völlig luisen aufzubringen -- sprechen Reise Winterquartiere -- lächerlich Einfall Luisen -- widersetzen -- 
  Stadt Antwort Beschuldigung -- holen Luise aufeinander folgend Brief Mann -- dringendst Zärtlichste bitten -- -- 
  tränend Blick fragen -- rien -- lang Manne leben -- groß Wankelmut schuldig -- -- Teilnehmerin bösen -- -- Glück lächelen -- Rücken wenden -- -- Schicksal abhing -- verdächtig suchen -- 
  ältest Bruder ergreifen -- Mitleid Unglück durchdrungen -- Hand -- bitten Mut fassen -- trösten -- flößt Hoffnung -- Gegenwart Wolk Mann Gemüt zerstreuen -- verschieden Datum Brief überzeugen -- Blachfeld widersprechend Ansicht Luisen Reise ökonomisch Ursache entständ -- schoß nötig Reisegeld -- 
  treffen Nachricht -- Blachfeld nächstens -- 
  schreiben Frau Ausdruck böse Laune Stolz -- Augenblick Versuchung geraten -- verwandte Vater B. reisen -- Zusammenkunft auszuweichen -- Kummer drohen -- 
  Mutter -- ausbruch Empfindlichkeit Blachfeld Betrag -- -- Ursache grämen -- müssen Luise Reise zerstreuen suchen -- Manne Weg -- 
  Luise bitten -- künftig Rechtfertigung Äußerung schriftlich geben -- 
  Madame N. -- Zettel -- Erklärung enthalten -- Mann hart Brief schreiben -- Schonung behandeln -- Blachfeld Tochter behandeln -- Magd dienen -- lang leben -- 
  -- Beifall Einwilligung Luisen Entschluß B. -- Blachfeld Betragen ändern -- Papier -- -- liebend Mutter -- unterzeichnen -- 
  Familie verabreden -- Luise vorgestreckt Reisegeld zurückzahlen -- einstweilen unterbring -- Fall -- Mann Aufführung Trennung zwingen -- Bereitschaft -- 
  Ungeachtet Vorkehrung unterleißen Luise -- unnütz -- Hausfrieden gründen -- 
  Blachfeld Wirtschaft Ordnung -- 
  Frau erlauben -- überflüssig zwecklos Gerät verkaufen -- uw notwendig Hausrat anschaffen -- 
  geschehen -- Wohnung Garnison völlig einrichten -- 
  Einkaufs Witwenkas gemacht Schuld -- 84 Pistole Wagen -- Blachfeld Abreise bezahlen -- abtragen -- 
  Luise mietet artig Wohnung angenehmst Gegend Stadt -- Köchin -- richten Wirtschaft sorgfältigsten -- 
  Blachfeld Frau schreiben -- Wäschevorrat Feldzüg völlig aufgebraucht -- 
  Bitterkeit Mangel beklagen -- glauben Luise -- ansehnlich Geschenk Leinenzeug -- Hand -- willkommen -- 
  Kredit wiederholtenmal bezahlt Schuld Mann feststellen -- damalig Erschöpfung Kasse Weg stehen -- Kaufleumit Vergnügen Rechnung Aussenstehe lassen -- 
  eilt Leinwand einkaufen -- arbeitet halb Nacht -- stehen morgens -- treiben -- Gesundheit angreifen -- weniger Stunde Ruhe gönnt -- Kind Weinen Schlaf verhindern -- 
  Anstrengung fertig -- müssen Näherinn Hilfe nehmen -- 
  Freude -- Blachfeld sehen -- Kind vorstellen -- erleichtert Last -- 
  erwartet Unruhe -- wieviel Zärtlichkeit Unruhe vermischen -- 
  Ankunft herbeikommen -- lassen Stadttor fragen -- Herein -- 
  längst -- ungeduldig -- Frau Kind sehen -- Gasthofe abgestiegen -- angekleiden -- obgleich Luise Kollation bereit halten -- Ort gegang Tee trinken -- 
  erscheinen Luisen -- -- -- 
  Auftritt Gedächtnis -- Blick Leser -- tief Vergessenheit hüllen -- 
  Blachfeld -- Tapferkeit Sittlichkeit erhöhen -- -- Verachtung stoßen Frau -- zärtlich Arm fliegen -- 
  Wohnung scheinen ärmlich -- eng -- klein -- luisen sagen -- Fürst vierzehn * * folgen müssen -- wissen nachkommen -- Geschäft ohnehin erlauben -- -- 
  -- 
  anderthalb gütig Fürst fordern -- -- 
  -- -- fordern -- gehen -- -- 
  -- verlassen Erklärung -- beleidigend -- hart -- kalt -- 
  lang Abwesenheit -- wiedersehen -- würdigen Mutter Kinde sagen -- Herz verstieß -- 
  Luise Ungewißheit aushalten -- schwankend Äusserung -- abholen lassen -- Geschäft verstatteen -- Qual ertragen -- beging Übereilung -- mitten Nacht Wagen bestellen -- * * Weg -- 
  peinlich Lage vermehren -- unterwegs Kutscher zurufen -- Hofwagen Pferd vorzufahren suchen -- 
  bilden sogleich -- Mann -- spät Schlos abreisen -- bitten -- Furcht erkennen -- Kutscher dringendst -- Pferd antreiben -- 
  Wagen fahren indessen -- Herz klopfen neu -- Frau Mannes -- Dienst Fürst -- erkennen -- Gemahl * * folgen -- 
  enthalten -- Frau ihrigen vergleichen -- Mann Feldzug begleiten lassen -- zurückkehren -- Dienst Fürst folgen nötigen -- lassen Kind * * -- 
  bildschön Knabe -- Anblicke Luisen Gedanke einkommen -- Kind Vater -- Knabe -- 
  unangenehm Empfindung Reue -- töricht Befehl Kutscher geben -- vorzufahr -- Auge Frau ansehen geben -- elend Rangstreit suchen -- 
  ungestümst Wetter * * -- schicken Gasthöfe Nachricht Manne erhalten -- erfahren -- folgend erwarten -- 
  fürchten -- töricht Fahrt gehören -- strafen spät abreisen -- 
  fing Strom Träne Brief -- beten Gott -- Blachfeld weigern lesen -- Zimmer treten -- 
  dankt Vorsehung -- gelobt verzweifeln -- hört gerecht Vorwurf -- Blachfeld Reise -- geduldig -- 
  Unwille auslassen -- überreichen Geschenk bestimmen -- Vers Abwesenheit -- 
  scheinen erfreut überraschen -- rufen unwillkürlich -- 
  -- -- geistvoll -- -- 
  -- geben -- setzen schmeichelnd hinzu -- Sprache Götter reden -- begnügen -- Sterblicher danken -- -- 
  umarmen zärtlich -- Erbot -- Abend speisen -- 
  wissen Wirtshause versprechen -- zufrieden -- Herz gewinnen -- Gesellschaft Freund berauben -- 
  bleiben Kind -- Genoß glücklich Aussicht -- eröffnen scheinen -- legen -- Vorsehung dankend -- Schlummer nieder -- 
  selig Täuschung dauern -- 
  erhalten Gefolge Befehl -- Dienst zurückkehren -- glückt böse Geister -- unbekannt bleiben -- Herz Mann abwenden -- 
  bleiben Gasthofe -- sorgfältig Luise Wohnung einrichten -- Vergnügen sehen erlangen -- -- Gesundheit zulassen -- abend Gesellschaft besuchen -- versprechen wissen -- 
  bringen Haus -- Achtsamkeit -- Türe fahren -- lassen Wagen Straßeneck halten -- Bedienter bringen -- 
  Mensch Stadt fremd -- verfehlen schlecht Wetter Rinnstock -- fallen nieder -- Anzug -- Blachfeld Geschmack schmeicheln wissen wählen -- völlig verdorben -- bekommen ohnehin zerrüttet Körper Schrecken Nässe übel -- folgend Krank -- 
  Blachfeld erkundigt Gesundheit -- ungeachtet Unfall eigentlich veranlassen -- -- erbon -- Wagen Mutter Haus fahren -- 
  Luisen Geduld Sanftheit besiegen -- Wohnung beziehen -- 
  Eintritt deuten Luisen -- frühstücken -- 
  stehen -- bereiten Tee Kaffee -- erscheinen -- lassen wecken -- melden -- Frühstück bereit -- 
  antwortet Frühstücke -- Schlief fort -- Frau sagen lassen -- Frühstück Zimmer schicken -- gehorchte -- teilen Frühstück bedienter -- 
  Luise lassen Kaffee -- einsam traurig verzehren -- 
  Geschmack Essen suchen umsonst erraten -- schwer befriedigen -- ehedem einfach genügsam -- 
  Ausgabe Stück überstiegen -- entschloß Brüdern borgen -- Gefahr -- Abreise fasn -- Schuld bezahlen -- 
  Lohn Mühe -- hören Mann tisch Bedient sagen -- 
  -- essen Hund -- einladen -- -- 
  -- Bedient tragen hauptsächlich -- Lage kränkend -- 
  Leute äffen Herr Äusserunge -- Blachfeld Unachtsamkeit Frau Wirkung -- Mensch Ehrfurcht Auge setzen -- 
  auffallend Familiarität -- Blachfeld leben -- benehmen Luisen Mut -- Manne beklagen -- -- gewöhnlichst Dienst versagen -- 
  morgens -- Köchin Markt -- Blachfeld Tee fordern -- Feuer anmachen -- Kammerdiener Schande anrechnen -- 
  andermal Luise Auftrag bekannte -- Lust ausrichten -- stellen tun -- bringen -- Name Luisen Freundin -- höchst beleidigend Antwort -- 
  Luise kennen zweifeln -- sprechen -- erhalten feierlich Versicherung Bedient Haus blicken lassen -- 
  Blachfeld entschieden Verachtung Weiber äußern -- finden Bedienter -- Wagen steigen -- Luise ausfuhr -- 
  geraten peinlichst Verlegenheite -- 
  ausgang Schauspielhause verlassen -- fremd Leute Bedienten Wagen ansprechen müssen -- Haufen -- 
  Abend warten -- Hoffnung abgeholen -- schlagen verschiedenemal Begleitung jung Mann -- Verlegenheit wahrnehmen -- 
  Logen leer -- Licht auslöschen -- müssen Anerbiet annehmen -- ungeachtet kannt -- Name -- ihrigen wissen -- 
  Bedenklichkeit Wagen steigen -- -- ungeachtet regnen -- Fuß -- Begleiter Fremder -- verfehlen Weg -- Unruhe zurecht weisen -- irren umher -- 
  andermal Dame Log verlassen -- wartet Stunde -- Finsternis zwingen herauszugehen -- Haufen dringen müssen -- halten zweideutig Geschöpf -- 
  glücklicherweise * * * * * * erkennen -- nennen Herr -- bedienter liehn -- Wagen holen -- 
  -- Angst Kränkung ermatten -- Haus -- Manne klagen -- Türe verschließen -- finden Geleg heit -- Nachlässigkeit bedienter erwähnen -- lächelen -- -- pfiffig Bursche -- 
  zwingen Zufall -- Stück annehmen -- 
  kriegsgefährt Mannes einst -- geendigt Schauspiel -- ähnlich Verlegenheit treffen -- mitten Treppe bedienter suchen -- -- 
  -- Gott -- Frau geschähe -- Kerl zurechtweisen -- 
  Mann Respekt verschaffen wissen -- -- 
  -- Offizier bringen Haus -- Mann schlecht Aufführung bedienter aufzog -- Blachfeld ehrenhalber nötigen -- Ohrfeig abzustrafen -- Abend Geschenk vergüten -- 
  Mensch weigern aufzuwarten -- Mutter Bedienten bitten müssen -- auszufahren -- Tisch müssen Bedienung entbehren -- 
  nagenderen Kummer häuslichen -- interessiert Person Zeuge -- schließen Trost fremd Mitleid -- wehe -- Mißverhältni kommen -- einmischen -- Bitterkeit -- entstehen -- gründlich Versöhnung unmöglich -- 
  Luisen Gesundheit halten schmerzlich Auftrittre -- 
  Namenstage -- Mutter Familienfest feiern -- Luise gütigen Aufmerksamkeit gerührt -- Mann Gefälligkeit -- Hof wegzubleiben -- Fest teilnehmen -- 
  finden Abendessen krank -- Zwang verbergen -- Blachfeld übellaunig -- nötigen -- Gesellschaft -- Pferd Weg zweimal -- 
  ältest Bruder fühlen indessen Puls -- raten -- Arzt lassen -- 
  treffen -- gewöhnlich bezahlen -- -- Verdruß ersparen -- Ausgabe übernehmen -- fehlt nötig Summe Pistole -- Mann bitten vorzuschießen -- 
  Blachfeld behandeln hart -- schmollt folgend -- Luise äußer Gewalt antat -- Mutter schleppen -- Mittagsesse einladen -- 
  innigst Wunsch -- -- Ursache traurigen Verhältnis nachdenken -- 
  würdigst Verwandtinn -- Schwester verstorben Vater -- Rat geben -- Mann Liebkosung gewinnen -- Weibe -- gelieben -- herzlich gut Wille befolgen -- 
  hoffen -- Blachfeld übel Laune vorübergehend -- zärtlich Blick Hand reichen -- bieten Wange Kuß dar -- 
  traurig Hoffnung täuschen -- innig Ausdruck Gefühl Falschheit Künstelei auslegen -- 
  müssen Arm leiden -- -- groß Glückseligkeit kennen -- gelieben -- mißverstehen -- zurückgestoßen -- 
  Gefühl freilich führen -- Zurückhaltung Mann Liebe verdoppeln -- notwendig -- unerfahren rein Mädchenherz Punkt belehren -- schwärmerisch Delikates geraderen -- vernünftelnden -- einfach begehrend Gefühl Mann nachgeben -- 
  spät -- häuslich Mißverständnis unheilbar -- Bande Herz zerrissen unwiederbringlicher -- 
  äußerst schmerzlich Rheumatismus Folge Unpäßlichkeit -- werfen Brust -- Luise müssen Blasenpflaster gebrauchen -- Wirkung Reizbarkeit Körper unendlich leiden -- bitten Blachfeld bleiben -- schützt dienstpflichter -- 
  Rückkehr erzählen lachend -- artig Frau Kaffee getrunken -- Theestund herangekommen -- fortgewollen -- befinden -- spät Abends bleiben -- 
  Luise Jugendfreund -- vorzüglich Talent Vorlese besitzen -- Mutter -- Krankheit -- Erleichterung -- zuzuhören -- 
  Blachfeld lesen indessen -- verzeihlich Schwachheit Luisen äußern -- -- Mann sehen -- 
  Freude -- nachgeben -- opfert Umgang alt bekannte -- Vorwande -- -- 
  Luise Mann bitten -- vorzulesen -- stellen beschäftigen -- -- 
  stellen -- Frau einst Mutter bedauern -- -- antworten -- -- Fall -- verlassen -- gestern -- -- zubrachen -- Abends -- obgleich beständig Versicherung beschäftigen -- -- Karte spielen -- 
  Luise Brustkrankheit einsam danieder liegen -- hört benachbart Zimmer laut lesen -- bitten Tür lassen -- zuhören -- schlagen Härte -- Manne jeder Weib -- vorzüglich Gatte krank Frau -- unverzeihlich -- 
  Luise neigen -- Unmut -- Verweigerung Arzt bezahlen helfen -- dringend Geldverlegenheit zuzuschreiben -- 
  ereignet Umstand -- Irrtum benehmen -- 
  Blachfeld Abends -- heftiger Fluchen gewöhnlich -- Maskerade Haus -- 
  Luise erkundigt Veranlassung Verdrusses -- hören -- sechzig Pistole Tasche stehlen -- 
  bieten Schmuck -- Verlust -- nahe scheinen -- einigermaßen ersetzen -- lachend -- 
  -- geringste -- 
  dreimal Chatulle -- -- 
  Widerwille Weib steigen -- Zimmer verschließen -- nötigen -- Kinderzimmer -- einzig übrig bleiben -- einschließen bleiben -- schlafen -- speisen -- zuzubringen -- 
  Haus Bild traurigsen Zerrüttung -- 
  bedienter -- ungestümst Härte behandeln -- sein Herr bleiben -- untätig zügellosest Lebensart verstatten -- 
  Hauswäsche -- Leinenzeug -- Gerät -- verschleppen -- Gestohl -- verderben -- Luise -- Mann -- Ansehen Hausfrau berauben -- müssen Unfug Auge dulden -- 
  verlieren Woche Wäsche -- jahrlang bemühen Arbeit anschaffen -- 
  Luise Sanftmut -- Ergebung Geduld bewaffnet -- Kränkung verschlucken -- Beleidigung stillschweigend hingehen lassen -- tirannisch Blachfeld Betrag -- 
  überreden -- Opfer vergeblich sein -- 
  Karneval -- Nacht warten -- Geräusch Wagen Schlafe verhindern -- Vorbeifuhr bilden -- brächt Mann -- 
  schlagen Herz bang Hoffnung -- Türe halten -- geliebt Mann Haus Nähe wissen -- 
  Stunde bringen süß Erwartung -- ausgekleiden -- bedienter fortgeschicken -- Nacht sagen -- 
  Sorgfalt Kind fordern -- hinreichend Ursache geschienen -- abgesondern schlafen -- Verdacht -- Vorwand -- zahllos Ungerechtigkeit erleiten -- 
  Gruß -- Beschluß Tag -- einzig Glück -- sehnen -- versagen -- 
  Traurig legen nieder -- hoffen -- nächster -- 
  erscheinen -- Blachfeld -- anzukleid Haus -- Abend bringen peinlich Spannung vorig Tag -- 
  fehlen Tropfen Kelche Leiden -- Luisen unerträglich -- schüttet Freundin -- wohlmeinend Teilnahme -- sicherlich unvorsichtig rücksichtslos -- vollends hinein -- Tages -- gäbe Blachfeld Schuld -- Meister Verstellung -- -- heftig Leidenschaft Ehe bloß Komödie -- 
  Äußerung zerriß Luisen Herz -- 
  Erinnerung -- vormals lieben -- Täuschung -- 
  bemühen vergeblich -- Blachfeld Herz jeder zärtlich Gefühl unfähig -- 
  fast verzweifelnd -- eilt Kummer Mutter Busen auszuschütten -- 
  Frau -- Gram Luisen unglücklich Ehe -- Unbefangenheit -- Augenblick Beruhigung geben -- 
  antworten vielmehr -- Bitterkeit hingerissen -- 
  -- gewiß heftig Leidenschaft Heuchelei -- 
  wundre -- Gewahr wurdest -- 
  Träne schwimmend -- schwermütig Geschöpf -- Grade lieben -- 
  scheinen -- beten -- Fehler Wille -- -- 
  -- aufrichtig meinen -- 
  -- -- sehen -- Mutter -- rufen Luise -- 
  sehen -- geben Kind -- entreißen Hoffnung -- -- 
  zweitenmal Leben vergessen Unglückliche -- Mutter schuldig -- überlassen Ungestüm Schmerz -- 
  nachdenken -- vergiftet Herz kalt Überlegung fähig -- Ungrund Bemerkung Freundin einsehen -- 
  Blachfeld übrig Fehler schließen Falschheit -- jeder zusammenhängend Gewebe Falschheit -- 
  Ungestüm -- launig -- wankelmütig -- Herz fremd Rolle -- allenfalls übernehmen -- sicherlich ausspielen -- 
  Wahrscheinlich Freundin glauben -- Artigkeit bringen -- Frau -- unglücklich Manne leben -- auf Geratewohl böses sprechen -- berechnen -- Kummer Luisen bereiten -- 
  niemals -- Haus verlassen -- weder Ehre Nutzen verblendet Gatte leben -- Gram Demütigungen überhäufen -- 
  Blachfeld betrachtet Schlafstell -- 
  unbedeutend Vorfalle -- Luise Wille erfüllen glauben -- spei Wirtshause -- übrigen bringen auswärts -- Zimmer einschließen -- -- Gesellschaft -- erkundigen sorgfältig Luisen Magd -- Gefahr kommen Frau treffen -- 
  grausamst Kampf Entschluß -- -- doppelt Eigenschaft -- Mutter Gattin -- Natur -- Sittlichkeit Religion -- -- Blachfeld streiten -- einst Kirche -- Stärkung Leitung Gott erflehen -- 
  singen schön Lied zukünftig Leben -- 
  Sturm Seele Gedanke -- Lied erregen -- besänftigen -- Bitterkeit Blachfeld verschwinden -- innigwehmütig Gefühl Nichtigkeit menschlich Wunsch -- Hoffnung Plane Raum -- 
  erinnern -- -- einsamen Spaziergang -- Blachfeld Zurückkunft sehnen -- freudig Teilnehmung Fort schreiten -- Entwicklung Kind fehlen -- Lektüre denken -- Blachfeld lesen -- 
  wünsche erhören -- zurückkehren -- 
  Freude -- versprechen -- begleiten -- 
  Unmöglich Herz ewig verschließen -- Weg Herzen finden -- 
  -- beschließen -- Versuch wagen -- Zärtlichkeit entgegen tragen -- 
  Vorsatz eilt Gottesdienst Blachfeld Zimmer -- 
  Meinung -- Bedienter -- verhindern Hereinzukommen -- 
  Ergriff Hand -- unfähig sprechen -- überströmt Träne Gesicht -- Blachfeld fließen -- lächelen -- 
  bemerken lächeln -- freundlich Weisheit -- tröstend menschlich Schwäche lächeln -- zurückweisend Ausdruck verhärtet Herzen -- Empfindung Glücke bedürfen -- freuen finden -- desto besser Erfolg quälen -- 
  Blachfeld Genoß grausam Freude Weile voll Maß -- führen -- fortlachend -- Luisen Türe -- 
  -- -- -- rufen erstickt Stimme -- 
  -- -- gering Sorge -- -- 
  -- -- Mitleid -- -- 
  -- -- vornehmen -- Mitleid -- -- -- 
  -- Luise begreifen -- verborgen Verdruß müssen -- fühlen neu -- unzerreißbar Kette Schmerz Fehltritt -- sobald Eintracht vernehmen Ehe verbannen -- 
  traurig Folge gewiß Mangel Mitteilung -- Teil entgehen Augenblick -- Umstand besonderer Nachsicht böse Laune Ungerechtigkeit erfordern -- unwillkürlich Verseh -- leidend Teil -- Ungerechtigkeit empfinden -- 
  Luise fahren sanft fort -- 
  -- hoff Vorsehung Sinn ändern -- -- 
  -- unterbrechen -- 
  -- nötig -- -- fühlbar -- 
  Welt Mensch benutzen -- binden -- 
  anderer -- glücklich -- -- -- schließen Unterredung -- Luise letzter Hoffnung bauen -- gelingen Bemühung Herz erweichen -- Besitz Bestimmung Glück abhing -- 
  nunmehr deutlich -- Blachfeld Gattin wünschen -- leiden stillschweigend Vorwurf gereichn -- unerträglich anfehen -- 
  Scheidung fordern fallen indessen -- Luisen Mutter Alter -- versprechen -- vorteilhafter Bedingung erhalten -- gegenwärtig Umstand -- 
  Madame N. merkt Plan -- äußerlich gut vernehmen stehen -- Betragen Tochter aufbringen -- insgeheim bitten -- willig -- Kind Stelle Erbe einsetzen -- 
  Luise Hoffnung -- gewinnen -- entsagen -- -- wahrscheinlich Fall früh Tod -- alt -- Kind abhängen -- 
  freilich Einrichtung verlieren -- Gesetz Niesbrauch Vermögen zukommen -- 
  Entschluß müssen indessen nehmen -- 
  Blachfeld Dienstgeschäft Reise -- kurz Dauer -- luisen Hoffnung geben -- Entfernung Betrag milderen möchten -- 
  Wirkung Alter -- Abkühlung Leidenschaft erwarten -- 
  wenden -- -- Welt verlassen -- Gegenwart befreien -- 
  Aufsehen vermeiden -- besseres -- nämlich abzureisen -- Zurückkunft abwarten -- 
  sprechen Mutter -- Frau -- teilnehmend Grund fühlen -- bloß -- 
  -- Abreise widersetzen -- 
  wissen Fall versprechen -- wissen -- Zeugnis dienstmägde -- Haus Hölle -- begreifen -- ausgedaueren -- 
  zurückhalten -- bedenk -- Abwesenheit sterben -- 
  kennen -- wissen -- trostlos Würdest -- -- 
  -- Vorstellung Luisen öfters Vorhaben abgebrachen -- gelingen -- Blachfeld geschien -- Ausführung wünschen -- 
  wissen Kindermädche -- finden -- vertrauen gewinnen -- 
  bringen Stunde -- Luise Mutter -- müßig Augenblick Zimmer -- vertreiben -- Mädchen Herrschaft ausfragen -- 
  Luise wissen -- Blachfeld Punkt denken -- Grund -- Luisen Abreise wünschen -- unmittelbar Vorteil finden hoffen -- 
  schicken -- verdienen vieler Geld -- ohnehin ansehnlich Lohne -- -- Luisen Erlaubnis -- Leute Haus arbeiten -- 
  berechnen -- Herrschaft -- Blachfeld Abwesenheit -- Land -- außerordentlich Erwerb wegfallen müssen -- Luise hingegen verreiste Haus lassen -- jemals verdienen -- 
  versichern Luisen -- Mann lang Aufschub Vorsatzes erbittern -- Hinterbracht mehrere Rede -- Herz unglücklich Frau tief verwundeten -- ungeachtet Mädchen stellen glauben -- 
  Reise erfordert Vorschuß -- Luise Händen -- 
  Blachfeld vierzig Pistole Behufe versprechen -- Diebstahl -- neulich erleiden -- dienen Vorwand Wort zurückzunehmen -- 
  indessen Ausführung Plan Weg -- bequemt Schrift unterzeichnen -- bekannt Trennung fordern -- Publikum überzeugen -- verpflichten -- Frau gewiß Summe standesmäßigen Unterhalt -- Ernährung Kind aussetzen -- 
  Luise überlassen -- Summe niedrig bestimmen -- Einrichtung -- 
  betragen Punkt anständig -- Luise -- Herz -- geringsten Anschein Delikatesse Güte -- Hoffnung schmeicheln -- nochmals Anbot bleiben -- 
  Antwort verwunden auf äußerste -- Gegenwart bedienter -- Anwesenheit unerträglich -- schonend -- fremd Sprache bedienen -- hinzusetzen -- -- glühend Kohl -- -- -- 
  Ruhe -- Gewissen -- bereiten Luise Abreise -- 
  beleidigt Ruhe Eigenliebe -- Haß -- unglücklich -- verzweifelnd sehen -- 
  ergriff gut Zweck erreichen -- suchen Mutter entzweien -- 
  Gelang -- letzter Stütze -- einzig Trost -- Segen Mutter abzureisen -- verlieren -- 
  wissen -- Madame N. Luisen Kind Zärtlichkeit Großmutter lieben -- groß Schmerz losriß -- 
  bieten -- behalten -- Luisen Brüder gewinnen überreden -- Schrift -- Luisen geben -- Kind Rede -- Erziehung anvertrauen -- 
  Hauptursache Grausamkeit schützt Besorgnis -- Luisen Schwermut Kind Einfluß -- 
  bevollmächtigt Schwäger -- Fall Luise widersetzen -- Kind sogar Gewalt entreissen -- 
  Gewalt Mutter -- schwach leiden Entbindung Kind -- 
  Gewalt -- Bande zerreißen -- Natur -- -- unbegreiflich arbeiten -- 
  schwach Weib mißhandeln -- unnatürlich Mutter -- Zärtlichkeit strafen -- 
  -- Blachfeld schreiben Frau Billet -- Wille Absicht Kind -- verlassen Haus ehe übergeben -- Mut -- Zeuge Wirkung Grausamkeit -- 
  Luise Eröffnung Zettel konvulsivisch Bewegung ergreifen -- 
  Magd -- abscheulich Botschaft überbrachen -- Gesicht Hand blau -- Zunge wandelt Farbe -- gebroch Wort stammeln -- 
  -- Kind -- Kind -- -- -- 
  Augenblick Händen Räuber -- Luisen Mutter nämlich Abhol lassen -- 
  gewöhnlich vertraut Luise Haus fremd Aufsicht -- Einpacke beschäftigen -- Mutter schicken -- sagen lassen -- Mittag speisen -- 
  regnen stark -- Blachfeld Pferd brauchen wagen -- ängstlicher Ungeduld erlauben -- Ankunft Mittagsstunde bestellt Sänfte abwarten -- 
  eilen -- trotz stürmisch Wetter -- Fuß Straße -- stürzen Zimmer Mutter -- Fuß -- bitten -- flehen -- Zärtlichkeit Angst Eingabe rühren -- Kind bekommen -- 
  Umsonst -- 
  Madame N. hört Stimme Vorurteil Wunsch -- taub Fleh Tochter -- 
  lassen Luise Verzweiflung hinreißen -- 
  -- fallen -- rufen -- Glück -- lieb Neigung opfern -- 
  Kind neu Opfer -- -- 
  -- -- 
  fing hören -- bieten jeder Unterpfand -- Abreise Augenblick aufschieben -- eilen schwer erkämpft Schatze -- Kind Arm -- Wohnung -- 
  erwartet Blachfeld Zurückkunft -- Zustande -- beschreiben -- 
  Gedanke zerrissen Gemüt -- 
  Seite Empfand grimmigst Erbitterung -- -- Geschöpf Mensch Schaden gesonnen -- Schritt Leben -- Gefühl -- eifrigsen Haß verfolgen finden -- -- zerfleischen Reue Herz -- abermals wohlmeinend Mutter vergehen -- Reise -- ewig trennt -- Zorn laden -- 
  -- ewig Vorsicht -- rufen Angst Herzens -- kanntest Reinheit Absicht -- Konntest Umstand Verbrechen hinreißen lassen -- -- 
  Augenblick scheinen -- Gott quälend Reue erfahren lassen -- groß ersparen -- Abreise vorbereiten -- 
  Mutter verlassen -- bleiben -- begehen -- 
  Idee beschäftigen -- Blachfeld Magd sagen lassen -- Kind Reise mitnehmen -- 
  Luise glauben -- Auslegung göttlich Wille irren -- halten Willensänderung Gemahl Wink Vorsehung -- Vorsatz bleiben -- 
  Blachfeld Betragen fühlen tief -- enthalten -- nachher sagen -- -- Ruhe Leben unwiederbringlich zerstören -- Zustand stürzen -- Verzweiflung Mutter Wort ausstoßen -- verzeihen -- -- 
  Blaß zerstreut Haar -- müssen Bild bedauernswürdigst Kummer -- Blachfeld Herz menschlich Gefühl -- einseh -- einzig tröstend Wort notgetan -- 
  Stadt vergiften Schmerz vollends -- kaltblütig Bemerkung -- Auftritt Art -- Mutter -- 
  Gesichtspunkt -- Luisen betrachten -- verändern -- 
  Vorwurf -- Mutter eher beleidigen -- ehemals -- Monat mitten Familie leben -- -- -- luisen -- Liebhabersprach -- -- mehrere Freund äußern -- Luisen Geduld Ertrag Unaufhörlichest -- unerträglichst Widerspruch -- Seite Mutter bewunderten -- Festigkeit -- rühmen dürfen -- fähig -- 
  gehen -- 
  Luisen unermüdet Achtsamkeit Brüder eifersüchtig -- 
  -- dulden -- -- Brüdern gefallen lassen -- -- Luise antworten -- wein -- einst jetzig Kummer vorwerfen -- erwidern -- 
  -- -- niedrig schändlich -- 
  fehlen -- Betrag Familie vergessen -- Klage entfuhr -- 
  Mutter handeln -- wissen Tochter Schicksal Händen beruhen -- Rede Einfluß können -- -- 
  -- -- erscheinen Luise Ziel eigensinnigen Wunsch -- Erfüllung Pflicht ziern Verdienst -- -- verblühen leiden Krankheit -- Weib -- Mutter -- lästig Fessel -- Unglück Stoff Vorwurf -- 
  letzter Epoche traurig Geschichte eilen -- 
  Madame N. erfahren -- Blachfeld Luisen Kind lassen -- versichern Tochter -- Übereilung ganz Herzem vergäbe -- angelegentlich bät -- Leben unnütz Selbstanklage verbittern -- 
  Luise bringen Abend Füßen Mutter -- bitten Verzeihung -- dankt Güte -- erhalten neu Einwilligung Segen Reise -- 
  Abend rühren -- -- Heimweg Rückkunft -- ernstlich denken -- Verzeihung Mutter völlig verdienen -- Reiseplan allemal aufgäbe -- 
  befehlen -- Pferd -- nächster bestellen -- abzubestellen -- 
  Mädchen -- erwähntermaßen Luisen Abreise Vorteil finden -- wiederholen nunmehr Grund -- bestimmen -- Entschluß getreu bleiben -- 
  Luise hören schweigend -- schicken Alsdann fort -- Absicht -- Blachfeld Versuch wagen -- Lasse beruhigen -- 
  klopft Zimmer -- bitten Erlaubnis sprechen -- 
  freundlich Antwort flößt Hoffnung -- Vorsehung Vorhaben -- tugendhaftest Bewegungsgründe beruhen -- behilflich -- 
  Überzeugen -- Blachfeld unbedingte Unterwerfung gewinnen -- -- bitten Verzeihung -- fragen -- hoffen dürfen -- vergessen -- Reise entsagen -- seinerseits erlauben -- Dazwischenkunft -- Treue verdächtig -- sprechen -- 
  Blachfeld suchen Ungrund Verdacht Mädchen überzeugen -- bitten -- glauben -- Abreise wünschen -- Mädchen bleiben -- 
  -- bleiben -- Luise -- rechtlich Mädchen -- -- 
  Blachfeld fahren fort -- artigst Tone Frau sprechen -- Luise legen hierauf Bewußtsein nieder -- Weg einschlagen -- 
  folgend -- Delikatesse -- glauben -- -- gestrig Versöhnung -- täte -- sogleich Zimmer -- Bedenklichkeit teuer stehen -- 
  Blachfeld sprechen Mädchen -- Neugierd -- Tugend prüfen -- edl Bewegungsgrund -- Eifersucht Herrschaft -- Ruf leiden -- Frau Reise abständen -- allenthalben sagen -- getrauen -- Mädchen Manne lassen -- 
  Mädchen eilen weinend luisen -- beschuldigt -- gut Name Grund richten -- stellen -- -- fortkommen -- 
  -- -- Mann -- fragt Luise zitternd Stimme -- Mann -- Verdacht -- -- 
  Mädchen bejahen -- setzen heftig aufbringend Ding hinzu -- Luise völlig Fassung -- vorig Erbitterung zurückgeworfen -- neu abzureisen beschließen -- 
  Mann sehen -- 
  Schleppt erschöpfen Zimmer -- flehen -- -- -- 
  Betrüg -- 
  schlagen laut Gelächter -- 
  -- Glaube -- Madame -- Gewissen -- sobald Mädchen zufrieden -- -- 
  -- -- Blachfeld -- antworten Luise -- Maitreß -- schmeicheln -- Achtung besitzen -- 
  -- -- 
  schwäch Gattin verrien -- -- Magd verrien -- Mädchen offen Streit Weibe Name tragen -- Mutter Kindes berechtigten -- -- -- Abreise beschließen -- -- 
  Madame N. Vorgang erfahren -- muntert Tochter -- Ort verlassen -- Gegenstand Kummer erneuen -- 
  umarmt luisen -- losreisse -- Arm zurückkehren -- drücken Enkelin Herz -- 
  Kind erstaunt rührend Auftritt -- 
  -- -- blicken Kind -- -- fragt Madame N. betreffen -- 
  -- weinen sehen -- Mutter -- -- antwortet Luise schnell -- traurig Ahnung auszuweichen -- Gehör geben -- 
  verlassen Haus -- Stadt Jugendglück verblühen -- vernichten -- treten zweitenmal Weg Vater Geburtslande -- 
  Reise verschaffen Vergnügen -- Blachfeld Vater kennen lernen -- 
  Güte Achtung Haus empfangen -- finden liebenswürdig Greis -- lang Umgang Welt fein ehrerbietig Ton weiblich Geschlecht geben -- Beifall verfehlen -- 
  Luise Vater gewöhnen -- Mann ehren -- Achtung -- Aufmerksamkeit -- alt Blachfeld erweisen -- fließen Herz -- Liebkosung eigennützig Grund -- hoffen Einfluß Sohn -- 
  liebenswürdig Enkelin -- zuführen -- gewinnen vollends Herz -- 
  Augenblick Zusammenkunft kalt -- Luise erscheinen Verbrecherin -- tun Namen Tochter unwürdig -- alt Mann voll Freude Name -- 
  folgend verbindlich -- entschließen -- scheiden -- schlagen -- Sinnesänderung Mann abwarten -- 
  -- gewiß -- -- Tochter Wunsch einstimmen -- -- 
  -- stottert Blachfeld Schwester -- rot umarmt Luisen -- 
  Blick Grund Erröten entgehen -- 
  eifersüchtig gut Greis Zuneigung Wunsch -- Schwiegertochter behalten -- 
  ferner bestehen -- verschaffen sogar Gelegenheit -- heimlich fortzureisen -- 
  Stimmung Schwägerin -- Mädchen -- -- Jugendjahr hinaus -- jung Weiber preisen höeen -- Luise alt Blachfeld gütigen Vorschlag Freude annehmen -- 
  still ruhig Lebensart harmoniert gegenwärtig Gemütslage -- finden -- Schwägerin etwaig Kosten Aufenthalt entschädigen -- 
  beschäftigen Augenblick Projekt -- Stadt Schwiegervater leben -- Wohnung mieten -- Wirtschaft führen -- Schwägerin Rate ziehen -- schlagen benachbart Stadt -- Projekt ausführen -- 
  Luise lächelen ungeschickt Verschlagenheit -- antworten höflich -- ehe fremd Stadt niederließen -- B. -- schmeicheln -- verwandter Freund aufnehmen -- 
  denken -- luisen ankäme -- Stadt finden -- bloß freundschaftlich Seele -- 
  Schwiegervater -- Zug Luisen teuer -- 
  gewahr -- Grund zärtlichste Liebe Sohn -- packen Reisepult -- Blachfeld Brustbild zeigen -- -- 
  danken -- bitten Erlaubnis -- küssen -- 
  Luise fühlt Feinheit Betragen -- 
  -- -- antworten -- zuvorkommen -- -- 
  reichen Alsdann Bild -- rufen -- Arm werfen -- 
  -- Liebe -- verdienen Ruf Tapferkeit -- Zärtlichkeit -- -- 
  -- verdienen -- Herz zuwenden -- alte rühren -- 
  -- -- -- geschehen -- 
  Mitleid empfänd -- müssen wissen -- hindurch seinetwill leiden -- sagen -- kein Mensch Vorteil Absicht -- 
  Zeugnis unvollständig -- kennen -- -- 
  Blachfeld Schwester schütten Öl Feuer -- luisen versichern -- Bruder Gemütsart taugen -- Glück Frau -- sehen -- jung Bruder verheiraten -- sagen pflegen -- trät Fußtapfen Vater -- Weiber unglücklich -- Gegenwart Sohn Öfter rühmen -- worauf alt Freude hören schienen -- -- 
  Tod beweinen -- Trost -- Luise versprechen -- 
  erfahren Mitgliede Familie -- Blachfeld Mutter Engel Duldung Güte -- Tod alt Blachfeld heftig angreifen -- Krankenlager hinzustrecken -- 
  Ehe Luise Ziel erreichen -- für Reise stecken -- empfangen wohltätigst Beruhigung zärtlichen Brief Mutter -- 
  Schicksal scheinen nunmehr -- lang leiden -- Augenblick Frieden gönnen -- 
  Ort B. vermeiden -- Mensch leben -- Heirat -- Manne mißfallen -- Umgang erneuern -- 
  mietet Dorf -- still heit Lage Stimmung Hilfe -- 
  vortrefflich Mensch -- Zutritt Zirkel verstatteen -- heben Geist trüb Nebel empor -- versenken -- heit Bild Zukunft schwebten -- 
  -- Mutter Gottheit -- Leben weihen -- 
  Unaufhörlich beschäftigt Bild -- dacht Rückkehr -- Füße stürzen -- Kind Arm führen -- geliebt Mutter Fortschritt Enkelin freuen -- 
  schwärmen -- -- Blachfeld trennen -- Mutter Land leben -- Abendstunden Seite zubringen -- Erziehung Tochter beschäftigen -- 
  Stahl lieb Zärtlichkeit Blachfeld Brust -- 
  stellen -- versöhnen M. leben -- gemeinschaftlich Kind wachen -- gegenseitig bemühen -- finsteren Weissagung Schicksal Schande -- Mutter besuchen -- häuslich Frieden erfreuen -- Segen Kind enkeln teilen -- 
  kindisch Phantasie rufen Gericht -- Mutter liebsten aß -- denken -- zubereiten -- sann Person -- einladen -- Mutter Gesellschaft leisten -- 
  zufällig Umstand Gefühl -- jeder Opfer -- jeder erlitten Unrecht vergessen fähig -- Glück erreichen -- vorzüglich bestärken -- 
  Ankunft B. -- ehe Ort Aufenthalt bestimmen -- erhalten Besuch Mann -- ehemals nämlich Dienst Blachfeld gestehen -- väterlich Erbteil anbauten -- 
  erzählen -- glücklich Frau Mutter leben -- laden -- besuch -- Familie gefiel -- Kost treten -- 
  still -- einsam -- ländlich Aufenthalt Ziel Luisen Wünschen -- 
  eilt Ort sehen -- finden Geschmack -- 
  meisten rührt -- Bild -- alt Mutter häuslich Glück eheleut -- Mann Abschied Kriegsdienst -- entwerfen -- 
  Welt vergessen -- Welt bedürfend -- schränkt Freude zweijährig Kind -- Liebkosung streiten -- 
  Darstellung wünschenswerten -- ewig verloren Genuß -- erfüllen Luisen Herz Trauer -- 
  erinnern -- Blachfeld Heirat anbieten -- Dienst verlassen -- Land leben -- 
  halten jung -- Entschluß Reue befolg -- setzen Klugheit Ausführung spät Zeitpunkt hinaus -- verscherzen kostbares Glück -- 
  Besitzer jung -- stark -- Blüte Gesundheit -- gering Mißfalle Lebensart äußeren -- unterhalten Luisen Reiz -- beständig Gesellschaft Frau -- Annehmlichkeit ländlich Arbeit -- 
  Frau Eltern Besuch gehen -- folgend Entgegenreit -- heimzuholen -- 
  alt Mutter freundlich Luisen -- 
  -- wünschen -- Frieden Glück wiedergäbe -- Wert lebhaft fühlen -- -- 
  nämlich Augenblick Luise gütigen Wirt Abschied -- empfangen Brief Frau -- Freude zittern -- 
  -- Anblick vieler Zärtlichkeit führen allzutraurig Vergleichunge -- eilt Wagen -- jung Manne -- wiederkommen -- Frau Abrede nehmen -- 
  erfahren -- Brief -- vieler Freude empfangen scheinen -- Scheidungsbrief -- 
  Frau erklären -- Kind Eltern aufhalten -- umsonst bemühen -- Entschluß verändern -- 
  -- unterrichten versichern -- schildern Gemahl rechtschaffen -- wohlmeinend Mann -- -- hinzugesetzen -- Kriegsdienst verdorben -- tätig Mißhandlung -- untergebene züchtigen -- geben abzuschleifend Rauhheit Sitte -- 
  Unglücklicherweise vergessen Frau -- Augenblick Zorn -- ähnlich Betrag -- sobald Zorn verrauchen -- fallen Fuß -- Übereilung -- 
  -- fest Sinn -- stellen anfangs versöhnen -- verlassen -- Vorwande Besuch Eltern -- entschließen Haus betreten -- einerlei Behandlung Jagdhunde befürchten -- 
  Gesellschaft -- erzählen -- loben klug Standhaftigkeit Frau -- 
  Luise handeln -- denken -- Pflicht Frau geböt -- Manne schlagen lassen -- 
  Erfahrung Unglück demütig -- nachsichtig -- 
  finden Entschluß jung Frau hart -- fühlen verzeihen -- 
  Begebenheit bestärkt Wunsch -- häuslich Frieden Preis erkaufen -- 
  -- spät -- 
  fortan Preis erkaufen -- 
  schrecklich erwachen wohltätig Träum stehen bevor -- -- erhalten Nachricht Tod angebetet Mutter -- 
  Ratschluss Ewig -- Ruhe Freude Seele fliehen -- 
  Mühselig Sehnsucht Glück Frühling Leben -- Reue -- Strahl Trost Hoffnung -- Überrest aufzehren -- 
  fühlen -- eigentlich menschlich Geschöpf lieben -- Mutter -- 
  empfinden -- verschwinden Gedächtnis -- Unrecht -- jemals Mutter -- treten grell Farbe hervor -- verfolgt unablässig Vorwurf -- 
  erinnern unzählig Auftritt -- eingebilden -- Märtirerin Geduld Laune Widerspruch Mutter -- Gut Welt hingegeben -- Augenblick Füßen liegen -- Wort Verzeihung Lippe vernehmen -- 
  Natur Schleier umhüllen -- Mutter erfreute Schönheit -- 
  Umsonst begrüßen Lerche -- umsonst goß Nebel wallend Schleier Haupt waldig Berggipfel -- umsonst vergoldet Sonnenstrahl reichen Tal -- -- denken -- Auge -- Mutter schließen -- Freude genießen -- 
  bequemlichkeit Leben Last -- schön Reisewag -- Augenblick wünschen -- Wunsch verleiden plötzlich Erinnerung Mutter -- Wagen sehen -- 
  Gegenstand -- Gegende -- Ort leben Zurückrief -- schärft Verzweiflung -- 
  Heck wild Rose erinnern Weg Nähe Mutter -- -- -- 
  Weg -- Weg Erde -- führen -- Arm führen -- 
  Leben -- Kind geben -- Augenblick -- zubrachen -- ungenutzt verschwinden lassen -- zurückzurufen -- 
  Einsam wehmütig Entwicklung Kind -- Liebenswürdigkeit -- aufkeimend Geist -- -- -- Anbllck erfreulich -- -- 
  arm Weib -- Vorwurf -- fortan froh Eindruck empfangen -- 
  jeher Botanik lieben -- Vater Lebzeiten -- wider Wille Mutter -- angenehm Wissenschaft beschäftigen -- 
  Mutter halten -- weiblich Arbeit -- Lesen Schreiben einzig Kenntnis sein -- Mädchen bedürfen -- ungern -- Luisen Vater ansehnlich Gartenfleck einräumen -- Anleitung geschickt Botaniker selten Gewächse anbaute -- 
  finden einsamen Spaziergäng Blume wild wachsen -- Garten Mühe pflegen -- Anblick durchbohren jedesmal Herz -- verwünscht Neigung -- Mutter missfallen -- Verbrechen -- 
  befinden Gesellschaft Spieltische -- sitzen jung Dame -- Stillstand benutzt Spiel aufzustehen -- liebenswürdig Herzlichkeit -- müssen Augenblick krank Mutter besuchen -- 
  Wort treffen Luisen Gewalt blutig Vorwurf -- 
  abend Gesellschaft verleben -- Mutter fern krank liegen -- 
  Mühe -- Bewegung verbergen -- Träne drängen unaufhaltsam Auge -- müssen Gesellschaft verlassen -- 
  andermal begegnen -- Treppe Wirtshauses -- ältlich Dame -- rheumatisch Zufälle lähmen -- Mägden Wagen tragen -- 
  zärtlich Sorgfalt Mägde -- Herrschaft bequem halten -- Aufmerksamkeit -- Vorübergehenden anstoßen lassen -- durchbohrten Luisen Herz -- 
  Mietling emsig Liebe Pflicht ausüben -- Mutter versäumen -- 
  zureden mitleidiger Freund -- Grund kälteren Vernunft vergeblich -- 
  Herz klagen -- Mörderin Mutter -- Frieden Selig -- -- Reiz -- 
  Unglückliche Luise -- 
  Tochter Gattin unglücklich -- 
  Ruhepunkt finden umherschweifend Gedanke -- umsonst Lichtstrahl suchen -- Geist erhellen -- 
  wohin -- blutig Krieg -- Blachfeld Leben täglich Gefahr setzen -- Gegenstand Gespräch -- 
  müßig Neugier -- wahrer Mitleid -- heft Mensch Auge -- Kind -- Augenblick Witwe -- Waise sehen glauben -- denken -- gutherzig zudringlich -- trösten -- 
  O beneiden Fall Frau letzter Soldat Blachfeld Haufen -- Angst Gatte beschäftigen -- 
  verlören Unterhalt -- Liebe -- Trost -- Stütze Kind -- feindlich Kugel Treue treffen -- wissen -- Weib -- Kind -- letzter Gedank blutend Gehirn sein -- 
  schamröte hören Luise Teilnehmung fremd Mitleid -- ängstlich schlagen Auge nieder -- unbefang Gemahl fragen -- 
  wissen -- würdigen -- Anzudeut wohin Wunsch -- Gebet folgen -- fallen -- Weib -- Kind letzter Gedanke weihen -- tausend verscharren -- ehe öffentlich Gerücht zuriefen -- 
  -- Luise -- Gemahl -- Kind Vater -- -- 
  zerreißen Kind müd Herz -- rührend Liebe -- Andenken Vater bewahren -- Luise stets ehre gebieten -- 
  Erhalten Mutter gleichgültig Brief -- ergreifen -- wiederholt kindisch Leichtigkeit -- einst wohlmeinend lehren -- Brief küssen -- Herz drücken -- rufen -- -- Papa -- Papa -- -- 
  -- Verwaist -- Hand unerbittlich Tod -- Härte dein Vater Jammer Mutter verwaisen -- -- -- Mutter -- Gram langsam aufzehrt -- -- -- -- Brief -- 
  schreiben -- denken -- besitzen einst groß Glückseligkeit nennen -- -- 
  halten Luise Mittagszeit Wirtshause -- lahmgeschossen Soldat treten Zimmer -- bitten Almose -- Kind erblicken -- reichen arme -- rufen -- -- Papa -- Papa -- -- 
  Luise schauderen -- erkennen * * Uniform -- bemerken entfernt Ähnlichkeit -- Irre führen -- 
  Gerührt lassen alt Krieger sitzen -- Mahl teilnehmen -- lassen erzählen -- Mann sehen -- gefochten -- 
  Kind verlangen Soldat Schoß -- lehnen -- -- Ähnlichkeit Scheu fremd benommen -- Natur Scheinbild ergötzen -- 
  Soldat küßte Kind -- bedauern Blachfelden -- Freude entbehrn -- fern zärtlich Frau -- liebenswürdig Kind -- gefährlich Handwerk trieben -- 
  bieten Luisen -- führen -- -- Mann -- ruhig folgen -- sicher Zelt geleiten -- 
  Augenblick Luise Gedanke ergreifen -- fühlte versuchen -- eilen -- Kind Arm werfen -- zuzurufen -- 
  -- machen -- 
  verdrängt Erinnerung Grausamkeit Entschluß -- 
  zurückgestoßen -- verhöhnen -- Spott -- Mutwillen Gesind preisgeben -- 
  verleugnen -- Auge Kriegsgefährt -- gaffend Menge kund -- Bande Natur fesseln -- Stimme Mitleids rühren -- 
  Augenblick Luise überleben -- 
  unbekannt Einsamkeit -- Bilde Jammer Auge -- Erziehung Kind beschäftigen -- Augenblick harren Tod Blachfeld Rückkehr leiden endigen -- 
  Hoffnung -- müde Herz sprechen -- wehmütig Gesundheit sehnen -- Augenblick fürchten -- Blachfeld sagen müssen -- 
  -- -- Unglück lindern -- vorüber -- Seite Glück versprechen -- müssen einsam Grab sinken -- Frieden wiederzufind -- rauben -- -- 
  -- 
  schwarz Schwermut -- Geist umhüllen -- Glut -- langsam Blut auftrocknet -- scheinen Zeitpunkt hinauszuschieben -- freundlich Rettung spät -- 
  möge Zärtlichkeit -- Nachsicht -- Duldung -- Blachfeld unglücklich Weibe versagen -- Kind vereinen -- -- lieben Ehre -- erziehen -- 