Eduard Allwill Briefsammlung herausgeben Friedrich Heinrich Jacobi Zugabe Briefe est l ' effet -- -- vérité -- la repoussen -- mais -- repoussant La Voit -- & ell Penetre -- 
  Garat le Jeune -- 
  Band -- 
  Königsberg -- Friedrich Nicolovius -- 1792 -- 
  Though all things Foul Would Wear The brows of Grace -- Jet Grace still Log -- 
  Macbeth Act -- IV. Sc -- III -- 
  böse Ding Gestalt guter annähmen -- Gestalt behalten -- Esch -- über -- 
  Herr Geheimenrat Schlosser Karlsruhe -- 
  wider löblich Gebrauch Buch Rücken zuzueignen -- 
  -- Freund -- fast Betrachtung -- löblich Gebrauche halten pflegst -- Zeitalter Rücken sogar -- Kreuz -- hättest Pflicht -- Verwegenheit -- unschuldig Nachahmung hingehen lassen -- 
  besseres Statten -- 
  -- ebenfalls -- laufend Sitt löblichen Gebräuche zusammenhängen -- nahe treten -- rechtmäßig Abscheu empfinden -- 
  geschehen lassen -- Brief erdichten -- Hirngespinst ansehen -- 
  wünschen sogar -- mögen Hypothese gefallen lassen -- Glaube dergestalt Maß halten -- historisch erwiesen Wahrheit -- obwaltend Verlegenheit freiwillig annehmen -- notdürftig gelten lassen -- 
  hiermit Leser zugemuten zwiefach Gefälligkeit -- -- unwahrscheinlich Hypothese beizupflichn -- Hernach -- Gemäss glauben -- eigentlich verstand glauben -- zwiefach Gefälligkeit -- geneigtest Leser erwarten dürfen -- Vorteil fänden -- 
  ungeneigt geneigt Leser -- zeigen -- -- offenbaren Vorteil finden -- Willfahrung desto gewiß -- zugemutet zwiefach Mühe -- zwiefach Erleichterung finden -- 
  Hypothese unwahrscheinlich -- -- eigentlich verstand glauben -- vergüten -- -- eigentlich verstand glauben -- unwahrscheinlich Hypothese beinahe -- 
  Leser Vorteil Auge stellen -- weniger Wort Stande bringen hoffen -- 
  setzen Voraus -- Leser -- 
  Leser Zeitgenosse -- folglich geschworen Feind Dunkelheit -- 
  finden Absicht vorliegend Buch Dunkelheit umgeben -- 
  fragen -- 
  Eduard Allwill -- 
  Leben -- tot -- 
  leben -- 
  Leben -- halten -- 
  bekommen Brief Hand -- 
  bringen übrig Gewalt -- 
  Bekanntmachung -- 
  woher Verbindung Herausgeber -- -- 
  dergleich Frage Menge -- müssen unbeantwortet lassen -- teils Unwissenheit binden -- teils gegeben Wort -- 
  Leser -- unvermögend sowohl Absicht Herleitung Hinleitung Buches finden -- Sammler Herausgeber -- unzufrieden -- Gegenstand Frage verwickeln -- Sache Hand schlagen -- Wunsch Reine bringen -- 
  mitten Verlegenheit kommen Hypothese Hilfe -- gelingen -- einigermaßen wahrscheinlich -- erhascht Wahrscheinlichkeit gewiß Freude -- -- Herleitung Hinleitung geben -- sagen -- begreifen -- 
  schlagen demnach fort Leser -- Herausgeber Mann vorstellen -- zartesen Jugend -- Kindheit Anliegen -- Seele Blute -- bloß Atem -- fahren -- 
  Anliegen bloßen gemein Lebenstrieb Grund -- vielmehr Gedanke -- gegenwärtig Leben ewig fortsetzen -- gräßlich -- 
  liebt leb Liebe -- -- -- 
  -- Liebe scheinen unerträglich leben -- -- 
  Knabe Mann Schwärmer -- Fantast -- Mystiker -- Name -- -- sorgfältig Definition -- mancherlei neu Schrift finden behalten -- 
  Liebe rechtfertigen -- Dicht Tracht -- Wunsch -- Licht Gegenstand erhalten -- Wissenschaft Kunst Eifer treiben -- Hindernis ermatten -- 
  verzehrend Feuer tragen Jüngling Busen -- 
  Leidenschaft Affekt -- Seele Leben -- Oberhand gewinnen -- 
  -- Wurzel fassen -- müssen Saft holen bilden -- 
  geschehen -- philosophisch Absicht -- nachdenken -- Beobachtung Situation Augenblick bringen -- äußerst selten antreffen -- 
  erforschen -- suchen einprägen -- bleiben -- 
  wichtig Überzeugung beruhen unmittelbar Anschauung -- Beweis Widerlegung -- -- Dünkt -- bemerkt -- verglichen Tatsache -- 
  müssen -- Überzeugung mitteilen -- darstellend Werk -- 
  entstehen Seele Entwurf Werk -- Dichtung gleichsam umgeben -- Menschheit -- erklärlich unerklärlich -- gewissenhafte Auge stellen -- 
  erbaulich Schöpfung -- moralisch Geschichte Erfahrung -- philosophisch Instinkt sinnlich vernünftig Natur -- Werk -- nenn Instinkt Energie -- Art Weise Selbsttätigkeit -- womit Gattung lebendig Natur -- Handlung eigentümlich Dasein anfangend alleintätig fortsetzend denken -- ursprünglich -- Hinsicht erfahren Lust Unlust -- bestimmen -- 
  Instinct sinnlich vernünftig -- d. i. Sprache erzeugend -- Natur -- fern Natur bloß vernünftig Eigenschaft betrachten -- Erhaltung Erhöhung persönlich Dasein -- Selbstbewußtsein -- Einheit reflektieren Bewußtsein mittels kontinuierlich durchgängig Verknüpfung -- 
  -- Zusammenhäng -- -- Gegenstand -- folglich -- befördern -- unaussetzlich richten -- 
  hoch Abstraktion -- vernünftig Eigenschaft rein absonderen -- Eigenschaft -- betrachten -- Instinct bloß Vernunft Personalität -- Ausschließung Person Dasein -- Person Individualität verlangen -- notwendig wegfällen -- 
  rein Wirksamkeit letzter Instinkt -- rein Wille heißen -- 
  Spinoza Name -- Affekt Vernunft -- 
  Herz bloß Vernunft nennen -- 
  glauben -- Indikation philosophisch nachgehen -- mehrere schwer erklärend Erscheinung -- unstreitig vorhanden kategorisch Imperativ Sittlichkeit -- Vermögen Unvermögen -- vollkommen begreiflich finden lassen -- 
  Funktion Sprache unser Urteil Schlüsse -- Instanz -- schwer enträtselnd Wortspiel beruhen -- Irre mutlos -- 
  ausgelass Philosoph -- erklären können -- verschwieg Moralist -- allerhöchster Einfluß leugnen -- Mann verdrossen -- Licht -- worin sehen -- -- sehnt -- allerhöchst Willenskraft Mensch -- menschlich Herz -- vertrauen -- Mangel Gabe -- Kopfe -- 
  sammelt Werk Liebe -- Ausführung entfernen -- 
  alt -- Vollendung Plan denken -- gewiß liefern Band -- höchst wahrscheinlich -- 
  Band -- Johanni erscheinen -- klug Mann geraten -- enthalten Epoche Clerdon Abwesenheit -- ankündigen finden -- 
  innerer Wahrscheinlichkeit Hypothese -- Hauptsache -- zufolge pragmatisch Absicht -- 
  äußerer Wahrscheinlichkeit außen -- Instanz -- bewirken suchen -- folgen -- 
  angeblich Herausgeber wirklich Verfasser Buch -- ehemals erschienen Brief Sammlung verändert Gestalt -- erblicken -- erhalten -- -- Gefallen -- dergestalt verändern -- 
  stoßen Zusatz -- Lücke -- überall blicken geschäftig Hand hervor -- Scheu tragen -- Brief -- Eigentume schalten -- 
  Hiergeg eingewenden -- 
  Brief -- erstenmal erscheinen -- ehemals -- zwingen -- Brief -- Herauszugebe bewegen lassen -- verändern -- nötig -- weggenommen hinwiese -- Abwesenheit unmöglich machen -- 
  verdrießlich Arbeit geschehen -- verdrießlich Arbeit geschehen pflegen -- Abschrift fehlerhaft -- 
  demnach Wahrheit zuwider -- seicht Kritik verraten -- gemacht Veränderung ansehen -- Gegenteil weggeschafft Veränderung sein -- 
  blöd -- Einwendung Übergewicht Wahrscheinlichkeit -- wodurch Instanz entkräften -- geradezu abzusprechen -- 
  Gewicht Instanz Zugabe -- Zugabe Bande Allwill Briefsammlung -- Schreiben Erhard O * * -- Hand -- vermehren suchen -- 
  Frage jedwed -- Familienähnlichkeit Schreiben Erhard O * * Briefe Allwillisch Sammlung leugnen unterfangen -- 
  schreiben philosophisch Inhalt -- philosophisch Einrichtung -- Angriff außen bequem -- Verteidigung außen -- Feind Freund beliebt gelitten -- 
  fehlen gut Einrichtung -- 
  sagen -- fehlen -- Stück Allwillisch Sammlung -- Reißaus nehmen -- 
  bestehen -- -- Zugabe annehmen -- 
  hiermit glauben -- unternehmen -- vollbringen -- Leser Frage -- beruhigen -- vollkommen Maß -- zerstreuen -- 
  überlass Zerstreuung -- schließen Vorrede bekannt -- erwogen alt Reim -- reichen Schatz Trostes -- Autor -- Leser enthalten -- Wort verändern -- Leser Autor setzen -- Leser -- gefallen -- 
  Leser -- gefällst -- 
  Allwill Briefsammlung -- 
  Natur schön Form sprechen figürlich -- Auslegungsgabe Chiffrenschrift moralisch Gefühl verleihen -- -- -- 
  bloß Reiz Farbe Tön nehmen gleichsam Sprache -- hoch Sinn enthalten scheinen Natur nah führen -- Kant -- Cr -- d. Uk -- S. 168. 170 -- -- 
  Urbild Tugend -- schön -- bilden -- bleiben -- -- 
  Schatten -- Wahn erzeugen -- wissen -- ewig -- -- 
  Goethe Tasso A. II -- Sc -- 2. ΗΑ Ολυμπος ηυλει -- Μαρσυου λεγω -- τουτου διδαξαντος -- τα ουν εκεινου εαν τε αγαϑος αυλητης αυλῃ -- εαν τε φαυλη αυλητρις -- μονα κατεχεσϑαι ποιει -- και δηλοι τους των ϑεων τε και τελετων δεο μενους -- δια το ϑεια ειναι -- 
  Plato Conviv -- ed -- bip -- X. p. 257. Einleitung -- 
  Syllie -- geboren Wallberg -- stammt alt Patrizisch Familie C -- 
  fünfzehn alt -- verlieren Mutter -- gemein Erdenlebe gebären -- fühlen -- beide Herz namenlos Liebe sproßen -- 
  Vater -- unglücklich Leidenschaft Wahnsinn foltern -- begrub nachher Kartäuserkloster -- -- folgend Brief schreiben -- leben -- 
  Syllie geraten Bruder Vormundschaft -- verwirrt Lage -- Herz wund müssen -- 
  alt -- Gefährte Kindheit zarteren Jugend -- August Clerdon -- wiedersehen -- heftigste Liebe empfinden -- feurig Mann -- Geistesgabe -- unstät Sinn -- 
  Verbindung stand -- Syllie ziehen eh -- Mann ansehnlichst Stelle bekleiden -- 
  Bruder -- Heinrich Clerdon -- Regierungsrat C -- 
  Schweiz gebären -- Kind Vater Deutschland versetzen -- 
  Syllie ahnden -- August vielerlei Weise unglücklich -- Herrliche jung Manne reißen -- 
  nachher sterben mitten Verwickelung niederträchtig Treulosigkeit angesponnen Rechtshandel -- völlig Zerrüttung äußerlich Glücksumständ drohen -- 
  Witwe -- Vermögen -- Gefahr -- müssen Rechtshandel -- schlecht Mensch unterstützen -- schlecht Mensch fortsetzen -- eh bleiben -- Ort -- gelieben -- desto zuwider -- Seele C hing -- -- Erde fesselen -- beisammen finden -- 
  einzig Kind -- gebären -- Vater nachgefolgen -- 
  beikommend Brief schreiben -- alt -- 
  Amalia -- Brief -- -- denken -- erscheinen -- Folge Sammlung -- Heinrich Clerdon Gattin -- Lenore Clärchen Wallberg -- -- Schwester -- Name zuweilen Erwähnung geschehen -- -- Sylli leiblich Kusin -- 
  Person -- verschieden Periode -- zubrachen -- lieben -- betrachten -- äußerer -- innerer Verhältnis eng bunt -- Geschwister -- 
  Eduard Allwill voraus erinnern -- überflüssig -- 
  Druckfehler -- S. 11 Z. 1 leisen -- -- 
  35 -- letzter L. st -- -- -- 39 -- 1 L. Alsdann st -- Alsdann -- -- 
  57 -- 15 L. gut st -- -- -- 79 -- vorl -- L. bleiben st -- bleiben -- -- 91 -- 7 l. chauve-sauris st -- Chauvesouris -- 99 -- 4 l. Schoß st -- schoß -- -- 
  103 -- 14 L. st -- -- -- 115 -- 5 v. u. L. Geist st -- Geist -- -- 118 -- 8 v. u. l -- 
  st -- -- -- 119 -- 8 L. st -- 
  -- -- 121 -- 2 L. st -- -- 
  * -- 165 -- 4 v. u. L. st -- -- -- 170 -- 5 u. 6 v. u. L. st -- -- -- 171 -- 4 v. u. L. st -- -- 
  * -- 221 -- 2 L. weich schwachherzig st -- weichschwachherzig -- -- 316 -- 3 v. u. L. Shakespeare st -- Schakesspear -- I. Syllie Clerdon -- 
  6t März -- 
  -- Freund -- öd -- setzen sonderbar Gemütsstimmung -- tadeln -- wofür Name weißen -- Fester -- 
  nennen -- weder Milzsucht -- Trübsinn -- Menschenhaß Menschenverachtung -- -- wozu Roman Schauspiel Deutung holen lassen -- Herz warm kalt -- Seele zugeschlossen -- 
  Clerdon -- andermal -- diesmal hören -- gestern Zutrug -- 
  geraten Stunde Bett sterbend -- 
  bekannt Tante Moßel -- -- stehen eigentlich persönlich Verhältnis -- alltäglich Geschöpf -- dumpf Sinn -- Arge -- 
  leiden Sterbebette -- 
  Genesung schrecklichst Operation versuchen -- 
  stehen gelassen -- 
  Fassung Temperament -- schlicht Fortsetzung Leben an -- 
  Stiefkind -- -- stehen Bett -- nah Mann -- bloß Gewinn Gewerbe -- 
  weinen schluchzten ernstlich -- gewiß -- Clerdon -- Trauer Herzen -- 
  Grund -- -- 
  Reue -- Erkenntlichkeit -- armselig Scheu Befremdung -- -- Bangen Bilde Todes -- -- 
  O gleichen widerlich -- 
  sitzen kalt -- körperlich peinigen körperlich leiden kranke -- sympathisieren -- 
  geistliche hinzu -- beginnen Geschäft -- 
  versicheren -- Frau zagt Zukunft -- minde Seelenangst -- Dahinsterben Kraft -- Lebensermattung preßt Brust -- jedesmal Zuruf -- Spruch -- Ver Liede -- 
  ohnmächtig Organe marternd Gebrauche anfing -- mild Hand Todes bewaffnet -- Seele wehren -- still Sanft hinweg scheiden -- -- 
  O Wust Welt -- 
  verstorbener Klage -- Wein -- Meinig -- Trost bange -- wissen -- Hochbetrübt -- Gattin -- Mutter -- Freundin -- Leben entbehren -- 
  -- klar vorschweben -- mitten Haufen -- Teilnehmung -- -- -- Innerst Wesen erschüttern -- unerträglich Gedanke -- 
  -- Name -- Mensch zerren -- Schlinget -- -- 
  Quell Strom Meer Gesellschaft -- woher -- 
  wohin -- -- 
  sehen finster Höhle -- Kessel -- worin Macbeth Hexe allerhand Stück Tier Mensch -- Froschzehe -- Wolfszahn -- Fledermaushaar -- Judenleber -- Türkennase -- Tartarlippe -- Ding sammeln -- Werk Name bereiten -- kochen koch Zauberwese -- gemeng Fantom hervorgehen -- erschein -- erscheinen -- erscheinen -- Schatten -- verschwinden -- 
  grotesk Rundetanz -- herrlich Musik -- bezaubert Luft -- -- gut -- vollständig Lustbarkeit -- 
  abenteuerlich -- fürchterlich -- -- 
  Grausen lachen -- anstieß -- 
  -- Clerdon -- -- bunt hölzern Jahrmarktspuppe -- Rumpf Rock Klötzchen -- arm -- Fuß -- Kopf geleimt -- Brettche -- stehen -- 
  Gespenst -- -- 
  II. 
  Syllie Clerdon -- 
  7t März -- 
  Bette -- 
  sonderbar schön Licht -- heller umgeben -- treiben Kabinette Zimmer -- weit Aussicht Gebirge -- 
  fahren Anblick -- bleiben unbeweglich Eingange Gemach -- 
  fesselen -- still Glanze -- weit Himmel -- unüberschaulich -- unaufhörlich Verwandlung -- sichtbar Wechsel -- Bewegung -- 
  treten Sonne nah -- fahren Hügel herauf -- Höhe fahren -- -- Clerdon -- selig Augenblick -- 
  sehen -- Sonnenaufgang -- heutigen -- Frühling Anbeginn -- Anbruch Jahr -- Lichtstrahl groß Schöpfung -- Schöpfung einzeln Tag -- 
  müssen heraus Gemäuer offen Welt -- 
  Sophie -- anrufen -- begleiten -- 
  Welch Spaziergang -- 
  Himmel rein -- Luft sanft -- Erde lächelnder Angesicht voll Trost Verheißung -- Unschuld Fülle Herzens -- 
  wunderbar auffassen -- Blick milden -- segnend -- 
  unvermerkt zuversichtlich Geschöpf -- Wonne Gottes-Welt Schönheit -- voll Hoffnung Herzen -- 
  -- voll Hoffnung -- be Clerdon -- wissen -- hoffen -- -- schön -- 
  lieb Verworrenheit -- Dämmerung -- -- Unglaube wach stören -- 
  nossen -- 
  frei Himmel Sonne untergehen sehen -- 
  nehmen unser Weg Wall -- 
  verweilt Ort -- spät Herbste stehen -- weit mannigfaltig Aussicht entzücken warst -- 
  -- Sähe -- -- -- 
  Frühlingshauch wehten -- stellen Seite -- 
  O herrlich -- schön -- 
  lassen ansehen -- begeben weg -- 
  Stelle -- lang -- breit Weg Ecke S * * sehen -- 
  -- -- -- Clerdon -- Weg -- -- 
  -- -- 
  erinnerst Lage -- unabsehbar Fläche -- -- Auge hemmen -- Weg -- breit -- -- hinrollen -- -- 
  lassen nahe -- Stadtmauer -- Instrument hören -- 
  Flöte Harfe -- vortrefflich Melodie einfielen -- begleiten fortführn -- 
  lassen -- lassen -- Auge naß -- 
  Sophie warten Freundlichkeit -- 
  Stöckche lehnen bleiben stehen -- laufen hurtig Haus -- -- Nacht -- Clerdon -- 
  Amalia -- Schwester -- Nacht -- 
  Poststation C -- 
  III. Clerdon Syllie -- 
  4t März -- 
  Solltest wissen -- lieb Syllie -- Stunde zubringen -- -- schreiben -- 
  Brief schreiben -- Brief schreiben -- dauern lang -- 
  sitzen halb Stunde -- Stunde Feder Hand Blatte -- nachsinnend -- Trost fände -- Trost beikämn -- 
  weniger Zeile 28. Februar -- einliefen -- zeug Beklemmung -- ergreifen Herz zusammengepreßen -- Angst Rat wissen -- entschließen -- Amalie Brief vorerst mitteilen -- 
  folgend -- März -- Brief erhalten -- worin flehentlich bitten -- möchtest Zurückhaltung ergießen -- dein Gemütszustand -- erklären wissen -- legen -- 
  Unfall begegnen -- -- erfahren -- verborgen Widerwärtigkeiten Grade niederschlagen -- augenscheinlich -- 
  woher sinken fürchterlichst Gattung Schwermut -- Charakter widersprechend Zag -- tötend Unglaube Liebe -- Freundschaft -- Menschenwürde Weg bahnen -- 
  Welt -- Ton verhallen -- fühlen -- glauben -- fühlen -- 
  drücken verwunden -- Verzweiflung hemmen täglich Geschäft Leben Beruf -- Hoffnung Besserwerden -- Einrichtung bleiben -- 
  -- Peinigung brav Mann -- nehmen -- 
  Fähigkeit verwandeln -- Eigenschaft fruchtbar -- Dummheit -- Niederträchtigkeit Bosheit umzingeln -- anfallen -- bedrängen -- 
  halten Geist Grimm empor -- 
  niederwerfen -- richten Höhe -- unterstützen -- Haltung -- 
  Schwester -- Freundin -- hold lieb Syllie -- -- 
  Raffe -- -- -- Hilfe finden -- -- -- 
  O -- vermöcht -- innigst Gefühl hierüber Wahrheit darstellen -- 
  gute Wissen -- -- -- 
  -- Syllie -- Himmelskind -- versinken Jammer -- könntest versinken schrecklichste Trostlosigkeit -- -- -- Vortrefflichkeit hoch Genuß -- Syllie fühlen elend -- -- 
  -- Engel Gott Angesicht -- selig -- -- 
  Syllie -- müßtesen Herz schauen -- schauen -- müßtest dein Busen aufnehmen -- empfind Trauer -- -- Trost -- -- 
  IV. Syllie Clerdon -- 
  8t März -- 
  gestern vorgestern schreiben -- Clerdon -- dein erhalten Brief Stelle beantworten -- 
  Wüßtest -- ängstigen -- Sorge -- Kummer meinetwegen -- 
  glauben -- gut Leute -- glauben -- übel -- vorstellen -- 
  schön Natur -- schön -- -- 
  wißen -- menschlich Freude innig kosten -- euer Syllie -- 
  Liebe glauben -- -- Brust engen -- 
  Hyazinthe -- 
  stehen -- klopfendem Busen -- sog Wesen Sinn -- Nerv durchbeben -- schön -- lebendig -- -- nennen Torheit -- Unsinn -- Schwärmerei -- Gegenliebe fühlen -- 
  pflegen Dinges -- Wohltun unmittelbar ausgehen -- Gestalt Geist -- Lied -- Harmonie -- Gemälde -- wollen -- 
  halten -- leihe Herd Feuer -- Ruhe -- innerer Wesen -- -- schön -- Wohltun strömen -- Leben empfangen Liebe -- 
  -- untergehen -- Blick Vereinigung Zuwarf -- Leben Leben -- untergehen -- daure -- 
  hiermit freilich Verletzung bloßgestellen -- empfände -- 
  Dumpfheit -- Achtlosigkeit -- Geringschätzung -- Flüchtigkeit Mensch -- ärg Schmach vorüberrauschend Entzückung -- treffen -- verwunden -- 
  Seite angefochten -- Hand wider -- Hand -- schwören -- wider -- 
  sehen Liebe Mensch -- 
  rosenwangicht Mädchen -- erquicken -- begegnen -- 
  -- wandelen Frühlingszeit Blütenreg -- 
  voll Mut -- voll Lust -- Hilfe rufen -- 
  hängen arme -- Hals -- entlad Lippe -- lassen schuldlos Auge Zauber finden -- womit vergessen -- 
  Wonne drücken Herz -- fast Liebe -- dauernd Liebe -- 
  sehen -- treiben ich_es hundert Ding -- lassen -- -- -- 
  werfen Boden -- tret Fuß -- aufspeichern Mensch Gunst Achtung -- 
  sehen -- -- dergleichen dauern -- erwarten -- überfällen Schwermut -- Zag -- vergehen -- 
  warm außen Herz anfühlen -- scheinend -- dünken alsdann Tiefe kalt -- 
  -- -- Anwandlung Vertrauen -- Freundschaft Seele Trauer- Schreckengedanken -- hell -- Wiedererscheinung längst entwichen Engelsgestalt -- Schoß Totengerippe -- 
  -- 
  Clerdon -- Amalia -- Schwester -- zürnen euer Syllie -- 
  wissen Geschichte -- -- wüßten -- offenbar -- tief fest verschließen liegen -- -- 
  reden -- zeugen -- Schuld -- -- 
  zaghaft -- weichlich -- denken -- Schmerz -- Träne ersparen -- bringen Anschlag -- Liebe -- 
  Voll Mut -- voll zutrauen -- Glaube unbeweglich -- dulden -- wagen -- -- 
  -- -- -- 
  Half -- -- 
  verdorren -- Baum Laube Gefilde Jugend -- sinkend Blumenbeete verheeren -- 
  O unvergiftet Pfeil -- Freund Hand eu Herz fahren -- lächelnd umkehren -- voll Unschuld fragen -- 
  Schmerz -- giftig -- 
  wider Gewalt bös Tücke brauchen -- Verderber -- -- sachen abfielen -- zeitig geworden Frucht abfallen -- Baum lassen -- Fülle hinweg -- 
  hören -- Blitz zersplittern -- abgehauen -- 
  ausgesogen -- Äste Blatt -- 
  Stamm erhalten -- Äste verdorren -- Blatt verwelken -- 
  O -- Auge wehren -- umher schauen -- wissen -- wohin abwenden -- weg traurig Einerlei menschlich Lug Trug_es -- 
  wahr Jammer -- Leute fordern -- erwarten -- hoffen -- Brüdern zutrauen -- geben nehmen -- 
  Sonne bringen unsterblich Liebe -- unsterblich Freundschaft Welt -- wissen -- Abend -- dreimal geschehen -- ehe Hahn krähet -- 
  meister dauern gut Seele -- -- fortgeschlendern -- Kindesbeine -- Sache gewiß glauben -- Schicksal -- Grab sehen -- Stürme trotz bieten -- -- unversehen Grund segeln -- -- armseligsen Grille -- scheitern liegen -- Rettung -- 
  -- selten Geheimnis Schicksal verstehen -- 
  Bild menschlich Tuns Sein -- sogenannter Laufbahn -- Seele -- ärgerlich -- richtig Bild -- Gang Krahne -- 
  zugeschlossen Auge rennen vorwärts Rade -- freuen zurückgelegt Bahn -- wissen Torheit -- Jammer -- merken -- dicht Rücken empor steigen -- neu Haupt -- Stirn -- Tritte -- 
  hiervon reden -- hellsten einsiehen -- -- Rade stillen stehen bleiben -- auslacht -- beseufzt -- -- -- 
  O -- schlimmsen dran -- 
  hingeran -- -- 
  Wille -- 
  Wille -- schaden -- 
  wißen -- tausendmal -- Not Augenblick -- Vorstellung übergehen -- groß fühlen -- lassen -- euer Syllie Grund Welt schlimm -- 
  Glaubet -- glauben Wort unser lieb Primrose -- 
  -- dunkelst Gegenstand -- nah treten -- erhellen -- Auge Gemüt bequemt trüb Lage -- -- 
  führen Clerdon Vers Mund -- 
  -- Zustand hart -- Chor still Freude -- Gesellt mitleidig -- -- O Glaubet -- glauben -- Zeuge -- wissen -- Dorn betten -- gut Rast erquicken -- 
  freilich sagen -- Herz Mensch -- -- gewiß -- hängen Nerv -- 
  erwehren -- Kind lieben -- sicher -- erwarten -- Mensch -- 
  -- hübsch -- munter Junge -- drücken -- küßt herzen -- lassen -- -- vortrefflich Mann denken -- verbergen -- 
  -- bloß Kind ziehen -- gegenwärtig Augenblick leiben leben -- lieblich anschauen -- süß Mund -- freundlich -- blickend Auge -- hüpfend Glied -- Leib Leben -- Nerv eurig Triller schlagen -- 
  wißen -- Zuneigung Naschereie Spiel erkaufen -- Genießet minder herzlich Wohlgefall -- 
  trauern -- zürnen -- anderer glänzender Geschenk höherem Tanze ablocken -- -- Bah -- schilen -- geradezu eurer müde -- Laune lang unterhalten -- Begierd erfüllen konnten -- 
  erstaun -- Bemerkung -- erwachsene alt Kind -- meistens -- -- verachtenden bitter Miene -- Behuf Lieblosigkeit anbringen -- zuverlässigste Lebensbalsam scheinen -- 
  -- hell Wonn -- Mensch lieben -- Eitelkeit -- Anspruch -- lauter Liebe -- 
  rein Herz -- Herz mächtig -- -- 
  O lassen -- lassen schweben Limbus -- vollenden -- 
  V. 
  Clerdon Syllie -- 
  8t März -- 
  Liebste Syllie -- schriebst -- 
  zerbrech Kopf -- Amalia -- Nichtchen -- Weise -- 
  nächster Sonnabend sicher Brief -- wissen -- lässt jung unbeantworten -- 
  Fall -- Herz angehen -- groß Zuverlässigkeit -- -- voraussagen -- Syllie straucheln -- 
  seufzest stark Glaube -- 
  Solltest -- lieb Syllie -- Reihe schlängen -- Frühling umtanzen -- 
  unwiderstehlich Wonn gestrig Tag mußt fühlen -- 
  Durchdrung -- lagern Gebein -- 
  -- Jüngling -- fromm Mädchen Auge Seele voll Liebe Hoffnung trinken -- froh -- heimlich -- Busen -- 
  Früh -- 
  erwacht sanftest Dämmerung -- finden aufrichten -- arm Freund -- unerwartet wiederseh Schlummer küßen -- 
  strecken arm Liebenswürdig -- irren -- finden -- finden -- schaffend Aufgange -- -- 
  Musik Auge zweifeln -- Morgenrot sehen -- 
  Engelsgesang schweben Tön Seele -- 
  wissen -- Sinn empfinden -- 
  -- 
  Augenblick -- erreich Gegenwart -- überwandelt mich_es -- durchschaudert mich_es -- tief Brust beben -- tief innig -- geheimst Busen auflösend beben -- Erdensohn töten -- 
  Tod -- schön -- himmlisch Jüngling -- 
  verwesend Teil entlad -- fliegen arme -- sinken Schoß -- -- -- -- -- -- -- kosten Allmacht -- Schöpfung -- ewig Bleiben Liebe -- -- 
  -- Syllie -- zurückkehren -- müssen -- 
  dennoch herrlich -- schön Leben -- 
  Blick Sonne -- Auge umh verbreitet herrlich Gegend niederlenken -- Erde wiedergeben -- schoß lichtschnell Seele Strafgedanke -- welcher sündlich Wesen -- herrlich Pracht Gott Wall Graben beschielen -- Abend vorbei hinterher schleichen -- 
  wehren -- hinein lagern Herrlichkeit -- anzukleid Pracht Gott -- genießen seinig -- weit offen Himmel -- offen Erde -- 
  raffen -- ziehen hinaus voll Sonnenglanz -- wandeln -- Besitz Acker -- Wiese -- Bach -- Wald Strom -- Höhe Tiefe -- Himmel Erde -- 
  Hügel -- Ziel -- gelangen -- hinaufkletteren -- droben stehen umherschaute -- hüpfte Blut -- pocht Brust -- trotzen Gebein -- schaudert Haar -- jauchzen -- klingen singen Nerv -- Liebe -- Lust leben -- -- -- -- -- -- -- -- -- -- -- -- -- -- -- -- -- -- -- -- -- -- -- -- -- -- -- -- Punkt -- lieb Syllie -- bedeuten gewaltsam Unterbrechung -- Pause -- Liede lassen -- Ton Takt verlieren -- 
  Begriff anstimmen -- Allwill Phaeton vorfahren -- Ruhe lassen -- Amalia Tisch spazieren führen lassen -- Mittag Gast -- 
  nachgiben -- Allwill -- geschehen -- verlangen -- 
  zerstreuen -- denken -- Stimmung früh versetzen -- 
  -- erzählen Allwill -- -- Irre -- zweimal fragen -- 
  werfen Zug -- 
  Frau -- jung Mensch -- alt -- annehmen -- beugen gut -- ausführlich Bericht erstatten -- 
  sahsen -- ausbilden -- unbegreiflich Durcheinander Mensch -- 
  Vater erzählen jüngst -- -- Knabe -- heil -- Paar Beule Kopfe -- Wunde überall -- 
  müde -- gut Major seltsam streich Knabe erzählen hören -- Herr Präzeptor Kind Hoffnung halten -- -- Lebhaftigkeit -- Studier träge -- Gutherzigkeit äußerst hartnäckig -- ausgelassen trotzig -- 
  schwach Geist halten -- Kamerad beständig überlisteen -- Mühe beredeten -- Zech überall bezahlen lassen -- 
  fallen Paar Zug -- erzählen -- 
  Kopf setzen -- treu Schaukelpferd -- nennen Fuchs -- lebendig -- lebendig Fliege beibringen -- 
  quälen unermüdet Zubereitungen Versuch -- anstellen -- Schaukelmaschine hohl -- 
  einst -- heftig Bewegung bringen -- vorderst Ende beständig Boden stoßen -- Unverhofft inne -- Fortrutsche -- 
  treiben Tier stark -- gelangen ziemlich geschwind entgegengesetzt Gemachs -- 
  Freude auslassen -- 
  Mensch vermögen auszureden -- Fuchs leben anfang -- Welt Seite gewichen -- 
  Mittag -- Eduard Hunger -- 
  Vater lassen sagen -- 
  herunter -- Major fürchten -- diesmal gehorch -- 
  Leute Haus -- Geist lieben Eduard auf Blut peitschen sehen -- laufen hinauf -- Fleht -- Schmeichelt -- verhießen -- drohen -- umsonst -- 
  Major -- schlechterdings horchen -- befehlen -- Knabe Gewalt herunter Schleppe -- 
  geschehen -- 
  weidlich ausgescholt -- Tisch setzen -- 
  -- Hunger -- 
  drohen -- zwingen -- vergeblich -- 
  Fuchs -- Himmel -- 
  schlechterding Kopf brechen -- bleiben übrig -- tüchtig abzuprügeln -- Fuchse trennen -- unverzüglich Werk richten -- Paar Stunde finst Loch sperren -- 
  nachh Abends Dunklen hoch Gestell geschlichen -- Absicht -- Sprung versuchen -- Übung Successen glauben Wagen -- 
  springen Herzhaft -- stürzen gewaltig -- fürchten -- Nasenbein entzwei -- 
  Kleinigkeit -- 
  folgend Vater erscheinen -- 
  Welt -- Ausschelten Junge leiden -- 
  diesmal Major bringen -- Eduard Strafe -- drein Tisch Sitz erlassen -- 
  essen Jung erscheinen -- entstehen Not -- 
  schüchtern Starrkopf hinunt -- alt Bruder Wilhelm -- Feiner -- beredt -- grundgut Knabe -- heiligsen Versicherung -- Vater zerquetscht Nase Miene erwähnen -- vermögen -- 
  Mühe dennoch kosten -- Wilhelm Kunst Eduard schlimm Handel verwickeln -- unversiegend Quelle Glaube Grund Herzens überschwemmt Gedächtnis -- Seite weiser -- 
  wanderen Eduard Bruder Hand Major -- verheißenermaßen Milde ansehen -- Bemerke unterlassen -- 
  Nasen-Futteral lassen -- 
  Rasch drehen Eduard -- Wilhelm -- 
  -- Lügner -- -- kräftig Stoß -- Schritt rücklings Sandtrog tummeln -- 
  Major entsetzen -- werfen Täter -- verächtlich Ungeheuer -- -- 
  dergleicher begeben -- Eduard Mut gut Humor beugt Seite -- 
  Mensch Schlag erleiden -- willig Übernehmung klein Schmach abkaufen -- Unwille vorgesetzter Träne Fleh milderen -- 
  erzählen neulich -- einst nah Tod geißeln -- Präzeptor Sokratische Frage Geständnis versuchen -- 
  Prügel sein Wohltat -- verstellt Albernheit Schlußfolg bringen -- 
  Kamerad übernehmen mehrmals Schuld Strafe -- sowohl Freundschaftsenthusiasmus Mitleid -- Fleh heul Exekution unerträglich ekelen -- 
  Schatten Dreistigkeit -- Gegenteil schüchtern -- demütig -- wovon denken -- vorliebend -- dankbar -- mild -- meister -- teils Tropf -- teils Schmeichler gelten -- 
  Unwahrheit -- bloß Irrtum -- -- neu Blatt suchen müssen -- schwerlich einfallen -- Viertelstund Post abgehen -- 
  -- kommen nächstens Materie -- erzähl Kontrast Eduard -- Unbändigkeit wild -- still -- vertraulich Leben neigen -- heftig Begierde sinnlich Lust -- Unbesonnenheit handeln -- grübelte -- Seele unsichtbar Gegenstand hing -- vierzehnt Pietist -- u. S. W. -- 
  unaussprechlich reizend -- Kind wissen -- hernach Jüngling beobachten -- dieselbig Karte -- Paar -- mischen spielen -- N. S. 
  fallen -- Brief beilegen -- Eduard jüngst Kambeck schreiben -- 
  unfehlbar -- Hälfte Verfasser vorlegen -- 
  Waldbegebenheit freuen -- 
  VI -- Beilage Clerdon Brief -- 
  Eduard Clerdon -- 
  Schlagflusse -- Bester -- fürchterlich beschreiben -- heftig Schwindel -- gut Ursache -- 
  -- Strafe -- ewig Leben -- -- Tollhau verbieten -- lesen -- schreiben -- menschlich beginnen -- 
  scheinen Sonne heiter Himmel -- Luft still -- Natur -- gut Humor -- 
  unser C * * -- Frau Kambeck Netz -- -- 
  liegen Fuß -- ben -- 
  -- 
  -- Clerdon -- Sache wissen -- 
  hören Geheimnis -- 
  Umgang Geschlecht reizen unendlich -- artig Geschöpf sanftes -- anschmiegende -- behagen -- 
  stimmen allmählich allzuheftig Empfindungsart herab -- stehlen Gleichmütigkeit Ruhe Herz -- 
  nah Beziehung hinzu -- fahren Juno drob Wolke -- Stutezerch unten klettern Berg hinan -- türm Fels -- o -- Clerdon -- bringen Satan Latein -- -- Weihkessel scheitern -- -- gewonn Spiel -- 
  -- vielmehr -- unerträglich Gedanke -- belobt Göttinn anzubeten -- ganz Ernst Fuß liegen -- 
  -- -- Roland Tat Sache -- ziemlich inne -- Grund Unsterblichen beschaffen -- bemühen glücklich -- Wille allgewaltigen Schicksal meinigen -- 
  -- -- Clarisse -- Clementin -- Juli -- sogar heilig Jungfraue unbefleckt Empfängnis überall geben -- -- bitte -- Lärm -- 
  sehen -- erhaben Einbildung Schuld -- Mensch verächtlich Weiber denken -- Gott -- Weiber Erde -- Mond -- wohin Herr Weg suchen -- 
  Schelt klagen Grausamkeit -- Treulosigkeit -- Abscheulichkeit -- Schandtat -- erfahren -- gut geschöpfche mehrenteils wissen -- Sache -- 
  Toll -- hart verfahren -- 
  Las -- Natur beliebt -- Engel martern versuchen -- Alsdann gerne lieben -- Innigkeit -- Festigkeit Großmut -- artig lieb Seelch vermögen -- 
  spotten -- ärgern -- zurückdenker -- Mädchen hängen -- Kraft bemühen -- gewiß Muster -- kopfe -- umzubilden -- 
  erinnern Amerikanischen wilde -- Brettern Kind Kopf Hirn quetschen -- Ungeheure verstellen -- löblichen Absicht -- vergötteren Sonne vergötteren Monde ähnlich -- 
  -- Narrheit schleppt -- schrecklich leiden erdulden -- 
  Augenblick Gestirn Verfinsterung -- arg lärmen -- häßlich Drache -- erhaschen laueren -- fortzuscheuchen -- müssen zuletzt Angesichte jämmerlich verschlingen sehen -- 
  vieler unglücklich Erfahrung müde -- sprechen einst früh Weislich -- 
  -- weder Aspasia -- Danae -- Phylli -- Melind -- Name -- weißen -- Name Stern Himmel -- sagen -- zecht Wachslichte fröhlich -- hoch Sonnenglanze tafeln -- 
  -- genieß Fest -- laß wunderbaren -- ungeheuer Herrlichkeit -- womit -- Zauberstab Merlin -- gelingen -- -- 
  -- Abenteuer Gebiet Liebe zustoßen -- Schöne -- Hörner -- Fischschwänze -- Kralle wahrnehmen -- -- lassen -- 
  kommen Anfang künftig Woche schwerlich weg -- 
  lassen halten -- jung Graf Batuff -- bös Geist hierher bannen -- Augenblick unangenehm schaffen -- 
  verstimmt Augenblick -- Schloß treten -- 
  wissen -- Präsident Auftrag -- Weg hierhin Paar Stunde umzureiten -- Wassermaschine Bergwerke D * * * Augenschein nehmen -- 
  -- -- ritt gestreckt Trabe Wald Kambeck -- 
  ungefähr Mitte Wald ausgespannt Pferd -- umgeworfen Karren -- Führer -- Baum gelehnen -- stehen -- 
  arm Kerl Holz abladen -- Rad ausnehmen -- dennoch Stande -- eingesunken Karren Höhe lüfren -- 
  Vorfall -- ich_es nehmen --- ungelegen -- 
  ritt vorbei -- vermutlich Arm mechanisch zurückziehen -- Pferd Trabe -- 
  Augenblick auffallend -- Flucht -- Meister -- -- 
  steigen -- bieten arm Hülflosen Dienst -- 
  Blick golden Einfassung -- bitter lächeln -- erwidern -- gleich Vornehmen Beistand -- grausamst Spott erwarten -- 
  Blitz Seele -- Clerdon -- 
  fühlt schimpfred Prügel -- unfehlbar Mensch geben -- ähnlich Umstand antreffen -- Hilfe versagen -- 
  greifen Karren Kraft -- Rucke entgegengesetzt Achse ruhen -- fliegen Rad -- rolln herbei -- Karren hervorgezog Rad einsetzen -- 
  Manne Holz aufladen helfen -- litt schlechterdings -- herzlich Bitte -- 
  fühlen -- Wohltat erweisen -- -- 
  -- zufrieden Arm -- danken -- bewundert -- nimmer vergessen -- Kind -- Dorfe erzählen -- 
  Gott -- 
  meinen Scham -- Unwillen Schwermut versinken -- diesmal gewiß Kambeck geriten -- wohin wissen -- 
  spät -- 
  übelzugerichtet Anzug schließen -- Pferd stürzen -- 
  erzählt Geschichte -- 
  Graf Batuff stehen ausgespreizt dicht Nase -- hört Gattung bekannt -- Anmaßung Leerheit Blick verratend Lächel -- diesmal Graf Bewußtsein Erhabenheit dergleichen Schwachheite -- Schuld lassen -- Ausdruck Leben -- 
  Erzählung -- brechen längst Hinterhalte lauschend Einfall hervor -- 
  Glück -- -- -- Frau Kambeck wendend -- Bauer Pferd durchgegang -- stark Blessur liegen -- Allwill Engländer einspannen -- lieb Nächst heimkarrigen -- -- 
  Herr Graf -- erwidern -- Urteil günstig -- nahe arm Bauer hülflos lassen -- -- hartherzig Schurk -- 
  leise -- Lebensart -- Wort Schurk aussprechen -- -- gebräuchlich maßen -- Frau Kambeck entgehen -- 
  verändert Farbe -- Auge Grafe -- seltsam Eingeweid -- 
  fahren fort -- schwatzen Herz rein -- ruht -- Schimpfwort Prügel -- worunter ängstigen -- jung Herr -- Wort Mensch -- verächtlichst Nebenbedeutung kennen -- vollzählig abladen -- 
  -- diesmal -- 
  -- Clerdon -- Präsident Licht stellen -- lang ausbleiben -- Vater wissen -- 
  VII -- 
  Amalia Syllie -- 
  Sonnabend -- 11t März -- morgens halb -- 
  gestern Nachmittag kommen Eduard -- Herr Kambeck Offizier -- kennst -- entführt Clerdon Born -- wohin Kuppel englisch Pferd -- 
  gut Clerdon -- weißt -- beschwatzen lassen -- 
  -- Kaffee -- betrübt Lage -- Fette Milch Tasse schöpfen -- 
  fing lesen -- Seite Kopf -- schaffen -- Zerstreuung wehren -- legen Buch weg -- 
  lieb Syllie -- Himmel heit -- Schuld -- Cabinet schön -- 
  Fenster öffnen -- Weilche stehen bleiben -- Freund nachzusinnen -- -- Knabe -- plaudern -- 
  unser Jammer -- unser Verdruß -- Ärger -- Zorn -- hiervon eigentlich müssen -- wissen -- -- -- ungewöhnlich Ausbleib Brief -- 
  Clerdon bar Geld verweten -- -- Meinst -- setzen -- -- Postillon mehrere Brief erhalten -- 
  gewiß -- Ur Paket Posttage ausbleiben -- 
  Überschwemmung -- E * * Brücke weggerissen gewaltig Schaden anrichten -- Schuld -- 
  Montage glauben -- können fehlen -- Brief müssen -- war_es fehlen -- ging_es folgenden -- -- Hoffnung -- Zweifel steigen -- Unruhe ergreifen -- schlechterding Vertrag Auskommen -- 
  Nachricht Überschwemmung -- ausgeblieben Ur Paketen -- begleiten Clerdon zureden kühn Wette -- neu eingewiegen -- 
  Sorge abrechnen -- lieb Syllie -- glücklich -- zufrieden -- ruhig froh Leben -- -- 
  O -- laß Dir_es -- Syllie -- laß Dir_es -- machen schön Schande -- 
  Abends -- halb -- 
  alt groß Jubel Spatzierreis Donau Haus -- herrlich Ding -- 
  Freude Knabe -- 
  führen ungemein -- Heinrich Musterhaft -- 
  allgemach Jung -- Vater anfangen -- Arg denken -- Carl -- Topinambu -- grausam vorziehen -- 
  Virtuoso ordentlich verlieben -- 
  etlicher Woche Ouvertüre Deserteur spielen -- Lücil Operett -- aufführen -- geigen Menge Sache Herzenslust -- dünken lassen -- machen schön -- 
  gewiß Junge musikalisch -- verdienen Platz Kapelle -- geschworen -- anderer bringen -- 
  -- Herr Bering Herr Kamp rühmen -- Georg Fein ordentlich Frisieret -- Würdest Freude erleben -- 
  Heinrich verkündigen Heinrich -- unser Geschlecht dereinst hoch ansehen stehen -- Ehre gelangen -- 
  Bildung täglich einnehmend -- 
  -- -- Knoten -- Knoten Kinn -- 
  ansehen nehmen -- Fingerspitze -- unmöglich Sinn schlagen -- 
  -- -- Bube schwatzen -- 
  diesmal Weile -- bedenk -- lieb Syllie -- herzwillig Teilnehmung dergleichen verwöhnen verstocken -- 
  Leute reden -- 
  hören Clerdon -- 
  Sonntag -- 
  -- 
  Schlief halb -- erschrak fast -- -- tot fänden -- 
  Laß Gleichnis -- hören -- 
  Negligee -- öffne Türe -- 
  -- Himmel Wille -- -- 
  gewiß -- 
  Denke -- Syllie -- sitzen Clerdon unverschämt Sessel Eduard -- lassen schmecken Schal -- 
  -- Clerdon Haaren Sessel nehmen -- rufen Kräfte -- Ausstand -- 
  -- sehen -- gnädig -- frisieren -- -- 
  -- bescheiden Mittag -- 
  bedeuten -- Kaffee bloß nehmen -- kalt -- bess Frühstück gebühren -- 
  sorgen -- 
  Kamin stehen Schokolat Topf -- -- Zubehör -- wack Ritter Huy Serviette -- Anstande bedienen -- 
  artig -- Syllie -- 
  glauben -- -- Beisammensitzen Geschwätz wert -- 
  Allwill wacker Junge -- trau Seite -- Seite trauen -- 
  Ruchlosigkeit -- 
  Clerdon beschönigen -- 
  hauswesen bestellen -- Kopf zurecht -- Stunde aufheben -- 
  Heinrich -- Carl Ludwig gestern Abend Heimfeld abgeholen -- bleiben -- Ferdinand sagen -- sofich Hand -- 
  arm Edmund -- weißen -- -- 
  sofich erzählen -- Hold -- Fromm -- Gehorsam -- schmeichelnd -- 
  Papa platt verlieben Ding -- 
  Türe -- fragen -- dürfen -- 
  antworten -- -- schreiben -- schlich sachen herbei -- küssen Hand -- Wort sagen fort -- 
  dergleicher Züge Menge erzählen -- 
  denken -- 
  Mädchen Mai alt -- 
  lieb Syllie -- -- genau neulich schriebst -- -- -- -- 
  Edmund -- Porträts kennen -- Albano -- hellbraun Auge -- Augäpfel klar sehen -- lauter Herzens-Fröhlichkeit Güte heraus -- anlachen anjauchzen -- lachen Jauchzt -- ausgeschlafen -- 
  Gutsel Knabe leiben -- Fleisch Blut -- -- Clerdon Herz mitbekommen -- sehen -- Sait berühren -- inwendig zittern -- Träne Auge -- Träne -- o süß -- 
  Engel Syllie -- mußt sehen -- Clerdon Vater Hausvater -- umgänglicher -- Kind herumtreeben -- freuen -- eins Weg -- Freude Unschuldige lohnen -- 
  Ferdinand Singens Springen -- lassen anfangen -- zausen hudeln -- herum stehen lachen bange -- 
  gewiß -- Syllie -- ordentlich Bube -- helfen allerhand Streiche ausführen erdenken -- Ding verstehen auslachen -- stehen -- Liebe -- Kind Spott -- ausgelassen Knabe herumtaumeln Kamerad -- jauchzen lachen -- Ecke Auge Vater sehen Mann -- -- -- 
  -- Syllie -- 
  beben schwach wonnevoll Weibe Glied -- sinken arm Liebenswürdig -- hängen Hals -- Erde Himmel möchten vergehen -- 
  Landgut Frau Reinach -- Lenore Cläre Wallberg aufhalten -- 
  Tante -- folglich Clerdon anverwenden -- 
  allzuglücklich -- Syllie -- 
  Gatte -- wohlanlassend Kind -- lieb treu Gefährtinne -- Lenore Clärchen -- Engel -- Schwester Tochter -- schicklich Auskommen -- Stand -- ansehen -- Hoffnung -- schön -- lieb Kranz Freund -- 
  -- sagen -- Syllie -- Leute -- können -- fröhlich -- herrlich -- 
  -- fragen -- -- heit vergnügen aussehen -- 
  Wunder -- -- -- gut Syllie -- Bild Glückseligkeit lebhaft Auge stellen -- -- ich_es -- 
  weißen -- Gedanke anziehen -- teilen -- Herz laut schlagen verlangen -- glücklich -- glücklich -- Tran Syllie fallen lassen -- 
  O -- weißen -- -- gute -- Kennst Meli -- 
  Dir_es -- Innere beständig Seite hinbewegen -- Widrige vernahmsen -- 
  -- stachelnd Unruhe lassen Augenblick zufrieden -- wissen -- unpäßlich -- mißvergnügt schwermütig -- 
  jung Brief scheinst ziemlich gesund -- * * * * * Stunde angenehm -- wofür herzlich danken -- Platz fänden -- 
  wirfst -- Ferdinand erzählen -- 
  jung alt -- anderer erzählen lassen -- aussehen -- -- erzählen -- 
  klein -- finster liegend Auge -- freundlich kucken -- Feuer Menge -- 
  weißen -- Clerdon längst verbürgen -- Ferdinand -- freimütigst jung Welt bekommen -- 
  hängen Klette -- Bruder Heinrich holen -- Fehl -- Bettchen -- ziehen Schuh Strümpfe -- frühstücken -- 
  Frühstück Bruder Heinrich fort Hof -- Spiel Gang bringen -- tun Bruder Heinrich gleich Geduld Freundlichkeit -- 
  -- schreiben -- Ferdinand Freudengeschrei kommen -- finden -- laufen -- spielen schwatzen herum -- 
  deinen Bombacino lassen Wörtche einfließen -- vorkommen -- gehören Kind Familie -- Kirche -- Mädchen -- schwatzen -- 
  -- lachen plaudern hierneben Clerdon Kamin -- 
  Augenblick -- lieb Syllie -- anziehen -- essen -- Kirche -- -- 
  -- Himmel -- Frau Direktorin Spieltisch -- 
  Ade -- gute -- Liebe -- -- VIII -- Clärchen Syllie -- 
  Heimfeld -- 14t März -- 
  Clerdon Amalia gestern -- 
  entgegen fliegen -- Clerdon linker Arm hing -- fassen Hand drücken leis Rocktasche -- 
  leise rufen -- Brief Syllie -- -- 
  -- -- -- Geduld -- -- Clerdon -- -- bring Brief -- -- -- 
  -- lächeln -- wovon Ungeduld groß -- 
  Tante anziehen -- 
  -- 
  laufen hinterste Boskett -- 
  -- -- -- Clerdon -- -- jauchzten hüpfen -- -- 
  stillend Blick Clerdon -- 
  schlüpften lagert Rasenbank -- 
  Clerdon stehen Augenblick -- Platz -- 
  Brieftasch hervor -- 
  hing Auge -- 
  --- schauerlich Freundlichkeit wandelen Stille -- 
  Clerdon öffnet Brieftasch -- 
  -- -- herrlich -- lieb Weib -- -- -- 
  -- -- erblicken -- Seele stehen -- -- -- 
  -- 
  -- Gott -- tief fühlend Herz schenksen -- schenksen -- Gabe -- -- -- 
  Brief lesen -- 
  Stunde verstrichen -- 
  zubringen Stunde -- -- lieb Syllie -- erzählen -- wissen -- -- 
  -- 
  Clerdon -- 
  erzählen -- 
  Anschauen -- Umarmung enthüllten -- schön -- tiefempfindenden Seele heilig -- Bild Wort nachgespiegelt -- 
  vermöcht Blitzstrahl abzulenken -- Leblosem lebendig Kuß Liebe verleihen -- 
  -- schau -- verklärt Blick -- Wonnegefühl -- Augenlider decken -- Unermeßliches Geist auftun -- 
  glauben -- Grund Welt schlimm -- arg ergehen -- leiden -- 
  rein voll klingend Saite Laute Natur -- mächtig Organ Allliebende -- o -- lohnen Schmerz -- 
  Dorn malmen -- Pflaumfeder wühlen -- lernen -- wissen -- Mensch Lauterkeit Sinnes -- Kraft Stetigkeit Willens -- Erleuchtung -- Wahrheit -- Eigenheit Konsistenz Herzen Geist -- wodurch eigentlich Genuß göttlicheren Natur -- Rück Aussicht -- wozu gelangen -- mehrmals äußer Gedräng -- verlassen -- 
  gestemmt Seele Teil fühlen -- -- Jacob -- Herr gerung Segen tragen -- 
  -- lieb Syllie -- Preis Zeitlang verrenkt Hüft schleppen -- 
  Clärche -- 
  Schön -- Clerdon -- -- -- Trost -- köstlich Balsam -- lindernd -- Wunde -- tödlich -- 
  arm Syllie -- übel -- schlimm Welt -- 
  hören hell Brust hervorgeh Schrei tiefst Schmerz -- 
  helfen -- hintennach Lächelst -- 
  machst bitterlich weinen -- 
  weißen -- Arria lächelen -- -- 
  -- Syllie -- leben Liebe -- lieb Zuversicht -- 
  Sage -- Liebe -- ewig wissen ewig erwidern -- Liebe -- bloß ergötzen -- -- Angst -- Name Liehest -- Blumenfreude -- Schmuck -- Tanz Spiel -- 
  hieran genügen -- Syllie -- -- 
  Seifenblas werfen -- -- Seifenblase -- -- 
  nachgrübelen -- -- O -- fühlen -- Herz zersprengen -- 
  Lenore -- 
  Zunge -- 
  -- fertig -- Clärch -- -- treten Zimmer -- 
  Clärchens Anblick hemmt Sprache Gang -- Herz heben Schlage -- -- 
  schieben -- Stellung verändern -- Geschriebene -- 
  lesen -- hierauf Augenblick sitzen -- Stuhl knien -- küssen -- 
  kommen allmählich Arm -- weinen -- finden Wort -- 
  Brief Stückweise wiederholen -- umgebilden -- fassen -- 
  Drang tief -- dennoch Heiterer -- 
  ahndet dein Zustand -- gewann himmlisch Wesen -- 
  Syllie -- sagen -- 
  bloß Abglanz -- Teil Seele -- -- -- schwach aufnehmen vermögen -- Mut Wonne -- 
  -- besitzen -- Seele -- Wesen -- unbegreiflich entzücken -- Quell Fülle Schönheit Größe -- -- 
  Syllie -- gäbe Unabhängigkeit hoch Selbstgenuss -- hell Wonne -- Göttlich lieben -- Reichtum überfließen -- 
  Glücklich -- glücklich Syllie -- -- 
  Clärche -- 
  Schwester abgerufen -- -- lieb Syllie -- Stande fortzufahren -- 
  Blick trüben -- 
  Wehklage -- wovon -- hell Brust hervorgehen hören -- dringen neu Ohr -- Jubel übertäuben -- 
  Kennst -- Gefühl verlieren -- Vorstellung befangen -- sehen -- wissen -- -- Himmel -- selig preisen -- 
  minder -- vorhin bemerken -- säßest Himmel Art Hölle -- 
  Brief Wechselgesang -- voll Verzweiflung Wonne -- 
  Herz ausstehen -- feindlich Ton zusammenkommen -- schmelzen -- Melodie vereinigen -- 
  Sait Instrument springen -- Sangboden -- 
  Liebste Syllie -- Ertrag -- 
  O -- -- dürfen Lenore missen -- 
  entbehren -- opferten -- helfen -- 
  Sage -- -- -- 
  unvollkommen Teilnehmung -- gut Kind fändest -- rein -- voll Maß innig -- 
  Auge -- Syllie -- lassen gewiß meister Blick -- 
  gewönn Seele Raum -- erhieln Stätte -- Leben hinflüchen aufbewahren -- 
  -- Sage -- Liebe -- -- 
  fühlen außerordentlich Trieb -- jüngst Anschlag unterhalten -- 
  fast -- 
  Freude -- erhielen zuverlässig -- ähnlich -- 
  dünken -- Amalia jüngst Heinrich -- Küsse müssen hold Wesen einhauchen -- 
  Clerdon schicken -- 
  zusiegeln -- 
  bekommsen Amalia -- 
  Gemm überwinden -- Frau Reinach lassen -- 
  wunderbar Weib -- 
  jung -- sprudelnd Leben -- Schuldigkeit ähnlich sehen -- völlig hingerissen -- Leidenschaft -- 
  fahren fort Vorwurf -- immerwährend Aufopferung zulassen -- Gottlose Fleiß verstocken -- 
  sagen tausendmal -- böte Mägdedienste -- dächen widersetzen -- lieb schicklich -- 
  hüten -- Huy Gefälligkeit -- weg -- wissen -- -- 
  Ade -- Syllie -- 
  laufen -- fall Hals -- 
  IX -- Eduard Allwill Clemens Wallberg -- 
  verlangen eher erfüllen -- 
  eigentlich Freundschaft -- Anspruch -- Seite laut anerkennen überall gelten -- Henker losen nichtswürdigen Bettel -- Galgen hängen -- 
  verzeih -- -- laß Vorstellung übergehen -- 
  weißen -- Meinung -- weißt -- Gesicht -- Leute hören -- leiben -- bekümmerten -- 
  Grund -- nachsehen -- 
  Fratz -- 
  Ekel nehmen -- erbosen -- ehed -- Tor lang -- ärgern -- 
  behagen Mensch -- einig -- wissen -- selten -- 
  brauchen Leute leiben -- woher wozu -- 
  Ding bestellen -- voran -- bleiben vernehmen -- bekümmern -- 
  indessen -- -- verhehl -- eigentlich Geist freundlich Toleranz edel Unbefangenheit -- Gleichgültigkeit Bettelei -- -- 
  -- Bruder -- verzeih Unrecht -- gut -- mußt sicher rechnen -- 
  ernstlich meinen -- spür -- Grund -- -- 
  ich_es hinfür -- wissen Himmel -- 
  -- innen außen -- wunderbar Gedrang -- 
  Ruhe nossen -- unpäßlich -- 
  Blieb Kopf dumpf -- nebelig -- -- sehen Verwirrung -- richten schlichten -- ausgemachen -- bleiben -- 
  weißen -- Nebel fließen Ding hübsch -- erscheinen mehrere -- Glied Platz -- Farbenverwirrung -- grau -- flach -- sieh -- Bruder -- wahrhaftig Nebel treffendste Bild weis Gemütsfassung -- 
  Geist umnebeln -- altklagen -- verständig -- Schulmeister -- wissen bescheiden -- heißen -- tun -- räume Zimmer -- bringen Papier Ordnung -- beantworten Brief Datum Ankunft -- Testament -- Erbe wissen -- gefallen lassen können -- 
  Clerdon -- gestern besuchen -- glauben Türe irren -- fremd Zimmer -- 
  stehen gehören -- stehen -- liegen gehören -- liegen -- 
  dergleich Rücksichte neblig Disposition zuweilen wahr Wohltat -- Sache nachdenken -- desto hell leuchten -- Tugend echt Schul-Stadt- Heer-Moral -- belieben durchgängig Aufführung -- exemplarisch Leben hervorbringen -- Art Nebel -- leichtfertig aussenwesen -- Glanz -- Farbe -- Licht Schatten -- Gegenstand verhüllen -- solide Unveränderlich beäugen lassen -- 
  merkwürdig Entwicklung Roman Nannche -- worüber Epistel schreiben -- -- Höre -- halb Stunde dachen Wunder -- erzählen -- 
  schneiden frisch Feder -- tunken -- wissen -- Fleck -- gering Befremde inne -- nötig -- vorher besinnen -- 
  Sann halb Stunde -- fertig -- -- wissen -- eifrig angeschicken -- wissen -- 
  Sache erinnern -- Weise erinnern -- mächtig interessieren -- 
  wissen -- Materie dürftig geschien -- Abhandlung Feder schön schnitten -- Anfangs tief eingetunken -- 
  ist_es geschehen -- Abenteuer Zufälle Zubehör -- Schelmerei -- Zaubereie -- Heldentat Wunder -- -- Augenblick -- interessant Ammenmärche -- Erzähl -- 
  Verstehen -- 
  Clemen Wallberg warst -- damalig Katastrophe Fall -- vergiften -- erstechen -- Kanon schießen -- Papagei -- Drache -- Teufel -- Gott verwandeln -- 
  -- glauben -- Haut erfahren -- 
  demnach sollst erlauben -- -- Ding -- Begebenheite Feenland unterhalten -- 
  Luzie Länge Bericht erstaten -- heilig Gelübde -- -- äußerlich innerlich begegnen -- verhehlen -- 
  wahrscheinlich Brief lesen geben -- schreiben gewiß Woche -- 
  -- -- Ding -- 
  fangen -- 
  Menge neu hiesig Lage erzählen -- 
  Stunde bringen Clerdon Haus -- 
  kosten Mühe -- vertraulich Fuß gelitten -- glücken -- 
  Clerdon fühlen verstehen -- durchgängig stehen gut Ruf -- 
  Prinzessin -- vollkommenst Hochachtung würdigen -- ausnehmend verehr -- 
  Lärm -- 
  gewiß -- gut Wallberg -- kommen fast unschuldig -- stifen überall böse -- 
  Anschlag weiblich Geschöpf -- verführen -- jeher fern -- Mensch -- fähig -- Haß Ekel ansehen -- 
  freundschaftlich Verbindung warm innig -- fern Maß Ziel wissen -- Herz -- hüten -- -- -- -- dein Cousinen Not -- wandeln Licht -- Leuchte entübrigen -- 
  Amalia -- sehen -- fern einfallen -- -- Gast Clerdon Herde -- 
  -- Clerdon anstehen -- treuherzig jung Auge sehen -- 
  Jugend -- Schönheit hindern -- vertraulicher Umgang Mama heißen -- wissen lieberen Name -- 
  Liebe Mama -- Mama Meli -- -- sagen -- -- heißen -- himmelhell Angesicht schauen -- -- anlacht -- -- 
  fühlen untergetaucht Unschuld Reinheit -- wissen saurer Welt -- Alsdann unentgeltlich Freude -- 
  Lauterkeit Herzen übersteigen Glaube -- 
  jeder -- jeder schön -- scheinen -- unversetzt unauflösbar -- Gefühl -- Hang -- Wunsch -- -- verhehlen -- -- verstellen -- 
  hiermit -- 
  -- besinnen -- -- Amalie persönlich kenn -- Stande Eigentlich vorstellen -- bestimmtest Verhältnis -- Gattin Clerdon -- Mutter Kind -- Frau Haus denken -- 
  Sage -- weißen -- besonderer Affekt -- Eheliche Liebe nennen -- verschiede Leidenschaft -- allgemein Name Liebe tragen -- -- Sage -- vorkommen -- 
  reden -- 
  wissen -- Entdeckung Clerdon Haus interessantest -- jemals Betrachtung dargeboten -- 
  eigentlich Liebe scheinen schön Geschlecht fähig -- Weib erscheinen -- Stoff -- 
  Amalie trauen Punkt fast -- Clerdon hierüber einig -- 
  Anfangs -- Braut siebzehn - Mann vorzüglich Grad Hochachtung abgewinnen vermochen -- Stunde wissen eigentlich Rechenschaft geben -- hernach allmählich verlieren -- Herz Rege seinigen empfangen -- gesamt Kraft unverrückt Wille fühlen -- Freiheit -- Leben -- Glück -- -- Seele hinwagen -- 
  wissen -- herrlich Liebe geben -- -- hoch -- wovon ehemals wunderbar Ahnung -- leer Hirngespinst -- Liebe gewiß Schaum -- 
  Findest -- entgegengesetzt Eigenschaft Bedürfnissen Mensch -- innig Teilnehmung -- Kraft Wille zusammenschmilzen -- Mensch verdoppeln -- -- 
  -- 
  Welt -- Schöpfung Regierung vereinigen -- tausendfach Organ -- fühlen -- fassen -- 
  gemeinschaftlich Interesse beitragend Vermögen gefühlt Wert -- regen Wesen Kraft -- vielfach -- verschieden Kraft -- desto merkbarer Gewinn -- desto entzückend Bündnis -- 
  Bedenke -- unterschieden -- entgegengesetzt Interesse einzeln Mensch teilen -- Wonne erquicken -- wahrhaft Einverständnis etlicher bewirken -- einstimmig derjenige Groß Glücklichst halten -- -- Fähigkeit -- Kraft geben schwächen -- Trieb Wille gemeinden -- mächtig Heer ordnen -- -- 
  -- Eins -- 
  Fülle -- Seligkeit -- .... O -- fühlen -- glühend Sinn -- tobend Herz -- hell unbestechlich Geist -- still himmelanschwebend Seele erhalten müssen -- -- Träne -- Wallberg -- Träne dein arm Eduard -- lieb Schöne verzehren -- ewig Zerrüttung zähnen knirschen -- -- Frieden Gott ahnden -- verdammen täglich Sünde -- -- -- 
  -- Stätte finden -- Haupt Ruhe -- 
  -- -- 
  -- -- 
  einst brechen -- brechen Wonn einst -- quaalvoll Herz -- 
  .... 
  Glücklich Rede -- 
  Liebe Mutter Amalia -- Antlitz -- lächeln -- 
  Mensch -- Mutter Amalia -- -- gewiß -- Fall Not missen -- Mann bleiben Kind -- 
  verhehlen -- -- Haus sträflich Weise hängen -- nämlich ungefähr -- alt Republikaner vaterlande hingen -- 
  Gehörst unser mächtig Philosoph -- Erdkreis -- -- -- 
  Universum übersehen -- -- gemäßlich -- Herz nehmen -- brennend Liebe Mensch Patriotismus alt parteiisch Liebe Gram -- 
  herkommen -- gütig Herr -- unbeschränkt göttlich Wohlwollen -- allsehend Gerechtigkeit - Untadel -- -- schauen fühlen -- --- Wahrheit antreffen -- -- Weibe -- Mann -- Kind -- Haus -- wider Welt empören -- -- 
  Holde Mutter Natur -- o laut klopfend Herz -- Pfade wahres Heil suchen -- -- 
  Sieh wohlgemuen Weib -- Befriedigung rein Trieb Wunsch vollenden -- Begierd -- teilnehmend Herz frei allgemein ergießen -- 
  --- prächtig Weltweis -- lieblich Herr Dame -- euren erhaben Grundsätze schön Sentiment -- -- -- -- 
  bestehen Hausfrau -- 
  verschleuderen -- verpuffen eur Seele weit Welt -- überall -- nirgend -- euer unbefangen -- richtungslos Herz -- Anfalle bloß -- Drang Ruhe -- Genuß Gabe -- strebend -- hangend -- Opfer willig -- Unfall -- bebend klein Faser -- schwach -- elend -- zehrend -- voll Wohlwollen -- 
  Weg Allumfasser -- hinab Amalies Schemel -- Kurzsichtig -- Armselig -- Mann lieben Kind -- übrig Wesen -- Wohltun -- voll Genug -- -- überfließen -- Sonne scheinen Licht Wärme -- -- Licht warm -- Fülle -- 
  Tritt Umfang Amalies Sphäre -- 
  stehst Segen -- -- 
  Amalia bescheiden Geschöpf -- demütigste -- sagen -- finden -- 
  Art unermeßlich wirken -- 
  -- Pflicht erfüllen -- Gebot halten -- wissen -- Grund durchgängig verhalten vollständig Begriff -- eigentlich Moral -- Jahrtausende uralt Hiob Dienst stehen -- 
  Wunderbar -- Amalia zurechtkommen -- -- fromm -- 
  Fordre eur ekelst Mückenseiger -- Wandel Streng prüfen -- leugnen -- Sündenfreier -- Tadelloser -- Fratzenbegriff -- -- Mückenseiger beugen bekehren -- 
  -- Wallberg -- siehst Wunder -- argwohnest Blendwerk -- 
  Tritt nah -- 
  -- echt Gottesgeschöpf -- Gesundheit natürlich Wohlgestalt -- auferzog Künstelei -- Alsdann beziehen Gegenstand -- Kraft sammeln -- ordn schicklichst Wirksamkeit vereinigen -- 
  Tugende frei Gabe Schöpfer -- unmittelbar Naturtrieb -- verschiede gestalten verschieden Form Zustand menschlich Gesellschaft -- 
  -- -- ehe Name Vorschrift -- 
  Moral -- jeher bloß philosophisch Geschichte -- spekulativ Entwicklung -- Wissenschaft -- innerer Harmonie -- Einheit Dicht -- Augenmerk emporstrebend Menschheit -- allemal Geburt ersprießlichen Hauptneigung -- Mensch Beruf erteilen -- Plan -- 
  Einheit Neigung entstehen -- Einheit Wandel -- bilden Mensch erwählt Lage -- formen -- -- eingeschränkt Seite -- desto frei übrig -- verletzbar Punkt Wesen -- gewiß -- mutig -- begnügen -- unabhängig -- Edel -- gefällig Seele -- 
  greif Enden -- finden -- gerad Sinn -- dringender Geschäft -- Emsigkeit Treue Lust -- Eckpfost Glückseligkeit Tugend -- 
  erinneren -- Anfang Briefe Nebel ordentlich Wandel philosophieren -- 
  klingen leichtfertig -- tief erwägen -- -- 
  dumpf Sinn -- ersterben -- Neigung lauter Moral bilden -- lauter Moral Gefallen unterdrücken -- 
  zehnmal gutherzig Wildfang -- Leben Busen nähren Liebe -- 
  Eins -- 
  Mensch hoch Art -- geordnet -- durchgängig zusammenhängend Leben führen -- vieler Nebel verhüllen stehen -- Duft -- aufgehellen Plan Wirkungskreises Grenze drängen -- 
  Philosoph bewohn Himmelnahe Felsenhöhe -- Dufte trüben -- rundum endlos Helle Leere -- 
  gehen Atem -- 
  Luft dünnen -- Sinn -- allmählich tief herabkomme -- 
  leugnen -- eng Horizonte Gegenstand wärmer Auge Herz -- 
  grenzenlos Begrenzung -- Raum Maß -- ich_es erblicken -- Höllen-Angst -- 
  engen -- lassen irdisch Beginn -- Tuns sehen -- Kraft setzen -- 
  Schlusse Wörtche Freundschaft -- 
  -- nichtswürdig -- los Wesen Name -- wovon zuvor Rede -- Feind sein -- 
  Mißgeburt tot Meer Unbestimmtheit -- Richtungslosigkeit -- unendlich Zerstreuung -- 
  schwach Fäd veränderlich Absicht flüchtig Ergötze gesponnen -- wirren -- 
  -- Riß Riß -- Knoten Knoten -- 
  Bande echt Freundschaft -- anfassen -- linker Hand -- Werk bilden -- fortbewegen -- füß Leib -- 
  - Weg -- -- Freundschaft Eigennutz gründen -- 
  Gegenstand -- vereinigen -- Medium empfinden -- Sinn -- Organ -- 
  derjenige Liebe meister -- meister tun -- -- meister ausrichten -- -- 
  Eigenlieb -- 
  eigenliebe -- 
  gehen -- angehen -- -- fühlen -- schätzen -- lieben -- -- 
  euren Philosoph Unsinn -- 
  Mag_es -- 
  weiße -- -- -- 
  Leb -- grüß Luzie -- -- Treffliche -- 
  Eduard -- X. -- 
  Woche -- Wallberg -- lang Brief abgeschicken -- 
  folgend Brief Luzie fertig -- wovon weißen -- schreiben -- Geschichte Nannche -- 
  Epistel -- 
  Antwort -- Antwort -- 
  Luzie gedenken Silbe -- 
  vermuen -- Brief zeigen -- 
  -- erzählen umständlich ausführlich -- heillos Verhältnis Nannchen -- -- Gottlob -- -- hochscheid Haus kommen -- 
  erzählen geraten Feuer -- 
  hetzen -- voll Verdruß -- Katastrophe erschüttern -- Schalt weidlich -- -- öfter geschehen -- tüchtig Verweis Leichtsinn -- -- wissen abgeschmackt Nachgiebigkeit -- verdammter Los liederlich Wesen -- Gutherzigkeit nennen -- wodurch dergleich Verwicklung gerate -- Anfange ärgern peinigen -- wohinein ziehen ziehen lassen -- 
  schreiben -- ich_es fühlen -- schenken -- 
  plötzlich anderer Mensch -- fallen -- -- weder -- weit verstehen geben -- 
  scheinen Luzie nehmen -- denken -- müssen geschwind fest Wort halten -- -- 
  verdroß Ursache -- erstlich -- albern -- zweitens -- unredlich -- 
  Albern -- Luzie blind Kuh edl Gänsespiel kennen -- hernach -- Mutter sterben -- unser Haus aufwachsen -- Wien neu sehen -- 
  freilich verlieben -- bringen gewaltig Bekanntschaft -- hörten verlieben -- stellen gewaltig Bekanntschaft -- 
  -- schüttelst inclement Kopf -- Clemen -- -- 
  Geschichte Tone reden -- widerlichste Leben -- schämen Luzie -- demütigen Stolz -- wahrhaft gnädig -- ewig Füßen liegen verehren -- Wesen hoch Art -- wofür erkennen -- 
  Feierlich -- Glückwünschungs-Schreiben -- Eduard Allwill -- ergehen lassen -- tun -- 
  -- sagen -- unredlich -- 
  schlimm Seite -- Mensch -- Auge fassen Herz nehmen -- unmöglich wahr Ernst froh Hoffnung -- wofür Fuß legen -- 
  Brief Predigt Chauvesouris -- Bekehrung anführen -- 
  Luzie leiben -- hingehen lassen -- 
  -- Gewissen halb -- Angriff feierlich Wesen -- 
  Liebhaberei feierlich Mädchen -- 
  Freund -- warnen -- sinnen -- Warn spät -- heile -- 
  Luzie heiraten -- Verzug -- 
  alt -- Fräulein fürchterlich Alter -- 
  stimmen -- finden Mann -- -- schuld -- Mann wenigster getaugen -- 
  Schwester -- nimm mir_es übel -- Bekanntschaft Luzie -- vortrefflich Freundin -- 
  spannen arm Luzie hoch -- vermehrt Hang weinerlichen Ernst -- 
  schieren -- ausdrücken -- 
  -- Luzie begegnen -- liegen -- sagen Gewissen -- 
  wiederfinden Wien -- mehrere sehen -- 
  schön -- Holde -- Gefühlvolle -- geistreich Mädchen -- 
  Kindheit -- Jugendjahr verklären -- 
  Eindruck -- 
  Freude unser wiedersehen -- 
  -- -- Bruder Eduard -- -- rufen -- fallen Hals -- 
  schmelzen Herz -- Liebe zerschmolz -- 
  -- 
  Wort Freundschaft nennen -- ihrig Leidenschaft übergehen -- teilen -- dennoch nähren -- wissentlich nähren -- -- 
  vorhin -- -- lassen -- verwickeln -- geraten Nachgiebigkeit -- täuschen -- -- verstockter -- -- -- -- weißt großmütig Schritt -- -- Sorge -- Herz verzeihen -- 
  Schwor -- Gefahr aufrichtig -- hintergehen wollen -- 
  Schwor halten -- Gelegenheit darstellen -- -- 
  Wahn Absicht bleiben -- 
  verkehrt hoffen Erwart -- beständig Anliegen Gequal -- unerträglich Verachtung Haß -- 
  Vollkommenheit -- -- wissen -- Vollkommenheit Ding -- 
  wenigster Luzie Kopf setzen Allwill -- -- 
  taugen -- Gewalt kopfe bringen -- 
  tot -- selig sprechen -- kanonisier -- Teufel -- leiden -- Hölle heiß -- Lust -- 
  leben -- tückisch -- -- 
  ekeln -- Bildche sittlich Heiligkeit -- -- betrachten -- 
  Laß abbrechen -- sagen Luzie -- 
  fing Brief -- Absicht -- vorbereit Solltest -- anderer Sinn Schreiben -- 
  --- Bösewicht lachsen übel Laune -- denken -- 
  hat_es fühlen -- -- 
  Meinetweg -- 
  Leb -- 
  Eduard -- 
  XI -- Amalia Syllie -- 
  20t März -- 
  schreiben -- Mann Maus -- Maus Mann -- Amli schreiben -- sogar gewöhnlich Syllis-Posttag vorbeigehen lassen -- fast heutig vorbeigehen lassen -- S. VIIIt Brief -- 
  böse -- Syllie -- 
  tun -- 
  -- 
  -- tun -- -- ich_es -- 
  tun -- schämen -- denken -- -- übel -- -- 
  fühlen -- Vorwurf -- -- Sieh -- böse -- 
  Clerdon fragen -- Weiber -- unartig -- widerwärtig -- unerträglich Mann -- heit aussahen -- unglücklich fühlen -- fortleben -- zugig -- -- 
  Clerdon erstenmal fragen -- -- Gelegenheit sanft -- Geistreiche -- allerliebsten Stromfel -- bekommen Antwort -- Stromfel Kind -- 
  wissen -- 
  weißen Du_es -- Clerdon -- setzen hinzu -- 
  Amalia Kind -- fassen Arm -- küssen lassen reden -- 
  Kind -- verstehen Clerde meinen -- glauben Frau Stromfel -- froh -- gelten lassen -- näh Mensch -- wenigster Clerdon -- 
  wissen -- woher Heinrich -- Carl -- übrig Reihe leiben -- leiben Kind -- -- Clerdon Kind -- bringen -- 
  verstehen Mensch -- 
  Sagt Leute Niederkunft -- -- wack Frau -- Clerdon -- Manne Sohn bringen -- -- 
  Hernach -- -- Clerdon stolz -- Manne Sohn bringen -- -- 
  -- -- Clerdon glücklich -- Mann wünschen Tochter -- Tochter bringen -- -- -- O -- 
  Syllie -- Clerdon stolz glücklich -- Amli stolz -- Amli glücklich -- Kind -- 
  Mühe wert -- Amli Kind -- 
  arm Kind -- Amli wäretn -- 
  lieb Stelle Brief bringen -- hängen Kind Kindesgleichen -- 
  sagen -- lieb Schwester -- 
  komm Mutter -- kommen Kind Kind Vater -- kommen Mädchen Heimfeld -- 
  glauben -- Jahr Woche -- 
  kommen -- -- 
  Mußt festsetzen -- -- -- fügen -- lassen -- 
  Mutter -- Syllie -- Kind verlorst -- Würdest missen -- Mutter warst Mutter bleibst -- 
  O Mutter -- kommen Mutter -- 
  Kind stillen -- tun -- 
  -- 
  Wesen ausgeschlafen -- stillen -- liegen Schoß -- fangen girr Lust reg Lust -- fangen lach scherz Mutter -- -- -- -- -- Syllie -- wissen -- Mutter -- wissen -- -- 
  wissen -- 
  hängen Mutter -- -- unaussprechlich -- hängen -- 
  Sage -- lieb Syllie -- süß hold Wesen liegen dein Auge -- hinaufschaut -- hinaufreicht Gliedern -- suchen -- unbegreiflich danken -- unbegreiflich lieben -- Drücktest Herztest -- falten Umfasse Hand -- Auge -- offen Weg Himmel -- konntest beten lassen -- 
  deuchen -- Vater -- hundert hundert Mal erfinden -- 
  lieb Syllie -- 
  sagen -- -- dergleichen erinnern -- Amli -- klug -- verstehen -- wissen -- -- 
  Freude Kind schreibst -- Trost -- nimmst -- sagen -- -- leiben schön -- nehmen -- 
  -- nehmen -- 
  Lieb Gern- Kind anfängst -- Anfang -- rot backen -- tanzen Spring Jauchzen -- Bon-Bon -- -- 
  sehen -- wissen -- Welt anfangen -- 
  Weißt -- Welt anfangen -- 
  wissen -- sagen -- wissen -- ich_es sagen -- will_es sagen -- Ohr -- gehorchen -- -- -- -- -- verstehen -- 
  gestern -- voll hierher -- Clerdon anstreiten -- kommen Eigenliebe -- Nutzen Schaden -- Freude Leid brächte -- halten lassen wir_es -- 
  Herr Welt anfangen -- 
  Clerdon Einwürfe -- kommen Heinrich Carl Saal herein drehen tanzen -- hing Vater Hand Arm -- lassen wegschleudern -- Teppich herumtummelten -- kommen Mutter zerren -- drängen necken -- 
  sehen -- Clerdon klug Manne -- Philosophie meinigen -- Knabe aufgeben -- 
  uneigennützig Liebe -- Wohltun entferntest Gedanke Ersatz -- überwiegend Treue -- Tatsache -- 
  Weib -- Kind -- Philosophie bringen -- 
  Mühe erklären -- sogar Tatsache dergestalt Wort Seite bringen wissen -- Wort aufkäme -- tief liegend Wahrheit Wortgewebe wider -- Instinkt Buchstaben -- Vernunft bringen -- Instinkt -- Vernunft umgehen -- Jupiter Vater -- 
  letzter Hörte Verstand halb -- Clerdon Wort aussprechen -- 
  Weib -- fahren -- rot -- -- 
  fallen Garbetto Auge -- denken -- 
  brauchen Clerdon Frau Kind Spiel mischen -- Hund fragen -- treu Tier -- sprechen -- 
  ging_es unwillkürlich Mund -- 
  -- sprechen Hund -- -- 
  -- weißen -- Garbetto Frage bellen anfangen -- 
  Clerdon -- erriet -- lachen -- 
  verbeissen -- zornig Hund -- 
  lachen -- 
  tischen -- fort rufen -- sprechen Hund -- 
  Hetze -- Geräusch -- Rumor Kind -- allgemein lachen -- Unterredung -- 
  empfehlen Philosoph -- 
  -- lieb Syllie -- 
  -- Auge sollen -- desto denken -- Philosoph -- Garbetto Mund stopfen -- sollst Auge -- Clerdon -- sollen -- Clerdon -- -- Auge fallen -- denken zurecht weisen -- 
  hergehen -- Auge fallen -- Traum erfahren -- 
  heraushelfen -- Traume meinen -- Auge aufzutun -- 
  -- Welt vernünftig -- 
  denken -- möchten unser Verstand -- denken -- gut Aussicht bekommen -- finden -- Finger -- zurecht weisen -- ergreifen halten -- 
  Höre -- Clerdon -- -- -- -- geträumen -- 
  Dir_es Wort Wort Brief abschreiben -- 
  -- vorig Nacht erscheinen -- lieben Amli -- errätsen -- Mensch wird_es erraten -- 
  Laß erzählen -- 
  Pferd setzen -- -- -- 
  sitzen froh ruhig beisammen -- Bedient Brief -- 
  Nachricht Haus -- rufst -- erbrichst Ungeduld Siegel lesen -- 
  Gott Himmel -- Clerdon -- sagen plötzlich -- gestern Kind niedergekommen -- Knabe Mädchen -- -- 
  unmöglich -- geben -- -- 
  -- antwortest -- lies Brief -- Kennst Lenore Clärchen Hand -- schreiben -- 
  ausstehen -- befinden -- Kind leben -- 
  sehen Brief -- überführen -- lassen groß Eile satteln -- Haus jag -- arm Kind Amm Taufe bekommen -- -- 
  Sieh -- lieb Herzig -- wunderlich Welt zugehen -- voll Ernst -- träumen lassen -- 
  -- Schwesterche -- schlimm -- schlimm Traum -- -- glauben -- träumen -- geträumen -- 
  Verzeihe Anspielung -- kommen -- schlimm Traum gewiß vergeh Auge bleiben -- 
  Clerdon Allwill verweisen -- 
  ausführlich erzählen -- 
  Neckerei -- 
  wissen -- Meinung Held -- Rachsucht Verlegenheit setzen -- Partei wider Herr ergreifen -- Ruhm grenzenlosen Untertänigkeit -- heucheln -- 
  Verlegenheit Allwill obenhin schreiben -- bloß vorkommen lassen -- vorkommen -- 
  Clerdon tückisch Handel ziehen -- 
  -- unverantwortlich -- wahr Andacht -- Allwill -- -- behandeln -- 
  -- 
  -- anfangen -- 
  -- genau wissen -- alt jung Mann -- Clerdon Verwirrung bringen -- schreiben -- Allwill -- waren_es -- -- 
  alt -- müssen loben -- gewöhnlich alt lassen -- nötigen sehen -- annehmen -- 
  Nötigung -- Urkunde verschaffen -- Gelegenheit vorzeigen -- Allwill unwidersprechlich -- Monat alt -- 
  Begreifst -- Allwill einerlei Alter -- 
  dächen -- soviel Einerlei dürfen -- Langeweile -- 
  gewiß schön Sache Jugend -- Allwill viele wissen -- viele -- Anlage trefflich entwickeln -- meister Bewunder ausnimmen -- Zierde -- jung -- 
  dächen -- jung -- 
  -- -- alt -- Lob erschallen -- Vorfälle -- 
  Clerdon warm -- verteidigen müssen -- Verteidigung gestern Verteidigung -- nötig -- vertragen -- übermorgen -- Kunst groß Anstrengung nötig -- 
  Anstrengung vermehrt Eifer -- Clerdon gehören -- alsdann Eifer Anstrengung -- 
  Sache -- Clerdon -- vergißen leben Sache -- eins Ding -- treiben -- -- Syllie -- Liebhaberei Allwill Clerdon ruchlos -- 
  Fort -- fort bös Mensch -- Eis brechen -- Schwesterche -- 
  Warte -- allmählich -- 
  Umsonst Clerdon hetzen -- 
  tief -- -- Hetzen lassen -- 
  Augenblick erhalten Billet Heimfeld -- 
  Mädchen Brief erhalten -- schicken -- Nachmittag herein denken -- -- lesen -- 
  Lobe -- doppelt lieben gut Mädchen freuen -- 
  Brief übermorgen liegen lassen -- 
  Behüte Himmel -- 
  Augenblick siegeln -- Post -- 
  XII -- Syllie Lenore Clärchen -- 
  14t März -- 
  dreimal hintereinander C * * schreiben -- arm Syllie geschwind hinsitzen -- C * * Heimfeld schreiben -- halten sie_es -- 
  neu traurig um Herz -- sehnen stark Schwung -- unmöglich Ruhe bringen -- -- -- unterdessen Susanna anziehen helfen -- Einladung -- 
  Antwort -- -- Empfehlung -- aufwart Abend -- -- 
  -- seufzen arm Syllie -- enthalten Susanna sagen -- 
  -- fliegen -- 
  wissen wohin Vesuch flögen -- -- 
  hölzern Susanna hierauf antworten -- 
  Mädchen allzu unbehilflich Geschöpf -- 
  Empfindung Anspruch -- Fantasie -- Glaube -- Art hängen kommen -- 
  -- Gliederpuppe -- denken -- versuchen neuerdings -- anzubringen -- allemal entgegen Seele -- hölzern -- vorgereckt Brust Leibes -- 
  Herr Regierungs-Rat Frau Regierung Rätin erwähnen -- Gnade -- unlebendig Aussehen -- Toiletteschachtel -- stehen -- Nadel reichen -- Seht -- Kind -- 
  geht_es -- 
  Woche böse Rechtshandel Vergleich Vorschlage -- 
  müssen Gelegenheit allerhand fatal Leute sehen -- hauptsächlich grundschlecht Gierigstein -- 
  alt Unhold Auge kommen -- erschrak Gestalt -- viele widrig -- 
  Denkt -- Mensch Vorwurf -- zuletzt -- einiger reden -- fing weinen -- 
  -- Auge seinigen -- Auge Träne -- 
  Gierigstein -- weinen -- müssen -- Träne -- Auge -- Staubflock abschütteln -- Träne rühren -- betragen -- 
  Gierigstein Schrecken auffallen -- Gestalt Vorschein -- verkehren Mensch Alter Maske wegdorretn -- Fleisch Farbe Zug verhüllen -- 
  zeigen abgehärtet Nerve -- 
  Erstarrt Häßlichen liegen gräßlich Schau -- 
  beben nackend Mund -- kalt -- Unholde -- zittert trüben Auge -- Blick -- lenksam -- harren Ausdruck argen -- schlappen -- Odemleer -- Nase -- verkündigen Stadt Neuigkeit -- Skandal -- -- senken kraftlos Stirn -- Furchtsamkeit Mißtrauen Hauptrunzeln prägen -- -- 
  peinlich Anblick -- wahres Höllenbild -- verkommen Mensch -- offenbar heillos Erde hinunt starren -- -- 
  Mutter -- Süß -- Liebe -- o -- schön schön Seele -- -- 
  verschwinden Engel -- 
  lieb Bild vergessen -- anfrisch Träne -- Freudenträne lieb Mutter -- -- aussehen -- 
  wissen treiben -- 
  Beisammen gewiß -- Sonntag -- Art Wohllebe -- wohin weiden -- Sinn -- 
  Amalia Heerführerin -- geht_es Fasanerie -- bekommen Gebackene -- Milch Musik -- Clerdon Spitze -- Wald -- Feld längst Donau -- holen Hunger Durst -- 
  -- euer Geschäft -- losen Mädchen -- 
  euer Schalksauge Glück Unglück zutragen -- -- 
  Eduard Frage -- 
  Eduard Eurer Mitte unmöglich Behag finden -- seh Brief -- gestern Clerdon erhalten -- größtenteils Allwill handeln -- gelitten -- 
  erfahren -- Bruder melden -- gewaltig halten -- zittern Unheil -- 
  unbändig Mensch wacker Junge -- gewöhnlich -- -- gefährlich -- offen -- unschuldig Miene -- wogeg Rat -- worauf Hand fern reichen -- anschlingen -- Gemeinschaft -- 
  hintennach gewahr -- unsicher Straße wandeln -- verwegen Handel -- Wohlfeil Haut bieten -- folglich Genosse -- -- -- -- Mädchen -- Wege kommen -- auszuweichen - -- 
  Luzie hingewagen -- süß Geschöpf verlieren -- sterben -- Kind -- Tod Allwill -- S. vten Brief -- 
  Clemens Wallberg -- 
  Holden Jüngling erscheinen Allwill -- sinnig -- bescheiden voll Geist edel Eifer -- 
  Tugend -- Liebenswürdigkeit -- abspiegelt -- Sonne Meer -- nackender Eigenschaft Natur -- 
  überall voll Entzück fremd Verdienst -- einzig bestreben -- gelitten -- 
  rührend Einfalt -- Vortrefflichkeit -- schönsen Jugendglanze -- müssen bezaubern -- 
  Luzie -- Auge -- -- O -- sehen Engel -- still unbemerkt Ferne schweben -- bet selten Jüngling - Entzündet Freude -- rein Engels-Freude Edlen -- -- 
  dennoch Gift -- -- 
  Kind -- hierbei schaudern -- schaudern -- -- 
  töricht -- 
  schaudern -- 
  retten -- Clerdon -- Amalia -- hüten lieb Geschöpf -- 
  unerhört -- Eduard Anschlag mißlungen -- 
  wagen Erreichung jeder Zweck -- 
  abgewönnen -- Gewönne -- Leben -- -- 
  Clemen nennen Besessenen -- fast Fall gestatten -- willkürlich handeln -- 
  -- schrecklich Charakter -- 
  -- Göttlich anseh Mensch -- -- schön verfolgen -- -- 
  O -- hüten -- 
  O -- fliehen -- 
  -- Lenore -- zart durchdringlich Sinn -- -- 
  Glaube -- gute -- 
  lieb Weiber unglücklich -- 
  Mann verdienen Opfer unser Dasein -- annehmen wissen -- geben -- 
  Glück Herz besitzen -- schätzen -- Herz Augenblick -- Gefühl Herzen laut -- 
  Wonn -- hoch Menschheit -- gelten -- rein bewahrten -- 
  Empfindung Grade leiben -- ekelhaft Vermischung trübn -- Bild entweihn -- 
  Fülle Köstliche -- schmecken -- -- genügen -- - ohnmächtig Liebe -- 
  Arm merken -- glauben Zeitlang stark lieben -- lieben -- 
  -- o offenbaren -- -- 
  stehen geliebter -- fühlen Wesen -- 
  -- -- - fühl Wesen -- 
  -- -- -- 
  gräßlich - unaussprechlich Schmach Gefühl ahnden könntest -- 
  -- -- -- 
  -- -- -- -- verloren -- verlieren -- 
  entflohen -- entflohen -- -- 
  verschwund Lebendig -- tilgen schand Zahl -- Elend Maß -- Name -- -- XIII -- Lenore Syllie -- 
  Heimfeld -- 22t März -- 
  weißen Amalia -- dein Brief erhalten -- Brief -- Brief traurig -- wissen Bangigkeit versetzen -- erklären wissen -- wovon mißmutig -- 
  Amli schelten -- erzählen schreiben -- heißen Muts -- flößt Zuversicht nahen -- heit -- -- -- lauter Freude -- 
  froh -- warnen hinterher -- -- -- betrüben -- trübe -- 
  Allwill schreibst -- -- Clerdon -- willkommen -- -- -- gut böse -- Schnur gehen -- 
  desto Gebrauch -- setzen lose Weib hinzu -- 
  Clärche -- Angriff helfen -- drollig -- verhaltungsbefehle erteilen -- 
  schlagen -- Probe halten -- 
  beileiben -- Amli -- wenn_es kommen -- probieren -- Irre -- 
  ging_es fort -- treiben allerlei -- gewaltig lachen -- Clerdon Zimmer treten -- 
  zanken -- rufen Amli entgegen -- 
  Clärche hat_es tun -- stehen -- ehe ich_es versehen -- Stuhl -- langen Cäsarskopf Console herunter -- versuchen -- Haube stehen -- 
  Überlief kalt -- hinauf langen -- gewaltig geschrien -- 
  kahl Herr glücklich Commode stehen -- Haube Rate ziehen -- Mäntelche fragen -- Anhat -- 
  -- Clerdon halb lachen -- Schäkerei müßen treiben -- 
  unnütz Clär -- Kopf zerbroch Hättest -- erholen -- 
  Deinig nehmen -- passen übrigen -- 
  Cäsar müssen geschwind Haube Mäntelche zurückgeben -- Leben tun -- Clerdon setzen Stelle -- 
  Mädchen Brief Syllie -- Amalia -- kommen beklommen hierhin -- dauern -- 
  mußt Rat schaffen -- Schwester -- schaff Rat ziehen E * -- Syllie umkommen -- 
  schön -- schön -- lieb Syllie -- Amalie hierbei Träne Auge stehen -- Wang Mund -- Zürn -- lächeln Bitte wechseln beisammen -- 
  kennsen Blick Clerdon -- womit Amalie hinüber langen -- anrührt -- Hand beben -- fordern -- Mund Stirn drücken -- Auge auszuruhn -- 
  Clerdon Brief lesen -- stehen -- Wort sagen -- übereinander geschlagen arm Zimmer nieder -- Kopf tief senken -- Höhe richten -- 
  Clerdon -- rufen Amalia -- Rat sinnst -- Frühe gelingen -- 
  Besinn -- sagen -- Lenore Allwill antworten -- 
  heiß -- vorgehen -- Clerdon finsteres Auf- Abgehen -- Wehmut versetzen -- Heimfeld kommen -- 
  liegen Gedanke Knien -- weinen schluchzt Schoß -- 
  schön Amalia Gang Unterredung leiten -- -- erzählen -- 
  -- Amalia Clerdon -- sagen trefflich Ding -- 
  -- Amalia -- -- -- unvergeßlich -- -- -- überall Ernst Scherz -- Clärch Wörtche bequem einmischen finden -- Wörtche übrig behielt -- hintennach eindringlich -- 
  Liebe -- lassen aufschreiben -- 
  ruhig unsertwegen -- Amalies Nähe -- böse -- berühren -- anhaben -- 
  Clärchen Stadt lassen -- Montag bleiben -- Clerdon verschieden abschreiben -- Hand geben -- -- hinzusetzen -- überlegen disputieren -- 
  bloß lachen Disputier -- beständig -- anfangen -- Clär -- 
  gewöhnlich Frage -- 
  Antwort zufrieden -- fragen -- -- -- zufrieden -- Streit Gange -- Zank -- 
  Clerdon -- schwer Begriff eigensinnig -- Preis Übung missen -- 
  stehen Unfried -- loben Abschreib -- entstehen -- 
  Kennst Clerdon -- Gefälligkeit -- -- Lust -- Ochsen -- drischen -- verbunden Maule sehen -- 
  schlau Clär benutzen -- Geheimschreiber wirklich Beisitzer empor Geschwung -- 
  müssen Amalia Standeserhöhung befördern -- gewiß zulassen -- unser Kopf kraus -- Clärchen Köpfchen -- 
  Lust -- schön unser Clerdon bringen -- sagen -- 
  fürchten -- Clär lehren -- spaßen -- 
  -- -- Clerdon wider gemein Sache -- Achselzuck ankommen -- 
  Schlag hingegen -- lassen gelten -- alsdann -- Erlaubnis -- zuweilen Wort führen -- 
  gestern Nachtessen Clerdon aufräumen -- erzählen zuletzt toll märchen -- erzählen -- Brief erheitern -- boshaft Mann -- 
  Hand geben -- 
  ausholen -- wünsch -- gähnen mögest -- Absicht -- 
  Höre -- 
  machen vorgestern Reise Stadt Cabriolet -- 
  Luft hell strengen -- 
  streng Luft blanken Sonne Clärche -- Nacht schlafen -- Auge schwer -- 
  verging nachher -- fühlt Tisch -- 
  Nachtessen desto stark -- zuletzt mitten Rede paarmal Auge zufielen -- 
  Clerdon wissen -- wovon schläfrig -- 
  schieben Katze -- abscheulich Geheule vorig Nacht ruhen lassen -- 
  Armes Kind -- Clerdon -- Wüßtest -- Kätzche Heule Sinn liegen -- Würdest schlafen -- 
  ich_es Strafe erzählen -- Tisch nicken -- gewiß -- nicksen -- 
  Anfang Katze bildschön Kater bildschön Kätzche hold -- kreuzen beständig Auge herum -- -- Kätzchen -- 
  -- kätzch Zärtlichkeit Freund groß Gefallen -- Wonne -- -- -- erscheinen Mäuschen -- 
  Kater -- -- Mäuschen -- 
  Kätzche - Zetergeschrei -- sinken Ohnmacht -- 
  Kätzche herbei -- hören geschehen -- fallen auf Herz -- begegnen begegnen können -- 
  groß Geheul -- jedesmal -- Liebhaber Füßen liegen -- Fuß liegen sähen -- Geheul wiederholen -- Maus Schrecken tief Loch verkröchen -- Liebhabertreu unangefochten lassen -- 
  Naturforscher Clerdon -- 
  Pos -- Brief -- Amalia -- Hand geben -- hinterbringen -- 
  ernsthaft aussehen -- betreffen Pomade -- wovon Haar wachsen -- -- verlangen -- 
  Front -- -- Grecque -- Stirnhaar augenbraunen -- 
  stehen -- -- 
  Hauptsache -- hauptsach -- erzählen -- kommen -- 
  -- -- gähnen -- -- 
  -- sagen -- 
  stehen gestern Fenster unten Saal -- -- reisefertig -- Erwartung Cabriolet -- Augenblick vorfahren -- Heimfeld bringen -- Amalia Clärchen -- 
  stehen -- sagen -- Fenster -- wunderlich Gestalt Mensch -- Haarzopfe -- lüge -- -- 
  dick Arm -- Seitenhaar Löwenmähnen dicht vorbeischweben -- 
  hören klingeln -- Franzose melden -- Töpfche vorgezeigen dringend Gehör bitten -- 
  neugierig -- wunderlich Gestalt genau betrachten -- lassen hereinkommen -- 
  kündigen Zeichen Wunder Wahrheit -- Anzeige -- überreichen -- schreiben stehen -- 
  Anzeige stehen Madame Amon -- -- Liebhaber Menge Haar Effekt Pomade gleichfalls überzeugen können -- -- 
  -- Frage -- -- halb Dukat Haar befiehlstn -- 
  Töpfche eingeteilen -- 
  denken -- Mensch unermeßlich Haarzopf gewaltig Mähn -- hättest halb Dukat überflüssig -- 
  NB -- 
  Haar -- -- bringen Pomade hervor -- jung Leute -- alt Monat -- 
  Verschieb -- Amalie Auftrag geben -- -- Sache obenhin -- ungläubig ausrichten -- 
  Sage -- lieb Syllie -- Glocke -- 
  denken gewiß -- Mittag -- schreiben -- verweisest -- Ankleid fertig -- Höre -- schlagen -- 
  sieh Sonne -- Eck lieben blau Tisch herbei -- 
  Punkt aufstanden -- häßlich Katze poltern Schreie antun -- 
  Schlafe Lärm -- bleiben nachh Schlafe -- Erinnerung Clerdon Pos mir_es lächerlich -- vollends Schlummer -- 
  entschließen Aufstehe -- 
  aufstehen -- Brief Frühstück lesen lassen -- Entfernung unglückseligen Bund -- 
  Laß ungereimt Klage hingehen -- Weg machen -- Entfernung trotz -- Brief heutig Frühstück dedizieren -- 
  Empfang Morgengruß -- blau Tisch -- froh Gezwitscher Menge Vögel -- unser Hecke Obstbäume flattern nist -- abfertig -- hindurch frisch begeben -- Empfang -- nimm Weissagung froh Herz -- laß gedeihen -- sprich Weissagung -- 
  -- 
  Lenore -- 
  XIV -- Beilage Lenore Brief -- 
  Lenore Brief spät -- gestern Abend Post abgehen -- -- sagen -- Schöne bieten -- schön Lenore -- 
  sitzen -- grün Zimmer -- schauen Kastanienallee weg -- auf frei Feld -- 
  Himmel herum schweben dünn Gewölk -- schön Bemalt aufgehenden Sonne -- schön -- -- Lauer -- Augenblick hervorbrechen sehen -- 
  Meinst -- Stumpfnäschen lassen -- hoch Gipfel weg Sonne blicken -- majestätisch Donnervogel -- 
  lachen -- 
  ärgerlich -- Gesichtchen -- lassen -- 
  lieb Syllie -- schämen -- neulich murren -- früh auf Land -- weißt -- Heimfeld Stunde Clerdon Haus -- -- binnen unser dreifach Mauer einbilden -- draußen Frühling -- 
  Hecke Sträucher grünen -- überall -- Erde herauf -- Zweig herab -- fassen lieblich -- äugeln -- o -- Herzig -- Mutteraug angeschlungen Säugling -- 
  sagen -- an Herz greifen -- nahe -- Syllie -- nah nah -- bange lieb Mai -- -- untreu -- 
  Vorgestern spazieren Sonnenuntergang längst Ufern Donau -- 
  setzen singen -- -- Mädchen -- lassen Freude schmecken -- -- 
  Hinaufwärt Strom dunkel -- Dunkel Dunkler -- -- Hell Heller hinab -- 
  sehen dannen ziehen -- Nacht -- Fers -- 
  leise rauschen -- nah vorbei -- herrlich Fluß -- spiegeln Himmel Abendrot schönfarbigen Gewölk Nacht -- 
  erinnern -- gut Syllie -- segnen Seele -- heiter Ruhe -- -- ergießen -- 
  Weggehen rufen -- Nacht -- 
  blicken Stern hervor -- werfen Kuß -- 
  fühlen -- 
  beinahe vergessen -- -- 
  verleumderisch Nachricht Lenore Brief -- ungerügen lassen -- 
  Lamm -- Clärche -- mitzuspielen -- 
  Bestrafe hart -- arm Lenore -- meinen böse Grund -- 
  vorlügen -- arg -- 
  betrügen -- beschuldigen -- Nachgiebigkeit Demut -- Rechthaberei -- bloßem Parteieifer -- 
  Ding -- Schuld geben lügen -- 
  -- lieb Syllie -- 
  Gnade Lenore -- 
  Clärche -- 
  XV -- Clär Syllie -- 
  29t März -- 
  lieb Syllie -- 
  Lenore Brief 22t Nachschreibe -- denken -- Heimfeld -- sieh -- -- bleiben übermorgen -- 
  unterdessen -- -- -- Nachricht -- schwer Herz berichten -- 
  Clerdon Auftrag -- wovon weißen -- wünschen -- erhalten -- 
  freuen -- 
  verreisen Gott wissen -- unmöglich freuen -- 
  Reisest -- 
  -- -- 
  -- 
  -- Syllie -- 
  Seele Flügel -- 
  Flügel häßlich Leim geraten -- Gefied kleben -- Loswerden denken -- 
  Plato sprechen Schrinn Juck Stelle Flügel -- Zeichen Loskleben -- hervortun -- 
  glauben fast -- Mann Zeitvertreibe erzählen -- -- -- -- -- ärgerlich Gänsefed -- womit leidig -- 
  -- lieb Syllie -- Andenken vertiefen -- wandeln -- Nahsein -- 
  fahren Schauer Gesicht -- -- -- gebiet -- erscheinen -- 
  -- sagen Trost -- zürn Clerdon -- -- Philosoph -- Trost nehmen verpflichten fühlen -- überreden -- Ewigkeit sinnlich Wesen bleiben -- folglich Körper -- 
  Hand Füße Welt nehmen -- schlagen sogar Flügel -- Fall Stelle bieten -- 
  -- gegenwärtig Einrichtung verbessern -- stehen -- 
  setzen -- bessert -- Lavateeres Vorschlag -- gabelförmig Einrichtung dergestalt -- Schritt Stern kommen -- müssen schreiten -- fast -- diesseits Milchstraße stehen -- stündest jenseits -- -- wanderen E * * -- 
  streben Erstreb -- Vollbring gleich Verhältnis -- -- bleiben -- sonderlich Seligkeit stand -- äußerlich Aufwand -- 
  bestehen -- -- Herr -- bleiben -- -- 
  Clerdon kommen -- Punkt offenbar Feindschaft leben -- geben jenseits Erde Sinnlichkeit -- streit Sinnlichkeit diesseits -- Ehre lassen -- Clerdon hingegen Sinnlichkeit Ehre bringen -- zuletzt gen Himmel fahren -- 
  mal böse -- Clerdon böse -- 
  Buch Engländer -- Berkeley -- vorn Kupfersticher -- worauf Kind vorstellen -- Erscheinung Spiegel greifen -- wirklich Wesen halten -- 
  sitzen ehrwürdig Philosoph -- Irrtum Kindes lachen -- stehen lateinisch Wort -- Philosoph -- Repräsentant sämtlich ungeneigt Leser -- bedeuten -- lach -- 
  Buch Kinderschuhe ausfallen -- Clerdon -- 
  ausfallen -- meinen -- müssen Höhe heben schütteln -- geben -- 
  nachhelfen -- finden -- -- vorbringen -- laufen hinaus -- -- Auge sähen -- Ohr hören -- säh -- Auge -- hören -- Ohr -- 
  Wort -- böse -- 
  Hernach drang -- sagen -- Auge Ohr sehen hören -- treiben herum Weise -- böse -- 
  schilen eigensinnig bösartig -- Vernunft -- Rinald Feind enthüllen glänzend Schild -- beständig vorhälen -- blind lassen -- 
  Auge -- sehen -- Ohr -- hören -- lauter Ewigkeit geschäftig Vernunft -- dulden -- 
  -- -- geben -- echt Annehme -- Natur ehrlich Gesicht glauben -- neu freu -- bloß -- 
  kommen -- sagen -- Nichtsdahinter -- anderer -- 
  Sprich -- Grund -- tun Klügste halten -- 
  Ärger -- -- Clerdon -- närrisch -- Gespenst -- Gespenster vorstellen -- Ernst -- Ernst -- Welt sehen empfinden -- 
  Bündigkeit Schlußverkettung Gerechtigkeit widerfahren lassen -- womit arm Vernunft gefangen Nähme -- bloß Spückeding lauter Spückedinger -- Kunst bewundern -- erfreuen -- 
  voll Ernst -- allemal voll Ernst böse -- 
  stehen Sache gestern Abend -- 
  hingehen lassen Schreiben Materie -- gestern Abend voll -- erzählen -- Zutrug -- 
  Finanzrat Eck Bibliothekar Sode bringen Abend -- 
  Hader Clerdon gehören -- fragen -- stehen -- 
  Clerdon Antwort -- Feindschaft bitter -- Eck Begierde -- Kampfe gewaltig Clerdon gewaltig Clär beizuwohnen -- verbergen -- beschließen -- ganz Herz Manne -- Lust -- 
  Clerdon Gegenteil beschließen -- -- bestärkt Vorsatze -- 
  Unglücklicher Weise gelingen Amalie -- helfen -- 
  erzählt wunderlichster Weise Behauptung Einwendung -- fragt Amalia -- -- worauf -- boshaft Weise Nachteil verbesseren -- erläutern -- auszuhaln -- 
  albern -- fangen lassen -- voraussehen -- entschieden Vorhaben unartig Leute -- böse sehen -- Einrede helfen -- 
  dennoch erträglich -- Amalia -- sobald erreichen -- einlassen -- schlagen unvermerkt Seite -- helfen Wacker -- Sekundant -- Clerdon Stiche lassen -- hart Stand bekommen -- 
  Mut -- -- verführen -- zuviel wagen -- ziemlich arg Klemme -- Türe Aufging -- Allwilln -- Rolle Papier Hand -- Zimmer treten sehen -- 
  Clerdon rufen Augenblick Richter -- -- Amazoninn fragen -- Schiedsmann gefallen lassen -- erzählen Streit -- diesmal -- Gerechtigkeit widerfahren lassen -- ziemlich -- 
  Allwill entscheiden -- fragen -- Amalie -- 
  Besann Clerdon -- Allwill können Richter -- überall Dame geschworen -- 
  -- Allwill -- geradezu Partei -- richten Schwert -- 
  Clerdon entschließen -- verlangen Allwill -- Beschuldigung gelten lassen -- -- Philosophie -- unser Ohr überall Ohr hören -- unser Auge überall Auge sähen -- Auge Ohr -- rückwärts -- Mittelpunkt Empfindung -- überall Empfindung empfinden -- deutlich erklären -- unser Auge sähen -- unser Ohr hören -- -- Mittelpunkt Empfindung -- Empfindung empfänd -- destowenig -- eigentlich wahr -- 
  wahr eigentlich -- Kraft Vergleichung -- Nicht- erkennen -- erkennen Stande -- müssen bringen -- spräch vernünftig Möglichkeit -- Unterschied -- rein -- 
  Clerdon Forderung -- zuvörderst Klar setzen -- unser Auge Ohr Auge Ohr sähen hört -- wider Form -- offenbar angreifend -- hergebracht Besitze Anmaßung stören Unternehme -- 
  bekennen -- setzen Allwill hinzu -- frei ungedrungen -- begreifen -- zugehen -- -- vermögen bloß Rührung Bewegung Empfindungswerkzeuge -- empfinden -- empfinden -- verschieden Gewahr -- wahrnehmen -- Allerwenigst begreifen -- -- unser innerer Zustande gehören -- unterscheiden vorstellen -- Empfindung verschieden Weise -- 
  Deucht zuverlässig -- ursprünglich Instinkt -- Erkenntnis Wahrheit anfängen -- berufen -- Unbegreifliche behaupten -- Seele können empfinden -- unendlich mannigfaltig Weise vorstellen -- -- Ding -- einzig -- weder -- Ding -- 
  rot Blaß Freude -- Allwill Worte Gedanke finden -- 
  hervor -- Rinaldo -- rufen -- hervor blinkend Schild -- ernstlich bestehen -- Nicht- kommen -- 
  Verwunderung Feind Clerdon -- anstatt böse -- lächeln -- Auge sogar gewiß Glanz Freude funkeln -- 
  Kriegslist unversucht lassen -- Allwilln Schanze locken -- Minerva -- -- -- Warnung -- Nutzen -- 
  müssen Clerdon -- Schimpf abziehen -- Ausrück Nicht Anstalt -- fing -- alliierter übel -- 
  jeder Wort -- womit ausrückt -- angehaln entwaffnen -- Allwill zeigen -- Sinn -- geben -- System zufolge -- können -- -- -- leer -- klar bar Nicht- unvermittelt -- 
  Clerdon Mühe lachen -- Sprache eng eng -- voraus -- zuletzt Hauch Artikulation übrig bleiben -- 
  merken -- Fräulein -- Allwill -- bewundern -- Herr -- 
  fußen -- -- ursprünglich Instinkt -- gebieten -- Wesen Wahrheit -- Festest -- unmittelbar -- vorauszusetzen -- folglich Wahrheit Wesen -- unmittelbar -- Vorstellung geben -- Gott unmögliche befehlen -- platt Unmöglichkeit -- vorauszusetzen -- Art Weise -- wirklich Anschauung geben -- 
  einfallen lassen -- Erwägung ziehen -- Niederträchtigkeit -- blind Gehorsam bequemen -- sichern -- 
  Frage trotzig -- 
  Instinkt aufzuweisen -- 
  Demut antworten -- 
  -- Gewalt Erstgeburt aufzuweisen -- Gräuel -- 
  dennoch Ding Gräuel verbannen -- Name lassen -- vielmehr -- wahrhaften Nicht- -- hoch Ehre gebühren öffentlich bezeugen -- 
  Dienst -- gehen -- unmöglich -- Herz -- widerwärtig zeigen -- unser Verächter vollkommen Nichtigkeit Anspruch -- wahrhaft wesentlich entferntest Weisung erteilen -- verständlich Wort -- Sache Weisung -- vermess -- unaufhörlich Auge stellen -- 
  Nicht -- Nicht- -- lassen -- Fug -- verbinden -- -- Nicht- Gedanke zeigen fähig -- 
  Weg ähnlich Ausdrucke Bedeutung verschaffen -- unser Widersacher -- vermögen systematisch Zusammenhang Grundsatz unwiderruflich abschneiden -- 
  wahr fest Boden ausgemacht -- allgegenwärtig ewig Nichtsdahinter Mensch -- 
  anerkennen -- hinfort Grenze decken -- Grenze fest -- -- denken -- Frieden -- Art Bündnis verstehen -- Feind Freund -- 
  -- -- bieten Clerdon großmütig Hand -- -- weg Frieden -- -- höchstens Waffenstillstand eingehen -- versichern -- bloß Menschlichkeit -- verwundeter Seite pflegen -- tote begraben können -- 
  unterdessen allerliebst Heinunge trefflich Manne herzig Albertin -- Nachtessen bitten -- ankommen -- Waffenstillstand Traktat -- 
  Amalia -- Waffenstillstand wünschen -- Allwilln Rolle -- womit -- Hand nehmen -- Opernscene Maja -- Frage Szene unterbrechen -- ungeduldig stellen hören -- -- 
  -- Streit anfingen -- führen Heinung anstoßend Saal -- setzen Allwilln an Klavier -- 
  Herr bleiben Diskurse -- 
  Allwill schlagen trefflich Klavier -- singen Geschmack Ausdruck -- obgleich sonderlich Stimme -- 
  Szene entzücken -- 
  Oper Iphigenia -- anfangsworter Rezitativ -- 
  Chi Resister Potria -- 
  göttlich setzen -- folgend Arie -- 
  Ombra Cara ch -- intorno t -- Agiri -- Fülle Majestät -- dünken -- Musik erschüttern hingerissen -- 
  Nachher bitten Heinung -- wunderschön Arie Jomelli -- 
  Se Cerca -- se Dice -- fangen -- 
  Enthusiasmus -- worin -- helfen -- vorzüglich heraus bringen -- 
  Allwill fragen -- alt -- einfach Komposition Arie Pergolese -- 
  gehören -- 
  wissen auswendig -- setzen an Klavier -- lassen hören -- 
  musikalisch Kunstwerk fallen Komposition Jomellisch gewaltig -- 
  übertraf -- Gefühl -- Maß Richtigkeit Ausdruck -- Innigkeit hoch Absicht -- 
  finden Tön Bewegung Wort -- che abisso di pene -- -- unübertrefflich wählen -- Versuch -- -- mißlingen müssen -- heilig Cäcilia Himmel -- dergleichen einfallen lassen -- Haus bleiben -- 
  Allwill Freude Eifer -- plagen -- Komposition Arie Meister vorzutragen -- 
  bringen heraus -- machen ungemein Freude -- Pergolese -- bleiben -- Allwill vollkommen Beistimmung -- 
  wissen angenehmer -- Gespräch -- worin zufällig ausruhen Klavier geraten -- fast unmöglich -- interessant Gegenstand -- Behandlung gut Stimmung -- 
  legen -- -- auseinander Zurecht -- -- -- hören Clerdon Wagen Hof rollen -- 
  Tisch rufen -- 
  Abend -- kommen -- schreiben Brief -- 
  Abends 10. -- 
  Clerdon Amalia -- arme -- Schmause Präsident S * -- 
  Mühe erhalten Erlaubnis -- Haus Kind bleiben -- 
  Bette -- eilen -- getan Arbeit ruhen können -- 
  gewiß Sancho Pansa Unrecht -- Mann loben -- schlafen erfinden -- 
  sitzen Klavier -- Allwill -- -- dicht Albertin -- Arm geschlungen -- 
  Amalia Heinungen Canapee gehen -- 
  wissen -- Allwill -- wenden -- -- melodramatisch -- Akkorde greifen -- -- entdecken verschweigen -- -- 
  lebhafte Griff Klaviere -- -- festgehalt Sait -- losreißen müssen -- rücken Stuhl Seite -- legen Hand -- fahren fort -- 
  helfen zurecht -- 
  -- 
  gescheh Singe spielen -- Sache wider Onkel Clerdon verdächtig -- schwer auf Herz fallen -- Feind übergehen -- wack Kusinchen Stiche lassen müssen -- 
  Rufen verschieden Name -- -- hören -- geben -- Gedächtnis -- nennen schön -- rührend -- erhaben -- majestätisch -- himmlisch -- Göttlich -- meinen -- Sait Instrument ablösen -- Ohr klängen -- Empfindung Brust -- Empfindung -- jeder Ohr Brust Töne -- erzeugten -- -- 
  Hierüber ungefähr einig -- 
  -- Ton -- bloß Ton -- angehen -- 
  Klavier Stimme hören -- 
  kommen -- Vorstellung -- Flaut -- Geige Hörner -- Partitur lesen -- brauch sagen -- Wirkung Begleitung Einbildungskraft -- 
  nehmen Augenblick -- Instrument sein gegenwärtig -- hernach denken menschlich Ohr weg -- bleiben -- -- 
  -- erschüttert Luft -- Flaut Hörner Geig Klavier-Ton -- 
  verschieden Ton Ohr -- mannigfaltig Erscheinung lösen rein Vermögen hören -- Quelle -- Grund Möglichkeit -- -- 
  durch Gehör -- -- bloß Hören -- gewahr -- bloß Nicht Gewahr -- Ton offenbar -- bezeichnen Modifikation unser rein Vermögen hören -- -- Nicht- hinzukommt -- 
  entstehen Hörender Gehörtes -- Vorstellung bloß Nicht- -- 
  Verfolg Betrachtung -- sagen -- Onkel -- gehörig bewaffnet -- unterliegen -- 
  -- antworten -- Wort gehörig besonderer verstehen -- Clerdon Rüstung -- gestehen -- finden -- -- plötzlich Mut zuvor Glück versucht Waffe benommen -- 
  verschieden Instrument Beziehung rein Höre sagen -- lassen verschieden Sinn Beziehung gemeinschaftlich innerer Sinn behaupten -- -- -- wirklich Sehe rein sehen -- wirklich Höre rein hören u. S. W. Grund liegen -- empfinden rein empfinden Grund liegen müssen -- zeigen -- Wurzel -- tief eigentlichste Wurzel Leben -- bloß leer Raum Empfindung -- Bewußtsein Bewußtsein -- rein Vermögen leben -- -- 
  Allwill lächelen -- 
  erzählt ungedruckt Aufsatze -- Clerdon abschreiben -- wovon -- Bewilligung -- Abschrift nehmen -- 
  Aufsatze führen folgend Stelle -- auswendig wissen -- -- 
  -- Vernunft blind Thebanischen Wahrsager -- Tiresia -- ähnlich -- Tochter -- Manto -- Flug Vögel beschreiben -- 
  prophezeien Nachricht -- 
  -- .... 
  Gedanke Fragment -- 
  wissen Stückwerk -- 
  sichtbar Welt Himmel erschaffen Geist Wüste scheinen -- ähnlich Wüste -- worin Tausend -- Hunger verzehrt -- Brot Fisch finden -- 
  Brot -- Gott aufträgen -- kümmerlich aussehen -- Fisch klein -- segnen -- 
  gesegnet allmächtigen -- Wundertätig -- Geheimnisvolle Gott -- 
  -- .... 
  Geist -- Entfernung wahren Wesentliche klagen -- Klage hoch Ursprung verraten -- Zeichen -- -- Schöpfer sinnlich Eindruck erheben -- fruchtbar -- Gerüste fügen bauen -- Himmel ersteigen -- --- Götzen schaffen -- Ziegel brennen Stoppel zusammensuchen -- 
  -- .... 
  philosophisch Neugierde -- Ursprung Unvollkommen -- Nichtig böse beunruhiget wundern -- dunkl Bewußtsein Göttlichen Ebenbildes Vernunft halten -- 
  .... -- Gott -- 
  anstatt fragen -- 
  unvollkommene -- nichtig böse -- Frage vielmehr umkehren -- wundern -- endlich Geschöpf fähig -- Wahrheit fragen -- gebiet -- Glückseligkeit Anspruch -- 
  -- Erscheinung Natur Traum -- Gesicht -- Rätsel -- Bedeutung -- geheim Sinn -- 
  Buch Natur Geschichte Schiffern -- verborgen Zeichen -- Schlüssel fordern -- -- Offenbarung glauben -- Auslegung bedürfen -- Absicht -- einzig Absicht Offenbarung -- Beweis Eingebung -- -- 
  Herausgeber Besitze Handschrift -- woraus Stelle ziehen -- 
  überschreiben -- London -- 16ter Mai 1758 -- 
  Fragment anderthalb Bogen -- voll Lücke -- 
  -- Publikum -- Fragment -- einst mitteilen -- 
  Allwill still Aufmerksamkeit -- Gebärde -- Ausdruck -- verbergen -- Gedächtni stören -- einzeln Wort -- womit Pause -- Stelle besann -- Ausfüllte -- 
  -- 
  Auge -- Heiterkeit ergießen -- Gesicht überall durchsichtig -- schön -- sagen fromm Seele -- verbergen -- sehen lassen -- -- -- eye Full of gentle salutations and Soft Response -- -- 
  -- -- zuletzt Hand plötzlich Hand ergreifen -- Lebhaftigkeit küßen -- erschrak -- Furcht anwandelen -- Blaß -- sehen Allwill -- 
  sehen -- stehen -- 
  -- -- Urheber Welt Bild schaffen -- Wesen Wahrheit geben müssen -- Leben erteilen -- 
  scheinen Hauch -- Schatten Hauch -- alt Dichter ausdrücken -- Schatten Traum -- 
  Wesen -- Schatten -- Wesen -- lauter Traum -- Unding -- 
  -- leben -- unmöglich -- Art Leben Dasein geben -- Art Leben Dasein hoch Wesen -- 
  Ton -- Farbe -- -- bloß Sinnenspiel wesenlos Täuschunge betrachten -- Anschauung Wahren groß Zusammenhang neu hervorgehen -- Grund Mißverstande erkennen lassen -- unsäglich neigen -- Buch Natur gut Sinn hinein radieren -- letzter Wort scheinen Stelle Tristram Shandy Th -- III. C. 37. anzuspielen -- 
  Botschaft -- Nachtessen aufgetragen -- unterbrechen -- 
  Allwill fragt aufsteh Klavier -- Plato -- -- 
  -- -- -- Clerdon erzählen -- 
  wissen -- z. B. Seele Flügel bekommen -- 
  -- Gespräch -- worin vorkommen -- näher -- -- -- 
  -- 
  -- -- Jon -- -- -- 
  -- 
  -- -- Teages -- -- -- 
  -- 
  Allwill suchen -- Nachtessen sitzen kommen -- 
  Mißlang -- mißlingen -- 
  mißlingen -- -- 
  mehrere Ursache -- lieb Syllie -- 
  schlimm offenherzig Beicht -- glaubst -- -- verheimlichen -- 
  -- gut Syllie -- Allwilln Abend -- -- -- stören -- sonderbar erschrocken -- Hand küßen -- 
  Augenblick verlegen -- ärgern -- -- 
  vergehen -- denken -- Klaviere weg -- übrig Gesellschaft kommen -- gewiß fehlen -- Allwill sichtbar Begierde -- Tisch sitzen -- kommen -- 
  bang -- sähen -- dawider -- freuen -- 
  neu Ärger -- Verlegenheit -- 
  -- Angst -- lieb Syllie -- -- 
  entdecken -- nämlich -- unmöglich vorstellen -- -- Allwill arg -- machen -- 
  Mensch -- -- Allwill reicch Maß tragen -- 
  gut schöne -- böse Meister -- 
  -- versicherst -- ruchloses -- angetan -- -- froh -- -- böse Geist -- 
  denken -- müssen arm Allwill -- müssen menschlich Natur Gram -- Freude Leben -- 
  bloß Gedanke schlagen nieder -- wehmütig -- -- -- Nacht -- Syllie -- 
  Nacht -- Liebe -- lieben -- lieben -- 
  30t März -- 
  -- Frühstück -- herauf Zimmer gehen -- -- gestern Abend schreiben -- überlesen -- Brief siegeln -- Clerdon Amalia nachgesprungen kommen -- offen Brief Hand -- vorhieln -- -- gefalteten Einschlusse -- 
  Brief 18t 20t -- 
  Augenblick stehen dicht beisammen -- Brief Clerdon lesen -- 
  fallen -- sein anderer Tinte schreiben -- Wort Auge -- 
  -- Clärchen treffen Saite -- beben -- -- 
  --- vorstellen -- wirken -- 
  folgen -- -- an -- 
  dünken -- Leben erschüttern -- 
  ergreifen melancholisch Gesang Briefe Amalia -- 
  widerfahren Amalie Clerdon -- 
  -- lieben Meli -- -- 
  Hättest sehen -- hören -- 
  fühlen -- -- 
  -- Sinnen Herz Geist -- herrschen -- wissen Kraft -- 
  Gott größeres Zeichen geben -- eins wunderbar Weib -- 
  begreifen -- Brief zerknittern aussehen -- 
  Brief lesen -- sprechen -- scheinen unerträglich -- Geschreibe abzuschicken -- 
  überkommen Ekel Verdruß Geschwätze -- Bogen -- Tisch liegen -- zusammenknülln -- hernach Feuer werfen -- 
  Clerdon reißen Hand -- Tisch -- bloß bereden -- Amalia befehlen lassen -- schicken -- 
  Tische Brief Allwill -- verlegen -- 
  Amalia -- abschreiben -- beilegen -- 
  Clerdon wünschen -- 
  fragen -- Clerdon Brief -- 
  lächelt Lese bedenklichen Miene -- hernach -- 
  -- zusehen -- 
  Kusinchen -- nimm -- -- -- 
  -- Kusinchen -- nimm -- 
  -- 
  Amalia lassen -- tausend Grüße -- sagen -- gewiß weißen -- 20t schreiben -- 
  XVI -- Allwill Cläre -- 
  30t März -- 
  verzeihen -- liebenswürdig Kusin -- vertraulicher Anrede -- Clerdon -- Onkel nennen -- entschuldigen -- -- verzeih -- hold Cläre -- bringen -- fordern -- 
  Versuch Schüler -- Meister erfahren -- verstehen -- -- Schüchternheit Eitelkeit gleich Maß ängstigen -- Spiel bringen -- decken -- verbergen können -- 
  Sokrat -- Jugendfreund -- vertreten -- Flügel nehmen -- 
  Jüngling -- Name Teages -- glühend Begierde -- Umgang Weisheit lernen -- 
  prüfen -- Mann Genius verlangen Widerstand -- 
  raten -- berühmt Mann wenden -- Vorteil Gewalt -- womit Mensch fortzuhelfen wüßten -- Genius -- vermöchte -- unterwerfen sein -- 
  Sokrates Widerstand Jüngling traurig -- 
  -- Vater Demodokus -- Begleitung kommen -- Wort führen -- 
  Sokrat treiben Spiel -- Ding reden -- kenn -- gleich Alter -- alt -- -- ehe Umgang -- taugend Leute -- Gesellschaft kommen -- kurz -- -- -- -- 
  leugnet Sokrat -- versichern -- dürfen -- Kunst gut Wille glücklich Erfolg beigemessen -- 
  Jüngling -- Enkel Aristide -- erkundigen -- zugegangen -- Vorteil Umgang ziehen -- lehren -- folgend Antwort erhalten -- 
  -- sagen -- o Sokrat -- eigentlich lehren -- -- -- Haus leben -- Gemache -- 
  Gemach -- dünken -- Gewönne -- 
  redetesen -- gewinnen vielmehr -- ansehen -- ansehen -- 
  Allermeist auf hoch -- sitzen -- berühren -- -- 
  Holde Cläre -- Sinn Worte übernehmen Augenblick -- vorgestern -- Begeisterter -- Hand ergreifen -- Ausdruck verschaffen -- größerem Danke Herz neuem erfüllen -- 
  Sokrat flehend Jüngling -- Vater unterstützen -- -- 
  -- -- Teages -- unser Umgang Wille Dämon erforschen -- sogleich günstig zeigen -- Göttlich -- beiwohnen -- Gebet Opfer jeder fromm gewinnen trachn -- -- -- -- -- Sokrat zuletzt -- -- scheinen -- -- -- -- 
  Glücklicher Teages -- Vorbedeutung Namens -- Gott geleitet -- Wahrheit Erfüllung -- 
  Jünglinge erzählen Plato -- heißen Phädrus -- 
  Phädrus Schüler Liebling redseligen weise -- Name Lysia -- Sokrat finden Tag voll Bewunderung kürzlich Freund Lehrer gehalten Rede -- worin begeisternd lieb Schöne lauter böse -- begeisternd Liebe Vorteilhaft laut -- 
  Sokrat nötigt Phädrus -- Rede vorzulesen -- finden -- Weisheit -- Kunst berühmt Mann seechen -- 
  laufen Lysias -- bemerken Sokrates -- hinaus -- Klugheit Vorzug Unbesonnenheit gebühren -- 
  Schöne -- sagen Lysias -- Angenehme nahe verwanden -- überall gemein Sache machen -- angenehm Vorteilhaft vorziehen -- 
  fände zuletzt -- -- Begierde Vernunft zugehören -- unterschied -- lieb schöne Liebe Nützliche verhalten -- Laster Tugend -- Zustande Besonnenheit Zustand Raserei -- 
  Seite -- versichern Sokrates -- können hervorgezog -- scharf stellen -- besserem Erfolg -- Lysias geschehen -- Ding Überlegung Ding bloß Empfindung erheben -- rein Sache Buchstaben wider unrein Geist verteidigen -- 
  Phädrus zwingen Beweis -- worauf Sokrat verhülln -- Scham Rede stecken bleiben -- Alsdann reden Anfing -- Wort -- 
  geendigt Rede enthüllt Sokrat -- -- entblößt Angesicht -- öffentlich Widerruf Gott Liebe versöhnen -- -- wider Wille -- lästern -- 
  -- Lysias zugeben -- Sokrat -- lieb Schöne -- Natur -- unbesonnen -- -- -- hoch Grad -- Mensch setzen -- Gattung Raserei -- 
  zugeben -- aufhören -- mächtig Liebe -- wahrhaft göttlich Mensch anzubeten -- 
  -- menschlich Besonnenheit vorhergehen -- Mensch Möglichkeit -- Gegenstand -- Antrieb -- Leitung Gesetz -- mittelbar Geschäftigkeit dürftig Nachhülfe erhaben -- sprüch Pythia Delphi Wähn Zeichendeutern Eingeweide Vogelflug -- 
  -- Gott Seele -- Würdest vergeblich Wahrheit besinnen -- Wahrheit ausmachen -- 
  kommen weder Besinnung Besonnenheit Vorschein -- 
  -- Mensch ersinn -- leer Mutmaßung Meinung -- wodurch schädlich -- Trieb Lust -- mißleiten -- Verrichtung Kraft -- 
  sehen Tor -- unmittelbar Begeisterung Muse Tempel Dichtkunst nahen -- Meinung -- bloß Kunst -- 
  Toter Lebendig -- Dicht -- bloß Vernünftig -- beflügeln sprüch Begeistert -- 
  sehen -- menschlich Besonnenheit gründen -- bloß sterblich kärglich Vorteil Dienstleistung Absicht -- wuchern lauter unedl Gesinnung -- erzeugen Tugend -- obgleich gemein Haufen Lob Weisheit Tugend Maß erteilen -- hingegen Gott begeistern -- -- Göttlich -- leben streben -- -- verlangen Höheren Irdische klein finden -- Schwärmer -- Unsinnig Rasenden verspotten -- 
  -- Wort bekannt erinnern -- tot Wort sinnlos Buchstab -- Geist Deutung -- unmittelbar Anschauung Erkenntnis Wesen -- alleinig Geist Wahrheit -- unzuverlässig Rohen -- weisen sicher gewiß -- -- 
  -- unzuverlässig Rohen -- -- 
  Griechischen -- Tom -- III. p. 245 -- 
  c. Ed -- Bipont -- X. p. 318. -- stehen δεινος -- Ficinus Contentiosus -- Jon -- häufig vorkommen -- Peritus -- Tom -- I. p. 532. a. Ed -- Bipont -- 
  IV. p. 182. -- übersetzen -- 
  Kleuker Allwill -- übersetzen -- Herausgeber Freund Kleuker leiben -- Allwill -- 
  Herausgeber -- Mühe Verdruß Phädrus zerstreut Stelle -- worauf Allwill Bezug nehmen -- Zusammengelese -- Ding erinnern -- Mühe lohnen -- 
  scheinen Allwill sogar ignorieren -- fast streitig -- Grieche Zeichendeuter Eingeweide wissen -- 
  Edle Freundin -- -- lassen hören -- -- Plato Weg -- 
  Beweis -- Weg -- halten -- gestern -- Begleitung -- betreten -- erhalten -- betraut Abschrift -- Selbstgespräch -- 
  verfiel Selbstgespräch zwanzigst Mai vorig Jahr -- Angesicht herrlichen Linde Vater Landhause -- kennen -- 
  Urkunde Erdichtung -- Wort -- Schwor Linde glauben -- 
  Erquickendes Grün -- lieblich Farbe schönsn Wechsel -- tanzend spielend Licht -- -- -- -- -- deinen Blick leisewehend Lindenkrone heftet -- sanft Entzück dein Busen füllen -- Regung Liebe wecken -- begeistern -- 
  -- -- 
  Leben Liebe erweckend Schein -- Schrift Sinn Sprache -- 
  klopfen Herz -- drängen Geist -- erheitert Wesen -- leer Züge Bedeutung anschauen -- 
  Stille -- 
  -- näher hinzu -- 
  O reden -- süß Farbenspiel -- red enthüll Wahrheit -- Wahrheit -- 
  winkest Herrlichkeit Blatt Erstreb hoch Dasein -- längst saftvoll Ast jugendlich -- kraftvollst Gestalt brüsten -- winkest -- O -- hoch schlagen Herz -- fröhlich schwingen Geist Flügel -- 
  sehen -- -- 
  Fülle -- Kraft Wesen -- -- ergreifen -- Durchdrang -- darstelln -- erkennen wissen Entzück -- 
  -- 
  bringen Natur gesamt Inhalt Mensch an Herz -- unterrichten lieblich Weise unmittelbar -- 
  verstock Herz -- 
  mißtrauen Weisheit Liebe -- 
  offenbarungen Trug -- Anweisung Fallstricke -- hoch Regierung Taumel Unsinnig halten -- XVII -- Syllie Clerdon -- S. Xvt Brief -- S. 168 -- 
  18t März -- 
  euer lieben schön Brief Heimfeld -- beantworten -- danken -- -- 
  S. VIIIt Brief -- 
  tief rühren euer Schreiben -- gefreut -- gewiß gefreut -- erfreuen -- erwecken -- -- 
  O -- Lieb -- gestehen -- bekenntnis ablegen -- 
  Clärche treffen Saite -- beben stark -- 
  -- 
  Hell wach -- lassen decken -- töten -- 
  manchmal mir_es Augenblick -- geben sich_es -- allmählich geben -- Sitz -- Kopf Hand -- wissen lassen -- 
  glauben -- Liebe -- -- 
  tragen Herz warm -- herum öfter schaudern -- 
  Clerdon -- schämen -- sagen -- 
  nenn Monat -- letzter Besuch -- scheinen -- Vergäßest -- nähmest Anteil -- Freude alt -- 
  Amalia Woche liten -- 
  schreiben Lenore Clärche selten -- 
  verstummtest beinahe -- 
  -- -- versäumtest -- -- nächster Anverwandte -- Blutsfreund leiden -- 
  klagen -- Versank Grübelei -- 
  schreckhaft Wesen bleiben -- 
  dünken -- Licht Zusammenhäng Schicksal aufgehen -- finden außerordentlich -- -- öde herum -- tot -- 
  entsetzlich -- herunter geträumen -- -- desto tief -- entfernt dunkl Anlaß -- 
  -- 
  verbergen -- Wahres -- Wahre Träumen erscheinen -- 
  Wahr -- Unwahr -- 
  heraus -- -- 
  sehen -- ängstigen -- 
  Zusammenraff -- schriebst neulich -- -- -- -- zusammenraffen -- 
  angegriffen Mittelpunkt Wesen -- Mittelpunkt Wesen Hilfe -- voll Hilfe -- 
  -- sagen -- sagen -- 
  merkwürdig Zustand leiten neu Rat -- Mittel -- 
  -- -- glauben -- laut rufen -- Hilf -- Clerdon -- 
  Hilf -- -- 
  müssen -- rufen -- 
  -- halten lassen -- 
  -- 
  beständig fest Hilfe -- 
  -- -- 
  durchkommen -- Durchkomme -- S. IIIten Brief -- einst -- Jahrhundert -- lassen Stimme hören Himmel -- 
  -- sehen -- beten -- -- 
  --- Betende fallen Auge Schuppe -- 
  -- 
  versuchen -- Amalia schreiben -- lieben lieb Brief Eurigen erhalten -- 
  -- arm Luzie - Bruder -- hören -- bekümmern -- 
  -- gute -- bloß Herzeleid -- S. VIIten Brief -- XVIII -- Syllie Amalia -- S. 
  Seite 168 -- 
  19t März -- 
  Liebe -- 
  Treue -- -- 
  sagen -- -- -- -- -- 
  wissen -- 
  zeichnen früh Auge -- unterdessen schreiben Sinn -- 
  unten Mittagsessen -- 
  dennoch schwerlich Blatt -- 
  stören meister -- redet -- hie bedeuten -- 
  -- verstehen -- -- lieb Frau -- geschäftig Wesen -- viele Einsamkeit -- Inneren emsig lassen -- 
  geschehen -- freist Augenblick genieße -- 
  einzeln -- trennen -- -- lieb Frau -- schwinden -- 
  sehen -- drehen Auge -- 
  -- -- 
  O lieben -- 
  Frage -- laß fragen -- 
  -- -- 
  glauben -- Syllie durchkommen -- -- 
  Clerdon Dir_es sagen -- 
  getrost -- ruhig -- stillen -- 
  Montag S -- -- schicken -- 
  würden euer Freude -- säheen -- Übung kommen -- leicht Munterkeit allerhand Leute unterhalten anpassen -- 
  Hierin bringen -- 
  Anstreng -- 
  Einsamkeit hang Leidenschaft -- 
  vertrautest Zutritt Montaigne -- 
  leben -- Lebendig -- 
  Mann -- stillen Gemüt -- Verträglichkeit lehren -- 
  verstehen -- wunderbar aufkommen -- 
  Besseres geben -- verkürz -- hüten -- 
  -- 
  danken -- lieb -- fortgesetzt Wohltat Brief -- 
  jung -- erquicken -- 
  weißen -- dienen -- bedürfen -- 
  weit Hand ausstrecksen -- fühlen aufrichten -- 
  jeher tun -- 
  Liebe -- erweisen -- dargetan -- Erinnerung -- 
  wären Empfindung frei -- gegenwärtig -- Liebe -- -- freuen -- 
  wahrhaft -- 
  fit Sammlung -- 
  -- lieben Amalia -- glücklich -- 
  Stunde stimmen Montaigne -- Amalia -- -- einzig schaffen bilden wurdest -- glücklich -- glücklich -- 
  bitte beschwören -- sorgfältig erhalten mögest Wesen -- bleiben mögest -- Abwehrest -- minde Änderung -- -- 
  20t März -- 
  gestern unangenehm Weise Schreiben unterbrechen -- 
  G. S. -- Freund -- heißen -- Gierigstein -- melden -- 
  Gierigsteinischen sachtsinnig -- Gemach -- mild freundlich Rede lauter Vernunft -- Billigkeit -- allemal -- -- riß Zahn -- S. XIIten Brief -- S. 112 -- 
  dennoch schlafen -- Stunde Zimmer gehen -- Montaigne Hand -- 
  Bombacino begleiten -- spielen zerrt Rocke -- bleiben stehen -- stehen bleiben -- 
  Fuß herum -- Pantoffel schaffen -- 
  Tierchen umgänglich sehen -- 
  Warte -- sollen -- 
  -- Bombacino -- 
  gebacken Mandeln -- Justitzräthinn Melbert Sonnabend -- 
  häßlich Gierigstein verlassen -- Stimmung unleidlich -- wackeren Frau -- verwanden -- hören -- Tant nennen -- 
  Geschenk Tochter -- 
  alt Justizrat erscheinen -- 
  freundlich -- -- Tant nachher Bedienten Körbchen Gebacken -- 
  bleiben -- verweilen -- 
  aufdecken Leute -- sagen -- offenherzig -- -- verbergen -- treuherzig -- 
  anstreich Gefühl -- vertraulich -- 
  kranke -- 
  Waldbeck -- rechtschaffen Mann -- Schar wohlgezogen Kind Haus erinnern -- liegen Tod -- 
  helfen schwer Bekümmerte -- -- 
  helfen -- ahnden -- 
  süß dergleich Teilnehmung hineinziehen -- süß -- willig Werkzeug -- Gott Engel verbergen -- 
  Waldbeck genestn -- 
  sagen -- lieb Amalia -- -- -- 
  Sieh -- Nahrung -- -- hie -- Hole -- 
  Herz -- draußen -- lieb Freundschaft -- eigen Wesen -- ergreifen -- ergreifen Gewalt -- seinigen -- Vereinige Wesen -- gedeihen -- 
  Größeres Unbehagen folgen -- 
  Frage -- -- 
  -- -- 
  -- -- -- -- 
  ich_es Reine bringen wissen -- Ärger durcheinander wirren sehen -- 
  inne halten -- verlassen Schreibtisch -- kleiden -- Tisch -- 
  ist_es Abend -- 
  beständig Regenstürmen abwechselnd Sonnenschem Glanz Untergang -- Abschied -- 
  landschäftchen war_es -- jenseits Donau Fenster erblicken -- 
  sonderbar Hellung Lichtwechsel -- 
  schön -- schön -- feierlich rührend -- 
  stehen -- lieben Amalia -- Syllie stehen -- 
  erschrecken -- Geistererscheinung -- unversehens finden -- 
  -- 
  -- Zimmer niedergieng -- hinblicken -- öfter hinblickt Antigone -- Clerdon Geburtstage übersetzen -- Übersetzung -- Liebe -- Xenophon Gastmahl -- Heft -- liegen bleiben angewiesen Stelle Sessel Schreibtische -- einnehmen -- Liebes -- Leib Seele -- Platz einnehmen sehen -- wiederkommen -- stark bewegen -- fast Erscheinung -- empört mich_es zuletzt -- Verweis -- ernstlich Verweis -- Weine bringen -- 
  -- -- 
  -- Beklemmung -- erfahren -- Herz Regsamer -- Ziehender -- sehnend strebender -- 
  Tropfen Blut scheinen Bewegung -- Seele -- anschaut -- anschaut -- -- Empfindung -- entspringen -- Empfindung -- lebendig -- setzen Herz Bewegung -- schlagen -- schlüge -- -- Blut -- wallen Ader Schläg -- stocken -- anderer Leben -- 
  schreiben -- lieb Amalia -- 
  Clärche -- Lenore -- Kind -- -- herz Seele -- 
  Edmund Syllie gehören -- Syllie -- -- 
  Leb -- lieb einzig -- 
  XIX -- 
  Syllie Amalia -- 
  25t März -- Mitternacht -- 
  Liebe Amalia -- 
  Abend gut Waldbeck -- langsam erholen -- Haus -- finden mitten Tisch dein Brief -- 
  -- schön Sommertage -- Blitz -- Wetterkühle -- zuck -- Dämmerung vermischen -- 
  flammen mir_es um Herz Anblick -- 
  Erbrach schnell -- bloß sehen -- -- stehen -- verschließen -- eilt auszukleiden -- bestellt Nachtessen -- einsam -- 
  Xiten Sammlung -- 
  Labung -- reichen -- vorbereiten -- -- 
  Waldbeck -- schlicht wacker Menschenart -- 
  Vater -- Mutter -- Tochter -- Sohn -- Güte Treue -- -- abstechend Charakter -- finden -- Seite modeln -- Rechtschaffenheit Tüchtigkeit -- -- wozu Charakter bequemen müssen -- arbeiten -- 
  Mann erziehen -- Frau -- erziehen Kind -- rechts links sehen -- 
  Krankheit Frau -- Leute Haus -- nah beseh eigenst Herz nehmen -- 
  früh kommen alt Tochter -- friederike Malch -- hing -- Leben lassen -- sagen -- Arzt erlauben -- Mutter Nachmittag Saale aufhielen -- schön -- hinkommen -- Freude -- 
  Tisch -- finden beisammen Saal -- 
  Waldbeck empfangen Rührung -- derben -- biederen -- munter Manne Sage schön lassen -- 
  Genesende Blick Strahl angesichts -- wobei Auferstehung Gedanke -- 
  umzingeln -- Waldbeck -- Mädchen Knabe -- Sessel Mutter drängen -- 
  umfassend lassen nieder Knie -- Ohr lispeln -- still -- Gesicht Busen verbergen -- Winken Ordnung bringen -- 
  lieblich -- 
  wack Fischering -- Vicarius Böck -- treu Seele -- Bruder -- Assessor -- -- kommen -- 
  vielerlei sprechen -- verständig -- 
  hören mehrenteils -- freut still Geist -- gesund Vernunft tun -- Mensch Natur Verstand -- -- Fantasie beschaffen -- gut -- treu tüchtig Mensch fest stehen -- Fels -- 
  Grundsatz -- Regel Glaube ehrwürdig -- bleiben gelten -- 
  urteilen wandeln -- Furcht Zweifel -- 
  -- hoch Versicherung geben -- sagen -- 
  gewiß -- stehen -- reden -- Feder Hand -- feierlich -- heißen -- sagen -- 
  Gott Himmel leben -- -- 
  selig hoffen -- 
  nehmen Wahrheit Treue Anfang -- eigentlich gesund Vernunft Haus -- 
  Wunderlich Mute -- Leute Welt -- Geistern befinden -- zusehen -- Gewalt Umstand -- nichtswürdig Ding -- behielt -- scheußlich Ohnmacht Umstand liegen -- Gram Scham -- 
  -- Fantasie Jugend bilden -- späterhin verzerren -- 
  Mensch -- Glanze -- hinstellen biederen -- fest -- überall treu Mann -- Waldbeck -- innerer Wirtschaft vergleichen innerer Wirtschaft -- schauderen Kontrast -- 
  -- stet Gang -- fortgesetzt Leben Zucht -- Mut -- Freudigkeit -- Standhaftigkeit -- 
  -- trüben Taumel -- ewig gestört -- zerbrochen Leben Unzucht -- Feigheit -- Unlust -- Wankelmut Selbstverachtung -- 
  schlagen -- ehe wir_es versahen -- 
  Arzt Verweis Aufsitzen kranke -- 
  bringen Ruhe -- bleiben Stunde lieben Weibe Bette sitzen -- beinahe vergessend süß Geschwätze Mädchen -- allmählich umklammern -- 
  unterdessen Mutter eingeschlummeren -- 
  schlichen fort Saal -- Mantel Arbeitsbeutel liegen -- 
  sehen -- Wolke -- Mond mittlerer Fenster stehen -- 
  Waldbeck Saal entzückend Aussicht -- Donau -- nahe vorbeifließn -- Hand herunter -- -- unterscheiden -- Seite -- 
  gleich Bewegung fliegen stehend Fenster -- bleiben -- -- 
  ziehend Wölkche -- -- bewegt formn -- Mond helle lassen -- 
  licht lichter -- stehen rein -- überziehen Strom -- zitternd Glanze -- 
  Mädchen vergleichen Silbertropfe -- hinein regneten -- 
  Abschied -- Haus -- finden dein Brief -- 
  liegen unten Rand Zeichnung -- -- Maratti -- vormittags vollenden -- schlummernd Knabe -- wahr Engelsgestalt -- 
  Schlummere fort -- schön Junge -- Auskleide zurückkommen -- Engel -- stören -- -- rücken leise Sessel -- lassen leiser nieder -- vorsichtig -- Tisch stoßen -- 
  lesen Kapitel Allwill -- womit stören -- fing vorn -- -- Las Langsamer -- -- unvermerken -- Blatt lesen -- lesen Blatte -- Meli -- gut Meli -- -- 
  Sieh Hold lächelnd Engel -- 
  Ruheseite liegen -- Kopf sanft auf Ärmchen stützen -- schläft -- -- 
  Meli -- 
  singen -- -- Schlummer Genesung kommen -- 
  Sanft eingewiegen Herz -- süß warm Fülle -- Fülle Liebe decken -- 
  Herz -- Fülle Liebe -- Unschuld -- Deines Glauben -- 
  -- stillen -- 
  Vorhang hindurch glänzt hochstehend Mond Auge -- 
  -- denken -- stehen -- 
  Helle frei Mond scheinen sehen -- 
  Wölkche weg -- ziehen seitwärts -- hierhin -- dorthin -- Truppweise -- lauter rund Wölkche -- überall schön blau Himmel -- hie Sternlein -- blinkt Sanft -- 
  Stern -- hell -- flimmeren rasch -- 
  -- 
  -- flimmerst -- Heller -- -- 
  Helle freundlich -- erwehren -- lächeln erwidern -- ertappen -- 
  Schlafzimmer denken -- 
  holen Schreibtisch -- setzen Sofa -- schreiben -- lesen -- 
  überlesen -- dein Brief gehen -- süß Pause -- 
  -- lieben Meli -- -- woran Ruhe Stille anlehnen fühlen -- 
  gegenwärtig -- stellen dar -- Bild -- Wort -- Wort unaussprechlich schöne -- heilig gute hergenommen -- Zeichen -- 
  Angeschmiegt Unsichtbar Gefühlen -- ich_es -- halten ich_es -- umfassen -- tragen heben -- 
  Sieh -- stürzen Träne Auge -- gewiß Zug Weinen Gesicht -- Züge Heiterkeit aussagen -- umgiben -- erfüllen lauter Wonne -- 
  Laß -- Holde -- Liebe -- laß Stelle entgegen schlummern -- 
  Ruhe sanft -- 
  26ten -- 
  gute -- Amalia -- gut -- Schwester -- 
  sinn Name -- Grüße -- finden -- suchen -- 
  Glücklich finden -- fandest Such -- 
  Mutter -- riefst -- o Mutter -- kommen Mutter -- -- umgeschaffen Zuruf -- 
  -- lieben Meli -- verstehst -- -- Einzig -- Seherin -- Träum -- arm Syllie -- Seherin offen Auge -- Seherin Wahrheit -- 
  Vergleich Schreiben -- 
  hattest rufen -- 
  komm Mutter -- kommen Kind Kind Vater -- kommen Mädchen Heimfeld -- kommen lassen -- 
  krank Syllie träumen fort -- wein lieb Wort Clerdon -- Edl -- herrlichen Mädchen -- 
  Sage Clerdon -- sagen Clärche lenore -- sagen dein Kind -- Syllie -- 
  lassen -- ehe Blatt abfallen -- -- 
  Mutter Mutter bleiben -- welcher Engel -- vorzusagen -- 
  ich_es finden Brief -- dünken -- hören erstenmal -- Krone aufgesetzen -- 
  Jahrszeit -- Gustav Herzen regen fühlen -- 
  er_es treffen erwachen -- Freute -- 
  hattesen Gatte -- warst Schwester -- 
  wählen -- wählen -- 
  O Zärtlichkeit -- Natur anherzen -- -- 
  sie_es aufnehmen -- vertraulichen Schwestergruß Händedruck Küssen erwidern -- 
  Hand -- Kind -- mitnimmen -- -- Komme -- -- sollst helfen -- 
  Entfalt Blüte -- Sprossen Blatt Zweig -- geschehen -- helfen -- geschäftig -- 
  fühlen ich_es -- 
  Vöglein -- Bäumen versammelt -- vielerlei Art -- zwitscherten -- Sange -- flattert fliegen -- nesthärchen Anlegt bauen -- 
  -- -- Auge -- Ohr -- Teilnehmung Sorge -- 
  Luft regen -- Witterung Leben -- süß Ahnung hinzu -- jeder Anliegen meinigen -- 
  wissen -- öfter denken -- erfolgen -- nachher geschehen -- bitter Schmerz erführ -- entbehren -- unaussprechlich lieben -- -- sehen Engel -- drücken -- Kose -- lächeln -- Blick nossen -- Lalle -- Freude -- Wiederliebe aufgesäugt pflegen -- läge erstarren -- müssen Grab tragen lassen -- finster Grab -- 
  .. grauen fürchterlich -- 
  dennoch geloben -- prägen tief -- -- unsäglich leiden -- Seligkeit -- nossen -- vergessen -- rein Liebe -- -- Tod segnen -- 
  versprechen Gustav -- wiederholen -- leben -- Versprechen heilig -- -- 
  O -- Mutter -- Mutter bleiben -- Misse -- -- 
  Liebe Amalia -- hell Stern -- freundlich winken -- anlächelt -- lächeln erwidern müssen -- Gustav -- Gustav erscheinen hell Stern -- 
  überall verstehen -- herrliche -- wissen Nichtwissen -- Stolz Demut -- 
  Clerdon Manne laut hierher -- -- Instinkt Buchstaben -- Vernunft bringen -- -- Blitz Seele fahren -- 
  erinnern treffend Wort Fénelon -- 
  -- Mensch verkehrt Wesen -- Fénelon -- Auge -- Schatten erblicken -- Wahrheit erscheinen Trugbild -- 
  -- halten -- -- halten -- 
  findest Stelle Buche Gott -- Schlus Teil -- Gottheit anreden -- 
  Laß Stelle einrücken -- 
  -- Wärest ohnmächtig -- leblos Körper -- Blume verwelken -- Bach vorbei fließen -- Gebäude stehen hinfällen -- farbengemeng Gemälde -- Einbildungskraft Gestalt hineintragen -- Glanz überzogen Metall -- 
  Mensch merken -- -- Torheit -- Vermögen zuerkennen -- Freude gewähren -- obgleich Freude Seellosem ausgehen -- -- Quelle Leben Genusses -- 
  Wärest Wesen gröber Art -- hinfällig -- leblos -- Maß Selbstvermög -- Schatten Wesen -- nichtig Natur Nichtigkeit beschäftigen -- Wärest angemessen Gegenstand niedrig tierisch Gedanke -- 
  -- einkehren -- verborgen Gott -- 
  innerer weitesen irr geworden Blick entfernen -- 
  Ordnung Schönheit -- Angesicht Geschöpfe strahlen -- Schleier -- krank Auge entziehen -- -- 
  Sage -- lieben Amalia -- 
  auffallen -- -- stehen bleiben -- stehen bleiben Wärest -- -- Mensch entschließen sterben -- 
  wählen Tod Leben vermögen Tier -- 
  sinnlich Trieb -- Erhaltung -- zwingen -- Erde fortsetzen -- 
  Mensch vermögen -- 
  wähltest Leben -- wählen Tod -- Antigone Schwester Ismene -- 
  lieb Mensch geben -- Tod Füße treten -- Schmerz achten Lust -- 
  Same Anschauung -- Bewunderung Achtung -- 
  Alsdann verlieren Mensch Leben -- gewinnen -- 
  erwachen Instinkt vernünftig Natur -- Seele Leibes -- Geist Seele erhalten -- empor bringen -- herrschend streben -- 
  hiermit -- Einsetzung Liebe -- Tod überwinden Unsterblichkeit biern -- Welt anfangen -- 
  Geheimnis Liebe Leben durchdringen menschlich Blick -- 
  Regsame fangen Begierde -- Gegenstand kennen -- 
  -- hie lüften leitend Trieb dicht Schleier -- 
  jeder Leben -- dunkelsen -- fordern Erhaltung Nachdrucke -- -- 
  Nachdruck tief verborgen Leben mächtigsten -- heilig -- 
  erkennen -- fühlen -- vertraut -- -- sagen -- finden -- -- sehen wissen -- Welt anfangen -- 
  27t März -- 
  Punkt Allwill Brief beantworten -- 
  jung Manne denken -- weißen Brief Lenore Clärchen -- 
  überspannen -- schreiben -- Verhältnis gute böse -- angeben -- wahrscheinlich Richtigkeit -- 
  kenn Menschengattung Grund -- Gelegenheit -- beobachten -- Interesse -- wovon Herz bluten -- 
  geraten schreiben Brief Bewegung -- vorwerfen -- sobald fort -- 
  Dergleiche öfter begegnen -- müßt fassen halten -- 
  mancherlei Rückfall hergehen -- S. XIIten Brief -- 
  Menschengattung angehen -- gründlich behaupt -- führen vorzüglich Anlage -- voraussetzen -- Gefahr Mißbrauch -- 
  -- Hüte -- irgendwo lesen -- -- -- Hüte -- Gott zeichnen -- -- 
  jeder Übermaß Kräften reizen Art Gewalttätigkeit Unterdrückung -- 
  hierzu Allwillen -- vorzüglich Gabe zart lebhaft Sinnlichkeit -- Gewalt Affekts -- ungemein Energie Einbildungskraft Grund liegen -- 
  nennen Affekt Einbildungskraft -- Einbildungskraft Allwille vornehmlich Einbildungskraft Affekt -- Mensch freier Geist Vermögen -- 
  Mischung Grundeigenschafte Einzeln -- einzeln Verstand -- Besonnenheit Wille Art Weise -- 
  Gefahr annehmen Gattung -- hell Kopf -- hoch Grad Ruchlosigkeit einstellen -- 
  Helle Kopf Übergang Empfindung Reflexion -- Beschauung Wiederbeschauung - Beihilfe Gedächtnisses -- schnell -- Mannigfaltiger -- gegenseitig -- durchgreifend -- umfassend -- Anschauung -- Betrachtung Empfindung Art -- groß Fertigkeit gediehen Selbstbesinnung -- Geistesgegenwärtigkeit innerer Sammlung -- Held Gattung -- ärgsn Beklemmung Leidenschaft -- verlassen -- unaufhörlich verschlungen -- Gewalt natürlichen -- 
  Mensch -- sittlichen Teil -- Poesie -- -- Wahrheit verlieren -- ehrlich Faser bleiben -- 
  Vollkommenheit Zustand eigentlich Mystizismus Gesetzesfeindschaft -- Quietismus Unsittlichkeit -- 
  egoist Zauberer Klasse -- 
  leidenschaftlich Bewegung -- Natur -- eigensüchtig -- 
  Regel annehmen -- empfindsamer Mensch -- -- eigensüchtigeren -- 
  -- -- Gegenteil -- 
  aufopfern -- -- Maße rühren -- 
  verstehe -- 
  bloß empfindsamen -- -- meinen -- besonderer Gattung bloß weichschwachherzig Beber -- Trembler -- gelitten -- 
  zärtelei Heuchelei -- Ohnmacht Tücke widerstehen sicherbar -- fliehen -- vermeiden -- 
  Allwillen vertragen eher -- zumal Vollkommenheit Gattung erreichen -- 
  widersteh -- Planvolle kalt Egoist -- niedrig Klasse Art gehören -- Gierigstein -- 
  Allwille äußerlich schonen -- Größe -- Fall Edelmut beweisen -- -- verdorben -- schön Regung Seele häufig blicken lassen -- -- selten leiten -- weder verachten -- beständig hassen -- 
  gefährlich -- 
  Eigensucht hart grausam -- -- 
  eigentlich Verleugnung fähig -- Federkraft Sittlichkeit tot -- 
  enthalten -- schlimmer sagen -- abbrächen -- 
  euer Eduard angehen -- genügen Mißtrauen -- Mädchen verwahren -- 
  Clärche ohned Gefahr -- sehen hell Lenore geben -- 
  Clerdon beschönigen -- 
  jung Lieblinge treiben -- jeher Mensch treiben -- woran lebhaft Anteil -- 
  scheinen -- geschickt -- Falte menschlich Herzen durchdringen -- desto fertig -- einzeln Fall täuschen -- 
  erdicht Mensch -- -- glauben -- müssen irgendwo vorhanden -- -- wirklich Mensch -- nirgend finden -- 
  Umfang -- Art Charakter -- Wunder -- 
  Einbildungskraft bereit -- hundert Plan vorlegen -- derjenige heraus wählen -- Vorstellung leichtesten ausführen lassen -- gegenwärtig Affekt wünschen -- 
  Verschwindet Affekt -- überschauen nachher gemacht Beobachtung -- Mensch -- wissen -- -- -- 
  Übel bekommen -- Clerdon lesen gibst -- 
  ergeben darein -- grüß herzlich -- Papa Allwill -- 
  XX -- Eduard Allwill Luzie -- 
  lang sendschreiben -- Luzie -- Mal lesen -- Seite werfen -- sitzen Stuhle fest -- Schreibtisch ungeheuer rund Tafel unser Ratssaale -- -- teur Fräulein -- sein Landesherrliche Porträt grün goldbefranzt Baldachin -- merken -- sofern Porträt -- -- vorstell -- traut Tischlein verwünscht ungeheuer rund Tafel Ratssaal vorstellen -- Vergleichung einzig fest Sitz gründen -- 
  närrisch -- ungefähr -- Arge -- Bildnis gepanzert Erdengott verwandeln -- -- lieb Luzie -- jüngst -- Weisheit Himmel Erde tratest -- Scheitel Sohle schön gebläutem Stahl -- mächtig erhaben linker Fuß -- Bein künstlich Erde geschwungen -- empor heilig -- Haupt Lorbeerzweige beschatten -- Wesen begreifen -- Verdauung göttlich Eule -- roh Ungepflückt hinuntergeschlucken hattest -- 
  gewiß hattest neulich gering Person veredelt Gestalt erblicken -- unermeßlich Perücke trotzig Haarzopf -- dick Schweißtropfe Stirn preßen -- Seraphimsflügel Schulter -- Fächer -- anzuweh -- dienen -- ebenfalls Bein stehend -- fest Fels -- -- 
  O kommen -- kommen -- lieb Luzie -- laß zuhinken -- dein Helm -- Perücke hineinlegen -- -- Sieh -- Eduard Luzie -- Auge -- reden -- -- 
  Schade -- lieb Luzie -- 
  Schade Weisheit -- prächtig Verwandlung -- worüber gratulier pflegen -- gemeiniglich sagen -- -- schämen -- 
  schwitzen Sommer -- frieren Winter -- Fall kleiden Taft -- letzter Pelz -- meistens Geschichte -- 
  wissen -- ptolemäisch epizykloid Ding -- -- Wallberg erinnern -- 
  Auf Ab Durcheinanderschwingung -- Mittelpunkt -- Planet treten Grenze Zirkel -- 
  liegen klar Gedächtnis -- ehemals -- merkwürdig Sinnesänderung -- wahr Weisheit bekehren -- einzig Weg Glückseligkeit betreten glauben -- entsetzen Scham vergehen -- weniger -- weniger Stunde -- unbegreiflich Tor -- 
  -- o Tyrannei Schicksal -- unbegreiflich Tor stattlich -- weise Mann -- an Licht -- schämt Vorfahr -- kurz schämen -- 
  Schelm tun -- alt deutsch Sprüchwort -- 
  lassen schön dicker Buch Sprüchwort schreiben -- -- einer Unternehme -- 
  Feuriger -- geistvoll Jüngling -- Epictet -- -- schlechterdings Schelmen -- 
  -- schön Entzück lieben -- genau Maß halten -- Irre -- 
  wissen -- Freude Torheit -- euren Überdruß -- euren Ekel -- eur Mattigkeit nachfühl -- lieben Graubärt -- 
  Mut euren Furcht entsetzen -- 
  -- schmerze trotzen -- Tod -- Lust wittern -- 
  -- euren innerer Sinn geben -- hätten -- hören -- vollends Genuß Leben rauben -- 
  kopf -- bissch Wesen -- eur Vernunft ärgsn Unverstand -- höchstens Schreckbilder Schwermut Einbildungskraft staffieren -- 
  Stimme tönen Alsdann Ohr -- verdrießlich Gegreine -- Weh -- 
  ärgsn Quale unaufhörlich leiden -- Leid widerfahren -- 
  Lehre eur klug Weisheit verstehen -- annehmlich finden -- Seele Zustande Gleichgewicht befinden -- lebhaftesen Begierden -- eingeschläferen -- -- Stand -- Lage -- entzückend Freude empfinden -- 
  --- Hole Henker Zustand wacker Junge -- 
  genießen leiden Bestimmung Mensch -- 
  Feige lassen Drohung abhalten -- Wunsch verfolgen -- Herzhafte spotten -- rufen Liebe Tod -- 
  wissen Schicksal ertragen -- 
  hohl Idee Welt -- bloß Vernunft Basis Handlung können -- Vermögen -- gegeben Empfindung Neigung Herz vorzuschematisieren -- augenscheinlich überall Dienst ursprünglich Lebensquelle geschäftig -- Richtung -- letzter Bestimmung -- Kraft -- Bewegung einzig hervorgehen -- 
  Preßwerk -- Blut Ader spritzen -- Herz Busen tragen -- Erde fortdauernd Gemütsruh stimmen -- Erfüllung wünsche schmecken -- 
  -- glücklich -- glücklich -- 
  Feig -- Zufalle beben -- fast -- Betagt -- eur Freistätt flüchten -- wagen neu Haut -- Freude hasch -- Fülle Leben genießen -- 
  schaffen Mensch Gott -- bisschen Unsinnig -- behaupten -- -- Gott -- 
  Glaube -- Holde -- Liebe -- gut -- bleiben Sinne Natur -- 
  Wesen Unschuld -- annehmen -- Umstand Ohr raunen -- befinden -- Monde -- 
  brauchen stark Gefühl -- lebhaft Bewegung -- Leidenschaft -- 
  gewöhnlich vernünftig klug Wandel meinen -- erkünstelt Sache -- Seelenzustand -- voraussetzen -- zuverlässig -- wenigster Wahrheit fassen -- -- 
  Nimm -- Haus künstlich Einrichtung bauen -- -- Licht Dache aufsteckt -- Haus erleuchten -- 
  geschehen -- -- Docht ausspreitet auflockeren -- -- Schimmer Gebäude dringen -- arm verwirrend Dämmerung -- 
  gewöhnt Dunklen hantieren -- 
  indessen -- Kunststück -- Bewunderung Anspruch -- verständig Licht allemal tragen -- gegenwärtig sehen brauchen -- dunkel lassen -- -- 
  fest Grundsatz bemühen -- unwandelbar Tugend gelangen -- 
  klingen -- vorschlägen -- Grundsatz Tugendhaft -- vorschlüg -- Grundsatz verlieben -- 
  Verliebter -- Empfindung -- Vorsatz -- freilich treu -- 
  Herzhaft -- Großmütige -- wohlwollend -- leidig Trieb -- Empfindung entbehren -- Zeit herzhaft -- großmütig -- wohlwollend -- besonderer Fall -- Nicht-Seher -- müssen -- -- 
  O -- -- 
  wissen -- Mensch gehüten -- -- -- empfinden -- Empfand -- früh strenge angewiesen -- schön -- finden müssen -- gefüllt erkünstelt -- erzwungen Glaube -- verwirrt Wesen gewaltsam Verknüpfung unzusammenhangend Idee -- hinweisen -- Hingestoß schiefen -- erlogener Existenz -- 
  dennoch behalten wahres Leben Oberhand -- 
  retten Herz -- 
  ferner gehorch -- Ohr Stimme neigen -- 
  vernehmen -- unterscheiden -- verstehen -- Weisheit -- mutig folgen -- Tugend -- 
  Schrei Gefahr -- lieb Luzie -- 
  -- Ruchlose vorgiben -- tun -- ruchloser -- 
  jeder Wesen ersprießen Natur -- schön Seele -- Keim -- schön bilden -- 
  zuverlässig -- Herz edel geboren -- -- -- Nimm Moral -- Philosoph Leben -- versuchen streng Vorschrift wandeln -- wahres Gefühl Schönheit Vortrefflichkeit -- Ausnahme stoßen -- 
  -- Furcht verirren -- Ausnahme gelten lassen -- 
  Herz Verstand verstockenn -- Geist frei Bestrebe unfähig -- 
  nehmen einzeln Mensch -- gefühlvollsten -- stärksen -- lassen -- gemachen unzählig Erfahrung -- bloß Person -- freisn Mute -- Philosophie Leben entwerfen -- 
  Folge Ausnahme stoßen -- fürchten -- gelten lassen -- Art Maschine -- wiewohl vorzüglicheren -- Rade gemein Vorschrift drehen -- 
  allzu gegenwärtig Gefühl unterdrücken -- glauben -- trauen -- folglich bloß Buchstabe handeln -- 
  umgeht -- verdrehen Gesetz -- Kerl Heuchler -- Schurk -- unterwerfen redlich -- allmählich Sinn Gefühl -- -- hoch Fertigkeit Tugend treiben -- desto kälter -- geschmackloser -- horchen -- Blindling sehend -- -- ehemalig Wille -- Wille -- Hinfort empor schwingen -- 
  wissen -- -- Sicherheit -- Richter dürren Buchstabe Gesetz urteilen -- Betrachtung blind -- abscheulichst Untat gerichtlich bestätiget -- Bösewicht Buchstabe Gesetz handeln -- Form Prozedur Schutze anwenden -- gewissenhaft Richter -- müssen -- wärm Menschenfreund -- verderben vervorteilt Rechtschaffen aussprechen -- 
  Mensch Richter -- anderer -- gesetzmäßig -- öffentlich Gewissen -- verurteilter Verbrecher halten -- 
  -- sehen -- Richter unbeweglichen Sittenbesteller -- 
  wissen -- Weg -- 
  System Glückseligkeit -- -- lehren -- hoch Genuß Menschheit -- -- wissen -- jedwed Umstand -- Auge Harmonie Bedürfnis -- Seele Maß menschlich Kraft -- 
  Hochweise -- hochgebietend Herr -- -- 
  sing anderer Lied -- wovon Melodie Walze eur heilig moralisch Dudeldey nageln -- 
  genießen verschieden Kost -- Tisch sitzen -- gesund Verstand -- gesund Sinn gehen eurer Krankendiät Schande -- 
  überlassen gut Natur -- verlangen -- Fähigkeit erwach -- Kraft Menschheit rege lassen -- 
  freilich drängen sich_es -- 
  frei Bewegung helfen -- passen -- sondern vereinigen -- -- bessern -- -- -- 
  hohulächelst -- weiser Mann -- 
  Register Vergehung -- Torheit -- -- 
  Sage -- schlimm -- Törichter -- -- -- schlimm -- Törichter -- glücklich -- -- -- -- 
  wehet Empfindung lebendig Atem Natur -- vermehrend -- ewig neu gebärende -- -- 
  Laß wehen -- -- 
  -- fallen -- aufstehen -- glücklich fortwandeln -- 
  dir_es Amm -- Falle lernen -- -- 
  O Doppeltgegliederten -- Krüppel eur Gängelwag -- 
  traurig ansehen -- gut Leute ängstlich emsig -- zusehen -- -- -- böse -- Ungerechtes verursachen zulassen -- Trübsinn zehnmal arg anrichten -- unsäglich Unheile Schuld -- 
  -- pflichtwidrig -- abwesend Nachbar verschlossen Türe einzubrechen -- überließen wahrscheinlich -- dringend Gefahr -- -- Garten ruchlos Sohn ermorden -- 
  verlören arm Nachbar Nährer -- Helser Freund -- müssen Sohn Rade sterben sehen -- 
  Gesetz übertreen -- Vorzuwerfe -- behielt rein Herz Gewissen -- 
  lassen Weise dartun -- Menge Beispiel erläutern -- Begriff entschiedenst Tugende schwankend bleiben -- zuweilen Mensch vortrefflichsten zeigen -- schnurstracks entgegen handeln -- 
  Fall gedenken -- erhabenste Verdienst -- -- -- -- -- -- -- -- -- -- -- leiten weit Feld -- 
  vorhin -- 
  erhabenst Tugende -- allgemein Anwendung vertragen -- übrig schützen -- vermehrt -- biern -- durchgängig Wahrhaftigkeit -- 
  göttlich Mensch müssen -- entschlössen -- -- 
  notwendig Rechtschaffenheit leiten -- Vorsatz ausführen -- Unwahrheit sagen -- Achtung Mitmensche -- brennend Spiegel -- Gestalt werfen -- 
  erinnern Vorfall -- Leidenschaft befriedigen -- Betrug Hilfe nehmen -- stellen -- -- anstatt heimlich Werk -- derjenige -- hintergang -- nackend Wahrheit -- eigentlich Vorhaben entdecken -- Auffahr erblasse bloß Gedanke -- -- Leichtsinn -- Absicht Wahrheit -- Sohn Vater Laster -- Helm Schwert -- klein Lüge einer ärgsn Verbrechen -- Menschheit -- -- 
  unser Zeit unüberlegt Entschluß fassen -- Unwahrheit sagen -- 
  Zeit Fall geben -- Trieb erhabensten Menschheit -- Eingebung Gott lügen -- 
  -- -- O entsetzlichen tun -- -- 
  -- -- -- antworten Desdemona -- ichselbst -- leben -- bring Gemahl letzter Gruß -- o leben -- -- 
  -- Othello rufen -- 
  -- Lügnerin Hölle fahren -- war_es -- ermorden -- -- 
  -- -- o gerechtest Gott -- Lüge Mund Geist aufgeben -- dein Richterstuhl stellen -- 
  sogar schwankend -- vorhin Behuf Wahrhaftigkeit -- Unverstelltheit -- Offenherzigkeit vorbrachen -- z. B. -- scheuen selten unschuldige -- Ruhmwürdige sogar -- offenbaren -- böse Schändliche -- Schüchternheit überwinden -- zuweilen Heldenmut vonnöten -- 
  schön Register eur sogenannter Tugende Weise durchgegangen -- Mischmasch betrachten -- -- chemisch Prozeß Seele treiben -- hermetisch versiegeln möchten -- -- 
  -- billig -- -- Art Gewäch -- Kastanie trug Pomeranz -- Anana -- Erdapfel -- Rosenstrauch -- Leib -- Dorn -- -- -- Asien liegen Europa -- bemühen -- Kunst Barometer Thermometer treiben -- Erde Zonam Temperatam bekommen -- schön fruchtbares Wetter -- Tugende erwerben ausüben -- Ball schlagen -- Taroc -- -- l'hombre -- -- -- -- -- 
  denken lassen freilich -- -- 
  schimärisch Vorstellung wahren -- Traum Wirklichkeit -- -- 
  erwägen -- unendlich Unterschied Bild Sache -- Begriff Anschauung -- 
  Menge entgegengesetztest Ding Begriff nehmen -- folgen lassen -- 
  denken Himmel Hölle -- ungefähr Mute -- -- 
  überwiegen häufig sinnlich Reiz Vorstellung schrecklichst Plag Zukunft -- Lumpenkram gelernt Religion gelernt Moral -- 
  Mensch -- beständig Anschauung edl Gegenstand -- unedel handeln -- minder -- minder schön Anschauung -- hoch schöne bloß angeblichen -- anschauungslos Begriff -- handeln gemäß -- 
  stimmen Mensch Fall setzen -- 
  beständig Widerspruch Handlung Grundsatz -- Irrung System Grundsatz -- irrleitend -- Kombination bloß spekulativ praktisch Begriff -- -- 
  Meinung -- Entschlüs Kindheit Köpfe schrauben -- Gesinnung hineingedämmern -- -- 
  Arm hinausgestoßen Welt -- dawider angehen -- welcher inner Zwiespalt -- Zerrüttung -- welcher gegenseitig Mißtrauen Herz Geist -- 
  O -- schlagen fort -- Herz -- mutig frei -- Göttin Liebe -- 
  Huldinne beschirmen -- 
  ließest -- Freude Natur lebendig -- -- vertrautest Unumschränkt allgütig Mutter -- schenktest zartest Lächel jedesmal neu -- strömtest verdachtlos Entzück -- lerntest -- empfingest -- geben nehmen -- -- 
  Million Lichtstrahle -- unzählig Gegenstand zurückprallen -- verwirren -- Auge sammeln -- verwirren -- -- o -- unaussprechlich Wohltun -- unendlich Güte -- Leben Liebe -- 
  Luzie -- lieb Luzie -- mitteilen -- Leben lehren unendlich Leben -- 
  Würdest befestig Sonne -- weder Osten Westen -- Würdest wend Aufgang Untergang -- 
  -- schön Mond Stern Nachthimmel -- schön dunkler Nachthimmel hellerfunkelnd Stern Neulicht -- -- 
  O -- Gottesader rühren -- immerwährend Pulsschlag bringen -- 
  XXI -- 
  Luzie Eduard Allwill -- 
  jung Brief -- teur Freund Lehrer -- beinahe wert -- persönlich Erscheinung -- 
  Zauberer -- 
  lesen -- Brief -- -- -- jüng -- verjüngen -- -- stehen -- Trennung -- 
  urteilen -- wunderlich kopfe herumgehen müssen -- schreiben -- schreiben -- wovon lustig -- heldenwütig -- 
  herzlich Epistel gerad Weg Posse -- müssen lachen erröten -- 
  Mann -- verzeih Unbesonnenheit -- 
  vergessen -- Held -- -- unbedeutend -- unschuldig Mädchen -- Unschuld Held unnütz -- nichtswürdiges scheinen -- Göttlich - Unschuld verspotten -- Göttliche - Unschuld Füßen treten -- -- erhaben -- Bahn nehmen -- 
  Unschuld -- Eduard -- -- Eduard -- Unschuld -- Unschuld -- Unschuld -- 
  -- Erwacht Erinnerung Seele -- 
  Besinn -- -- -- 
  schattigst Gegend Seele -- schweben Schauder -- ergriff -- offen Auge eng -- lichen Stirn dunkel -- Gewölbe Busen weichen -- Atem verminderen -- Stand Tritt -- Wesen schwanken -- 
  -- Unschuld verlassen drohen -- 
  wallet dumpf Nachhall Donner -- Unschuld werfen -- -- -- arm Eduard -- verschwinden -- verschwinden -- 
  -- 
  unmöglich verstehen -- 
  gut Leute überwachsen Kinderschuh -- 
  bevor sammeln -- eu Wesen angreifen -- bevor eu Herz fühlen -- betören -- 
  entstehen höchstens -- Schönheit Größe Anlage -- herrlich Ungeheuer -- ehemals Kentaur -- 
  Eduard -- außerordentlich Mensch wahrlich -- 
  kennen -- wunderbar vorkommen -- Engel Tugend -- Satan Laster -- 
  Ungereimtheit Wesen widerstehen Begriff -- 
  unbändig Sinnlichkeit stoisch Hang -- weibisch Zärtlichkeit -- äußerste Leichtsinn -- kältest Mut festest Treue -- Tigers-Sinn - Lammes-Herz -- allgegenwärtig -- nirgend -- -- -- 
  Las -- Eduard -- 
  Ertrag lang -- nehmen -- 
  -- ertragen -- 
  hören -- woran Epistel erinnern -- 
  Eduard erinnern -- unseren D -- wissen -- Gelegenheit -- folgend Weise ergießen -- 
  -- Verträglich -- nachsehend -- tolerant -- feurig Jüngling -- -- gewiß -- eigentümlich Charakter verderben -- Inkonsequenz -- 
  deuchen -- Weise tolerant -- mißbrauchen Sache Wort -- tolerant -- wankelmütig -- schwach -- kindisch -- 
  Kind Ding entzücken -- Vorübergleit angenehm Eindruck zart Sinn -- unterscheiden -- schätzen -- 
  Stunde anderer schön -- gegenwärtig Augenblick vergnügen -- schön -- 
  Mann Gegenteil unterscheiden Ding eigentümlich Merkmal -- ordnen Gebrauche -- wissen -- schön -- Name nennen -- -- 
  -- möglich gewiß Seite betrachten -- lassen erträglich Licht sehen -- häßlich böse -- 
  -- entfernt Körper sagen -- wahr Gestalt erkennen -- sehen -- Nähe -- Distanz erscheinen -- Betastungssphär nennen -- moralisch Gegenstand ausgemacht Distanz Sphäre -- verschieden Erscheinung berichtiget -- beständig Gestalt Gegenstand zurückführen -- 
  bestimmt Sphäre unwandelbar annehmen -- -- flatteren -- Augenblick Horizont wechseln -- überall Haus -- -- Hälfte Lebenszeit Mensch scheinen -- Hälfte scheinen zuverlässig desto schlechter -- würdiger -- Augenblick Mann -- -- 
  D schreiben Eduard -- 
  -- romantisch Gebrause jung Grafe unerträglich -- 
  Clodius -- Brutus spielen -- 
  denken -- Mutter sagen -- -- 
  Laff -- regelmäßig dummen schlecht Streich spielen -- einfallen lassen -- Welt -- 
  Vorlieb nehmen -- jung Herr beschaffen -- -- zusehen -- uneben Weise Abschied erhalten -- 
  fallen Maulschell -- Leute erhaben Gesinnung heran sehen -- rechtschaffen Gesinnung beweisen -- 
  zufrieden -- schön Gesinnung sogenannter schön Handlung begleiten -- -- weich Herz Feuer Blut -- leicht dergleichen lassen -- 
  böse meiden -- 
  erfordern Kraft -- Mensch nehmen -- Vernichtigung anstrengen -- finden -- Kraft Menschheit -- -- 
  -- 
  -- -- mancherlei -- -- Lust -- sünd bleiben -- Missetat -- -- o schwer -- 
  -- erhaben -- 
  wunderbarst Luftspringer Unerschütterlichen Kampfe -- -- 
  vortrefflich Schriftsteller irgendwo -- 
  wissen preiswürdiges -- wozu äußerst mißraten -- fehlerhaft Mensch zuweilen erheben -- Ordnung -- Mäßigung Beständigkeit ausnehmen -- -- 
  fordern -- Eduard -- Auszug erheblichst Stelle jung Brief Verbindung bringen -- wissen -- leisten -- 
  hoch Idee philosophisch Gabe -- beinahe Unmögliche zutrauen -- 
  Herz Anheim geben -- Fülle Wahrheit -- -- 
  glauben Herz -- glauben -- 
  Frage Herz -- freisten fühlen -- einstimmt Gedanke gleich Strom -- Briefe D -- -- 
  -- offen -- königlich Jüngling -- 
  -- tief herabgewürdigt -- bangen -- schielend Sophist -- 
  erinnern schwerlich Brief -- anderthalb schreiben -- -- Wien verlassen -- 
  äußerst versuchen -- abschreiben -- lesen folgend Stelle -- 
  -- -- nachts Einschlafe -- früh Erwach -- still Augenblick Wiener Aufenthalt Seele treten -- verblichen Rest neu Leben erhalten -- Beziehung stehen -- einigen -- wog -- innig -- viele -- o -- viele herbe -- tief Trauer Versank -- fahren unversehens -- giftig Pfeil -- Brust -- 
  Jammer -- Reue -- Klage -- 
  Hohn -- 
  unbezwinglich Leichtsinn -- verruchen Achtlosigkeit -- liegen tief brausenden -- unaufhörlich gehrend Natur -- 
  kennen -- trauen -- lieben -- -- 
  O Luzie -- Verwirrung hat_es fast bringen -- Sinn -- hadern -- -- 
  erzählen -- -- -- 
  -- leiben -- 
  -- nah Eduard Gattung -- -- 
  Allwill -- 
  dennoch weiser -- müssen desto töricht -- desto unglücklich -- 
  -- unbesonnen Heftigkeit -- womit überall anwerfen -- vielfach zertrenn -- ungereimtest Verwirrung Wesen verursachen -- gänzlich Zerrüttung nah bringen -- 
  Hand voll -- greifen -- weder Fasse halten -- 
  Überdem Gegenstand Genusses Gegenstand vervielfältigen -- 
  Mann -- spotteen -- Oranienbaum Kastanie -- Kastanienbaum Pomeranz verlangen -- leichtfertig Dirn hoch Reiz -- Tugende -- Liebe frommen Mädchen -- fromm Mädchen -- schnöde Annehmlichkeit -- Torheit leichtfertig Dirne besitzen -- dergleichen finden -- Not -- Jammer -- zweifeln -- Welt Gott Urheber können -- 
  sinn Natur -- -- 
  Allwill -- 
  -- Sinne Natur -- 
  -- immerwährend echtest Bande Natur auflöset -- wahr -- rein Verhältnis zerstören -- erträumt -- schimärisch Stelle setzen -- abarbeitet -- Schwarzkünsteleien Hilfe nehmen -- Wankende Schatten befestigen -- destowenig Sonne verrückt -- Segens-Wandel Sonne fluchet -- -- Sinne Natur -- 
  wüßen -- Natur entgegen -- Unmäßigkeit -- Bedürfnis vervielfältiget grenzenlos Mangel schaffen -- unendlich Nöt -- Angst -- Schmerz -- Gewalttätigkeit -- Betrug -- Arglist Tücke -- 
  flüchtig Blick Welt -- verderben -- böse nennen -- -- 
  offenbar Ungenügsamkeit -- blind Ring -- Scheidekünsteln Ding -- Wesen Substanz -- Wirkung Ursache ablösen -- widernatürlich Bedürfnisse widernatürlich erfinden -- 
  wissen -- fruchten -- predigen -- predigen -- Theorie Unmäßigkeit -- Laster -- einzig Philosophie Leben -- einzig Weg Glückseligkeit -- hoch Vortrefflichkeit -- anzupreisen -- -- deuchen -- unsinnigst Beginn -- erdenken lassen -- bösesen -- 
  -- Eduard -- Theorie Unmäßigkeit -- Grundsatz ausgedehntest Schwelgerei -- eigentlich Name -- Eifer -- groß aufwand Witz -- Räsonnement -- dichterisch Schmucke -- Stelle alt Weisheit setzen trachn -- gewiß Anrat Herzens -- Edel -- Sinnlichkeit Liebe -- -- Wort Empfindung -- Herz Ein mischen -- Mensch tun -- -- 
  Sinnesfreude Lichtwolke -- worauf Göttlich Himmel hernied steigen -- Dunst Moor Grüften Wolke Himmel -- obschon Hügel hinan schleichen -- Sonnenlicht haschetn -- 
  unterscheiden -- 
  unterscheiden scharf -- empfinden Reinweg schön -- -- freilich -- schön lebhaft -- Eindruck berauschen -- Besinnung rauben -- 
  Tropfen Nektar Becher Rand -- verschlingen -- merken -- abscheulichste Getränk -- 
  fürchterlich Bestimmung -- Eduard Allwill -- 
  Unaufhörlich -- mancherlei Weise Mark erschüttern -- Menge tief leiden Folge -- 
  Armer -- -- Grund gehest Stöße -- zerschellen -- erstickest Schutt -- 
  jeder lieb unschuldig Geschöpf Bann entfernen -- 
  -- Unglücklichen -- eigentlich Bestimmung -- natürlich Verhältnis entsetzen -- Haltung künftig Leben verlustig -- -- 
  Mädchen -- sagen -- lieben -- 
  lieben gewiß -- Wahrheit -- anderer Mensch lieben -- lieben wahrhaft Schätzbare -- -- worin gutgeschaffen Seele angemessenster Tätigkeit -- eigen Wonn -- fühlet -- 
  -- Fühlst -- sichern -- innig lieben -- -- Liebest -- glauben -- Liebe -- 
  -- arm Kind -- 
  Allwill lieben -- Gegenstand -- -- Ehre -- vortrefflich Manne -- Kunst -- -- geliebter -- 
  -- Sieh -- Allwill -- Unglückliche -- unsten flüchtig -- verfluchen Erde -- zeichnen Finger Gott -- Mensch Hand legen wagen -- -- Eduard -- Eduard -- jammern arm Geschöpf -- 
  O Schone -- Schone -- Schone -- -- 
  -- helfen Fleh -- hülf Fleh Welt -- 
  Sinn -- Begierd mächtig -- bequem täuschend Hülle schön Fantasie -- erkennen -- -- 
  -- Bedürfnis Sinn -- Täuschunge Sinn -- glauben -- Allwill -- 
  -- schwindend Atem Brust -- kommen -- sammle -- Stimme beben -- krank laut erreiche -- -- Allwill -- Mörder -- 
  -- Hierher gräßlich Ohr gellen -- 
  Mörder -- -- 
  Meuchelmörder -- 
  Unheil -- unsäglich Jammer Bezirk Menschheit anrichten -- Nichtigkeit System hinlänglich bloß stellen -- ausdrücklich erfund -- dergleich Ansicht blind -- 
  Menge herrlich Empfindung -- erwerben bringen lassen -- böse Wucher ersetzen -- innerer Genuß Kosten aufwiegen -- 
  hierbei fallen -- wissen sagen hören -- 
  vergleichen Haufen studierend Leute -- emsig laufen -- suchen -- verlieren -- 
  belacht Torheit geschäftig Müßiggang -- lauter Wisserei Wissen -- 
  sagen -- Eduard -- reeller Sache müßig Sammel Empfindung -- Bestrebe -- Empfindung -- empfinden -- Gefühl -- fühlen -- 
  Finden ungereimter Absonderung -- Wissen -- 
  glauben -- schön Seele besitzen -- halten -- Empfindung -- Handlung treiben -- entzückend Gefühl -- begleiten -- Weise abzusondern -- dergestalt bewußt -- Vorstellung aufbewahren -- Betrachtung unabhängig Genuß bereiten -- 
  -- 
  Seligkeit Empfindung -- Gefühl -- Seligkeit -- 
  -- -- Bahn Edlen -- 
  Monat sterben Greis -- Name Wigand Erdig -- elend Flecken D * ansehnlich Stadt voll glücklich Bürger -- 
  glauben -- Gewerbe Katechismus wissen -- Gewerbe verstehen -- Ordnung -- Fleiß -- Mäßigkeit -- gesund Vernunft gewohnen -- klüg -- geschickt -- emsig unternehmend -- 
  legen D * Tuchmanufaktur -- 
  Fortgang Unternehmen leiden unzählig Hindernis -- Gedränge -- müssen -- 
  Schwierigkeit überwinden -- Mann mutig Weiser -- 
  verstreichen -- fünfhunderen Familie Brot -- 
  benachbart Bauer -- schaffen -- vergrößert Haus öde Länderei urbar -- fruchtbar Baum pflanzen -- Garten anlegen -- Gegend füllen verschönert -- 
  Glücklich Tal engen -- 
  sprengt Fels weg bauen Stufenweise Berg hinan -- 
  bringen einzig Mann zuwege -- Absicht -- Bewußtsein -- Gewerbe Flor bringen -- Haus gründen -- Nachkomme Segen setzen -- 
  Eigenschaft ehrwürdig Menschheit -- 
  Klugheit Unsträflichkeit Wandel Mitbürgern ansehen setzen -- -- Vater -- walten lassen -- 
  Urteil -- Licht Gewissen -- gelten Gesetzbücher -- 
  letzter -- alt Erdig Straße -- treten Leute Haus -- begegnen -- wich Seite -- gebührend Ehrfurcht grüßen -- 
  Leute sehen -- erzählen -- ehrenreicher Greis langsam einh treten -- -- freundlich -- leuchtend Haupt neigen -- erinnerlich -- stiften -- -- 
  Träne -- Auge -- verbreiten Gesicht -- Verheißung ewig Leben -- 
  Gott -- -- 
  Allwill -- Glanz Heiligkeit -- wissen -- 
  euer Flitter-Philosophie -- Form -- verbannen wissen -- 
  frei Hand geschehen -- menschlich Seele gut schöne -- bilden -- bedenken -- menschlich Charakter flüssig Materie gleichen -- Gefäß -- Gestalt Bleiben -- lassen einfallen erwägen -- eitel Wasser Glase taugen -- Nektar Schlamm gegossen -- 
  moralisch System -- Haltung erteilend Form betrachten -- Preis geben -- bereit -- Menschheit Mensch trauen -- Weisheit Tugend -- -- verlassen -- 
  Menschheit Mensch gehören Grundsatz -- Zusammenhäng Grundsatz -- klar Unsinn -- hiervon Entbehrlichem reden -- 
  nützen Erfahrung -- Vergleichung standhaft Begriff Urteil zuwege bringen -- überall Mensch vornehmen -- Wirksamkeit Begriff Urteil fußen -- 
  nehmen allgemein eigentümlichst Vorzug Menschheit -- Grundsätze handeln -- Grad Fertigkeit hierin Grad Hochachtung Verachtung bestimmen -- 
  preisen derjenige -- Empfindung Gefühl -- Gefühl Gedanke Waage halten -- 
  Gefühl verringern -- schwäch Weisheit -- reinigen -- Lebhaftigkeit Gefühl Gedanke erhöhen -- Empfindung -- schärfen -- vergrößern -- 
  wissen -- mehrmals -- hoch Idee begeistern -- heftig Begierd unterdrückten -- Leidenschaft überwältign -- 
  jemals groß fühlen -- Augenblick -- Freudiger -- Triumphierender -- 
  dünken -- gewiß Idee fest halten -- Vorfall Glaube Augenblick irr -- Sinn Imagination vorspiegeln -- 
  Edler Stolz Quelle -- 
  Erhabenheit Charakter überschwänglich Idee -- 
  Portia Brutus überführen -- Seele fähig -- seinig Unternehmung begleiten -- wissen besseres -- Probe Auge legen -- sinnlich Eindruck vermöchen -- 
  steig Helden-Sitte gefälligen Wesen herab -- überall sehen meister ehren -- Obermacht Gedanken sinnlich Trieb beweiset -- 
  Lebensart verschieden -- Gebräuch mannigfaltig abwechselnd -- Begriff halten -- genau Untersuchung -- überall Stand -- erstrecken Urteil Miene Gebärde -- führen Quelle Gefühl Anständigem Unanständigem -- 
  Gedanke Mensch verlassen scheinen -- Triebe Gewalt -- Oberhand gewinnen lassen -- Gefahr aussetzen -- übermeisteren -- 
  fühl Unanständigkeit -- 
  Vorteil Grundsatz -- Anfang Brief widersprechend Erscheinung Mensch anführen -- wechselsweise Weisheit Torheit -- Torheit Weisheit -- 
  glauben -- fein Organisation -- dergleich Bemerkung schicken -- Materie Form bieten -- müssen Überzeugung aufdringen -- Mensch fest Lehre Achtungswürdig -- unverbrüchlich Vorschrift verhalten unentbehrlich -- 
  sicheren -- zuverlässige Mann darstellen -- -- 
  Weg verlieren -- 
  eingestanden Wankelmut menschlich Herzen sogar Seite -- annehmen -- Ihrig beschaffen -- leiten -- Weise -- eingeführt Ordnung zuwider liefe -- 
  müssen dennoch Charakter verwildern -- 
  fehlen -- Gesetz angriffen -- gemein Menschen-Sinn unverbrüchlich erklären -- beinahe Weg stehen -- Bestrebung hemmen -- unwissend Absicht äußerste Qual verursachen -- -- Hand wider erhöbe -- 
  zwiefach Ihrige -- 
  Ekel -- Gram Haß nehmen Seele -- 
  Gewalt drängen -- 
  müssen -- erhabeneer Leben retten -- List -- Verstellung -- Betrug Hilfe rufen -- lauter krumm Weg -- entzweit notwendig Weise -- müssen voll tief Gräuel Welt verfluchen -- 
  Schnöde Prahlerei -- Herz frei frei schlagen -- 
  frei schlagen -- Geheimnis Frevel Schande bergen -- Blick Unsträflich ziehen -- Atem Rein ersticken Blute -- Stirn wissen bleiben -- Ding Finsternis Name bezeichnen -- Fühlest -- reden deiner Tat -- 
  Allwill -- schaudern -- manchmal beben -- vergehen -- Ohnmacht Verwirrung Absichtlosen Wort Tor -- Kind -- Mutwille Gassenbube -- Schmähreden Trunken -- 
  nunmehr dergleich Schwachheite abwerfen -- 
  Stück Briefe -- Zweideutigkeit Tugende erweisen tracht -- erhellet -- Mühe arbeiten -- 
  stören -- Eduard -- 
  -- Erholung -- lassen erzählen -- gestern ungefähr ehrlich Montaigne lesen -- Anekdot -- wissen -- 
  treuherzig Montaigne erzählen -- vermögen -- König Vaterland sogar -- Schlechtes willigen -- 
  glauben -- untreu -- nachh Staat -- 
  Sache Gott überlassen -- -- menschlich helfen unmöglich -- unmöglich -- rechtschaffen Mann treu Glaube verlassen -- 
  geschehen -- Mann Ehre Unkost Ehre Treue bewerkstelligen -- 
  Hiernächst erwähnen -- -- Epaminonda -- vortrefflichst Mensch -- einzeln Pflicht hoch ansehen stehen -- Schlacht Überwunden Boden stoßen -- Gewissen -- unschätzbar gut Wille -- Freiheit Land verschaffen -- Tyrann Mitgenossen -- Form Gerechtigkeit -- umbringen -- derjenige schlecht Mensch halten -- Bürger -- Feind Schlacht Freund Wohltäter verschonen -- 
  -- -- schrecklich Waffe Blut bespritzen -- zertrümmert unüberwindlich Volk -- überwindlich -- 
  mitten Handgemenge begegnen Gastfreund -- seitwärts .... 
  Wunder Wut Kriege Gerechtigkeit vereinbaren -- Festigkeit Epaminonda verleihen -- Sanftmut mildest Sitte verbinden reinst Unschuld -- 
  .... 
  Größe Mut -- Wirkung außerordentlichen Tugend -- allgemein Gehorsam Obrigkeit -- Freundschaft -- Privatpflicht -- Wort Verwandtschaft Auge setzen -- 
  wahrlich hiervon loszusprech -- Art Größe -- Epaminonda Seele Platz -- -- 
  Anekdot -- 
  kenn Auguste G * * -- treu -- makellos Seele -- einzig -- Begriff Gutem Wahrem -- gut Wahren Witz Laune -- 
  unselig Kokette verführt Mann -- 
  Auguste -- hoch Grade arglos -- merken -- 
  G * * nötigen -- Unwahrheit sagen -- Unwahrheit Lüge Zahl biern -- müssen lieb Weib merken -- hintergangen -- 
  begeben -- -- Mann Gegenwart -- auffallend Betrügereie offenbar -- 
  G * * -- Zustand vorstellen -- 
  Freund -- unschuldig Weise Sache an Licht bringen -- Tür hinaus -- heben Auguste -- 
  -- Höre -- Max -- hattest Sache -- -- hören -- 
  Merk -- öfters Unwahrheite sagen -- Wüßtest -- betrüben -- -- 
  -- freilich -- antworten G * * -- Schuld -- unbescheiden Frage erlauben -- zwingen Lüge -- -- 
  O Gott -- Auguste freundlich -- weinend Stimme -- 
  wissen fragen -- gewiß fragen -- lügen Brauchtest -- 
  Lüge -- Eduard -- Kraft gute -- Erhabenheit -- unschuldig Gebet Auguste Wahrheit schätzen -- 
  Unschuld -- Eduard -- Eduard -- Unschuld -- Unschuld -- 
  fing -- endigen -- 
  -- Süß -- rein -- ewig Wonne Unschuld -- -- -- Eduard -- -- Suchest -- -- Weg Verstockung -- 
  Liebes Mädchen -- dein Name -- 
  -- 
  Eile -- 
  Eile -- Freundin -- Blick finden -- begegnen -- Deinig fassen -- 
  Liebe retten -- Herzen Geschmack Lauterkeit Unschuid regen -- 
  O -- kommen -- komm entzünd Strahl Auge -- Sehkraft ziehen -- aufhören -- leichtfertig umh gaffen -- Auge Licht -- 
  Fülle Busen Ahnung Wonne -- Zusatz vertragen -- nüchtern -- -- Leben -- -- Freude -- erfahren Lerne -- 
  O -- glauben -- berufen -- Wesen Liebe erwecken -- Liebe heiligen -- 
  Eduard -- dulden -- entbehren -- Deinetwille -- 
  Stunde -- fühlen -- einst verachten -- 
  Ergriff tief Schrecken -- entfloh -- 
  entflohen -- verhüllt Angesicht -- 
  Liebe heiß Sorge verwandeln -- 
  Verborgen Liebe -- lassen -- 
  Schwärmerei -- Einbildung sterben -- heißen -- -- 
  -- -- 
  Grab kommst -- Eduard -- Mädchen -- rufen -- Mädchen -- Wesen erneuern -- Freude Menschheit Sinn rein stimmen -- 
  Ein -- Köstlichst -- -- anekeln -- Köstlichst -- liebst -- Kraft genießen -- Genuß ähnlich Geringeren Verlust -- 
  -- Eduard -- kommsen Grab Mädchen -- küssest himmlisch -- ewig Kuß Treue -- -- 
  Kommen -- 
  Il y Cette Difference entre l -- amour et le Soleil -- que le soleil Montre sur terre -- ceux qui Ont Yeulx -- autant ler laid que les bell choses -- et que L'amour n -- est -- lumiern que belles Seulement -- 
  Plutarque -- Λεος ανϑρωπῳ ου μιγνυeταιen -- αλλα δια του δαιμονιου πασα εστιν ἡ ὁμιλια και ἡ διαλεκτος ϑεοις προς ανϑρωπους -- Διοτιμα -- Zugabe -- 
  Erhard O * * -- 
  Quid est Enim Verius -- Quam nemin esse oporter Tam stuln Arrogantem -- ut se rationem et Mentem puten inesse -- Coelo Mundoque Non puten -- aut ut ea -- quae vix Summa ingenii Ratione Comprehendat -- Nulla Ratione Moveri puten -- 
  quem Vero Astrorum Ordine -- quem dierum noctiumque vicissitudin -- quem Mensium Temperatio -- Quemque ea -- quae Gignuntur Nobi ad Fruendum -- non Gratum esesn cogant -- hunc homin Omnino numerar -- qui decet -- 
  Cicero de Legg -- II. 7. Βουλει δητα και ἡμεις τοις εμπροςϑεν ὁμο- λογουμενοις ξυμφησωμεν -- ὡς ταυϑ̕ ὁυτως εχει -- και μη μονον οιωμεϑα δειν τ̕αλλοτρια ανευ κιν- δυνου λεγειν -- αλλα και συγκινδυνευωμεν και με τεχωμεν του ψογου -- ὁταν ανηρ δεινος φῃ ταυτα μη ὁυτως -- αλλ̕ ατακτως εχειν -- Πως γαρ ουκ αν βουλοιμην -- Plato Phileb -- T. II. p. 28. 29. ed -- Bipont -- 
  IV. p. 244 -- 
  28t Januar 1791 -- 
  Heißest schimpfen -- zürnst -- -- lächelnd -- Antediluvianer nennen -- 
  lächeltest ehemals -- scheinen fallen -- Riese zählen -- derben elastischen Mann -- strafend Geist striem Beule schlagen Arm -- Glückliche -- Ding -- freit -- frei lassen -- grämlich Noah spotteen -- einpackt -- Kasten schwamm -- 
  Feind unsklavisch herzhaft Ahn -- 
  derb -- elastisch Mann -- 
  Ding überall -- -- 
  fern -- Brief -- 
  warst hoch Grade -- Rechtsweg -- zunimmst Wesen -- Liebe hoch steigen -- 
  Freundschaft Abnahme spüren -- 
  Ehre ehemals -- richt Schatz -- Natur -- außerordentlichst Geistesfähigkeit -- heiter Gemüt unschätzbar Wert -- Gutmütigkeit -- Brudersinn -- edl Fleiß schön Mut -- 
  lieben -- lieben Ehre -- Atme -- 
  lieben -- lieben -- -- mehrmals definieren -- -- -- undefinieren -- Kopf Armseligkeit Herzen verschmähen belächelen -- fehlen Innigkeit -- tief Bewußtsein Mensch -- tieferen Bewußtsein hervorgehend Vermögen -- 
  nährend -- stärkend -- gedeihend Sinn Geist -- fehlen still Sammlung -- -- verzeihen -- -- 
  Andacht nennen -- feierlich schweigen Seele Natur -- fest Ansauge Schöne -- tief lebendig -- unabhängig -- 
  fehlen -- verstummend -- gut Seele allmählich bildend Echo Mittelpunkt Deines Wesens -- 
  Höre -- Erhard -- 
  -- sagen -- 
  -- Heiter Sinn froh Mut -- Mensch geben -- Höchste -- -- 
  -- Freude erscheinen Wahrheit -- Freude erscheinen Leben -- 
  Bedeutung -- Ernst -- verbergen -- -- Trieb -- Gegenstand kennen -- erschallen lebendig Wort Brust -- durchdringt selbsttätig -- ausführend fortbildend Natur -- 
  ἑυρηκα -- Zeugnis -- 
  leben -- -- 
  Freude -- Erhard -- 
  Liebhaber Vergänglichkeit -- Ungestalt -- Tod -- 
  spottest Hoffnung -- Ringen fest Überzeugung -- -- voraus -- Wahrheit Erkenntnis nennen -- 
  Schatzgräberei such Art nennen wissen -- 
  Fragst Fragst -- Unterlass fragen -- 
  Wahrheit -- 
  -- Frage -- 
  ruhsen sanft Schoße Gottheit -- ewig verschlingenden -- ewig wiederkäuend Ungeheur -- Werter erscheinen -- ehemals Brutus bös Genius -- 
  -- wiedersehen Philippi -- -- -- 
  Philippi Held Geist Wort -- 
  -- Tugend -- leer Name -- -- 
  -- 
  -- Erhard -- rufst edl Unwille -- 
  -- 
  -- laß Wahrheit ringen -- Schatze graben -- Finde verzweifeln -- 
  Schein Schatten umgeben -- 
  Wesen unser Dasein erkennen -- 
  prägen unser Bild -- Bild wechselnd Gestalt -- -- nennen -- zweideutig Geburt -- seel Erscheinung .. Wesenheit nähernd Erscheinung -- 
  Selbsttätigkeit Leben offenbaren unmittelbar -- Seele rein Gefühl -- Substanz - Urbild Sein -- rein Sinnen -- bildend Kraft -- rein Trieb -- Herz Natur -- 
  erfüllen Unendliche lebendig -- sehend -- ordnend -- bestimmend Geist -- 
  Vertieft Gesicht gleichen staunend Forscher Beherrscher Assyrien -- wissen -- 
  liegen Traum Seele -- 
  Traum -- ausbilden -- viel_weniger deuten Stande -- Non valet Tantum Animus -- ut se Ipsum Ipse Videat -- at -- ut oculus -- sic Animus se non videns Alia Cernit -- 
  Non viden aut -- quod Minimum est -- Formam Suam -- 
  Fortas -- quamquam id Quoque -- 
  Cic -- Tusc -- Quaest -- Los I. c. 28. Daniel -- II -- 
  weisere deuten -- Lebendig Unlebendig -- Vernünftig Unvernünftig -- sittlich viehischen -- ergründen -- 
  Wahrlich -- heißen törichter tote fragen -- Aberglaub fragen irgendwo versuchen -- 
  Milton tadeln -- sichtbar Finsternis sprechen -- sichtbar Finsternis denken lassen -- 
  Seher -- Auslegung Rechtfertigung Fülle Zeit aufbehalten -- 
  Milton prophezeit Weisheit -- Mondscheine Dämmerung Irren Wähnen materiell Nacht sichtbar Finsternis positiv Unwissenheit kühn hindurch dringen -- ehemals dachen Irrtum Wahrheit -- eiferen geraubt Licht -- 
  Glaube Wahrheit -- ärgste Irrtum -- 
  leuchten anderer Stern - Stern überschwänglich Unlicht --- unfruchtbar Jubel golden Hochzeitsfeier Erebus Nacht -- Nachkommenschaft Himmel Erde -- The opinions of the Academics and Epicureans of Less Religiou Cast -- -- Than those of the Stoics and Platonist -- -- -- but Whilst The modest science -- -- Former induced them to doubt -- The positiv ignorance -- -- Latte urged th to deny -- -- Providence -- suprem Ruler -- 
  Gibbon -- 
  Äther Luft entsprang Nacht -- Erebus vermählen -- 
  -- alt Mythologie -- Anfang Ding -- 
  -- letzter Zeile schreiben -- jung Blatt Tagebuch -- nunmehr freist Hauptstadt bringen -- 
  liegen vierzehnt Nummer -- Auge fallen Wort -- -- Locke halten Täuschung -- -- dauern -- ewig Fels Natur gründen -- streng Demonstration Vernunft gleichsam -- Kahl -- quelque Sorte mis -- nud par les Demonstration rigoureus -- -- raison -- -- -- 
  kahl Fels -- 
  ewig Fels Natur -- 
  heißen wahr Name -- Selbstsucht Scheinsucht -- klar bar Egoismus -- 
  -- nackend stehen Gram Scham -- Tugende wissen -- 
  heucheln -- trotz Frechheit -- täuschen -- 
  täuschen -- schwärm Grenze -- Leben machen -- 
  Täusche betrügen -- Ekel vergehen -- 
  -- neu Himmel Erde -- unten -- -- 
  Gabe Verheissung fließen Allgenugsame -- Glückseligkeit -- rein vollendet Glückseligkeit sterblichen Mensch -- 
  weg Ehre -- Achtung Nützlichen tret Törin Stelle -- 
  Weg Liebe -- Schwachheit Gestalt -- richtig Einsicht Zusammenhäng Vorteil erheben -- 
  Weg Glaube -- Wort Treue -- Wesen Mangel Augenscheinliche -- Wurzel böse -- Abgrund Brut Argen -- 
  -- Äußerung Augenblick gewiß Gegner französisch Revolution Frankreich beigesellen -- politisch Gesinnung meinig heterogen -- Schrift -- Ausnahme -- beweisen -- Geschichte Leben -- 
  -- Bellum est eos qui Judiciis Coerceri non Possunt -- 
  bleiben ewig -- gestehe Scheu -- Cromwell Enthusiast allerlei Art empört -- Herz verträglich Menschheit lassen -- königlich Nachfolger -- Lustigmacher -- Anzettler -- Metze Sündenvergeber -- 
  hing Idee -- überall Gemeinsam Auge -- womit Eigennutz vermischen -- hing -- haßt Gemeinsame -- lächelen abscheulich Frevel -- verächtlich Willkür -- -- alleinherrschend versprechen -- -- -- Salomo -- König Weiser -- Prediger -- kanonisch Buch -- 
  -- Unglück Sonne -- nämlich Unverstand -- Gewaltig gemein -- -- 
  entfliehen -- küß erhaben Felsgebirge weggefegen Erde -- 
  Glaube behalten -- Liebe -- Scham -- Ehrfurcht Demut -- behalten tief Auge Ewigkeit -- Ernst feierlich Aufschwung tief Brust -- hoch hoch Ahnung Geist -- voll wirklich Genuß Unsichtbar Seele -- 
  O arm Stolz -- Ding verschwindend Gefühl -- wesenlos Täuschunge geringeren Seele verachten -- Füß treten -- 
  Öffnet Allerheiligste eur Unveränderlichen -- Selbstständig -- Wirkliche -- Wahr -- Würdig gute -- -- 
  Vorhange stehen -- alleinig Vernunft -- -- 
  -- 
  -- Vernunft vorhanden -- rein Vernunft -- Vollkommenheit Leben vorhanden -- 
  Vermunft Erscheinung Widerschein -- 
  Vernunft gewiß streng Sinn einzig -- -- -- -- Ἑν και παν -- -- -- menschlich Anschauung -- Οὐδεν και παντα -- 
  Vorhange -- wissen -- 
  stehen -- 
  sagen -- Stehest -- 
  --- unendlich Raum besonderer Natur Körper bestimmen -- rein Vernunft Mensch überall gut Wille -- Mensch -- Grundlage besonderer -- verschieden Leben ausmachen -- wirklich Person eigentümlich individuell Wert erteilen -- 
  Sinnesart -- fest Geschmack hervorbringen -- wunderbar innerlich Bildungskraft -- unerforschlich Energie -- -- alleintätig -- Gegenstand bestimmen -- ergreifen -- festhalten -- Person annehmen -- Geheimnis Sklaverei Freiheit insbesondere ausmachen -- entscheiden -- 
  entscheiden stehen Vermögen --- Syllogismus -- Vermögen Hälfte scher Zange vergleichen -- -- Gesinnung -- Vermögen unveränderlichen -- Leidenschaft siegend Affekt -- 
  Wort namentlich Mann fuße -- bringen rein Vernunft -- Bewegung Lippe Schall Mund Anschlag -- 
  trau Worte Mann -- Manne Wille -- 
  gewiß -- Sinnesart -- Geschmack -- Gemüt Charakter -- 
  gründen Bund Bund -- -- wodurch -- 
  glaub Herz tief verborgen unsichtbar Wort -- geben -- 
  verlassen geheim Kraft -- stark Tod -- 
  -- Mensch Meinung Leben -- liegen Gewalt Begriff -- überwiegend Energie vernünftig Natur -- Gedankending Vernunft -- klar -- Tor leugnen -- 
  Gewalt hoch -- Begriff mächtig Empfindung -- zeitlich -- Vergangenheit -- Gegenwart Zukunft zusammengesetzt Bewußtsein -- Begriff -- 
  leben -- gegenwärtig Bewußtsein -- zeitlich Leben erzeugen -- innerlich alleintätig -- Verknüpfung -- 
  Form Leben -- Trieb Leben -- Leben -- wirklich Ein -- 
  Gegenstand unbedingt Triebe -- Grundtrieb nennen -- unmittelbar Form Wesen -- Trieb wirksam Vermögen -- 
  Form erhalten -- ausdrücken -- unbedingt Zweck Prinzip Selbstbestimmung Kreatur -- Wesen vermögen Zweck vorzusetzen -- Kraft Triebe gemäß -- 
  beziehen Trieb Bedürfnis -- 
  Lebendige Natur bewegen Absicht -- -- Verhältnissen Bedürfnis -- 
  Grund Art Entstehung Verhältnis unerforschlich -- Trieb Bedürfnis -- Bedürfnis Trieb erklären -- sagen -- bestimmen -- -- 
  Anfang -- gemeinschaftlich Anfang -- 
  Geschäft Triebe -- gewiß Zusammenhäng erhalten -- fortsetzen -- erweitern -- erkennen -- -- notwendig -- unverknüpftes -- -- innerlich äußerlich -- verknüpfend endlich Wesen -- Unding -- 
  TOTUM PARTE PRIUS ESSE -- NECESSE EST -- 
  Toute Opinion est Assez forte -- Pour se faire espouser au prix -- -- vie -- Montaigne XL -- Cap -- Buches Versuch -- lassen Beweis mangeln -- 
  -- Form annehmen -- -- 
  Läßt Form -- lauter Form -- denken -- Wirksamkeit -- alleinig Absicht rein -- leer Absicht -- -- 
  Trieb -- betrachten -- frei Wirksamkeit -- 
  Wesen Verhältnis -- 
  Befriedigung -- 
  Trieb vernünftig Natur Wahren gute -- vollkommen Leben -- Leben richten -- fordern Unabhängigkeit -- Selbstgenügsamkeit -- Freiheit -- -- 
  dunkel -- dunkl Ahnung -- 
  Leben -- Freiheit -- 
  wahrlich jenseits Natur -- 
  innerhalb Natur offenbar unendlich -- Freiheit Tod -- 
  dennoch wissen -- -- -- Urheber unerzeugt Tätigkeit -- Kern unser Dasein -- wunderbar umgeb Vergänglichkeit -- versenken -- Same aufgehen -- 
  Ewiges Leben Wesen Seele -- unbedingt Trieb -- 
  woher kommen Tod -- 
  Vater Leben gute -- innersen unser Herzen Willen Herz Wille abdrücken -- anderer abdrücken -- 
  Animi praestantissimi -- schreiben Plato Dionys -- haec ita se habern divinant -- deterrimi aut Contra -- 
  Sed Majoris Fidei Sunt Divinorum Virorum Praesagia -- Quam aliorum -- Plat -- ep -- II. Ed -- bip -- Tom -- XI . p. 66 -- 
  kahl Fels -- -- atmend Fest dringen hervor Eingeweide Erde -- erheben Wolke -- Altar Ewig -- jeher Volk versammeln -- Gewissen -- Religion -- 
  Gespenster -- Erhard -- 
  -- frech -- les Brief -- -- Gespenster leugnen -- 
  erscheinen gewiß -- Mondlicht -- Nachtlampenschein -- halb erwachen Träumen -- bildend Fantasie -- 
  sehen -- Besitze Theorie Erscheinung -- sogar erschrecken -- 
  Umgang suchen -- -- Umgange wirklich Ding vorziehen -- allerwenigst Gleich trachn -- -- 
  sagen -- Erhard -- 
  -- verstehen -- Erscheinung entkleid -- Wirklich betrachten -- 
  hieran Verzweiflung versuchen -- neu Rätsel -- Rätsel unheilbar Unwissenheit zuletzt erbeuten -- 
  Mensch Anspruch wirklich -- Freiheit Erkenntnis fahren lassen -- längst meinig -- hart abschlägig Antwort -- Natur -- Geschichte -- Vernunft -- Wille -- Herz Bewußtsein -- aufgeben -- 
  verschwind Forschen -- anderer verschwinden -- -- anderer -- 
  -- -- innig fühlen -- 
  sehen Mittelpunkt menschlich Vernunft -- ruhen -- bewegen -- denken -- dicht trachn -- Idee Unbedingt -- Selbstständig -- streng Sinn Anfang -- 
  sobald Mensch ausführen -- Vorstellung Begriff Wesen bilden -- sehen -- Geist grundlosen Unding entstellen -- Vernunft -- ruht -- fürchterlich erschüttern -- 
  Einheit Zusammenhäng -- Zusammenhäng Einheit -- Zweckmäßig -- suchen -- sehen fühlen -- Begriff Anfang -- unser Forschen -- 
  -- erforschen unvermögend -- Zusammenhäng Zweck -- lernen -- desto begreifen -- desto betroffener stehen Himmel Erde -- desto verlegen -- -- 
  brauchen -- -- -- allgewaltigen Lückenbüßer -- -- -- -- -- -- -- gegenseitig -- ausfüllen unterstützen -- -- 
  -- -- 
  -- Verstehest lesen -- -- 
  gesamt Bedürfnis -- Verhältnis harmonisch Befriedigung -- 
  Knochengebäude Fundament menschlich Gestalt -- Schönheit -- Königlich Anblick -- 
  stehen -- Inhalt Bekleidung -- bedeuten Tod -- -- Nacht -- Jemand Freund -- 
  scheußlich Gerippe -- 
  Rührte regen -- 
  lebendig Lebendig -- 
  Anfang Begierde -- heftig wirken -- verstehen -- Gabe Weissagung -- Plato nennen -- mystisch -- Wiedererinnerung -- 
  hungrig -- bemerken Plato -- empfinden -- nämlich fern Sättigung anstreben -- Entgegengesetzt desjenig Zustand -- worin -- 
  ausgehungerte Schmerz empfinden -- gegenwärtig Zerrüttung Körper -- -- herstellen -- verlangen Speis -- Erfahrung -- Schmerz Speise stillen -- Vorhergieng -- 
  Begierde wittern -- suchen finden Gegenstand Erfahrung -- gewahr -- Subjekt Wahrnehmung schlechterding finden -- 
  sehen Begierde -- Empfindung reichen -- erblicken -- entgegengesetzt Empfindung hervorbring Untergang bedroht Wesen retten -- 
  innerlich Arzt -- Rat Helfer -- Kraft -- einzeln Wesen -- Endlich Unendlich gemessen Art verknüpfen zusammenhalten -- 
  Seele -- 
  Erkenntnis -- beweisen -- Körper -- Leben verursachen -- Erfahrung -- Gemeinschaft -- hernehmen -- Erkenntnis Erfahrung -- 
  Erkenntnis vorher denken -- erscheinen gegenwärtig Zustande Besinnung -- Besinnung -- wodurch Seele vorhergegangen -- alleintätig -- Andenken behalten -- nennen Gedächtniß -- S. Philebus -- -- -- -- -- Erhard -- unwissend -- unwissend -- sagen -- -- 
  unwissend Maß -- bloß Zweifler verachten -- 
  -- Den- -- entfernt -- überschwänglich Unwissenheit brüsten -- verwechseln Wahrheit -- Verheißung Busen tragen -- -- Hochmut trunken -- Tempel Altar weihen -- sinnlosest Abgöttereie anzurichen -- demütigen vielmehr Bewußtsein Schwermut --- Hohn vertragen -- lachen satt Wisser Nichtwisser sagen -- toll -- Freude -- 
  machsen -- 
  Sokrat -- -- Ahndungsvolle -- -- Unwissenheit wider trotz Lüge Schlacht führen -- Hinterhalt Wahrheit -- -- 
  -- Wahrheit Wahrheit -- 
  geben Wahrheit -- 
  Mensch seechen schal -- sagen Ding bleiben -- 
  -- wissen -- glauben -- 
  soviel Mensch -- wert -- Fähigkeit ahnden glauben -- 
  liegen Natur endlich -- mittelbar -- sinnlich erkennend Wesen -- Wahrheit -- eigentlich Leben -- aufdeckn -- verbergen -- 
  Sympathie unsichtbar Wirkliche -- Lebendig Wahr Glaube -- 
  Sinn unsichtbar Natur Mensch zeigen -- wirksam tätig Unsichtbar beweisen -- desto vortrefflich -- allgemein -- -- Seltsam -- samt Wissenschaft -- Kunst -- Geschäftigkeit -- Überschwänglich -- Wunderbare erreichen -- ehren -- lieben -- -- begreifen -- 
  seltsam -- Maß ehre lieben -- plötzlich wegwend -- --- theoretisch dartun -- gewissermaßen -- -- Hand greifen lassen -- Mühe wert -- unser Blick heften -- 
  finst Geheimnis liegen schwer -- Geheimnis Nichtsein -- Dasein Vergänglichkeit -- Vermögen lauter Unvermög -- Geheimnis endliche -- 
  unendliche scheinen Stoff -- Endlichkeit Form Ding -- 
  nichtsein -- Begriff Endlichkeit Nichtsein fließen -- Möglichkeit -- nichtsein nächster Ursache Natur Inhalt -- 
  Plato äußern merkwürdig Weise Gegenstand -- 
  Kühn weisen -- Reihe Ding -- Unendlichen Unterste -- Maß -- endlich Unendlichen vereinigen -- wirklich Ding an Licht bringen -- oberer Stelle -- 
  setzen Gott voraus -- Geist -- besonnen persönlich Wesen -- Urheber Ding -- Vollkommenheit Willen -- Philebus -- 
  Plato verstehen unendliche unbestimmte -- Bild denken -- -- -- vorstellen -- 
  unendlichen setzen entgegen -- endlich -- -- ewig -- wahr Wirklich -- Ding erkennen -- fern erkennen wirklich besitzen -- 
  endliche stehen Unendlichen Ewig -- Wahr Unwahr -- Nichtsein Mitte -- 
  Reihe Wesen oberer setzen -- Maß -- bestimmt -- unerzeugt Bestimmend -- 
  -- Ebenmaß -- erzeugt Endliche erhalten -- gemessen Mischung -- Schönheit -- Vollkommenheit -- 
  -- Erkenntnis -- 
  stehen Ordnung billig Gegenstand -- Absicht -- Erkenntnis -- Erkenntnis -- 
  überall Wert Wert Inhalt -- Grad -- Grad Wahren -- Vorstellung -- 
  -- Theorie Kunst -- 
  letzter -- angenehm Empfindung -- 
  erhalten unterst Stelle -- weder Anfang -- -- -- Zweck nehmen -- Erzeugung begleiten -- gleichsam Signal Erfüllung -- 
  vorübergehend -- passiv -- folglich Gattung begriffen Freude -- Verstande -- Art Ursache -- Erkenntnis Tugend Genugsamkeit unentbehrlich Beimischung -- hervorgebrachen -- gehören demnach Natur Ewig -- 
  Erörterung lassen Plato Sokrat folgend Wort beschließen -- 
  -- Ochsen Pferd sämtlich übrig Vieh widersprechen -- bloß Lust nachjagen -- 
  glauben -- Wahrsager Vogel -- urteilen -- Wollüste köstlichst Gut Leben sein -- 
  glauben -- Lusttriebe Tier ansehnlich Zeuge Wahrheit sein -- eingegeben Rede philosophisch Muse -- -- 
  Zeitliche Ewig erzeugen -- welcher möglich Verhältnis beide lassen -- menschlich Weise -- denken -- 
  Klust füllen Philosophie -- bedürfen -- hinüber -- Brücke -- Flügel -- 
  einsehen -- Fuß Erde wandeln -- hinauf Wolke schwingen -- 
  Auge -- bloß Auge -- entdecken -- Hand greifen -- Fuß Besitz nehmen -- 
  verknüpfen Verstand folgend Weise -- 
  Ewigkeit hervorbringen -- darstellen erfüllen -- 
  Vergänglich Wesen Seele Natur -- lebendig Modifikation Unlebendig -- vernünftig Zufälligkeit Einschränkung -- leer Form nichtig Erscheinung -- 
  glauben -- entscheiden Verstand -- Ewig -- bloß Unendlich Erscheinung -- Lückenbüßer ohnmächtig Fantasie -- Anfang -- glauben Lebendig -- Wahrheit -- allmächtig Gott -- Geist Schöpfer -- 
  Hand -- Geist Gott -- 
  Frager Wort antworten Vernunft -- festes -- 
  -- -- entfernte Versuch -- Analogius wirklich Einsicht nah -- Irrtum entgegen schreiten -- hart anthropomorphisierend Ausdruck -- offenbar symbolisch -- Vernunft -- entgegengesetzt Wirkungsart assimilieren -- liebste -- 
  begreifen -- Maschinisttisch Vorstellungsart Schöpfung - Möglichkeit Weltall -- vernünftig -- erhaben -- hoch Wesen -- -- Weise -- vorauszusetzen nötigen -- annähernd -- anthropomorphestisch -- 
  Glaube höchst Wesen -- Quelle Sein Werdens -- Glaube Gott -- Geist -- Mensch unerforschlich Tatsache Spontaneität Freiheit -- Euklids Postulat denken lassen -- geben -- 
  Glaube Gott Mensch -- natürlichst Glaub lebendig Gott -- 
  Grübler -- losgewerden -- müssen zuvor -- geilst Mißbrauch Vermögen willkürlich Bezeichnung -- zweischneidig Schwert Wahrheit Lüge -- Natur Wesen gewaltsam ab -- müssen Leben gleichsam Wurzel anfassen -- werfen -- 
  sagen -- laut sagen -- Geschichte Philosophie lang desto Drama entwickeln -- worin Vernunft Sprache Menächme spielen -- S. Schauspiel Namens Plaurus -- Regnard -- Schakespear -- letzter -- Irrung -- 
  sonderbar Drama -- Katastrophe -- Ausgang -- reih Episode -- 
  Mann -- -- Auge -- nennen -- Größe stehen -- Tale -- Menge weg -- Höhe geschmückt Bühne - Mann scheinen Gang Verwicklung Stück erforschen -- absehen -- mehrere behaupten -- finden -- 
  -- 
  fehlt Kritik Sprache -- Metakritik Vernunft -- Metaphysik Sinne lassen -- S. 
  Kant Untersuchung Deutlichkeit Grundsatz natürlichen Theologie Moral -- Beantwortung Frage -- königlich Akademie Wissenschaften Berlin 1763 aufgeben -- 
  deuchen -- sehen Auge -- schrieben wunderlich Ding -- 
  lassen -- leben -- 
  F. H. Jacobi -- 
  Verzeichni Brief -- I. Syllie Clerdon Seite 1 II. Syllie -- 6 III. Clerdon Syllie -- 10 IV -- 
  Syllie Clerdon -- 14 V. Clerdon Syllie -- 24 VI -- 
  Beilage Clerdon Brief -- 
  Eduard Clerdon -- 36 VII -- 
  Amalia Syllie -- 46 VIII -- Cläre Syllie -- 58 IX -- 
  Eduard Allwill Clemens Wallberg -- 68 X -- 
  -- 88 XI -- 
  Amalia Syllie -- 95 XII -- 
  Syllie Lenore Cläre -- 110 XIII -- Lenore Syllie -- 119 XIV -- 
  Beilage vorhergehend Brief -- 
  Cläre Syllie -- 133 XV -- 
  Cläre Syllie -- 137 XVI -- 
  Allwill Cläre -- 171 XVII -- Syllie Clerdon -- 184 XVIII -- Syllie Amalia Seite 189 XIX -- 
  Syllie ebendieselbe -- 199 XX -- 
  Eduard Allwill Luzie -- 224 XXI -- 
  Luzie Eduard Allwill -- 246 Zugabe Herausgeber -- 
  Erhard O * * -- 281 Übersetzung griechisch Stelle -- 
  Titelblatt Vorrede -- EA Ολυμπος ηυλει u. S. W. Olympos spielen -- nenn Stück Marsya -- Lehrer -- 
  Stück Flötenspieler schlecht Flötenspielerin spielen -- göttlich -- setzen Begeisterung offenbaren -- Götter Religion Bedürfnis -- 
  Schlus Allwillisch Briefsammlung -- Theos ανϑρωπῳ u. S. W. Gott lassen -- unmittelbar -- Mensch -- Vermittlung Dämon Gott Mensch Umgang Unterredung -- 
  Titelblatt Zugabe -- Βουλει δητα u. S. w. Stelle folgend Zusammenhäng -- Sokrates -- 
  annehmen -- All nennen -- Kraft Unvernünftig absichtlosen -- Zufall regieren -- Gegenteil -- alte sagen -- Verstand gewiß bewundernswürdig -- zusammenordnend Weisheit Rud -- 
  Protarchos -- 
  -- göttlichst Sokrat -- -- 
  -- -- scheinen ruchlos -- 
  annehmen -- Verstand All Ordnung halten -- Anblick Welt Sonne Monde Stern umlaufs würdig -- 
  sprechen denken -- 
  Sokrat -- 
  -- unser einstimmig alte annehmen -- verhalten -- begnügen -- Gefahr nachzusprech -- Gefahr übernehmen Tadel ausweichen -- gelehrt Mann behaupten -- verhalten -- überall Unordnung -- 
  Protarchos -- 
  -- 