Abteilung -- Poet -- 
  jung Europa -- 
  Novelle Heinrich Laube -- Band -- 
  Leipzig -- 1833 -- 
  Otto Wigand -- Inhalt -- 
  Seite 18. Hippolyt Konstantin 1 Valerius Konstantin 1 19. Kamilla Ludovico 36 20. Hippolyt Julia 3921 -- 
  Valerius Konstantin 41 22. Julia Mutter 48 23. Valerius Konstantin 59 24. Hippolyt Konstantin 62 25. Konstantin Valerius 70 26. Kamilla Alberta 81 27. Hippolyt Konstantin 83 28. Valerius Konstantin 93 29. Hippolyt Konstantin 100 30. Julia Mutter 103 31. Alberta Kamilla 105 32. Leopold Valerius 109 33. Kamilla Alberta 118 34. Valerius William 122 Seite 35. Hippolyt Valerius 143 36. Valerius Konstantin 149 37. Kamilla Valerius 161 38. William Valerius 166 39. Konstantin Valerius 169 40. Kamilla Valerius 182 41. Valerius Konstantin 18542 -- 
  Oberst Kicki Grafen Topf 19218 -- 
  Hippolyt Constantin -- 
  7. August -- 
  Pferd -- Pferd -- Horse Horse -- kingdom for Horse -- Geschrien -- hinuntergestürzt -- fortzujag Paris -- lach -- Schmähe -- schlagen -- an Portal Schlosses -- 
  Julia steigen Reisewag -- neugierig Auge -- Auge Weltgeschichte schlagen Wimper -- bleiben glüh Liebesfieber -- Seele -- 
  Vergib -- reich Valer Feder -- schreiben -- 
  -- 
  Valerius Constantin -- 
  geles Wort -- Freund -- -- König verjagen -- Chart brechen -- Babe gehören zitternd Mund hundertmal Höre vorgesagen -- Eisrinde Herz springen liebend Seele -- hoffen verlernen -- glauben -- geben Gerechtigkeit Welt -- Freund Mensch brauchen gebrochen Herz sterben -- 
  O Berg -- Seele lasten -- flogst -- o schlimm Jahrhundert -- hattest verpuppen -- liebendst Sohn Angesicht erkennen -- 
  Franzose Hand -- Küssen -- drücken Küssen -- 
  leichtblütig Volk müssen -- Mal Riegel Entwickelungsgeschichte hinwegstoßen müssen finsteren -- Licht hereinbrechen -- strahlend Licht -- 
  O Vaterland deinen Philister -- diesmal abscheulich Undank -- Pförtner Weltgeschichte -- rosenrot Franken anerkennen -- 
  Konstantin -- Konstantin -- gefreut Knabe -- eingesperren -- hinausließ Sonnenschein -- unnützen Wanderstab werfen Rücksicht -- Besonnenheit -- fallen Grafe Hals -- sitzen Tisch -- Brief ankommen -- küßte Tochter zwei -- dreimal -- küßte Kamilla fünf- -- sechsmal -- reißen Fenster schreien Himmel -- 
  -- -- blau Bogen -- behalt Sonne -- Erde Freiheit eingekehren -- -- Leopold heben Höhe drückt Brust -- zerquetschen fast Schädel rufen -- -- jung -- sing Freiheitslied -- - Kind -- glücklich Stunde Leben -- 
  -- Konstantin -- vergeb dumm Streich schlimm Ding Schmarre Wange -- glücklich -- wollen -- bluten -- Leben wagen unser Glaube -- 
  Laß schweigen -- laß schweigen -- Freund -- kindisch -- 
  unser ameisentreiben erzählen -- sammeln -- 
  -- 
  Gleis hinaus Welt -- helfen Bau Weltkirch -- 
  Verhältnis beginnen Unordnung ordnen -- -- -- Volk tanzen Arm Arm Papier herum -- Liebespaare -- -- 
  -- -- Freiheit -- Glück -- Gewitter kommen -- gewöhnen -- 
  -- übermorgen unser Liebesgeschicht -- Parodi begonnenen -- -- 
  O Gott -- rosenfarben Welt -- gestern aschgraun -- soweit Blick senden -- Vogel -- Fenster setzen -- kommst schön Frankreich -- flogst Paris letzter Julitag -- bunt Stück Welt sehen -- 
  Vöglein -- Zucker -- bleiben ruhig -- ta Freiheit -- solch Frevler -- -- Freiheit Höchste -- fliegen fort lachen -- 
  bravor -- Vöglein -- 
  Wärst Kutscher -- Vogel -- -- 
  Konstantin -- siehst -- kindisch -- aufhören -- 
  Fluß werfen -- Glut kühl -- Welle ringen -- 
  Körper zucken Tätigkeit -- ermüden -- bringen -- -- 
  8. August -- 
  -- 
  heiligst Liebe einschließen Herz -- 
  Grünschloß erzählen -- grün Idyll rot Epos treten -- 
  erinnerst -- Graf Topf rätselhaft -- 
  glauben Rein -- 
  Graf Fip -- Ohrfeigengesicht -- offenbar Graf Tochter Alberta freien -- 
  schreiben Stadt jung Manne sogenannter vornehm Ständen -- freundschaftlich beweisen -- bitten Auskunft Herr Fip -- unser Grafe sagen -- 
  jung Adlig schreiben unbefangen scheinen -- genau unterrichten -- 
  Fips suchen reich Frau -- wünschen -- glaublich -- 
  Urteil Grafe klingen bizarr -- richtig Detail unterstützen -- passen hoch Stil originell Figur -- 
  -- Graf Topf -- -- Briefsteller -- -- -- Jugend Mann Mode -- neu -- Umgebung voraus -- stets wunderlich erscheinen -- 
  Mode aufkommen -- Italien reisen -- mehrere -- errichtet Florenz glänzend Haus Künstler -- wohnen leben -- Behörde dortig Kunst -- 
  --- Franzose vertreiben -- schimpfen -- Napoleonspoet -- verteidigen Welt -- 
  europäisch Kongreß beginnen Aristokratie neu übermütig Leben -- Muster Graf Topf -- Halbe vorher Residenz Grand Seigneur spielen -- glauben -- ruinier eitel Hochmut -- 
  leben Haus bedeutendst Schriftsteller Reaction -- Hr. Haller willkommen -- Kotzebue aufnehmen -- Hr. Stourdza Absteigequartier Grafe Topf Frau Krüdener trank Tee -- segnet Teegesellschaft -- 
  Turnzeit -- altdeutsch gebunden Gesangbuch Reaktion -- beinahe verpassen -- 
  allzu demokratisch Zeitlang abhalten -- einlassen -- wahrscheinlich hoffen -- Richtung vorübergehen -- 
  dennoch erinnern lebhaft -- durchziehenden Turnerband altdeutsch Mal rüsten -- schnell deutsch Rock Hand -- bloß Hals halb entblößt Brust alt Jahn Schlafrock präsidieren -- 
  erinnern lebhaft Streit -- führen -- Kastavien echt deutsch Frucht -- 
  Jahn verneinen zürnend -- werfen hölzern Schüssel -- -- Topf halb -- Geschirr Antik -- voll Kastanie Erde -- obwohl Turner opponiert -- schmackhaft Maron behagen -- 
  -- Eichel -- Topf -- wachsen Teutoburger Walde -- eicheln -- welsch überalpin Gewächs -- wahrscheinlich Hannibal Truppe Capua verweichelen -- 
  Tue Gleich jung söhn Teut -- Topf -- beschwör Hertha's weiß Rosse -- -- 
  Graf argumentieren Zeitlang Nibelungenliede -- rührn -- umarmt Jahn Wort -- 
  -- rett Deutschland ausländisch Tand -- 
  -- Jahn -- Kastanie -- -- 
  -- spanisch Korteskrieg ausbrechen -- wahrscheinlich englisch Unterhause Rapport setzen -- mehrere vorher -- ehe Canning St. Stephan erheben liberalen Donner Europa schleudern -- halten Graf Topf Gastmahl ähnlich Rede -- verrückt halten -- Zeitung England ankamen -- 
  Schlacht Navarin renommiertest philhellen Land -- teilen englisch Griechenlied -- Specialissimus Lord Byron schicken -- 
  ehe Kaiser Nicolaus denken -- Verdienstadel Erbadel erheben -- verteidigen steigend Beredsamkeit Idee fochen Türke Halbmond -- ehe russisch Truppe kommandieren -- 
  unverkennbar Absicht gehen -- weitsehend Politiker -- Mann modernsen Bildung spielen -- 
  wissen -- wichtig Staatsamt suchen -- Titel Gonfaloniere erstreben -- trotz extrem Handelsweis -- vorübergehend lächerlich -- stehen Rufe Klugheit -- Welt Meinung -- jung Geister Art umgeben -- vorausgehoben -- 
  -- Frankreich vorgefallen -- scheinen gelingen -- kennen liberal Richtung -- wahrscheinlich Freund teilen -- 
  sprechen Julirevolution Grafe Topf historisch Treffer -- wahrscheinlich mehrere hiesig Notabilität Grünschloß sehen -- Terrain rekognoszieren -- 
  Graf groß Freude -- 
  Vermögen kühn Art leben erschüttern -- keineswegs zerrütten -- Vermählung Tochter Rücksicht folgen -- historisch modernst Manne geben -- 
  Stand -- Vermögen Betracht -- Mode -- sogenannter geistig Vorzug Gegensatz herkömmlichen beachten -- 
  Seite -- werter Freund -- stehen Weg -- Absicht schön Alberta -- Julitag allgemein überzeugen -- Graf Fips reüssieren -- -- 
  -- Brief -- 
  denk Grafe Fünfziger -- Mann feinsen Sitte -- gebildetsten -- artigst Betrag -- Ding Kenntnis -- Empfänglichkeit besitzen -- 
  -- Wissen meist oberflächlich -- Klassiker lesen empfinden -- kokettieren Grieche abgeschmackter hohl Römer laufen hie -- Geschichte studieren -- verschieden Faden aufreihen -- Ansicht verworren -- 
  Religionsphilosophame nippen -- abwechselnd Atheist -- Deist -- Protestant -- Quäker Pantheist extrem Geist -- Positivität Haltpunkt finden -- romanisch Katholik -- Aufmerksamkeit Religionsgespräche anhören -- 
  Äußeres imponierend -- 
  hoch stark Wuch Gang adlig Gemessenheit Sicherheit -- früh Jugend damalig Grafe baronen sehen -- 
  Gebärde -- Gestikulation -- Bewegung -- breit -- sicher runden -- 
  siehst -- Tanzmeister ankommen -- überzeugen -- Graf Mühe geben -- modern -- kurz Bewegung erlernen -- 
  modisch kleiden -- 
  lockig Haar voll dicht -- Jüngling -- schneeweiß -- 
  Gesicht -- ebenfalls weiß Teint auszeichnen -- Geisterartige -- unstät schwarz Auge irren heimatlos umher -- 
  Schnitt Gesicht Edel -- Römernase erhöhen Eindruck -- 
  breit eingekniffen Mund unt Kopfes deuten -- Mann leben -- 
  Faltenlinie Nasenflügel drängen unter Wange tief hinab Kinn -- 
  unt Kopf hängen -- Spannkraft verlieren -- Bild Charakterlosigkeit -- 
  reden fast Sprache Anschein -- versichern Hippolyt Spanische -- William Englischen -- Leopold Italienischen hören Französischen -- keineswegs altmodisch meister Aristokrat reden -- jung Anacharsis plappern -- 
  Eins überaus liebenswürdig -- Sinn Art Poesie -- 
  Mann verdauen Vers Niedersitz Monat Stande verbrauchen -- hören Räsonnement Poeterei -- Raisonneur heiser -- 
  glauben -- lieben -- kosten klein Lied ausgebildet Gefühl -- klein Andeutung Beziehung entgehen -- 
  schön Band -- Tochter fest Herz erhalten -- 
  glauben -- Neigung Entferntest Weg treten -- müssen veraltet jung Mann fallen -- 
  Besorgnis schön Alberta -- 
  neigen offenbar Vorliebe altertümlich William -- altenglisch Stockjobber -- nennen beliebt -- 
  glauben -- gläubig Christentum fesselten weich furchtsam Seele -- 
  Hippolyt -- reizend böse Geschick Weiber -- Verwirrung vollständig -- 
  schlimm Sache Hippolyt -- 
  vorstellen -- Rechtsverhältnis -- Frauenzimmer begeben -- 
  Verbindung -- Seite Anderes gewähren -- genießen -- Laune -- 
  ernst Tadel ernst Versicherung -- einsperren lassen -- Gewalt -- erwidern lachend -- Frauenzimmer Liebe verlangen -- augenblicklich Neigung versprechen -- 
  rechtlich Kontraktsverhältnis -- Seite präsumieren -- Schuld -- 
  anfangen -- 
  Polizei anzeigen -- 
  betrachten bloß moralisch Bucklig -- Lahme etc. -- äußerer Übel -- Mensch sehen -- unaufhörlich Steckbrief schreiben Umgebung warnen -- Gendarm blank Klinge herreien -- 
  überzeugen -- unser bürgerlich Konstellatione Unrecht -- verband Gesellschaft Vielerlei -- Opfer bringen müssen -- 
  Verhältnis Mann Weib ordnen traurig Eins Ehe -- erfordern Verpflichtung stehend Aufmerksamkeit -- Schonung -- Vorsicht -- Entsagung -- Hippolyt kennen Verpflichtung -- eigentlich zivilisiert Staat brauchen -- 
  persönlich Freiheit Theorie gefährden -- Freiheit sehen -- Schrankenlosigkeit blind -- 
  Weib -- Ehe Krücke tausend schwache -- notwendig Hilfsmittel Gesellschaft ansehen -- Weib -- stark fühlen -- äußerer Nachteil Gesellschaft ertragen -- sobald Betrug entdecken -- Weib ergeben Freiheit -- freuen leiden selbständig frei Wesen -- jenachder Verbindung Freude Leid bringen -- weib suchen gewinnen -- sobald Interesse erregen -- 
  Galeerensklaven Freiheit Genuß reden -- grausam -- weib -- gewöhnlich Bande Gesellschaft Notwendigkeit sehen -- Befriedigung -- Genug finden -- Opposition Grund müssen -- Weib reiß Ansicht bürgerlich Leben annehmen -- Laster -- 
  Fall Hippolyt -- 
  Welt leben rechtlich Friedenszustande -- ziehen umher außerrechtlich erobernd Krieger -- unverschämt Bevorzugung Individuum Absolutismus -- verabscheu -- philisterhaft Handwerk entschließen -- Alberta -- sichr Beute -- Unglück -- harren -- warnen -- 
  weiße -- Mädchen glücklich -- heiß Stunde Strahl Liebessonne ruhen -- 
  glücklich -- sehen -- träumerisch umh -- lächeln schmerzlich -- sprechen -- innig -- weich Blumenblatt -- 
  waffengattungen Liebe sanft Herz ziehen -- Kriegsstande ausrüsten -- Feind Liebeshinderniß unser Gespräch Vorschein -- heben schön Köpfche plötzlich mutig -- Türkenbund -- Kopf tragen -- werfen Nacken fordern kühn Welt heraus -- 
  Scheu gewich Moment -- 
  ähnlich Gespräch redet -- Promeniert entfernt Teil Garten -- voll Herz innig Überzeugung Freiheit Art -- 
  horchen gesenkt Haupe -- plötzlich bleiben stehen -- rührend Blick Engel -- Gefühl Brust sprengen -- innig -- fassen Gesicht Hand -- legen Köpfchen Brust sprechen -- 
  -- Mann -- -- fliegen Schüchtern Reh dannen -- 
  Hippolyt sprechen -- schaueren Liebeslust -- fürchten -- öffentlich Hals fallen -- 
  Graf Fip lassen Kravatt Frack Stadt -- glauben -- fangen allmählich verzweifeln -- sprechen Abreise -- 
  übl Stellung -- bewundre aufrichtig Schafsgeduld Mensch -- treiben mehrere Woche ansehen -- 
  bürgerlich Pack verachten Grund Herzen Verzweiflung richten hie Gespräch legitim William -- einzig Knopf Rock -- verlassen -- 
  Graf suchen Gespräch allgemein -- lieben Graf Fips -- Unterhaltung -- Dame anknüpfen -- schnappen stets Geschwindigkeit -- Hippolyt befürchten -- Antwort bekommen -- 
  Leopold -- manchmal -- verwickeln poetisch Gespräch -- Ausweg finden -- leiden -- neulich Gespräch Adel -- fein Manier etc. -- mitteilen -- hassen unzweifelhaft entscheiden -- laufen Verlorener Gedanke vergangen laut fremd Buch herum -- rücken Brille -- zupfen braun Frack Taille -- Laffe -- Vergnügen -- 
  demokratisch treiben Tisch vorschlagen -- sprachlos -- 
  aß lang Tafel -- Sitz herrschen Art Rangordnung -- 
  stellen Grafe -- schön -- Ecken heutig Tag abgeschliffen -- drauf speis -- ten rund Tisch setzen -- -- 
  Graf ausbedungen -- Sitz -- zusammenschwatzen -- sitzen Kamilla fast Seite -- müssen böse -- 
  liebenswürdig Wesen -- Verstand -- fassen schnell munter -- 
  weißen -- lieben -- 
  stellen -- schnell Gefühl Finger fort -- glauben einzeln Gewitterschläg Wesen schließen -- tief Leidenschaft fähig -- verschlossen Gemüter gehören -- verstehen -- -- Tür wesen halten -- innerste Herzenstür Träne schönsen Freude tief Leide_es öffnen -- verstell -- Tür ahnen -- wissen glauben -- 
  solch verstockt Gemüt -- einst unendlich reich tausend Beglücke -- unendlich glücklich Unglücklicher -- 
  innerst Herzenskraft harren nämlich ungeschwächt Befreiung -- 
  schön wachsen äußerst liebreich Gesicht -- lächelnd schalkhaft Auge -- zierlich Stumpfnase -- üppig Mund -- schwatzen lachen blendend weiß Zahn zeigen -- 
  voll lichtbraun Haar flatteren zurückgestrichen Locke voll -- feist -- schneeweiß Nack -- Kopf -- 
  nennen Ludwig Frau -- erkläre öfteren Eigensinn Hartnäckigkeit -- 
  tun -- Mund schlagen -- 
  bunt Vogel kleiden -- mehrmals verhöhnen ausgelacht -- Farbenschönheit Farbenverhältnisse begriffe -- 
  Sieg tragen -- mehrmals einfarbig kleiden -- zugestehen -- bunt Wesen passen -- 
  Abend -- Alberta erregen -- fast geliebter verwechseln -- finden Hippolyt zurecht -- 
  zufällig Szene -- artig Bild -- 
  saal -- -- Glastür trennen mehrere Stufe tief Gewächshaus -- Orangerie stehen -- Raum Schloß deutsch Luft vertragen -- 
  suchen Kamilla -- nirgends sehen lassen -- Saal leer -- gehen Glastür seh Tiefe südlich Baum Alberta sinnend träumend Hand Schoß legen Feigenbaume sitzen -- 
  Preciosa -- gebrochen Herzen nachsinnen -- Alonso Madrid nachfolgen -- 
  öffnen Tür Seite Orangerie Fandango singend Hippolyt herangestürmen -- 
  Traum springen Mädchen heben Arm -- 
  -- Hippolyt -- überraschen -- fassen Hand -- sinken Brust umschlingen -- heben Hand Kopf Höhe küssen -- 
  fremd Baum Glastür -- sehen still -- mal Bild -- -- 
  Graf holen gestern Schreiben spazirengehen -- 
  verdrießlich -- Freund -- all Ding -- zusammenfädeln -- lächerlich -- erzählen -- Markt Welt herumbewegst -- 
  denken -- Mikrokosmus unterhalten -- fürchten interessant -- 
  Graf unsicher -- fühlt Hippolyt -- wissen -- beschreiben -- 
  heiß -- -- heiratlich -- bürgerlich ernsthaft -- Zweifel bleiben -- Graf wollen unser Weibertreibe an Leben -- 
  klar heraustret Antwort -- Frage -- Solchergestalt Betise begehen -- indes lassen undeutlich merken -- Wendung Fahrt Kram passen -- sogar unangenehm -- 
  Welt wahrhaftig Heiratskanzlei -- Haus treten -- worin weiblich Wesen wohnen -- Herausgehn Heiratsfragezeichen Rücken -- 
  Geselligkeit Grunde richten -- 
  Sieh Schloß -- verzweifelt Einzäunung zerrissen -- zerteilen -- 
  Graf Fips reisen 14 -- ärgern dreimal -- beschließen 10 Mal -- reis Mal -- warten wollen -- 
  Sonne aufgehen -- Erde unschuldig unglücklich Liebhaber hoffen gute -- Fip Maulaff -- fühlen traurig Schmerz -- Korb Frackschoß tragen -- -- 
  Gefühl Empfängnis Schmerzes fehlen -- ersetzen Eitelkeit -- glauben -- warten bloß -- fürchten -- leer Stadt ankommen -- 
  Leopold's leicht Sinn sogar brechen -- hinkt lahm Fülle hinaus Feld -- ernsthaft -- Scherz erschricken verkauft verschenkt Auge -- Blick -- 
  wenig bange -- Flußreiher Fabel -- nascht herum -- Liebeshunger drängen -- Gründling vorlieb nehmen -- 
  hören -- Pastor Förster -- tändeln wahrscheinlich Waldmaid Gotteslämmchen -- 
  William Greuel -- philisterhaft Absonderungswut rächen fürchterlich -- -- reichen schön Welt abschachteln traurig dumpf Arche Noah -- verlaßen -- trostlos Wesen -- 
  Alberta entscheiden Kraft Hippolyt wenden -- William wahr Cromwell -- Maltraitiere -- 
  ingrimmig -- grob -- ungezogen -- boshaft verwöhnt Knabe -- 
  ärgern -- 
  christlich Liebe -- Mann Lippe tragen -- 
  Freiheit kennen Glaube Gefühl -- wissen gestatten -- 
  Eifersucht Fanatiker Schwärmer -- unangenehm -- 
  Schmerz -- Grimm -- 
  Ruhe aufgestört -- fröhlich Kamilla täglich verweint Auge sehen -- heiter Wort Lippe hören -- Mädchen innig dauern -- wissen fehlen -- 
  unglücklich Mädchen Mörder Hippolyt lieben -- -- 
  Sieh -- Ding -- unnützen Wirrnis -- Leben unklar -- unerquicklich -- 
  -- ärgerlich -- 
  geben Welt Beziehung Mann Weib -- 
  traurig Kamilla -- Verwirrung fürchten -- 
  führen Geschick Gräfin Julia hierher -- Haus Tollhaus -- 
  Sache reifen lassen -- ehe breit sprechen -- 
  geben möglich Mühe -- wichtig -- spannend -- verletzend Gespräch allgemein Gegenstand auf's Tapet bringen -- sobald Tisch Tee versammeln -- Spannung Zerrissenheit Gesellschaft zudecken -- 
  Höre -- 
  William behaupten Grimm -- häuslich Einrichtung hoch Bürgerhäuser bequem -- meister sogenannter vornehmen -- adlig Haus -- Adel wohne schön -- selten wohlhabend Bürgerlich -- 
  Fip plump angefangen Sache plump -- reizen -- fortführen -- 
  -- Vornehme kennen häuslich -- klein -- fast trivial aussehend Bequemlichkeit Leben selten -- wohne brillantest Stube -- Stube wollüstiger Winkel -- Körper Faulheitsdrange ausstrecken können -- Herrlichkeit aufhäufen -- zerschlag fürcht -- fehlen Lauschige -- behagliche Wohnung -- Hauptblüt Kultur -- Horazisch Vermischung Nützlich Angenehma -- angenehme schöne -- Hauptsumm all Ding -- bequeme gehen sogenannter Vornehm meist -- 
  leben ewig Frack -- Keck zuzusetzen -- Haus kurz seiden Strümpfe umh -- Sprung wagen -- fürchten -- platzen -- 
  -- Oberfläche -- Erscheinung berechnen -- schätzen -- Auge fallen -- scheinen -- niemals -- oberflächlich wissen -- historisch Erscheinung -- fast gesellschaftlich sonstig Entdeckung vornehm Klasse ausgehen -- 
  wohnen -- Kleid -- Form -- sogenannter Manier -- hell Sonnenschein Schneeflur -- sehen glatt -- wissen -- glänzend -- schimmernd -- unerquicklich -- kalt unbequem -- 
  fehlen Innerlich -- Herz -- 
  Bringen -- -- Geist -- nimm Seele -- liegen Zuschnitt -- Jugend glänzen -- wärmen -- 
  Hippolyt setzen hinzu -- eigentlich vornehm Leute Staffage Welt -- Ausnahme -- tief fühl ausfüllen -- meist unglücklich -- 
  Alberta schrak -- Sprecher -- Blick schneidend Schmerz -- 
  Fip verächtlich Gesicht -- 
  Graf scheinen ebenfalls verletzen meinen -- Räsonnement einseitig -- Winkel ansehen -- 
  -- historisch Stellung Adel -- Angriff unzweifelhaft gelten -- Weise dartun können -- 
  Adel -- Hippolyt Wort -- Konstruktion Gesellschaft begründen Stellung -- integrierend -- lebendig Staatsleben -- Wort -- Leben -- Herr Sklave -- 
  herrschend Klasse -- Anführer Kriegern Eroberer bestehen -- 
  Schwert Kriterium -- Adel -- gestatteten -- Fürst -- halten soweit Zaum -- Teilnahme Herrenrecht nahe treten -- 
  Allmählich machen Sklave heranwachsend Maß -- Erfindung -- Gelehrsamkeit geltend -- Schwert reichen -- sprechen Adel Vergangenheit Hilfe -- erfand Stammbaum -- Ahn -- Stelle Schwertrechts treten historisch -- 
  Verzug groß Besitz -- hoch Klasse repräsentieren -- 
  spekulativ Geist Bürger reißen Besitzes -- Gelehrsamkeit flüssiger -- fing -- Bestandteil Gesellschaft prüfen -- Adel nötigen glänzen -- Kern verdorren -- 
  hoch Tätigkeit Mensch drängen allmählich Früchteknot -- entstehen Bildung stürzen Adel -- Kriterium Schwert Ahn vernichten -- 
  Allgemeinheit vernünftig lächerlich Begriff -- hoch Stellung Gesellschaft Anspruch -- Vorfahre tun -- 
  Gott -- beginnen Graf Fips -- Unterschied existieren -- 
  erhalten Antwort -- lachen -- 
  Gespräch scheinen abgebroch Leopold knüpft spaßhaft Antwort Fip -- 
  -- -- Unterschied Klug dummen -- existieren -- 
  Graf Topf schweigen -- 
  William erheben Stentorstimme verteidigen Erinnerung -- Tausend aufreize -- -- selbiger -- 
  Adel -- Verhöhn Herkommen historisch zugäbe -- bräch jakobinisch Vernunftrecht unheilvoll herein stehen sicher -- 
  erwidern -- bestehen sollen -- vernünftig -- Zweifel obwalen -- Art Weg -- alt Schutt wegzuräumen uneins -- 
  gemäßigt Reformer Privatrecht verletzen -- allgemeine erzeugen -- 
  Adel Privatrecht -- usurpiert Titel alt Gewalt -- Gewalt stürzen König Land Narr -- König nennen Hofzeremoni umräuchern lassen -- 
  Adel wahnsinnig erklären -- fahren Hippolyt fort --- Generalsuniform einhergehen wollen -- längst Menge Reihe Glied marschieren müssen -- 
  -- -- schwach -- sagen -- -- schalten Graf Topf -- 
  siehst -- gereizt Gespräch -- 
  versuchen einlenken -- Anfangspunkt Unterhaltung -- Mangel bequem warm Leben beziehend -- setzen hinzu -- 
  Seite -- Adel Herrscherzeit behalten -- -- leicht Art leben -- 
  leben geflügelt -- frei -- stellen glauben -- Geschäft Nebensach -- Genuß Leben Hauptsache -- 
  wissen genießen -- suchen -- 
  mühen Jahrhundert -- hierher kommen -- lasten lähmend unser Schwing -- 
  Adel Mühe -- Wesen leicht -- verfällen Irrtum -- Geschäft Zweck ansehen -- z. B. Kaufmann tun -- 
  hoch Bürgerstand leben bequem -- Jugend Flügeltür Herzen stehen innerlich voll -- bloß Äußere sehen -- erben ansehen -- Reisegeld verdienen -- Adel leben leicht -- Jugend sorglos -- 
  kennen Hypochondrie -- Krankheit Mühe -- -- 
  Inde -- Sieg erkämpfen -- Not Kampfe vergessen -- erwerben Vorzug -- Adel tadeln -- verlachn -- banquerotte Kaufmann -- Goldstück rechnen -- 
  Mensch Sinn trachten Bevorzugung -- heben Graf Topf -- moralisch Streben bändigen -- siegern historisch Klasse bilden Aristokratie -- Phasen Geschichte Wechsel herrschend Klasse -- Aufhör -- Feind Geldaristokratie wahrlich -- Herr -- platt prosaisch -- Funke Poesie -- Extrem Adel -- trostlos Geschäft -- schwingen Gewande Industrie Thron -- schaudern -- bloß rechnend Herrschaft -- Herz gelten -- 
  gestehen -- Hut müssen -- Sieg stehlen lassen -- Sieg Bildung -- 
  -- fahren fort -- Schritt -- Erbaristokratismus stürzen -- Geldaristokratismus ankommen -- Ekelhaft -- 
  nächster Morgenröte Geld -- Gelehrsamkeit -- wissen bringen -- Ewigkeit -- Gott Vergangenheit -- lächerlich Ahn geben -- Adel verlangen -- 
  liegen Fundament zukünftig -- Frankreich beginnen -- 
  Weg -- unbedingt Gleichheit -- unbedingt gleich Befugnis -- Losung Jahrhundert -- 
  Erbt Sohn Millionär Million -- werfen abgehend Schlußsatze Graf -- 
  Hippolyt antworten -- 
  verlieren -- Nachbar gewinnen -- 
  Ahn verlieren -- Nachbar gewinnen -- ruhen Widerspruch Theorie -- 
  erreichbar -- 
  Graf Fips meinen -- fein Manier erwähnen -- barbarisch Ansicht Grund -- 
  erwidern -- fein Maniere Produkt Zivilisation ansähen -- keineswegs Untergang Adel glauben -- 
  -- fahren fort -- -- Herr Graf v. Fips -- nennen -- dürfen verlieren -- -- Adel verstehen -- Frucht schön Schale -- Zweck Aussehen erreichen -- nimmer öffnen brauchen -- eigentlich fein Manier Ergebnis hoch Kultur -- meister fein Leute kennen -- kultivieren -- 
  handeln Kompliment Floskel -- Tournüre -- Übung tanzen erlernen -- erlernen -- Bedingung Erscheinen -- erscheinen schön -- 
  handeln hoch geistig Verständnis schön gewandte geeignet Erscheinung Geistigen -- handeln -- wissenschaftlich Bildung schön sauber kleiden Gesellschaft -- passend harmonisch Kostüm Ton auftreten --- Blüte Kultur -- fein Manier -- 
  Sache Kunstsinn verwerflich Ästhetik -- huldig -- äußerer Erscheinung angenehm runden etc -- -- Tölpel verletzen ästhetisch Gefühl -- wiandte Weltmann erfrischen -- -- Sicherheit zuschauenden Mitbeteiligt Sicherheit erzeugen -- 
  Blatt Blüte Kultur -- Frucht -- Kern -- bleiben ewig Hauptsache -- Tölpel schön gediegen Wort erquicken -- Weltmannes fad Geschwätz anekeln -- gebildet Mensch Ziege Blätter leben -- Frucht brauchen -- 
  stellen dar -- Anbeter fein Manier Schaum Fleischtopfe schwimmen -- abheben Erde werfen -- Koch Sekunde Gewißheit erfreut -- Fleisch beginnen -- 
  künd Kultur -- -- 
  Schein -- Äußere Innere durchlaufend unterscheidend Typus sogenannter Vornehmen Gebildet -- 
  sogenannter fein Mensch Geringst -- geistig Interesse Gesellschaft Kopf stoßen -- zierlich Komplimente tun -- sprech Wichtigste -- erzählen -- les Interessanteste -- gesellschaftlich Unding -- ereignen -- brechen -- stören -- Mensch fein Manier fragen -- Gedanke -- Folgerung unterbrechen - manier Form -- Gedanke halber -- Gedanke erzeugen Form -- Form Gedanke -- 
  Gipfel Förmlichkeit -- Auserwählt -- Römer formosi nennen -- äußerlich schön -- -- 
  wissen -- Rom groß Mann formosi -- 
  z. B. fein Manier -- anzudeun -- verstehen -- Schlangenwindungen Gedankenprozesse folgen -- straucheln Hand reichen -- eilen fliegen -- nachzueilen -- nachzuflieg wenn_es fliegen artig -- bemerken -- geistig sonstig Interesse Teilnahme verfolgen -- geistig moralisch Atmosphäre -- -- ungeteilt Aufmerksamkeit schenken -- Äußere -- herab gefallen Nadel -- Zwirnknäul etc. übersehen -- 
  Mensch anschmiegt -- Manier -- angenehm Zugabe -- 
  hauptsach -- setzt Hippolyt -- Leerheit -- Abgeschmacktheit -- Unkultur -- fein Person -- Wohlbefinden -- unser gebildet Ständen zählen -- Bildung wissen hohl Spielereie -- Firlefanz Puppenkram -- 
  -- fein Manier Prärogativ Adel -- 
  letzter -- bürgerlich Aff -- 
  lächerlich Schwäche -- arrogant Titel -- Adel -- gestatten -- Polemik gebrauchen -- nenn -- Junkerei -- ähnlich -- 
  still -- heftig sprechen -- fürcht -- hiesig Gesellschaft Auflösung nahe -- 
  sehen Glastür Kamilla einsam wandeln -- leben -- ernstlich erfahren versuchen -- Kummer lieb Mädchen drücken -- -- 
  Leb -- 19. Kamilla Ludovico -- 
  Grünschloß -- 
  Unrecht -- gerichtet Vorwurf gerecht -- 
  bleiben -- lieb Hand antragen -- überraschen -- unerfahr Ding -- wissen -- versprechen -- 
  müssen bleiben -- kommen -- versprach -- Frühjahr -- 
  Schmerz ersparen -- 
  Treue brechen -- 
  Verlobungsring liegen Kasten -- 
  Fürchten Nachricht Exzesses -- gelten Treue Herzens -- 
  Valerius -- Poet -- -- werben -- leben ruhig -- harmlos -- Anschein Wunsch -- verlangen Seite gewinnen somit -- suchen -- Teilnahme -- 
  -- zuweilen dämmert Vermutung -- gefährlich -- 
  -- Erlaub Wort -- letzter Brief berechtigen -- 
  schütteln lächelnd Gedanke leicht Schwing wesen -- hoffen lieben -- zuverlässig Freund gewinnen -- 
  unwandelbar Gleichmut bestärken -- 
  Blitzstrahl treffen Wetter -- 
  such Alberta -- Garten promenierten -- 
  bieg hoch Zypressenreihe sehen Tiefe Garten Bäumen Gruppe -- erstarren -- traurig Gewißheit Innere bringen -- 
  Alberta ruhen Brust Valerius -- 
  heiß Träne stürzen Auge -- fühlen -- untreu -- unglückselig Mann lieben -- 
  Erde Geständni Lippe bringen -- ich_es schuldig -- 
  Vergebe -- vergessen -- 
  denken Teilnahme grün Schloß -- Leid breit Feld Trauer sprießen -- 
  -- Jüngling lieben Mädchen -- erwählen -- lieben -- vermählen -- 
  Stifter Unheil unglücklich -- 
  Alberta lieben Freund Hippolyt -- fürchten -- lieben schön Gärfin Julia -- Kurzem ankommen -- 
  Unglück eingenisten -- 
  grüßen innigst Schwester -- o Leid Busen weinen -- 
  bitte -- antwort -- aussprechen -- 
  Vergebe -- 
  Kamilla -- 
  20. Hippolyt Julia -- 
  Haus tot geschrieben Wort richten -- warm lebendig gestatt Zugang -- 
  verschließ Zimmer -- nehmen -- Licht Auge -- 
  schuld -- sehen Alberta -- 
  heiß glühend Herz -- Fräulein -- schwören -- -- kalt Gemüt erwärmen -- Hand reichen -- Fingerspitze Leben Herz treiben -- 
  weib Liebe erklären -- -- Julia -- sagen -- vergeh Liebessehnsucht -- 
  Sonne -- Mond -- gestirnt Himmel Wunsch -- Erde -- Welt -- Hoffnung Seligkeit -- 
  Antwort -- Seele flehen -- antworten gütig -- öffn Zimmer -- sehen -- verschmacht Wüste -- 
  Anblick erfrischend Quelle -- rennen Kopf Nacht -- 
  Licht -- o leucht Meer Licht Auge -- 
  zünd Schloß -- Flamme tragen -- Dampf Glut küssen -- 
  -- Weib -- Unterjocht -- lieben Julia -- weißen -- 
  Antworte -- erscheinen -- -- 
  21. Valerius Constantin -- 
  schreibst Zeile -- Mensch -- 
  Lebst -- 
  Stärke Gemüt zusammennehmen -- drang Ding fest stehen -- 
  Unglück begegnen -- laß wissen -- -- Freiheit gefocht -- einzig Unwandelbare Leben -- 
  Unheil -- 
  Kamilla weichen -- stehen Rede -- 
  tun unendlich weh -- 
  Alberta liegen krank -- Hippolyt Herz brechen -- Südländer rasselnd aufgesprungen -- rasen Liebe schön Julia -- 
  fliehen Reh Wolf -- halten mehrere Zimmer verschließen -- 
  Tisch -- Augenblick setzen -- fahren Fürstin Constantie -- 
  Verwirrung vollständig -- 
  Hippolyt schäumen Eber -- Not -- zivilisiert Schranke halten -- 
  Mensch Bildung -- sehen Tat blutig Barbar -- 
  Graf äußerst niederschlagen sprechen wehmütig rührend Wort -- 
  -- alt -- -- voraus -- übereilen morden arm Kind -- -- 
  -- 
  erhalt Ausforderung unbekannt Hand -- 
  Nichtswürdigkeit häufen -- entsetzlich Verbrecher -- 
  unangenehm -- einzig Mensch Gegenstand Abscheus -- 
  Sinn -- Gedanke aufsteigen -- Handschrift irgendwo sehen -- 
  aussinnen -- 
  Anschuldigung indes unklar -- unbestimmt ausdrücken -- genau wissen -- Übeltat anklagen -- 
  Weiber scheinen beteiligen -- eifersüchtig Ritterdienst tuend Mann -- 
  somit Sache Mißverständnis -- wissen wahrlich -- Weiber halber tun -- 
  Mann verlangen Antwort -- Kurzem melden -- 
  offenherzig -- 
  Sache unangenehm -- neuerdings gefürchten -- Duellangelegenheit verwickeln -- fatal Kampf gesund Ansicht schwächlich Empfindsamkeit voraussehen -- 
  Duell verhassen -- sogenannter Skandäler Universität zurückdenken -- Harlekinad -- bunt Lappe studentenleben bestehen -- Paukereie erscheinen ernsthaft Spiel -- Unglück geschehen -- 
  Harlekinsjack ausgezogen -- Spiele lassen -- 
  Staatsweg verbieten -- Beschränkung persönlich Freiheit -- Verhältnis -- fein Linie bürgerlich Kenntnis -- Natur -- Fresko malen -- 
  wehren -- Vorteilen Zivilisation Anteil nehmen -- sobald -- -- stören -- 
  Gesetz begreifen Angelegenheit Degen Kugel schlichen -- gewähren lassen -- 
  betrachten jeder Duell mißtrauisch Auge -- Günstig tun -- 
  gestatt -- unbeschadet äußerer Ehre zurückweisen -- blamiern -- verlach mittelalterlich Courage -- Vorrecht Student Soldat -- Ermangelung gut Kern Mittelpunkt Leben -- Eigenschaft bedürfen -- vollkommen gelten -- 
  Mann Weltgeschichte dürfen leichtlich taugen -- Duellmaßstab anlegen -- Mode -- selbigen Maßstab anlegen -- 
  Kind -- 
  Dummheit fürchten -- tüchtig Mann -- Klugheit Furcht -- Dummkopf -- tun Ehre -- 
  Universität schlagen -- -- -- Student -- wahrscheinlich schlagen -- schwach -- Mut -- stark -- 
  gut -- Schreckbild gewöhnen -- Feig gelten -- gehören wahrlich Mut -- Angesicht sehen schmal Kugelmündung -- 
  Besserung schnell Statte -- jetzig Ausforderer heimschick -- letzter -- Narrheit treiben -- 
  Laß gestehen -- Schwäche Umgebung steigern -- Adel sehen Duellmut Prärogative -- womit Prärogativ verdienen -- Unsinn Duell klar beweisen -- zucken Achsel schwappen Bauch sprechen -- 
  -- sieht_es -- etc -- 
  -- Indianer mussen Götz -- verehren -- glauben -- ehe -- beweisen -- Götze Götze -- 
  gläubig stellen -- offen Markt Götzenbild zertrümmern -- 
  lächerlich -- Laffe preisgeben -- Zeitpunkt betreffend -- Dienst -- 
  beschäftigen hoch Interesse Menschheit alt Rest blutrache -- faustrechtlich Larifari unterwerfen -- Predigt Kanzel sündigen Kirche -- 
  Krieg bleiben Akt Barbarei -- Verschiedenartigkeit Stufe -- Volk stehen -- abschaffen -- Krieg wahrlich dämpfen -- 
  Dummheit -- Kriegerstand übrigen voranstellen -- nachzusetzen -- 
  notwendig Instrument Übel -- Kultur gering -- Instrument bedauern Mitleid ansehen -- redend Beweis Unkultur -- 
  eingefallen -- Kanone Verehrung ansehen -- Maß Mensch niederschießen -- 
  alt Rest Eroberung -- Lehnwesen -- Barbarei -- gelten -- physisch Gewalt entwickeln -- Furcht einflößen -- 
  Kultur beginnen Zerstöre -- haut Wald nieder -- töten wild Tier - Beginn Kultur stehen bleiben barbarisch Schutzmittel Staat -- Kriegsheer vorn stellen -- hoch Kulturzustand Staates -- desto tief treten roh Krieg Schatten -- desto verschwinden roh Mut -- Professions-Duellant nötig -- 
  Lehre Jugend -- Tod fürchten -- Lehre zivilisiertecr Weise -- 
  -- Fürstin Gefolge mitbringen -- 
  bunt festlich treiben eingekehren -- putzen -- vergnügen -- leben Totenacker -- bunt Blume bewerfen -- 
  Hippolyt stehen knirschend Todesengel vernichtend Wort -- Blick Gebärde -- 
  beißend witzig -- verständig -- vornehm sehen -- 
  keck Fürstin richten Wort -- werfen Dolch Wort -- 
  gestern fragt Desdemona -- 
  fürchterlich Kälte erwidern -- 
  schlang Leben vergiften Ort vertreiben -- glücklich -- wahnsinnig -- 
  Constantie erbleichen -- 
  fragt -- gräßlich Erfindung Grimme -- 
  -- erwidern -- reichen Brief -- 
  Wien Desdemona anfangen -- schreiben herzzerreißend Sehnsucht -- Liebe stehen Höhe -- schwindelen -- Fortsetzung unbekannt Dame -- Hippolyt mitteilen -- Desdemona hitzig Fieber verfallen -- Arzt Leben Verstand besorgen -- 
  möge ergehen -- 
  Leb -- 
  22. Julia Mutter -- 
  -- lieben -- lieb Mutter -- -- -- Wort passen -- unglaublich wunderlich -- 
  Augenblick fühlen beseligen -- schwimm Blütendüfte -- lang unaussprechlich Angst -- kindisch Verzweiflung -- 
  leit Dichter gewöhnlich -- verliebt Mädchen einführen -- wissen -- Papa lachen -- -- 
  jung Mann -- Welt Hippolyt nennen - Sohn spanisch Grand - beispiellos Weise Hof -- 
  stürmisch Wesen -- übereilen -- tödlich erschrecken -- Fürstin Constantie -- -- vernehmen -- unglücklich Alberta sehen -- glühend lieben -- plötzlich verlassen -- flößt Grau Mensch -- 
  Zauberhaft schön -- beredt -- liebenswürdig -- lieb Mutter -- Ausdruck erfinden -- 
  gefährlich Mensch -- 
  -- vereinzelt hören -- Ausbund Lasterhaftigkeit -- Größe Untugend -- versuchen bewundern -- 
  wissen z. B. Alberta heftig Neigung -- hinnehmen angenehm Geschenk Ankunft mind Notiz zeigen -- 
  Meinst -- Gegenwart befangen -- Mindest befangen -- 
  Gott bewahren -- unterhalten harmlos -- vorgefallen -- 
  verfolgen feurigst Versicherung Liebe -- Bitte liegen Wild -- Herausfordernd -- 
  Himmel wissen -- Fürstin -- Hiersein unglaublich leidenschaftlich Partei -- erregen -- sprechen -- Zeitlang glauben -- glühend Neigung Livrée Haß kleiden -- auffallend Anblick -- stolz gewaltig Frau imponierend Hippolyt sitzen sehen -- 
  Constantie vornehm -- fest -- starr Auge -- erzähl Geschichte Nichtswürdigkeit -- Blick sprühend -- werfen blitzend wolkenhimmel laut Zerstörung Verachtung Auge -- verächtlich heruntergezogen Mund sprechen Erläuterung fürchterlich Blick -- 
  Name Desdemona aussprechen -- Stolz Fürstin brechen -- Schlacht verlieren -- unverkennbar -- Leute -- vielfach Beziehung -- 
  Constantie heftig -- leidenschaftlich -- sogar rachsüchtig -- eitel -- stolz -- Hippolyt arm Alberta ergehen -- 
  genau -- Hippolyt fragen -- erinnerst -- lieb Mutter -- verwegen vorig Winter Berlin dergleich Ding sprechen -- Donnerstag klein Gesellschaft -- 
  Art lieben fürchten -- Neigung glühend Sirokko -- passen eigentlich Hippolyt -- 
  Alberta unaussprechlich gelitt -- scheinen hitzig Krankheit Heftigkeit -- schnell vorübergehen -- 
  Glück Freude Herr Valerius -- wohltätigsten Einfluß ausüben -- 
  einzig -- Hippolyt jetzig Leidenschaft -- allerlei Ingredienzie zusammensetzen -- reden -- 
  glauben -- Hippolyt hassen Fürstin -- lieben glauben -- Manne -- lieben -- teilen wahrscheinlich Woche Schicksal Verlassen -- Schicksal teilen -- hinreißen -- übereilen lassen -- Gefühlsaufwand -- Stürm -- Unebenheit -- unersprießlich Geräusch -- 
  lieb Mutter -- Vater Tochter -- schilen Wesen -- 
  innerer Ordnung Glück -- 
  Könntest umsehen -- Neigung -- Leidenschaft -- Verhältnis bunt liegen -- ungeordnet Zimmer -- Würdest zurückschrecken -- 
  Unklarheit -- Verworrenheit innerer Ding Unglück -- Tod hetzt Gespenst -- 
  loben Herr Valer -- fast lehnen -- fest stehen scheinen -- 
  -- Alberta magnetisch Rapport ständen -- treten -- schließen Blume Schmerzes Träne -- lieb Mädchen mild -- Sanft -- manchmal sogar heit -- 
  sprechen schön -- glänzend Hippolyt -- eindringlich -- gediegen -- Eigenschaft blendend -- sicher -- fest -- abgemacht -- 
  lieben -- 
  Graf Topf zugetan -- Fürstin -- anfänglich ignorieren -- sparsam Annäherung Höflichkeitsformen -- geizen förmlich Gespräch -- 
  schaffen einzig heimlich Abendstunder -- 
  sitzen Plattform Schlosses Zelt -- sehen Seite fern Berg -- nah Stadt Flusssspiegel -- hinziehen -- Hippolyt rasten selten -- stürmen meist Pferd Ebene Valerius bringen liebenswürdigste Geschwätz -- 
  eigentlich abscheulich Grundsatz Ehe -- Staat Mensch -- verstehen -- Wildeste geordnet vorzutragen -- interessant -- wünschenswert -- frei Ding -- Constantie äußern -- eigentlich weit Arg -- klingen Gräulicher -- 
  -- unweiblich dünken -- 
  Fürstin verteidigen Genuß Vergnügungen -- unser bürgerlich Ansicht verbotenen gehören -- 
  halten z. B. Ehe Form -- äaßeren Ding -- namentlich materiell Besitz Weibe sicheren -- 
  unheimlich -- verheiratet Frau sprechen hören -- dergleichen verwirklichen -- müssen trostloses Durcheinander entstehen -- 
  Valer -- Frau selbstständig stellen sehen -- wunderlich verwirrend Zeitbewegunge erwarten -- opponieren Fürstin Ding -- 
  aufmerksam -- äußerer Leben Frau Luft schweben -- einzig Haltpunkt -- Ehe -- aufgäben -- stärksn edelst Weiber Übergang besserem freier Gesellschaftslebe bilden können -- Ehe unterwürfen -- Begriff Weise unterstützen -- politisch Revolution sozial Tor liegen -- Weib gesellschaftlich Stellung erlangen -- 
  Christentum Weib Hälfte frei -- müssen -- jetzig Durchgangspunkt bringen jeder ringen Zustand -- Halbe Unglück -- Frau müssen Hut -- öffentlich Meinung keineswegs bringen -- Toleranz üben -- 
  alt Verhältnis alt Kirche Auflösung begreifen -- Rettung nahe -- Gefahr doppelt -- 
  schreib Ding treu Gedächtnis -- verstehen -- Änder beunruhigen -- säh Vortrage Valer abgemacht -- 
  Fürstin protestieren feurig -- 
  eigentlich Auflösung Ehe Kirche hoch Stände -- finden Auflösung vernünftig -- verlangt Beibehalten alt Form -- Gebildet schützt beengt -- Maß notwendig -- 
  Valer nennen lächelnd Aristokratismus gebraucht garstig Ausdruck -- Weise Welt Verfaule -- 
  Geschwür müssen aufschneiden -- schmerze -- 
  Fi -- -- häßlich klingen fallen -- Mund Mannes klingen -- 
  Herr William -- hiesig Gast -- verteidigen hart unduldsam Bestehend -- tadelt Ansicht -- unchristlich unsittlich -- löst Fundament Zivilisation -- untergrüben Grundprinzipium Gesellschaft -- Ausgeburt menschlich Dünkel -- Gottheit spielen ewig Gesetz umändern wollen -- 
  Mensch hundert Male versuchen -- Christentum abzuschaff Schande -- verdankt Art Bildung heiß Barbarei zurückdrängen -- dergleich Auflösung predige -- menschlich Verstand ordne Welt -- göttlich Christo Hilfe kommen -- heißen Gott lästern -- Institution verbessern wollen -- 
  Valer Gespräch -- wiederholen -- lehren -- 
  Fürstin laden -- Woche Lustschloß einzukehren -- Monat hindurch Gesellschaft zusammenfände -- 
  Gesundbrunn Nähe -- Valer fest Gesundheit zuträglich -- 
  Alberta aufmerksam fast ängstlich drein horchen -- 
  William Einladung dankbar -- Valer schlagen -- 
  Fürstin verletzen -- 
  Alberta scheinen erfreut -- trennen -- -- -- 
  Graf Stadt zurückgekommen -- wunderlich -- meinen -- zuverlässig Nachricht mitbringen -- hiesig Poet verkappt Prinz vornehm Haus befinden -- 
  denken -- Neugier Nachricht erregen -- Meinung -- können Hippolyt Valerius -- 
  dauern -- Frage -- Zischel -- Aushol erfuhren -- handeln -- 
  Hippolyt schlagen toll Gelächter -- verlangen unanständig -- sollen Vater verunglimpfen -- Mauleseltreiber Catalonien -- 
  Valerius lachen ebenfalls erklärt liebenswürdig Offenheit -- Vater schlicht Landgeistlicher 400 Thlr -- 
  Gehalt Prinz Prinzessinn auferzogen -- 
  Gesellschaft Erklärung verstimmen -- Fürstin fragen pikieren Valerius -- unangenehm -- Prinz halten -- 
  abscheulich Mensch antworten ernsthaft -- -- 
  William raten wunderlich -- obwohl Vermutung Hippolyt Valerius keineswegs aufgeben -- sogenannter Provenzale Herr Leopold -- 
  hübsch Mann Schloß sehen -- streifen Umgegend umh lauter demokratisch Liebschaft anknüpfen -- 
  Freund wissen Herkomme einfältig Valerius fallen -- Leopold Ähnliches gehören -- vergessen -- -- -- -- -- sitzen Nachmittag Garten -- Streifereien ankommen -- 
  apparte -- Fein niedlich -- Purpurwindel wickeln -- 
  fragen -- verlegen -- leugnen direkt -- -- bestätigt vorgefaßt Glaube -- immerwährenden Spott Hippolyt -- Scherz Valer erdulden -- 
  nennen -- Exzellenz -- -- 
  anbetreffen -- glauben Prinz stecken anderswo -- 
  O Mutter -- Rat -- hilfn -- Hippolyt überströmen feurig Liebe -- zuweilen kommen glücklich Omphal -- Füßen Herkules ruhen -- zuweilen unglücklich Proserpina -- Gott Unterwelt bedrohen -- Licht Sonne hinwegreißen -- 
  O schmerzhaft Unsicherheit -- Verwirrung -- Mann anrichten -- 
  fröhlich munter Kamilla ist-- Himmel wissen wodurch -- vollständig umwandeln -- 
  still Grab -- -- 
  erhalt Brief Vater Paris -- beilegen - Adieu -- tausendmal Adieu -- lieb zärtlich Mutter -- 
  23. Valerius Constantin -- 
  krank -- gemütskrank -- 
  Krank Frankreich -- glaub Krankheit -- euer heiß Juliblut konfiszieren -- 
  Schreibe karg -- -- -- Wermut -- 
  Abend plötzlich Gegner ankommen -- kennen Graf unterrichten -- 
  -- ernsthaft feierlich stimmen -- sonstigen Wärme Spur -- 
  Mensch Ding -- 
  Leben finden Anhaltspunkt -- 
  versichern Grafe -- müssen notwendig Irrtum -- 
  wunderlich Bestimmtheit versichern -- -- Fremd triftigst Grund fordern -- 
  erklären -- Duell Rede können -- bevor Ursache unterrichten Narr -- Person -- totschießen wollen -- -- -- 
  Grafen bitte -- fragen -- heilig Versicherung -- vollgültig Richtigkeit -- wunderlich Farce entschließen -- Duell eingehen -- kenn -- Vorwurf Zornesgründe unbekannt -- 
  früh Leute Park schießen -- 
  treten Sache -- Pfahl an Ziel -- -- Gott wissen -- Ehre Schuß Pfahl reinigen -- 
  O Welt -- Fratzenbilder eingezäunt -- 
  Begegnet Menschliches -- bedauer Enkel -- Kämpfer Freiheit fallen -- beneid herrschend -- unversöhnlich Feind Herrschaft -- 
  Interesse Welt -- Freiheit -- sterben -- ungern Fratzenkampfe untergehen -- -- -- 
  hören tief Schmerz -- Kamilla Ankunft fremd geraten -- einschließen -- packen Reisewag bestellen -- 
  Wagen rollen Schloß -- laut Geräusch Flur -- Treppe -- -- -- 
  Tür hören fremd Stimme Camilla's -- -- offenbar Fremde -- Grafe versprechen -- auszuweichen -- 
  -- Alberta sprechen weinend -- Hausflur -- eilt Fenster -- Licht Latern erhellt Raum Schloß -- Kamilla eilig Wagen -- wehren Hand -- springen Wagen -- fliegen -- 
  Schloß einsam -- Mädchen -- 
  Lösung Rätsel erwarten -- 
  24. Hippolyt Constantin -- 
  Teufel gelten ernsthaft Versuch -- besiegen -- 
  Weib -- gewinnen -- Freund -- Herzblut unnützerweise strömen -- 
  Valerius schoß fremde -- verlarven Mensur erscheinen -- Graf Topf ernsthaft sekundieren -- 
  schossen Barriere -- 
  Valer vollkommen passiv -- bleiben unverrückt Platz stehen -- Mien angreifen -- 
  Desto eilig avanciert Gegner -- 
  Valer blutig Absicht verkennen -- regt Galle -- treten Schritt drücken -- nämlich Augenblick Gegner -- Blitz Knall Seite -- stürzen -- 
  fing arm Freund arme -- 
  Blut stürzen oberer Brust -- 
  Ehe Haus bringen -- Gegner aufgeraffen -- Streifschuß Schlaf betäuben Maske heran -- 
  Valer -- Augenblick Besinnung verlieren -- scheinen sogleich erkennen -- sprechen -- unwillig Bewegung Hand Zeichen -- Auge mögen -- 
  Narr Komödienspiel lassen fing deklamieren -- Clara's Bruder -- Valer Schwester unglücklich -- Brief -- Schwester finden -- verraten -- -- 
  -- drängen Schulter Arm Freund weg -- bedeutend -- Epiloge schwer verwundeter überflüssig -- Sekundantenkugel Weg zeigen -- schleunig machen -- 
  Graf hart Wort unziemlich Betragen -- ziehen Mann gelb Italienergesicht fort -- 
  tragen Valer Zimmer -- früh -- 
  stören -- 
  Graf Abend vorher Arzt schicken -- herbeiholen -- untersuchen Wunde -- 
  Kugel dicht Schulter hineingegangen sitzen -- 
  malitiös Schuft Pulver nehmen -- 
  Valer Wort sprechen -- legen -- Bequemer -- fordern plötzlich zögernd Arzt -- rasch an Werk -- Kugel herauszuziehen bar sagen -- Leben kosten -- dauern können -- 
  Arzt scheinen Tölpel -- arm Valer unsäglich Schmerz -- ehe Kugel fassen herausbringen -- zucken -- nochmals befragen -- unsicher Achsel -- 
  stoßen Narr weg -- Untersuchungswerkzeug -- forschen sorgfältig -- Kugel dringen -- 
  umsonst Cuvier menschlich Körper Lebensströmung aufgesuchen -- 
  Bescheid tröstlich -- 
  -- Gefahr -- Valer -- abwenden -- mehrere äußerlich innerer Bewegung still ruhesen -- 
  -- -- -- danken -- -- -- bericht Manne -- fanatisch Wut aufgeben versichern mögen -- Irrtum Schwester -- -- 
  -- -- Hanswurst Hals brechen -- -- 
  Valer lächelnd mißbilligend Bewegung -- Grafe -- 
  Haus aufgewecken voll Besorgnis -- arm Alberta -- gutmütig Kind -- verweint Auge -- Gräfin Julia -- schlimm Weib angelegentlich gebet Nachricht Valer -- Fürstin eingefunden -- stellen besorgt unser Freund -- 
  Graf begegnen -- Weg -- alt Mann weinen -- Todesangst Liebling -- Herz mißtrauen abgebeen -- Anklage fremde erregen -- 
  teilen Valer Auftrag -- Fremde fort -- Camilla Verlobter -- entflohen Braut nachgeeilen -- 
  Gott wissen -- flüchtig Kamilla Sinn gehen -- 
  rühren Domestik -- schluchzend Herankam -- fragen -- Herr Valerius Leben bleiben -- 
  bewundernswern Valer eigentlich vornehmem Wesen bleiben -- demokratisch stehend behandeln fesseln wissen -- 
  niedrig Volksschmeichelei -- hass Speichelleck Hofrat -- vertraulich Zugeständnis -- Anspruch selbigen geltend verschieden -- Valerius Herzen Volksmasse gewinnen -- 
  entsetzlich -- Tod Kralle schön Herz schlügen -- 
  Valer leiben -- 
  allzu sanguinisch Mensch brauchen wechselnd Wog Stürme -- Auge ruhen Freund Spiegelfläche innerer Meeres -- 
  gewiß -- unsäglich Kosten -- ruhig ordnen -- Gedanke -- wild toll blutdürstig Tier Wüste -- zähmen -- stolz zivilisiert Löwe Panther Wagen einhergehen -- überzeugen -- Kraft verzehren -- umfassendst Revolution Busen tragen Humanität Augenblick vergessen -- 
  -- Gefahr Unglaublich vermocht -- Pause Leidenschaft Julia hervorbringen -- Weib denken -- Wesen breiten -- Sturmwind Fläche -- bedecken -- durchdringen -- fortreißen -- 
  gewöhnlich Koketterie -- Widerstand doppelt reiz -- despotisch geliebt fragen -- Gegenstand jedesmalig Neigung aufnehmen -- nähern -- wissen -- Valerius -- fürchterlich Egoist Liebe unmoralisch nennen -- wissen -- schön Julia schwimmend Herzensaug Morgentau Jugend lüstern schwankend Gestalt verfolg Zone -- weich Wesen straf Glieder anschmiegt Begegnung Wollust -- 
  -- -- -- -- Valer Gefahr abwenden -- beenden -- 
  Totenfieber schütteln -- lieb Mann Feind -- Tod -- entreißen -- 
  Trabante -- Planet eigen Licht -- Komet -- 
  Anblick -- Wort Mund -- zeil Hand Bolaster Seereise -- Woge überlassen -- gehen Stern -- -- -- -- liegen still griechisch Philosoph Schmerz -- 
  William lesen Aschylus Prometheus -- Zustand bedenklich -- Furcht Herzen Zugang gestatten -- Konstantin -- fürchten -- schön Herz Valer -- Nacht still stehen -- -- Leopold weinen Bett still hinein -- Valer Hand ruhen Lockenkopf -- sehen Träne -- 
  unten Gesellschaftssaale -- versammeln -- Fürstin sprechen leise -- Kirche -- 
  Mal Julia Ankunft -- küssen -- Alberta -- eintreten -- arm Kind blaß -- 
  helfen -- Tröstliches Valer sagen -- 
  Julia forschen ängstlich Frage ergreifen Mal Hand -- 
  Valer rann Ader -- fühlt Augenblick - Augenblick -- Blut -- floh Hand feig Kampfe -- 
  Fürstin tun verständig teilnehmend -- widerwärtig -- 
  Graf Fips -- Stück Holz stehen -- angenehm -- 
  Alberta Kühnheit -- Vater Erlaubnis bitten -- kranke besuchen -- 
  Abend zusagen -- 
  verweigern -- glauben -- Valerius aufregen -- Clara lassen -- 
  -- abends sehen Sterbend Sonnenschein -- hell Leben Tag kontrastieren grauenhaft heranziehend Tod -- natürlich Nacht sterben -- -- 
  -- Wort Grafe fallen Grabgeläut Herz -- erstarren -- 
  hass Glockengeläut -- hass Raben -- hass Tod -- 
  Dummheit Natur -- Valerius sterben lassen -- 
  25. Constantin Valerius -- 
  wissen Freund -- Brief -- dumm -- albern -- verrückt nennen -- 
  Vergib Albernheit -- -- geben -- Kopf bewegen -- 
  fühlen Grenzlinie ankommen plötzlich anderer Mensch -- fühlen -- Mensch behagen alt Fehler -- 
  gestatt -- allmählich -- bewegen -- darlege -- 
  mehrere Monat rhapsodisch schreiben Stande -- wundern -- Ordnung hernehmen -- Krisis tren -- Ordnung lechzen -- 
  Welt Unordnung plötzlich Brust fallen -- allmählich herunterwerfen -- Gott wissen -- übrig bleiben -- 
  reich arm -- 
  arm -- aufräumen -- 
  glauben Ähnliches schreiben -- -- denken -- jetzig Antipode Früheren -- Abenddämmerung -- Reaktion Revolution -- 
  Schutt wegschaff -- arm Seele -- 
  Menschheit vergessen gewöhnlich Mensch Brand -- Kanon glühend Rede erbärmlich kalt -- 
  Idee schön Sache -- fast bleiben Idee Vermählt Individuum -- Gestalt -- -- 
  traurig erbärmlich Pathos -- 
  bestrafen Franzose Meineid Königs -- -- obgleich schlimm -- betragen Weile vernünftig -- -- 
  Redensart libertén -- Gloire etc. heran -- 
  hundsföttisch gloir Leben Glück Generation opferen -- ruhmgekrönen Eroberer -- unbeschadet übrig Größe -- gebrandmarkt ehrlos -- 
  hitzig -- hören -- gemein wütend -- schweig Journalistik -- 
  Gott -- -- wissen -- -- müssen -- 
  -- August -- lafittsch Partei Herzog Orléan werben -- Volksmassen Stadthaus umlagert heis Republik geschrien -- Dubourg stehen -- König drohen -- schlechen Karl -- Eid brech -- geballt Faust Augenblick Ludwig Philipp erheben -- Straße geschrien -- -- Revolution konfiszieren -- -- Welt ermorden -- Luft sprengen -- Pulver -- 
  -- verfiel hitzig Fieber mehrere Woche finden Besinnung Hotel Dieu -- 
  Bein -- finden Paris Ordnung -- 
  dachen Ordnung -- kleinlauen -- 
  Ding Ordnung -- Freund -- 
  Bube Holzkast -- Quadrat Dreiecke geschickt passen -- groß Bruder verstehen Zusammensetze -- vorsichtig Werk -- Teil auseinander -- nachmach stürzt Kasten -- Stande müssen Hilfe rufen -- durcheinander gegeworfen -- kosten Mühe -- Schalt -- 
  Umstürzen Holzkasten eilig -- 
  befinden - fremd Ort ertragen Jammer leicht -- historisch Entwicklung Jammer ansehen -- 
  Rocke traurig alt -- 
  alt -- blutig Kittel ausgezogen fühlen leicht frei -- 
  Welt sprechen Universalrevolution -- lutherisch Revolution Wendepunkt erreichen -- indes Special-Umwälzung vollenden -- glauben -- ermangeln äußerer Wechsel Vielerlei schließen -- 
  hören -- Monat Nähe kein Weibe kommen -- Haar -- -- Caracalla streichen -- lang trunken -- 
  sogar Wassertrinken lernen -- kurz rauch Tabak -- 
  demnach Titulatur Falstaff antiquiert gänzlich unpassend -- 
  alt Gewohnheit vollblütig Phlegma gewichen -- leicht -- 
  Unterschied -- Bier Wein Blut Ader fließen -- 
  tummle mitunter wahnsinnigst Reimereien bloß Reimerei -- früh schimpfen bloß Form platt -- bloß Form Leben Seelenfäde geübtesn Auge sichtbar -- 
  Auge üben -- 
  -- Künsteleie gering Verdienst -- mühsam -- Übung Vers Blutigel -- 
  -- lernen -- glauben -- früh Materialismus -- geistiger Sauberkeit mitbringen -- 
  hören Musik -- 
  Werdende -- Bewegende Musikalische -- Zusammenhang überblicken -- -- Freund -- Revolution Gewagt -- äußerer Notwendigkeit hingeben -- Geworden -- Abgemacht -- plastisch Liegend Vergangenheit -- 
  übersehen leicht Sache Herr -- 
  Vorzug Stabilität vorsichtig Reform -- 
  plastisch Weltgeschichte -- Musik Revolution -- 
  Zwiespalt unser innerer -- abwechselnd Musikalische Plastischen hinziehen -- Bewegung -- Ruhe unangenehm vermissen -- 
  vermittelnd Liebe Poesie -- 
  Dicht lieben -- Musik betäuben -- wirr -- 
  Liebe Poesie Geistigste -- Idee -- Plastisch -- Augenblick deutlich vorhalten -- Materielle -- Form -- äußeren -- Musikalisch -- Ruhe Bewegung genießen -- 
  religiös Ansicht unzufrieden -- 
  sehen Pyron-rationalistisch Ansicht 100 Meile -- Unbehaglichkeit empfangen -- 
  Zeug quälen -- 
  Liede -- 
  religiös Gehörig Reine bringen -- -- -- 
  Wissenschaft Welt Gefühl -- 
  Blüte Kraut zerstörend Giftzeit Gefühlen wahrlich sparsam umgehen -- 
  siehst -- nächstens schreiben -- Konstantin Fromme gehen bekommen nächstens Bistum Partibus infidelium -- 
  -- Mann -- -- Suche fortwährend negierend Positiv hervor -- honett Gesellschaft präsentieren -- 
  fest Entschluß fassen -- Leben schön finden Stunde -- erträglich finden -- 
  kennen weder Christentum Religion genau -- genau -- ordentlich urteilen -- soviel Religionsdilettant scheinen -- Christentum dauerhaft gearbeitet Lehre -- überleben -- Feld zögest -- 
  Bibel -- kennen -- -- wunderlich -- 
  heilig Buch -- Verehrung fordern -- leiden -- Buch -- meinen -- bleiben Buch können Buch Sand strecken -- episch Gedicht stehen unnennbar außerordentlich lieb -- 
  -- König Ägypten -- wissen Joseph -- -- 
  -- Verschlungenwerde rührend ausdrücken -- -- 
  Stunde indes -- Freund -- überaus vernünftig Ansicht Gewerbschule angestellt Regierungsrat vorkommen -- 
  Vater Versöhnung Vergebung schreiben -- denken juristisch Karriere aufnehmen -- 
  Tollheiten Paris kennen Land -- 
  stet Ring -- Lesen -- denken -- Rezensier -- Rezensiertwerde nützen -- -- ringen -- denken -- lesen etc. -- -- gemäht Gras wachsen -- mähen -- 
  verstehst zeitgemäß Religion -- 
  Religion zeitgemäße -- 
  raisonierst Pfaffe -- gemächlich alt Dachsbau bewegen dito anlegen -- 
  Religion sprechen schreiben -- gewiß Verkehrtes heraus -- Sprechende Schreibenden fremd -- Kassandra -- -- Wort Mund verdrehen -- 
  -- dergleich besprech nächster Wollschur Weinlese -- 
  schön Anständig trocken Sturme offen Rock spazieren gehen -- friedlich Menschenantlitz sehen -- tüchtig -- Knalleffekt haschend Musik hören -- duftig Gemälde Statue rein schön Form anblicken -- lustig -- lassend Gesellschaft sehen -- 
  wissen klar Himmel Bescheid -- wahr Freude -- 
  sammeln -- durchgesehen verbessern Gott -- Religion etc. sprech schreiben -- flugs Albernheit Welt -- 
  Kurzem Christentum Conglomerat Dogmen wert Muhamedanismus etc. -- Gedicht -- Christtuschlehre -- Grund liegend Idee -- hervorrufen neu beleben -- lumpig 18 Jahrhundert halten -- 
  Fragst Ilia -- zeitgemäß Epos -- 
  Katholik -- Religion Rationalist -- 
  Laß -- finden -- alt Mensch wirtschaften heftig -- 
  achtest Individualität -- Hand tastenden -- 
  bilden entgegengesetzen heraus -- gewähr Gerechtigkeit -- wissen -- -- Teilnahme -- 
  reg Gedanke alt Mensch -- plötzlich kleinlauen -- 
  unterdrücken -- 
  -- O vernünftig -- toll Streich -- -- 
  gewiß -- Zeitlang denken enthielen -- 
  schädlich Erfindung -- 
  sitzen konstruiert abstrahiert Leben Begriff -- anstatt leb Sache herzhaft -- Skrupel -- nahe treten -- 
  denken -- Freude Leben bloß Grillenfängerei versäumen -- ohrfeig -- 
  Leopold eigentlich einzig vernünftig Mensch -- kennen -- 
  Brief Paris -- Europa's Zukunft kreiset -- 
  Plastik -- Musik Theologie schreiben -- 
  echt deutsch -- 
  echt deutsche behagen Embryo Mensch -- 
  gehen Gesellschaft -- Mensch machen -- -- 
  Mensch anfangen -- Studium benutzen -- 
  -- eitel bunt Musikalisch -- -- Plastisches -- 
  Deutschland -- 
  26. Kamilla Alberta -- 
  Gotteswill -- -- Haus Fürstin vernehmen -- Ludovico Valerius erschießen -- 
  O beschwören -- fertig Boten sogleich -- Nachricht -- 
  stehen lauter Gräber wissen -- springen -- 
  O Gott -- -- schreiben -- sehen Tränenstrom -- 
  -- -- Gott Liebling heißblütig Tölpel ermorden lassen -- einzig Verdienst heiß Blut -- 
  arm Mädchen -- leiden -- 
  Unsinn -- 
  Mann -- Welt -- erschießen nutzlos Mensch -- 
  Narr verrücken -- auszukundschaft Hand verlangen -- nächster Frage eingestehen -- Valerius niedergeschossen -- wissen -- leben -- 
  Herz still stehen -- o wozu Klapper tausend unnützen -- -- 
  O Liebe -- schreiben sogleich -- 
  Ludovico Wege Berlin -- einholen -- Übeltäter Wind fahren -- bleiben Hand -- Alberta -- -- schreibst sogleich -- Gott -- wissen sagen -- -- -- Gewißheit -- -- -- 
  27. Hippolyt Constantin -- 
  Natur Mensch groß stark schaffen -- 
  Berg stolpern -- Jammer -- Maulwurfshaufe fallen -- 
  solch Wicht eigentlich schön -- 
  Statue -- menschlich Figur malen -- Heldengedichte Dramata schreiben -- 
  Natur verdienen -- einzeln Mensch -- 
  Herz Mädchen erobern -- o -- Mensch Wicht -- 
  Valerius scheinen Hauptgefahr überstehen -- indessen keineswegs retten -- 
  Arabien erhören -- 
  barmherzig Samaritanerinn sitzen Weiber Lager herum sprechen lesen -- 
  stolz Konstantie fehlen -- 
  Graf arm kranke weichen seiden Patientenanzug schenken -- liegen Valer verwundet Emir -- verrückten Kreuzfahrer hart zugesetzen -- Ottomane lassen Houris tändeln -- 
  sitzen sensitiv Alberta -- Untreu schön Auge versenken scheinen -- 
  Meinethalben -- weich -- weiß Kind ansehen Valer Nähe scheinen stärken -- 
  Fürstin übertreffen -- Geschicklichkeit sehen -- Gedächtni besitzen -- 
  kurz Wortwechsel Desdemona scheinen bewegen -- 
  lauter stolz Laster -- ebenbürtig Gegner -- stolz Tugende -- 
  scheinen Nachricht Desdemona leiden William -- Unterwürfigkeit gesellschaftlich Sinn bereitwilligsn entgegen -- erfahren -- lebhaftest Anstalt Wien treffen -- Desdemonas befördern -- 
  jung Pfaff triumphierend -- scharf Andeutung anklagend -- 
  wehren diesmal -- Mensch -- lassen heiß liebedurstig Seele verschmachten ziehen -- 
  Mensch -- 
  Constantie lassen stundenlang William christlich Moral auseinandersetzen scheinen aufmerksam zuzuhören -- stellen Art Examinatorium legen schwierig Fall rohr -- 
  William entzücken -- Kram anzubring lächerlich hochmütig -- Geduld verständigen Leute -- 
  Fürstin schließen meist Gespräch -- plötzlich kopfschüttelnd -- lächelnd Aufstand -- hinsprach -- -- -- -- schlimm Ding -- -- 
  lächeln William fallen Himmel Wolke -- Konstantie Sitzung Wort aufhieben -- 
  -- Herr William -- lauter Büchermoral -- bestauben aussiehen Sonnenschein -- unser modern Zimmer lagern -- 
  Mensch Vordersätz Schlüsse -- Ding unmöglich passen -- 
  Moral -- Por leichtsinnig Bursch dringen -- holen Grunde alt abgestanden Gewässer -- greifen Flut -- leichtsinnig Bursch treiben -- Syrien heilen klug Leute Pariser -- Paris -- 
  Zeug langweilig unzeitige -- -- 
  -- Zeus -- verständig Weib -- Blick -- Augenblick blitzend Auge treffen -- erinnern nächt Bibiliothek -- Herrscherblicke -- regieren -- 
  -- vorging -- schnell Windstoß fliegen nächtlich Liebe Auge Lippe -- 
  umarmt -- sein -- 
  William stehen zerschmettern -- Mal Leben bedauern -- 
  Fürstin Fenster sitzen -- gestehen -- Julia sitzen Sofa Gemälde -- Teppich sticken -- 
  sitzen Tisch erzählen Spanien -- Einsamkeit öd Straße -- romantisch Zauber Alleinsein dergleichen -- freundlich gewöhnlich lassen zuweilen Nadel ruhen -- forschend hinsehen -- 
  träumerisch zuhören rührend unschuldig -- harmlos Ausdruck -- Gesprunge -- 
  wünschen Konstantie William Henker -- 
  schließen Gespräch -- erzählen -- 
  Fürstin -- William -- 
  Julia unruhig -- Miene Arbeit zusammenzulegen aufbrechen -- scheinen Unheimliche Alleinsein fliehen -- 
  springen -- drücken Hand Lippe bitten -- schmerzlich erregen -- Sanft -- mögen hart -- mögen fliehen -- 
  Augenblick stehen unschlüssig gesenkt Köpfchen -- lassen Hand -- -- Wasser stehen Auge -- alt Hippolyt erwachen -- Arm schließen -- drückt warm Hand Gesicht -- schütteln weinend Locko Tür -- 
  Abweisen Sturm Versuch hingehen lassen -- 
  bleiben starr traurig stehen -- 
  scheinen ermutigen -- 
  Tür Hand -- rührend Stimme -- 
  -- Gang Garten -- -- 
  führen dunkel Kastanienallee -- Garten nah Wäldchen führen -- 
  Sanft mild sprechen gewöhnlich -- 
  fassen Arm -- führen -- bebt -- Hand berühren -- 
  ungeduldig Herz duldet Zwang lang -- drängen stürmisch blühend Mädchen umarmen -- 
  klar -- durchsichtig Haut Bewegung Wang röten -- warm tragen leicht weiß Kleid -- dünn rot Flortüchlein Hals -- Lüfte spielen -- Stande -- schön weiß Fleisch rund Schulter jung Busen verhüllen -- 
  Platanusbaume -- einsam Kastanie stehen -- breit Ast gefällig Liebeshehler ausbreiten -- halten plötzlich inne -- schlingen Arm heiß strahlend Mädchen -- wendet Seite glühend Körper drängen -- 
  -- -- Hippolyt -- -- bitten Innig -- 
  gerührt Herz zerbrichen Sehn Körper -- knickt Kopf sinken Schulter -- 
  fühlt Hand Haaren Hauch Kusses Stirn -- 
  -- Leb -- Freund -- -- sprechen flog -- 
  Platane gelehnen schmerzlich -- 
  Eurer sentimental Liebe -- Mädchen kommen -- 
  wissen -- ergehen -- Auge stehen Träne -- 
  Baume gestehen -- wissen -- Prinz Leopold Wäldchen hergeschlenderen -- wecken Gesang -- 
  leichtsinnigen deutsch Liebesliedche -- deutsche -- Franzose -- Spanier -- lieb Liebchen gutmütig verspotten -- 
  Kritik leicht Herzens -- 
  erzählen lachend -- Pfarrer Förster Tür weisen -- 
  kommen -- Liebesverhältnis Töchter gleich unterhielen -- 
  Pfarrer Förster Pfarrer zukünftigen Schwiegersohne erzählen -- sich_es ergeben -- meinen -- 
  Förster unsanft mehrfach Grobheit Flüche -- Pfarrer himmlisch Schwefel drohend salbungsvoll Rede Haus weisen -- 
  nämlich letztere solch Final rasch Tochter ersteren stärken -- Regen Traufe kommen -- 
  groben Förster Prinzlichkeit drohen -- ergrimmen -- 
  Haus indes gutmütig Försterröschen Abend Rendezvous Walde versprechen -- Rückweg Kirche vorbeigekommen -- Juditha -- Pfarrer Töchterlein -- Abschied Abends Sturmdach Sakristei zusagen -- 
  müssen unser Detailhändler Liebe herzlich lachen -- 
  Affe -- Sohn Prinz -- glauben gewiß -- lauter Poesie -- 
  Duft -- Lüge -- Traum -- wenigster Auskunft geben -- Verhältnissen -- 
  glauben Vorgang -- erzählen -- klag lügenhaft Wille -- wissen -- 
  Vorfall sehen tausend dichterisch Auge -- -- unendlich Ding sehen -- -- 
  Ader Historiker paar Eimer Blut zuviel Poet -- 
  lächerlich -- Leute Mühe geben prinzlich Inkognito -- Graf verleugnen antizipierend historisch Charakter interessiert -- 
  William offenbar peinlichst Verlegenheit -- früh fanatisch sittenrichterlich Rolle milderen aufgeben -- freuen -- scheinen soviel Stolz besitzen -- entschließen -- 
  knurren grollt Kettenhund -- aufgehört bellen -- 
  Fip respektvoll Konstantie betrachten lächelnd -- ahnungsreich -- sarkastisch komisch gutmütig lächelnd -- sehen tief Gewebe -- klug Weib -- Gott wissen -- -- neugierig -- kümmern -- 
  Sache wichtig -- Tragisch ereignen -- Frage stehend Person zuverlässig Auskunft geben -- fest überzeugen -- Dichtung Wahrheit Leopold Prinz fließen -- wenigster entscheiden -- Prinz -- 
  Fürstin -- Komödie aufführen -- lachen William protegieren offenbar ernsthaft Schloß einladen -- lächeln spitzbübisch Leopold ebenfalls mitnehmen -- achten scheuen Valerius offenbar Partie -- 
  glauben -- fürchten meister Leben -- 
  schwer ergründend Weib -- 
  William wahrscheinlich gläubige verehrungslustig Lamartin erziehen -- Od Lied preisen -- bedeutend poetisch Talent -- richtig Takt längst herausfinden -- 
  einzig -- Hofsänger qualifizieren -- 
  behandeln wegwerfend -- umstrickt Aufmerksamkeit -- Leopold Kind behandeln -- verhätscheln -- 
  -- innig Teilnahme -- Valer legen -- Oppositionsgeist -- wissen -- Frau wissen Anfangsfäden schlau verbergen -- bizarr affektieren Bizarreri -- schwer richtig Anschauung -- 
  Merkst -- Verzweiflung schwatzen -- umsonst Julia suchen -- entziehen geflissentlich -- 
  Schicksalstragödie lesen -- glauben fast -- Schicksal Liebe Weibe rächen schön Mädchen -- 
  -- lieb nachtrage Bettler hartherzig Wanderer Bitte -- ist_es -- verschmähen -- 
  Leben verdorren -- Blut vertrocknen -- Geist versumpfen -- 
  liegen -- unerklärlich Hauch Sympathie -- verbindend verschiedenartigst Wesen -- zusammenziehen -- 
  Elfenbrück -- Mann Weibe Gedanke Mondschein finden buhlen -- ehe -- Mann Weib klar Vorstellung -- zurückhüpf Tiefe Herz -- nächtlich Geschichte erzählen Liebe stiften Gedicht -- 
  O Elfenpoet Julia Hyppolits -- -- 
  Sieh -- soweit kommen -- klar -- sonnenhell Mensch Mondscheingeheimni sentimental Liebe nachspüren -- blass Romantiker -- offen Walten Kraft -- Naturgesetz anziehen -- suchen mysteriös Sympathie -- 
  kommen -- 
  überschwenglich Mediziner -- Therapie ausreichen -- flüchten sympathetisch Beschwörungsformel -- 
  weißen Julia -- 
  O Teufel -- verschreiben liebreizend Mädchen -- -- -- 
  lächerlich Szene -- begeben -- lachen -- 
  Valerius Provenzal Schreibtisch zitieren -- Brief diktieren -- Leopold zappeln Böcklein -- fort -- Valer Auge Wort fesseln -- Magnet herrückend Stecknadel -- entweichen -- sehen pudelnärrisch -- 
  28. Valerius Constantin -- 
  Kraft Augenblick schwächen -- dein Brief sorgfältig einzeln umfassend beantworten -- 
  trüb Nebeltag -- geschickt -- Freund -- 
  gewissenhaft Mensch zweifeln zuweilen Wahrheit -- Leben leiten zusammenhalten -- 
  bedenklich Krisis -- fürcht -- Jugend deiner Geist Herzen Grunde -- fürcht -- Kurzem alt Mann -- Jugend irren Alter -- Poesie Leben -- grün Irrtum schön vertrocknet richtig Wort -- 
  Natur wechseln -- Bild bleiben unverändert -- gemalt Frühling knospend grünenden vorziehn -- unverändert bleiben -- 
  Krise Reaktion mangelhaft Geschichtsauffassung -- Minute Tagsgeschicht -- Wissenschaft Wissenschaft zählen Jahrhundert -- 
  Mann bringen Tausend Tod -- Million Leben bereiten -- Haufen Toter -- Kampf aufhäufen -- verengen Aussicht -- sehen blutig -- golden Jahrhundert -- 
  Wort ruhen Erscheinung vieler Reaktion gut Wille -- 
  Wort -- vergessen -- kritisch Leben -- -- 
  Jugend -- Ruhe bedürfen -- Leben besitzen -- fragen -- kosten -- Revolution -- Abwechslung -- Lebensentwicklung -- 
  Jugend verlassen -- -- müssen ebenfalls vollenden -- verlangen -- kurz Schritt gehen Mensch -- schnell Leben -- 
  Historiker -- Schlage Herzen urteilen -- zeitig schlagen menschlich Herz matt -- Herzschlag geschichtlich Epoche -- 
  Jahrhundert Wandersmann zerrissenen -- abgetragen -- schmutzig Kleid Ort -- neu kleiden -- Reinigen -- säubern -- umgestalt -- Kleidungsstück abgeworfen -- unkundig Mensch vorüber -- lebhaft wünschen -- Wanderer neu gestalten -- sehen halb entkleidet schmutzig Figur -- entsetzt -- nennen Wunsch Frevel -- verhüllen Gesicht laufen heulend dannen -- 
  metamorphose unterd -- Bad -- -- freilich Blut färben -- Zivilisation halbkriegerisch -- somit halbbarbarisch -- waschen letzter Flecken -- Gedanke flattern Kleid umher -- vollenden erscheinen Markt -- Mensch -- vorüberging -- glauben Schmutz Gewänder verstecken -- sehen -- Herz alt -- hoffen verlernen -- erkennen -- schön -- Blick befangen -- Mensch reaktionär gut Wille -- 
  plötzlich vergessen -- inmitten kritisch -- zerstörend -- umwandelnd Epoche -- Metamorphose vollenden sehen -- Glaube täuschen -- täuschen müssen -- Nacht blühen Erde -- läufst heulend Gesicht verhüllend dannen -- Spukt Tag Wochengeschicht Kopf Weltgeschichte Deines Herzens vergessen -- -- Jahrzehnt Jahrhundert schreiten -- Herz plötzlich zusammengeschrumpfen -- 
  mangelhaft Gesellschaftsanschauung entreißen wiedergebärenden manch brav Mann -- Kraft reichen fortwährend Untersuchung Anklagestand -- Eitelkeit überkommen erklären Irrtum -- schwach -- 
  Feldherr -- Masse beurteilen verstehen -- Historiker -- Zeitmassen Geist aufnehmen beherrschen vermögen -- 
  Napoleon Brücke Lodi tausend Grenadieren schonen -- drang freiheitsmörderisch Österreich Frankreich Million Freiheit bringen -- Frankreich aufwuchs Welt -- 
  Jahrzehnt alt Jammer kehren -- 
  handgemeng Freiheit beginnen -- Trieb -- Begriff -- Wissenschaft -- Kunst Handgemenge verwickeln -- schreisen schwach Stimme -- Ordnung -- Ordnung -- -- helfen -- wirfst weinend Boden -- 
  Kampf - Kampf Kriegszeit nächster Weg Ordnung -- 
  Ermannst -- erreichst Höhe historisch Überblick -- Störung verschwinden -- Freund -- Kurzem scheiden -- Mumie -- 
  Kopf Höhe -- hell Auge laß sausen brausen -- Rechtest Natur -- Sturmwindes ausgehst verlangst -- Rock sollen Falte werfen -- romantisch Figur sollen zerstören -- Sturmwindszeit vorüber -- Kalend königlich Stempel wissen -- -- 
  Ade Konstantin -- Valer -- 
  Schreiber -- Prinz Zerbino Provence -- schicken Füllhorn grüß Entschuldigung -- Hand leih herb Ding -- 
  29. Hippolyt Constantin -- 
  Jage Auge Karriere Zeile -- 
  sobald -- eil Tor Deutschland -- gib Auftrag -- beschreiben -- unterricht -- versprich Belohnung -- tun -- Gräfin Julia -- Wohnung -- Nachricht habhaft -- Paris -- 
  Brief kürzest Weg -- reisen gewiß schnell Dame -- 
  Stunde Julia abgereisen -- treten töricht Geschwätz Leopolds -- wobei vielfach stehen bleiben -- lachen -- vertrödeln -- Schloßhof -- hoffen Julien verschämt liebevoll Gesellschatfssaal finden -- fliegen Julien Reisewag jenseitig Brücke -- Pferd wiehern hohnlachend ziehen Beute gestreckt Trab dannen -- Muskel schwellen -- Starre zürnend Steinbild -- tausend Leidenschaft drohen zersprengen -- wenden Kopf Wagen -- erkenn Juli -- winken Abschied Taschentuche -- 
  Stein lebendig -- fliegen Stall -- Sattel -- werfen Pferd Zaum -- spring Jage ventre -- terr eilend Beute -- nächster Dorfe erreichen glücklich Wagen -- Ruf Kutsch Halt -- erhalten Wagen Gegenbefehl -- Julia -- erblicken -- erteilen Gegenbefehl -- Pferd drohen zusammenzustürzen -- 
  Wagen springen -- gerungen Hand bitten -- abzulassen -- zurückkehren -- 
  Gesicht schwamm Träne -- scheinen immerwährend weinen -- Hyppolit -- touen mon ame Vou Prie -- -- faire Partir -- Vou m assassinez m empechant -- geschehen Trabe -- schrie Kutscher -- erwürgt Schritt führen -- tat_es -- Julie -- mon ange -- Pourquoi ça -- -- 
  reichen Hand Wagen -- glühend heiß beben -- 
  drücken Lippe -- 
  -- Vou -- Tuez -- si vous ne Retournez pas -- -- -- 
  -- Blick -- Rührung Himmel spalten -- 
  halten Pferd still bleiben -- 
  werfen Kutscher Pferd Galopp -- Wut erwachen -- Schufte ermorden jagen -- 
  Julia erheben händeringend Wagen -- stürzen Pferd -- hören Julien Schrei Haltrufen -- Stolz heben Leib Pferd Höhe -- winken -- fortzufahren -- fahren -- 
  wissen -- zurückgekommen -- 
  Tue bitten -- siehst -- 
  30. Julia Mutter -- 
  hattesen Mutter -- rietsen Aufenthalt Grünschloß abzukürzen -- Hippolyt Unglück -- 
  schön -- gewaltig Mann -- sehen -- lang bleiben -- überwältigen -- gelieben -- wissen -- 
  gestern abgereisen -- hoch -- gehen Vater Paris schreiben Billet Nachtlager -- 
  -- lieb Mutter -- totmüde -- 
  fast Stunde Wagen ohnmächtig -- Hippolyt zürnend Gott Wagen halten -- 
  Mutter -- gelitten -- 
  Hand -- unendlich Wollust jagt Kuß Sinn -- war_es -- halten wild Geist -- 
  Mädchen -- unser Gespräch verstehen -- Kutschern Zeichen -- Wagen fliegen -- Hippolyt schreien -- Mark Bein erbeben -- jagen -- Pferd brechen stürzen -- Mutter -- zertrümmeren -- schreien Halt -- Wagen -- -- Kraft verlassen -- bewußtlos zurückfallen -- Mädchen fortfahren lassen -- 
  erzählen -- Hippolyt unverletzt geschien -- Fortgewinkt -- aufgestand untergeschlagen arme dastehend nachgesehen -- 
  -- traurig -- lieb Mutter -- froh -- 
  31. Alberta Kamilla -- 
  -- -- arm geliebt Kamilla -- 
  O küssen -- 
  wunderst -- traurig -- Fürstin gehören -- Julia fort -- Hippolyt spornstreichs Nachgereist -- 
  -- Liebe -- traurig -- still -- ruhig -- sogar glücklich -- 
  Schwarm fortgeflogen -- weißt -- Constantie William Leopold mitnehmen -- Graf Fip stumm Mann -- lieben krank Valerius -- wert -- 
  -- Hippolyt verlieben -- unglücklich -- -- glauben -- Wort treffen -- 
  Geliebt -- 
  -- -- berauscht -- -- o bitte -- erlaß Zerglieder -- weißen -- -- lieb bewußtlos -- ungeprüft Hinträumen -- fragen -- 
  Valerius nennen romantisch Dame -- versprechen Paris reisen -- dortig Romantiker Victor Hugo -- Janin heißen -- -- 
  -- -- versprechen -- 
  lieben -- -- Mann -- 
  Gestern Victor Hugo's Hernani vorgelesen -- -- lieben Donna -- sterben gewiß Hernani -- 
  Hernani gleichen vieler Wildheit Hippolyt -- toll spanisch Blut -- 
  Valerius bitten -- sanfteren Hernani -- deutsch schreiben -- 
  lachen -- ich_es -- deutsche liebenswürdigsen sein -- 
  Vater versprechen -- -- -- Valerius Spätherbst Paris reisen -- 
  Papa weich -- lustig -- 
  Fehlst -- lieb Kamilla -- o kommen mach Munter gut Laune -- 
  kommst -- reisen -- 
  Valerius schön gebet Vater nicken still kopfe unbeschreiblich -- 
  Gott -- warst letzter vergnügen -- fallen -- 
  Gib dein garstig Ludovico -- 
  Herr Valerius sprechen -- betrüben -- 
  Fürstin mitnehmen -- Vater -- Scherz ausgesonn -- jung Leute Ansicht Gesellschaft auftreten lassen -- Lustschloss versammeln -- 
  verspräch Turnier alt Ritter Spaß -- William Leopold hälfen eigentlich -- fromm legitim -- -- luftig -- unsicher nachgiebig -- 
  Poesie aushelfen -- Valerius mitkäme -- vorteilhaft Kampf rechnen -- 
  bestimmen Ausschlug -- versprechen -- feindlich Brief hinzuschreiben -- Gesellschaft besprech -- bekämpfend Sekretär William beantworten -- 
  hübsch Constantien -- unser krank Freund schaffen -- ruhen -- gehen Ts -- schreiben Zeile -- 
  Brief -- Komme -- kommen -- Herr Valerius bitten schön -- Vater -- 
  hübsch still heimlich Grünschloß -- behagen -- 
  Valerius -- sitzen fast Terrasse Akazie schwatz lesen treiben Allerlei -- 
  Herr Valerius tragen Arm Tuch sehen Blasser -- sanft -- freundlich -- mild -- 
  Komme -- kommen -- Geschichte erzählen -- -- Hörst -- 
  Kommen -- 
  küß eins-zwei-dreimal zärtlich Alberta -- 
  32. Leopold Valerius -- 
  -- wunderschön Monat Mai Knosp springen -- Herz Liebe aufgehen -- 
  wunderschön Monat Mai Vögel singen -- stehen sehn verlangen -- 
  September Frucht fallen -- -- Vöglein singen -- Natur schön -- üppig Frau voll Lebenslust -- Saft Liebe -- 
  weißen -- Präsident kabal Liebe spreizen feierlich groß Hälfte Mord überscharf geschliffen Begriff Malitiösen -- Toten-Wurm wälzen weißen -- lach -- 
  wälze -- minder feierlich -- bunt Leben Verantwortung -- 
  fliegen unbewußt umh Stahl -- tun systematisch -- Stück Deines System gehören -- 
  sündig -- geschieht_es Rechnung Trost -- 
  Erinnerst Worte -- sißen Promenade -- Roué streichen vorüber -- Arm hing reizend Mädchen -- 
  Mann glücklich grün Baumzweig -- Sonnenstrahl hin- herhüpfen -- Wesen wollüstig Sonnenstrahl hinschaukeln -- Freund Valerius -- nahmst Wort sprachst folgen -- -- schelten Mann -- -- Scheltwort verdienen -- 
  Natur überschwenglich reich -- meister Mensch arm -- sünd arm -- 
  verschließen tausend Tor Genusses -- öffnen -- 
  Tugend -- überschwenglich genießen -- 
  Versteht treiben -- Demokratismus -- hoch hoch leuchtend Haupt heben -- 
  Stadt tausend Mensch Million beglücken -- Gegensatz Aristokratismus -- 
  Nehmt Strahl leuchtend Kopf -- sehen -- hören fühlen Organ tausend glücklich somit Tugendhafter -- 
  Verbiet Natur unsäglich Freude ausstreuen -- 
  Fortschritt Kultur -- mannigfach glücklich -- Roué nennen -- tüchtig Mensch -- zivilisiertest Mann -- Natur hellerem Blick umarmt plumpen sogenannter tugendhaft Philister -- Verdienst bestehen -- meister Freude kennen -- fliehen -- 
  fort Eurer bleich negativ Tugend -- 
  treiben unnatürlichst Prozeß -- Fähigkeit schaffen -- größ Reichtum ring -- trachten Reichtum zerstören -- euer Armut -- 
  traurigsen Revolutionär -- 
  Paris -- Stadt -- -- reich bewegt Leben -- Idee -- tausenderlei neue -- -- C Büchlein Eurer Moral Fähigkeit stehen -- eiligere Ding verdammen -- 
  gewaltig Mannigfaltigkeit gesellschaftlich Leben -- bunen Vielerlei Stadt -- verschiedenartig geworden Wesen Modeweiber genießen verstehen -- preisen -- würdig Reichtum Kultur -- Mann -- Mann Tugendhaft -- 
  abschmacken Vorwurf wild -- toll -- ausschweifend Leben -- lauter Neid Schwäche anhängen -- genießen verstehen -- 
  Mann -- göttlich Demokratie Teil Gesellschaft aufnehmen verstehen -- Kunst -- Wissenschaft -- Geselligkeit -- Weib -- sogenannter Natur lieben -- reifsen Studiosus Herrgott zujauchzen -- Welt begreifen -- -- 
  -- ärgern Roman -- 
  wunderbar zurückgeblieben Wesentliche unser Roman -- Wilhelm Meister -- Vielfältigkeit verstehen -- 
  Romanhelde lieben meist mittelalterlich Minnenarr -- 
  einzig Gegenstand leben sterben blind -- 
  Natur zusammenschnür Gesellschaft Kämmerchen abteilen -- 
  Bildung fangen Individuum vervollkommnet Einzelverhältnis bereiten allgemein Ausbildung -- 
  ewig bloß anfangen -- 
  bitte -- Leute -- reich -- -- 
  Sieh -- aufmerksam Zuhörer -- 
  Wort erschließen Welt -- schreiben Apologie Treiben -- 
  Schöneres -- treiben -- unser unklar Drange hervorgehen -- plötzlich ordnen -- systematisch rechtfertigen empfehlen Mund edl Mann darstellen hören -- 
  leben -- nämlich bunt -- Mensch -- verschiede Umgebung leben -- zuweilen Gewissenszweifel -- Unrecht Menge -- geordnet religiös staatlich Verhältnis bewegen -- Allgemeinheit richtigern Einsicht -- 
  Zweifel zerstoben dein Wort -- 
  vorher -- Genuß finden -- genießen -- unbekümmert übrig -- suchen Abwechslung Mannigfaltigkeit -- 
  halten bewegter Innere rechtfertigen -- 
  fürstlich Schloß Lustgarten orientalisch Farbenschmelz öffnen -- 
  Fürstin dichen Sonett Tee lesen -- Prinzessin Amelie sing tausend Liebeslied -- Singvogel duftend Zweig -- 
  weiße -- singen -- 
  O Welt tausend tausend Auge -- einzelnen sehen Liebe Schönheit -- 
  Könntest schwärmerisch himmlisch Amelie sehen -- Lied provenzalisch Dichter ruhen -- -- Grünschloß scheu Hippolyt -- klingend Wälder vertreiben -- 
  eingefallen -- William aufmerksam -- 
  William nebenbei elend -- fürchten -- lieben Fürstin -- lassen gewiß eher kreuzig -- Wort -- 
  Grundsatz -- schwerfällig Grundsatz -- 
  scheinen leiden hassen förmlich -- Fürstin Interesse Achtung sprechen -- 
  beiliegend Brief -- Gesellschaft vortragen -- beginnen Polemik -- aufgepassen -- glauben meist Theologie -- 
  Fürstin stacheln lassen größtenteils Kampf -- Fürstin Niederlage phrophezeihen Ehrgeiz stechen -- 
  Antworte -- 
  Kampf öffentlich führen -- unterdes einaktig Tragödie schreiben -- modern Heinrich Ofterding -- Blick thüringisch Fürstin Grundsatz Blick verwirren -- trauriges nehmen -- 
  Wartburg schön Eisenacher -- Liebespsalm Amelie sing -- hebräisch Davidsche übersetzen -- Schade -- 
  Prinzessin Amelie nordischen Sakontala -- schimmeren golden Duft -- sprechen süß Peri -- Auge Stern heiligen König -- anzuschau erhoben Wesen Zeder Libanon -- 
  Psalter -- 
  Amelie reizend verkörpert Romantik -- wiegen Tön -- schweben Akkorden -- 
  Lache Überschwenglichkeit -- 
  fliegend Gespräch begegnen -- Lied flog Fenster Garten -- träumend -- Lied klingen Abends Zimmer Gitarre fragen schelmisch -- kleiden gehen -- 
  sonnig Sonntagsmorg -- Landleute gehen geputzt Kirche -- schaukelt zauberhaft Reimen Schöpfung -- 
  schlüpfen Amelie Auge Garten -- hört Tür Pavillon öffnen -- 
  -- fliegen hinunter Gebüsch Fenster Gartenhaus -- 
  stehen Pfeiler gelehnen -- halten Buch Hand -- lesen abwechselnd Himmel -- 
  kennen Einband -- Ludovico Tieks Gedicht -- 
  Amelie tragen rosenrot Kleid -- lang blond Locke fallen à l'enfant Sonnengott Strahlen Schulter -- Lilie unschuldig Auge hervor -- 
  Prinzessin schlank Gazell -- Haut wissen Federgewölk -- Mund süß klein Liebeswort -- schmal Lippe bebten -- spräch beflügelt Ver Lüfte -- 
  springen -- stürzt Fuß -- bedecken Küssen Hand -- weint Liebe -- umfaßt Knie drücken Kopf -- 
  wissen geschehen -- Hand fühlt Wange -- liegen Brust -- sprechen Tick Liebe -- 
  dicht Küssen täglich Welt wunderschön -- 
  Schreiben - Himmel send Glück -- Fürstin sprechen schalkhaft nah Hochzeit -- 
  33. Kamilla Alberta -- 
  -- 
  harmlos Kind weißen -- bittest -- stark Mädchen -- siehst -- 
  -- wissen wohin -- Grünschloß schön -- verführerisch schön -- 
  jung -- fügsam Charakter -- Liebe -- 
  hart garstig Herz -- 
  Schloß Fürstin halten Langeweile -- 
  William schmachten Fürstin bemerken -- Schwager schnöde -- unwürdig -- verächtlich abschmacken behandeln -- o Valer Zorn donnern -- ansähe -- 
  Prinz geworden Leopold spielen wunderlich Rolle -- 
  behandeln Auszeichnung -- Stande zukommen -- wissen -- eigentlich -- hüpfen gefährlich Spott Lippe Fürstin herum -- -- verzaubert Prinz sprechen -- wissen -- sagen -- 
  erregen ernsthaft Liebesverhältnis -- Leopold Prinzessin Amelie bilden -- Art gespenstig Grauen -- 
  fürcht -- Canstantie hassen Prinzessin -- 
  klar -- Goethe poetisch Frau Gegensatz Nebelhaft -- unklar Romantisch -- 
  Freund sagen -- griechisch -- plastisch Gott wissen -- Prinzessin ossianisch -- mittelalterlich -- christlich -- 
  -- wunderlich Wesen -- Amelie -- 
  Begriff Mondscheinprinzessin -- ansehen -- feineren -- durchsichtigeren Teint erblicken -- weicheres -- schönerer Organ gehören -- Gedanke losmach -- toll romantisch Person schwachköpfig -- 
  weißen -- Haus -- woher stammen -- vornehm -- arm -- 
  all Schwärmerei Amelie niedrig Stände Stolz -- Hochmut -- innerlich erbittert fühlen -- -- 
  Fürstin -- 
  Schwager passen Amelie -- garstig Mensch -- Hofton grinsend Rohheit lauern scheinen -- 
  Anschein -- zeichnen -- unheimlich all Larve -- Grünschloß erinnern -- doppelt schmerzhaft -- Liebe hören -- -- 
  -- Eurem Frieden glücklich -- gut Leute -- 
  Paris reisen -- 
  -- -- lieb Alberta -- Welt -- 
  stark schwach -- Grünschloß -- 
  gestern lieben Brief Ludovico's Schwester erhalten -- 
  liebenswürdig Wesen -- bitten Nachricht Bruder -- plötzlich verlassen -- Grund Abreise wissen -- 
  Valer Gesundheit -- 
  Himmel -- Unglück abwenden -- -- -- 
  -- sehn -- lieb Alberta -- Torheit -- gehen -- 
  Glaub -- übel -- 
  Fürstin klar Geist Verhältnissen Grünschloß Licht darstellen erscheinen -- übler kommen -- verzehrt Herz Sehnsucht -- 
  Frag -- Rätsel -- Frag -- Kind -- 
  Laune einkehren -- erzählen -- erzählen -- 
  tausend Grüße Ade -- Ade -- -- 
  34. Valerius William -- 
  auflegen -- theologisch Bedenklichkeit erwidern -- müssen Tone geschehen -- euer bunt Gesellschaft passend erscheinen -- 
  Brief Konstantin früh Gegenstand schreiben finden -- euer Kreis passen hie Notiz einstreuen -- 
  warn Name Leopold dummen Streich -- 
  Kurzem Reihenfolge Meinung zitieren -- Mannigfaltigkeit Leben empfehlen -- Hand dürfen Anpreisung rücksichtslos Leichtsinn -- gefährlich Liederlichkeit verwandeln -- 
  Gewöhne verzweifelt Parenthese -- machen selbstständig Satz -- -- wissender somit sagend -- geschlossen -- abgerundet Mensch Ganzheit wert solch geschmeidig hofschranzchen -- überall anschmiegt -- anhängen somit überall Raum finden -- 
  Instrument -- -- deutsch Adel sagen -- trennen -- verbind -- nipp Fisch Angelhaken -- reden -- -- erblasse Tod -- hinten vorn einschließenden -- Rücken deckend Haken klammern nehmen -- frei Sturm Sonnenschein preisgeben dastehen -- 
  Provisorisch Sprecht leise -- halb Wort -- zerstörenden schaffenden -- verständlich -- rückhaltslosen -- 
  Wort emanzipieren -- Gleichheit Mensch Gleichheit Gedanke -- Schäme fürchten -- ungeschützen hinzutreen -- 
  furchtsam Parenthese deutsch Manier -- Sprache qualten -- Volk persönlich Stolz -- Cicero ausnehmen -- Mut Mut zeigen -- -- 
  Laß Konstantin reden -- 
  -- sünd Selbstmord spaßhaft -- 
  wozu Fähigkeit -- Tritt Wesen dahier -- -- 
  -- -- ruhen -- -- -- sagen sogenannter fromm Leute -- -- -- euer fei Wille beschränken -- zeigen -- Gute brauchen -- bezeigen dankbar Schöpfer Geschenk Leben -- geben -- Gelegenheit Möglichkeit Prüfstein -- fallen -- -- -- 
  -- prüfstein Prüfsteine -- lieb Gott hergesetzen -- vertreiben laut Prüfe -- 
  Theologe fallen überaus lehren -- Schüler -- dräuend Haselnußstock examiniern -- Karzer Hölle Heraufrücken Nachbar Himmel -- 
  Leute gewähren weh -- Lektion nehmen Natur -- 
  Lehrer -- -- Straße frisch Luft Sonnenschein lehren -- Schulstube -- 
  -- Herrgott Schulbuben behandeln -- 
  -- Wahrlich Hypochondrie befördern Theorie -- tausend Zunge predigend preisend -- Christus bringen Tod besiegeln -- Handwerker entstellen -- 
  Opfer -- wodurch unschätzbar Schatz Wahrheit beglaubigen Welt an Herz legen -- Opfer erdrückend Kreuz Wundertheorie verdrehen -- 
  schämen -- Zeisig lustig zwitschern hören -- Erde schwarzblutigen Leute Sarge eingesegnen -- Sonne -- Mond Stern Totenfackel -- Himmel schwarz Leichentuch -- Mensch lauter Tote Todesreif tragen Leid -- 
  schicken lachen -- Gott denken -- o fröhlich Gott -- Freude ausgegossen -- 
  nennen Christentum -- 
  Christus -- Würdest Ausgeburt menschenfreundlich Gedanke sagen -- 
  richten Mensch Unglück -- 
  Pfaffe blutig Cordelier Franzose -- schön innerer Leben schnell guillotinieren -- langsam vergift Angst Furcht -- 
  Muttermilch trübe Glaube eingesogen -- eingedrohen eingeprügeln -- Knecht Ruprecht Schöpfer -- Furcht Furcht Demut predigen -- unversiegbar -- unzerstörlich Quelle geistig Gesundheit Mensch -- Herrschlust stärkeren Mensch halb aufrecht Stellung erhalten teilweise Quäker -- Herrnhuter dergleichen zusammenknicken lassen -- 
  lebendig Natur Lebendigkeit entwickeln lauter Freude -- -- Furcht Zitt -- freuen -- einst weltbeherrschend Römer geben -- Welt straf Zügel halten -- ausgeartet Jude -- einst trefflich Mann galiläisch tot Meer unwürdigsten Tödlichst verfolgen -- Jahrhundert furchtsam denken Mensch furchtsam stempeln -- -- 
  -- Geschenk -- Freude -- 
  welch unwürdig Gedanke göttlichen Gerechtigkeit -- aufgedrängen -- fällen -- 
  schwatzen frei Wille rühmen -- gebrauch Dürfet -- 
  -- nützen -- schwer Last -- -- 
  -- Spitze geistig Freiheit -- Dasein händ -- deutlich Beweis -- Gottheit geben -- Jammer hergesetzen -- Prüfung Prüfung gottlos Gedanke -- unlogisch -- -- prüfen -- -- 
  Kraft -- Gott geben -- -- 
  Kennt -- 
  -- verbrauchen -- 
  -- 
  verbrauchen -- nehmt gefangen -- 
  Errichtet Tribunal Eurem Herzen -- gerechtesten -- denken lernen -- Tribunal möglichst weisen -- 
  Tann lauschen Urteil folgen -- 
  einst sicher bestehen -- sicherst Rechtsgrund basieren -- 
  Gesetz richten -- -- halten -- fügen -- -- 
  -- stand Eurer despotisch Objektivität -- einzeln Subjektivität appellieren menschlich Konstruktion Objekt akkommodieren -- soweit -- Eurem Gesetz -- 
  -- Mensch Schuh brauchen -- Schuh -- -- 
  -- Pfaffen Unglück Welt bringen Aristokrat -- drückt Boden -- Sonnenlicht nehmen -- verhüllt Sonne schwarz Tuche -- worauf Kreuzestod malten -- 
  Pfaffe schlimmsen -- glauben -- 
  Klugheit hineingereden -- gebend Welt stehen -- abscheulich Dünkel ausbleiben -- 
  Schlüssel Himmel Hölle -- Türsteher schlimm Hausherr -- 
  Rede Empfangen -- meist alt Weiber -- halten -- -- Nebensach -- überflüssig -- glauben -- -- 
  -- jämmerlichst Dorfpfaffe -- 40 Welt gebären -- jenseits nächster Berg sehen -- bedauern gescheitest Mann -- hie Ding sprechen -- Essen Trinken -- 
  -- Verzweifel -- solcher Manne beschränktest Verstandeskräft stehen -- geistig überlegen fühlen -- tierisch blind Keckheit Zuversicht sehen -- Mann -- -- stehen -- -- Pfarrkind -- tüchtiger Geistesfähigkeit -- Jammer -- drücken theologisch Daumdrücken hinunt -- 
  -- Pfaffe halten Bildung -- schlecht Weg Reise -- -- 
  -- unendlich Segnung -- Christentum Erde bringen -- positiv Religion minder Gesellschaft entwickelnd Mensch bringen -- preisen -- sobald täglich Perfektibilität Lehre annehmen -- sobald Dienst grenzenlos Freiheit gründen -- unterlassen -- zerstören gute -- tragen Segen Schwing unendlich Elend -- 
  Freiheit groß -- erlangend politisch -- menschlich Geist Grenze staatlich Beschränkung verstehen -- -- 
  -- wissen gewiß -- 
  Geistestätigkeit wild umzäunt Gehege -- beziehungsweise -- Hecke -- Gräben -- Zäun einschließen -- -- 
  Einschränkung -- Ausnahme Zeit Land geboten verbieten -- 
  steifsn Grammatiker reden Wort -- sagen -- Regel Ausnahme -- -- 
  -- Religion meister Wissenschaft Zunft -- zünftigen Theologe Konfession -- Handwerker schaffen -- jeder Handwerk golden Boden -- 
  Klappern gehören Handwerk -- 
  tun Volk -- abonnieren Vorlesung -- Herrgott Sonntag lesen -- 
  aufgebläht Pfaffe hervorbringen -- Katechismus Welt auslachen -- verstand dünken -- -- -- -- sagen -- -- göttlich Verstand -- -- eifrig -- fromm -- gesund Paulus durchdrung menschlich Schwäche -- eng Begrenzung unser Vermögen -- -- All Wissen Stückwerk -- -- schreien -- -- Betet singen -- verworfen Kreatur -- wert -- Sonne bescheinen -- Wahrheit Leben draußen -- außerhalb Kirchtüre -- grün Erde Finsternis Schatten Tod -- -- 
  -- böse Geist Besessenen -- -- dummen Teufel ebenfalls Gergesenersäue fahren -- -- 
  -- positiv Religion vervollkommnen -- Nutzen -- leugnen -- Drittteil jetzig Welt anderer Christentum Pfaffe brauchen -- 
  zumeist lehren -- Einfluß weniger gläubige -- blind halten Stab -- tun Wunder -- -- sehen sehen -- 
  aufgestellt Perfektibilität hören Pfaffentum -- treten Theologe Reihe übrig -- Kriterium beugen -- hoch -- anderer -- sagen -- Höchste -- 
  Vernunft Kriterium -- Partei fechten -- Banner entfalen -- zusammengewickeln Einhertrag -- 
  ist_es -- sogenannter Supranaturalist -- 
  unmittelbar Offenbarung statuieren -- Gottheit offenbaren unmittelbar -- wissen -- Baum grün -- Erde Gewächse treiben etc. -- annehmen -- Gott offenbaren unmittelbar -- -- 
  -- Mann Ansicht -- Schlafmütze Baum Erde werfen -- 
  -- Gebrauch Vernunft -- nenn Rationalist werfen Schlafmütze Gesicht -- 
  Vernünftig Leute heißen -- 
  -- Faulheit Erbsünder -- hundert Mal angefang Kirchengeschicht -- kurz Weile müde starre Wegweiser -- 
  hat_es Protestantismus -- 
  erstarrt Lutheranischmus Clavinismus -- Rationalismus ebenfalls -- Wegscheider -- Paulus Röhr stehen bleiben -- Sache fertig -- 
  ekelhaft Faulheit -- -- 
  -- Streit Rationalist veralten -- Pietismus Mystizismus unterd Berlin debütieren -- Naturphilosophie minder hie dreingemengen -- 
  transzendent Fahrt modern Odysseus -- hoch Tätigkeit Trab setzen -- irren -- fahren -- suchen -- 
  Meinethalben Odysseus verliebt Insulanerin schwärmen Phantasie Zügel schießen lassen -- Phäake verständig reden -- materiell Frei agieren -- 
  scheinen bunt -- karnevalartig Philosophie herzugehen -- stürzen Menge Kriterium kopfüber Strom Himmelsüberfluß Naturerguß jeder schwimmen Kraft -- 
  Schwimmen vergnüglich -- gibt_es grünend Ufer -- immerzu -- schwimmen -- Herr -- schwimmen such Gefahr Columbus Richtige -- -- finden Amerika -- Beweis Richtigkeit Spekulation -- grün Guanahani -- -- 
  -- Philosoph Zeitungsanzeiger Beilage -- 
  unterzeichnet letzter Post direkt Herrgott et kommen -- Himmel herunt einzigrichtige gut Qualität beziehen -- empfehlen geehrt Kunde billigst Preis etc. -- -- unser Tadel zurückhalten -- Lob sogar austeil -- mancherlei Weise Erkenntnis streben -- -- 
  -- Naturphilosoph gebräuchlich Sinn Wort -- obwohl Natur anbet Brunnen Brunnen halten -- obwohl Jahrhundert reich Ernte samenkörnern Knospe Blüte Philosophie erwarten -- 
  hass religiös Fühlerei -- Gefühlsschwärmerei -- wozu Praktischen häufig führen -- -- Tolerant -- meister begeben Verdammen -- Mensch gut innerer Tätigkeit vorn Zug redlich beteiligen sehen -- 
  -- Rationalismus -- -- Valerius -- öfter angreifst platt -- leer nennen beliebst -- Folgend -- Vernunft zeigen -- Natur Welt gewiß Gesetz Regel entwickl -- erkennen erkennen -- unerkannt voraussetzen -- wissen -- Kraft Blüte aufsprengt -- wissen -- Kraft nötig -- seh Ordnung entwickeln -- Gesetz Landrecht Paragraphen teilen -- Begriff Gesetzesgang -- 
  -- -- Gottheit überall gewiß bestimmt Kreis Gesetz Natur wirken sehen -- statuier plötzlich unvorbereitet gewaltsam Herausschreit Erscheinung leiblichen Sohn Gott -- Erde überall -- hinkämen -- gewöhnlich Gesetz vermögen Überirdischkeit aufhöbe -- 
  Moslem etc. streitig -- -- 
  -- tief schwer Jammer -- Kopf theologisch halbtheologisch Lehrstühle sitzen sehen Bedenkt -- Leben hindurch Kaiser Bart beschäftigen -- 
  leben Kamera obscura wehe -- rütteln hineinleuchten -- 
  Reich -- umschloss chinesisch Mauer Terminologie Technologie -- Kirchenväter errichten -- 1800 alt Buch -- Sinn herumquälen -- unveränderlich Staatsgrundgesetz innerhalb Mauer hetz Leute trotz Reformatione Revolution Tod -- 
  Heraus -- draußen liegen profan Natur -- weltseele vergib Dummheit Blasphemie -- ewig Gut heilig profan teilen -- Tempel -- -- Draußen -- Privilegierten Profanes -- 
  Voltaire einst Bevorzugt -- einst Spor Fuß untertanen Sättel Rücken Welt kommen -- totenbleich Klasse -- Bibelsprüchen bedrucken salbungsreich Phrase Mund Welt erscheinen -- -- 
  -- Zauberkreis -- Klasse Mensch -- professionsmäßig seligmach Verdamm beschäftigen -- einsperren -- herauskönnen -- 
  schlimm -- Leute Rationalist nennen -- ratio Handwerk vermieten -- Esel Mühle -- Kreis herumgehend Rad bewegen -- 
  hoch gut Grundsatz Leute -- 
  -- Erklär einfach gut Art -- Hermeneutik sogenannter profan Schriftsteller lehren -- heilig Schrift Resultat Erklärung Religion -- sagen -- Stifter Religion vortrefflich Mensch -- Mensch Mensch Glauben Sittenlehr geben -- 1800 Land -- gesellschaftlich Verhältnis zehnmal umgestürzt umgeändert -- unverändert gelten -- 
  Erscheinung -- gebildet Welt -- Theologie leben -- überall Sittenlehr -- sogenannter Sünder wimmeln -- wunderbar Stellung -- Theologe unbefangen Leute einnehmen -- Glaube -- Theologie bloß -- Volke vorzumachen -- geben -- -- 
  -- gesellschaftlich Verhältnis moralisch Anforderung Ein bedingen -- Eins aufgehen -- 
  verlangen -- heutig Gesellschaft Gesetzbuche Solons Lykurg glücklich fühlen -- unantastbar Stabilität veraltet Moralgesetze verlangen -- 
  Vorbedingung verändern -- Folgerung gemäß bestehen -- 
  Philosoph -- taufen konfirmieren -- Vater Glaube vollkommen hineinerzogen -- Wenig -- Autoritätseinflus frei erhalten -- überschrien Menge -- Wissenschaft kirchlich infizieren -- 
  Moralprinzipie neu Geburt Abdruck früh Platte -- 
  sogenannter Indifferent Mut glauben prüfen -- 
  Dahinein gehören fast Leute hoch Bildung -- Geschrei Pfaffe wechselnd Gleichgültigkeit religiös Ding -- 
  Mißverhältnis Anforderung Gewährleistunge entspringen heben -- 
  Erscheinung -- Leute unruhiger Blut gering Geist Seelenstärk -- Haltpunkte bedurft -- gewaltig auseinandergehen herrschend geworden Lebensansicht vorgepredigt deutlich Auge sehen -- äußerer Zipfel greifen -- Gute tun geschlossen Auge plappernd Mund hineinschritt Nacht Mystizismus -- 
  Grund -- Indifferentismus erzeugen -- schaffen Pietisterei -- Winter Eis Schnee -- Regen bringen -- -- 
  -- Gebt Leute Führer -- Sprache -- Land kennen -- irr -- jung alt Pfaffe sprechen hebräisch unverständlich tot Idiom -- lassen Mode zuschneiden -- lassen französische Englisch lernen -- modernisieren -- 
  Mode stecken bloß Schnitt Kleid -- zufällig Ausdrück -- ewig jung Kraft menschlich Herzens -- Trieb Weltgeschichte -- Erdkugel Zivilisation bewegen -- -- 
  -- Skizze -- 
  arm Balladendichter -- -- 
  Sieh Katholizismus -- gestürzt -- gebeugt König einher -- sprechen Teilnahme finden erregt -- ursprünglich Hoheit -- angelernte ansehen -- verrichtet Amt -- Poet bestach himmlischem Golde -- uralt Absolutismus -- 
  rüstig Jüngling -- -- erwerben Meister entbehren -- platt Zyniker treten Protestantismus -- altklagen -- verschrumpfte -- -- etc. etc. soviel Brief Konstantin -- 
  weggestrichen -- euer Kreis bunt -- ausschweifend -- Meinung Brief Ding teil -- weißen -- 
  Richtung Grund -- 
  Prinzip -- Blut Ansicht rollen -- Freiheit -- 
  religiös Ding -- 
  gestatten -- glauben -- Teufel brauchen -- -- 
  beglücken Teufel sünd -- 
  hass Schematisier -- Zusammendrücko Mensch Knäuel -- 
  Bilden Volk -- kein Popanz bedürfen -- euer theologisch Weg mißbillige -- 
  Volk geistig Freiheit -- 
  Bildet Gefühl -- Bedürfnis -- Atmosphäre -- Mensch Religion -- Glaube frei Einzeln angehörig -- 
  Fundament gründen Sicherheit Zusammenleben Staat -- Rechtlichkeit -- Gesetzlichkeit Ausdruck Religion -- 
  Konstantin -- euer Theologie anklagt -- stockig verstehen -- 
  Glaube anbelangend Konstantin klar -- 
  sprechen nüchtern Religionsmathematik Rationalist -- 
  wichtig Läuterung Jakobiner -- bloß furchtsam -- platt -- eitel egoistisch bissch Vernunft abmachen -- 
  Poesie jeder Mensch Glaube -- 
  geben frei -- entledigen Fessel -- Mensch poetisch -- Pfaffe hindern Entwicklung -- objektiv Märche schaffend Tätigkeit Mensch einengen -- 
  Staat Konstruktion jeder religiös Element verschwinden -- Königsglaube -- Obrigkeitsreligion -- gelehren -- existieren -- fragen hoch Einsetzung -- fragen Nutzen -- Rechtsverhältnissen -- Staat göttlich Institut -- einer Klugheit -- Verstand -- fließend gegenseitig Vorteil -- religiös Bedingung -- 
  Fragt Katechismus -- fragen Rechts-Breve -- lassen Staat -- Jude Heide -- 
  frei Kunst -- Poesie -- Himmel Hölle Werk Poesie -- 
  -- Leb -- warn Leopold -- glauben -- Weg -- dumm Streich -- 
  Rat annehmen -- verlassen schleunigst Kreis -- befindest -- 
  35. Hippolyt Valerius -- 
  Wien -- September -- 
  verachtet Trostlosigkeit -- Freund -- trostlos -- 
  Haßte Reue -- Schuldenmacherin Zukunft -- unnützerweise Geld Vergangenheit leihen -- fing bereuen -- 
  tret Speisesaal setzen -- 
  leise Schrei Nachbarin lassen genau halbverhüllt Gesicht sehen -- Julia -- aufstehen eilen -- 
  fassen Krampfhaft Hand halten fest -- fort -- Aufsehen zahlreich Gesellschaft verursachen -- 
  Himmel wissen -- Glut Wut Liebe zuflüsteren -- beben Espenblatt -- Brust schlagen -- Gesicht brennen Scham Feuer -- 
  fallen weinend Auge fußfällig -- bitten -- Sünderin Beichtiger Hoffnung Seligkeit bitten -- mögen lassen -- 
  ehe entschließen -- erstarrt Hand -- lehnen Rückseite Stuhl ohnmächtig -- 
  Auge bleiben -- Mensch kennen Zustand -- 
  Kellner präsentiert Speise -- danken -- 
  wild Mensch Lust -- Ereignis freuen -- unwohl geworden Dame Zimmer bringen lassen -- lebendig Schwäche erobern -- 
  alt stolz Hippolyt schämt jämmerlich Gedanken -- Liebe alt Kraft zermalmen -- 
  Augenblick treten Kellner berichten -- Dame -- Haus wohnen -- Name erfahren fragen lassen -- -- Schauspielerin Desdemona -- 
  liegen krank selbig Hotel danieder -- wünschen sehnlich sprechen -- 
  verödet Gegend Herzen schlagen Blitz -- entzünden -- 
  Julia erholen -- führen Saale -- küßte gebrochen Auge fliegen -- Desdemona Zimmer suchend -- 
  O erleben -- 
  gestählt Innere bog Baumzweig -- 
  Bleich -- Bild zerstörend Tot -- liegen einst schön Weib Lager -- 
  lang schwarz Flecht hingen auflösen Gesicht Schulter weiß Nachtkleid herunter -- weich Zug Antlitzes spitz schmerzhaft -- Mund -- lieblich Liebeslied -- vrrzogen -- Auge ewig Liebe Stern bleiben -- heranbrechendem Tageslicht Matter scheinen -- 
  sprechen -- eintreten -- scheinen überraschen -- Bett treten -- nicken merklich Haupt lispeln -- 
  -- -- Hippolyt -- wehren lieben -- -- 
  heiß Träne -- Freund -- heiß Träne Kern Herzens -- stürzt Auge abgemagert Hand -- 
  -- Fürstin -- -- -- zweischneidig Schwert wühlen Inneren -- -- sehen Desdemona spielen -- mich_es lehren -- -- 
  fühlt krampfhaft Druck Hand -- holen tief Atem -- Mund Liebe lächelen -- Auge strahlt alt Glückseligkeit -- hören leis -- leise Wort -- 
  -- lieb -- -- Desdemona tot -- 
  stehen unbeweglich -- tot -- 
  Kindes Stimme -- Erde spielen -- plötzlich Spiel aufjauchzen -- erwecken -- 
  erstarrt Hand Desdemona halten fest umklammern -- tote aufbrech Schmerz -- 
  bleiben stehen suchen frei Hand all Tasche herum -- Waffe finden -- 
  Weib bleiben -- 
  Tasche leer -- 
  müssen Gräßlichst Hand gewaltsam tot Liebe befreien -- 
  Langsam Tür -- 
  Mädchen lächelnd bitten -- spielen -- 
  stehen Tür lieben Leiche -- schließen Tür leise -- Weib stören -- 
  zuschlagend Schloß trennt innigst Vergangenheit -- 
  langsam Saal entlang Ferne -- dicht vorging -- 
  Dame Reisekleidern schlüpfn vorüber -- Julia Mädchen -- beachten -- 
  erzählen -- Hansthür stellen fortfahrend Julia starr zusehen -- gerichtet Wort erwidern -- 
  Totenstunde Leben denken Grausen - Tod garstig Scheusal -- bar häßlich Gegensatz schöne -- 
  trüb Regentag -- Haustür Hotel stehen -- brechen plötzlich Nachmittagssonn Wolke leuchteen Starre Auge -- 
  wich Feind -- Tod -- Gliedern -- fühlen lebendig Blut -- sehnen spannen -- auferstanden -- 
  fallen Lebendig -- sehen -- -- 
  Julien Abreise Schönheit -- rufen Pferd -- 
  kümmern Tod -- 
  Mensch dumm -- abscheulich Zustande Gepränge Aufsehen vornehmen -- 
  gestorben Mensch Sache -- bringen schnell -- 
  Leichnam beschäftigen -- Seele leiben -- verhärtet unästhetisch Leichenweib -- Handwerks-Totengräber -- 
  sterben sterben sehen -- 
  schreiben Gasthofe wart Pferd -- 
  bunen Bastei Sonnenschein liegen offen Fenster -- Tod überwinden -- Vergangenheit vorig Stunde liegen tiefem -- entfernt Nebel -- 
  Leben lebendig -- Wagen fahren -- 
  Ade -- Freund -- fliegen Paris -- Julien erobern -- 
  erobern -- müssen nachjag Zone -- 
  Sentimentalität lieben -- Krücke Schwäche -- Regenschirm Gewitterreg -- furchtsam Gesicht Donner Blitz verstecken -- Liebäugel Tod -- 
  sterben leben -- 
  Sonne -- täglich untergehen -- Untergeh -- 
  O täglich sterbend Mensch Eurer Romantik Fratze nennen -- Blut Wärme suchen -- such Liebe Julie -- Gott befohlen -- Freund -- 56. Valerius Constantin -- 
  Hippolyt Reise Paris -- schreiben -- begonnen Metamorphose Gedächtnis übrig behalten -- Interesse Angelegenheit nimmst -- Staat Kirche schreiben -- Herz drängen Mitteilung -- sprechen -- schwätzen -- hören -- 
  kommen -- Kamilla nämlich -- 
  errötend treten entgegen -- Morgenhimmel Schamhaftigkeit glänzt liebreich Gesicht -- wissen -- wissen ich_es -- 
  spazieren Geritt ankommen -- Himmel blau -- Sonne -- Auge Gott Erde -- wärmend freundlich mild Liebe -- Lerche singen jauchzenden stoßtön Freude -- Baum Früchte beladen sehen glücklich Mutter freundlich drein hell Welt -- schaukelt Pferd gesund fröhlich Empfängnis all Freude -- Schöpfer -- Ärmsten freigebig schenken -- Weltgeschicht rosenfarbig vorüber -- hoffen gute strebend Mensch -- 
  Stimmung riten langsam Schloßhof -- 
  Stufe Schloß Dame stehen -- erkennen Alberta weißen leuchtend Gewand -- Tuch winken -- 
  Kamilla -- ankommen -- 
  glückselig Seele fallen verschämt Blick tiefsinnig Liebesgedanke Byron -- ruhig Freude -- glücklich Vogel Baumzweig sitzen -- erheben plötzlich Schwing flattern jubelnd Höhe -- ruhig Freude innerer erheben jauchzen namenlos Glück -- 
  plötzlich -- Kamilla lieben -- 
  reichen schön -- weiß Hand -- drücken innig zuckend Lippe -- Glück heraus tief feucht glänzend Auge Herz hinein -- Hand vermählt -- harmlos Alberta freut Freude -- 
  gehen Garten spielen glücklich Kind -- 
  Kamilla weich -- innig warm Maiabend Auge hing küßend Engel Blick -- Munter auslassen -- lacht -- Engel -- freuen -- 
  Glück mitunter aufjauchzen -- springen sonstig hüpfend Temperament hervor -- Auge blitzn -- Zug Gesicht jubeln -- Glied hoben schwebend Tanze -- beginnen fröhlich Lied -- tänzelen Strecke -- 
  sagen -- Herz bewegen -- Alberta Seite -- 
  Schwärmt romantisch Ungewißheit halb Garte Wald umher -- Blick sprechen voll Herz -- süß Glück -- Lippe bargen Schönheit Welt -- 
  scheinen Schatten Camillas Angesicht fliegen -- Alberta tändelen -- lieb kindlich Wesen kosend Wort wechseln -- 
  Graf letzter Einsamkeit aufleben -- Stelle langweilig Fip -- diplomatisch Bestrebung aufgegebe Lend gürten -- bunt Marschall Laune -- Kamilla -- treten -- 
  leben Engel -- Monat Paris -- 
  romantisch Ungewißheit Kamilla reizend Klarheit auflösen -- 
  sitzen Ankunft Plattform Zelt -- Seitenwänd aufschlagen -- 
  Abend -- Himmel rot -- Erde duftet Wollust -- 
  glücklich Land hinein stehen untergeschlagen arm Kamilla -- Gegend zeichnen -- 
  Alberta stehen Seite singen -- Kopf Säule Zeltes hinauslehnen -- singen Wanderlied lieben Wilhelm Müller -- 
  Kamilla hing innig Blick freudestrahlend Auge -- 
  küßen Seele -- 
  Nachtigall schlagen Alberta Gesang -- 
  kehren -- küßte Kamilla -- reichen Hand springen hinweg musizieren -- Gesang -- -- -- müssen Ton -- herumwogt -- ausströmen -- 
  setzen Kamilla Zeichnung -- Auge -- 
  fühlen -- Begriff stehen -- unseren Dämmernebel zerreißen -- 
  Mann plump Weib -- trachten Nüchternheit bestimmt Form -- griechisch -- Weib romantisch -- christlich -- 
  rein Weib lieben Jahrelang Worte -- Mann Monat -- 
  -- Kamilla -- -- sprechen leise -- ahnen -- beben -- 
  -- Valerius -- fragen hörbar -- 
  Bleistift fallen Hand -- neigt Fülle Haar fallen Wange -- Schulter Busen -- 
  Ergriff Hand -- führen Mund -- bewegen Auge -- 
  erwidern Druck Hand -- Träne stehen Auge -- Kopf Schulter herunter wallend Locke drücken -- ziehen Hand fühlt weich rund Arm Nack Tran fallen Stirn -- 
  selig Gesicht -- leise -- 
  -- Kamilla -- lieben -- -- 
  leises Weinen Schluchze Antlitz Haupt verbergend vernehmen nah Ohr hörbaren Wort -- 
  -- lieben unsäglich -- -- 
  springen -- heben Gesicht Höhe -- küssen Träne Auge drücken weich nachgiebig Gestalt fest Herz -- 
  lächelen Engel -- küßten freut Liebe -- 
  früh Übermut -- reizend vielfarbig Knabe -- Geständniß -- 
  Blöde bescheiden vorher -- toll auslassen -- 
  rührend klagen -- gelitt -- Alberta Garten Brust sehen -- Träne gestehen -- hinwegreisen unsicher -- schwankend -- halb ungläubig Seite -- Versicherung -- groß Irrtume -- Alberta Anderes freundschaflich Verhältnis bestehen -- 
  halten Mund -- 
  glauben -- roh Mann laß Alberta unser übereinkommen Liebe Zärtlichkeit wissen -- Hörst -- 
  versprach_es Freude -- 
  Hindernis bürgerlichen Gesellschaft -- Polizei Strafgericht -- Unsicherheit unser Leben -- Ungewißheit nahen fern Tod furchtsam Wesen -- schöne -- besitzen -- gefährden glauben -- sobald Geheimnis -- 
  herzdurchdringend Liebe Wohnung Herz -- fliehen hassen Markt -- Jugend -- 
  gleichen jung Bürger dumpfgebaut Reichsstadt -- schleichen strahlendst Sonnenschein -- Tor üppig arm Erde schlagen -- lebendig Menschenmenge -- laut Dasein freuen -- düstr stübch Mädchen -- dunkel Einsamkeit froh -- Sonnenschein Menschenwoge dringen -- 
  äußerlich aristokratisch Absonderungswese jung Liebe -- 
  freut Grund Camilla Vorschlag -- 
  öffentlich Liebe sünd Clara -- 
  Fragst -- Klärch suchen -- erfahren -- frei -- harre wahrscheinlich alt geliebter -- Tröstliches meister Leute erwidern -- 
  Liebesharm süß Krankheit -- schönsen Schmerz beglücken reifer Gesundheit enden -- 
  deutsch Liebesharm chronisch Übel -- Jüngling Mann entnervt -- 
  kämpfen -- 
  treu -- Treue zumeist Sünd unser fort- fortrückend Planet -- drauf dran -- halten -- 
  Treue Schutzmittel schwach -- ausreichend Kraft -- Kraft stark -- 
  Krücken Liebe fortwirfen -- lernen selbständig lieben -- 
  Liebe verlassen sogenannter Tugend herkommen ruhen hergebracht Privilegium -- -- unversiegbar Kraft bestehen -- 
  Traditionsgut -- jeder -- Länge Verdienst -- Größe Schönheit Sache -- 
  tausend gebrochen Herz -- langweilig verdrossen Ehen Kind Treue -- 
  jeder schwindsüchtig Mädchen -- jämmerlich Jüngling verlassen Schutz -- gelingen -- schwach Stunde Eroberung -- 
  treu Gängelband menschlich Faulheit Schwäche -- Poesie Kraftlosigkeit -- getreu Eckardt -- -- einst vorhattest -- sünd wider Geist Geist heilig Geist -- 
  König Gott Gnade herkommen angestammt Treue berufen -- Vortrefflichkeit Regierung Notwendigkeit finden lassen -- steif Lehre Treue -- 
  Blut -- leben -- Leben aussehen -- deiner Leben Blut alt Liebe finden -- treu -- Liebe jung -- 
  schön Lehre Beständigkeit -- Tugend -- äußerer Verhältnis inneren Harmoniere -- 
  Ehe Damm Strom Geselligkeit -- wissen frei Weise Strom leiten -- brauchen Damm -- 
  Tausend Herkommen Liebe -- Lebenselement Herkommen -- Unzweifelhaftigkeit -- vernichten -- Welt nähern Sturmschritt -- 
  Hand Hand -- Gesetz Kette -- trennen Glied klirren ebenfalls auseinander -- 
  geben -- Jugend Kraft vertrauend Ruhebänk Staat -- Amt still Gewässer -- Welle steigen fallen -- Rücken ansehen -- Faulplatz jung Alter überlassen -- Kraft spüren Schoß hergebracht Ordnungskraft Schutz suchen -- 
  Staat Grundsätze Amt beweglich -- Kraft behalten -- herkommen zahlen Deut -- gelten -- -- -- 
  Amt Liebe -- 
  Geschrei -- Aufhebung Ehe Treue erheben -- erheben wechselnd Staatsdienst neu constuirt Staat -- 
  -- Fülle Leben bringen schnell Tod -- Gesetz gesellschaftlich Verhältnis erfinden -- finden -- Freiheit Gesetz -- 
  Teil erweitern -- ruhen unbehaglich drängen jung Geschlecht -- 
  Furchtsame erschrecken -- Mutige gehören Welt -- 
  erwerben -- fürchten meister verlieren -- Kraft fühlen -- bangen Verlust -- Kraft herrschen -- Herkommen -- 
  sprechen still Stunde Kamilla -- 
  hören aufmerksam -- schmäln -- -- nötigen deutlich sprechen -- nicken lächelnd -- verstünd -- weinen -- verlieren lachen -- -- 
  glauben -- -- glauben -- -- -- sollst heiraten -- -- Heirat hübsch -- philisterhaft -- 
  bleiben -- -- -- -- Vergangenheit leben glücklich sterben -- -- 
  Augenblick traurig -- küßten heiß leidenschaftlich -- trocknet Auge -- fahren Hand Stirn Luft -- schlimm Gestalt hinwegjagen sprechen fröhlich -- 
  -- reizen -- Revolution beginnen -- bezahlen helfen -- freuen -- Leute anklagen beneiden -- frei fessellos schön Liebesleben führen -- 
  gut Eltern tot -- machen Sorge ungewöhnlich -- verdammt Leben -- Vermögen reichen Wünsch unser Herzen verkehren -- -- schnell sogleich fallen -- Valer -- -- Paris bleiben -- Graf heimkehren Frage gehören -- -- 
  Kind Engel überaus glücklich -- unverfälscht Seele -- Frohsinn Flecken bewahren -- schleichen liebenswürdig Zudringlichkeit Ritze Herzen nisten fest -- o frei göttlich Liebe -- Heiratskandidaten Ahnung -- -- erfährst -- schreiben -- Hippolyt ankommen -- 
  37. Kamilla Valerius -- 
  garstig -- garstig ungezogen -- dummen Stadtgeschaft schnell abmachst lang -- erlauben -- ausbleibst -- 
  Alberta ängstigen -- tun -- stark Mann -- gewöhnlich Lebensgange hart Nack brechen -- kommen Herz -- Seele -- Gedanke Leben -- lechze Auge -- Druck Hand -- Wang -- heiß Gesicht drücken -- 
  gestern Abend eigentlich heit -- sitzen Zimmer -- naschen dein Papier herum singen Lied -- finden sogar schön -- -- sehen -- fehlen -- Schwäche trotzen leben -- 
  Alberta trauriger -- sprechen immerwährend Sehnsucht -- 
  Abend -- gehen entgegen -- Weiber -- Hexe erwartet Makbeth Heide -- -- -- 
  brechen Glut Leidenschaft -- Ruhe Tag täuschen -- Orkan heraus -- müssen bitterlich weinen -- o bitte -- schilen -- denken -- wolltest wiederkommen -- -- dummen schwarz Abendgedanken -- fremd Blut -- 
  ist_es -- Munter heit denken -- -- -- -- -- 
  hören -- treiben -- Welt -- trennen leben -- 
  Vergiß -- hochrot Band kaufen -- mußt Schelt verblichen Band -- -- matt häßlich blond Augenbraue brünett Gesicht -- 
  ausgesonn -- hübsch Küssen -- sollst sehen -- laß Bärtche abschneiden -- bitte -- bitte -- 
  Vergiß Zeichenpapier -- kühn Pyrongesicht malen -- 
  Form schön -- fliegen Freiheitsmelancholie Augenwinkel -- schön Liebesmund -- Wort süßen Küs ruhn -- schön Italienerinn bestach -- 
  Bote Brief unterwegs begegnen -- 
  Wärst -- überaus zuverlässig Valer -- Wegbleibe -- Kamerad -- erzählen -- machen Angst -- 
  wild -- unbändig -- schonungslos betragen Verhältnissen Hippolyt hören -- Fürstin schreiben -- 
  Leopold Prinzessin Amelie heiraten -- sicher bestimmt Dokument Herkunft sonstig Verhältnis begehren -- unlösbar Inkognito vorgeschützen -- Fürstin wunderlich Partie nehmen folgend Hochzeit -- schwach Fürst Einwendung -- 
  Schloß glänzt Abends Kerzenschein strahlend Polterabend -- Park büsch blitz Liebeslichter -- geladen frei herbeiströmend Menge erfüllen Gang -- glücklich Prinz Leopold -- ätherisch Braut arme -- hüpfen populär Masse lächeln äußerst glücklich -- 
  sprechen vorübergeh Bauer volksrechten Freiheit Gleichheit -- Volksjubel groß -- wütend Geschrei lassen volksfreundlich Erbprinz leben -- verlangen sehen -- tragen Schulter einher -- 
  Prinz Leopold Prinzessin Braut -- hätten_es alt Minnefürst Romantik treiben -- bestellen Tragbahr romantisch Dame -- nehmen Triumphzug -- 
  Balkon sehen Hof Fürstin lächeln -- schreiben -- 
  Schwager -- zerstören dräuend demokratisch Herrlichkeit -- 
  rufen Leopold Seite sprechen -- 
  Braut -- sprechen Träne Romantik -- erbitten William Summe Geldes -- Bauer beglücken verschwinden -- 
  Fuß Fortwandernde Bauer begegnen -- fahrend Prinz erzählen -- gehen Belgien Volkssouverainetät fechten -- erringen -- dürfen Liebe Freude pflegen -- 
  Prinzessin Amelie erklären -- Ohnmacht modern -- befassen -- tragen Haar auflösen singen offen Fenster Nacht Lied Tick Novali -- ißt Gericht kleiden aschgraun -- -- 
  Fürstin setzen hinzu -- Sache Skandal nennen -- Herr Valerius -- Wasser Mühle -- 
  mögest besuchen -- wollen sprechen -- 
  hoffen -- bleiben lassen -- 
  Stolzes -- herrsch rachsüchtig Weib -- glauben -- fürcht -- absichtlich anzetteln -- -- -- 
  schrecklich Nachricht -- 
  William Abends Korridor Schwager Fürstin Dolchstich niedergeworfen -- Zimmer Fürstin wahnsinnig gedrung Hülferufe entflohen -- 
  Lebhafteste verfolgen -- Nachricht Kurier -- 
  -- begegnen -- 
  O eil -- Eile -- bangen grauenvoll Nachricht -- 
  38. William Valerius -- 
  bauen Redlichkeit vertrauen -- 
  Verfolgung Ferse -- Not -- entrinnen -- tun Möglich -- falsch Spur leiten -- verbreit -- Österreich fliehen -- 
  Augenblick wagen -- verbergen halten -- 
  falsch Nachricht wirken anfangen -- hoffen Belgische Grenze entkommen -- 
  innerer auflösen -- Frage Rechenschaft -- geben -- 
  Gewissen verlieren -- Autorität vermögen frei sprechen -- rolle Rad Abgrunde -- 
  Fürstin glühend verlangen lieben -- klar -- 
  kämpfen Grundsatz hartnäckig Fleisch -- 
  siegen -- freundlich Wort Blick schön Weibe verführen -- 
  stehen Punkt abzureisen empfehlen -- reicht weich Hand Kusse -- streichen Haar Stirn fragen -- drängen -- 
  fort -- sünd ausgebilden Herz -- vermögen -- Gewisse rechtfertigen -- 
  schlagen Gewissen tot genießen -- 
  unheimlich Schwager stellen entgegen -- fallen Opfer Mensch -- Bande Ordnung zerrissen -- 
  schweige -- schweigen -- erkennen -- -- 
  Ordnung -- Ordnung -- verabscheuen -- 
  gehen Grund -- System bleiben unerschüttert -- -- 
  Begierd -- Gesetz Religion starr Bande halten -- rasselnd aufgesprungen -- bemächtigen -- Fehltritt begehen -- 
  Stein herausgerissen -- stürzen Gebäude -- rennen rennen -- Geschick entgehen -- 
  Hölle hohnlacht -- glänzend Fange -- verlieren -- Lust gewinnen -- 
  führen Weg -- Himmel abgrund -- falsch Tritt hinreichend -- 
  gefall Gesellschaft würdig -- 
  lohnt Tugend äußerer Entbehrung -- Entbehrung Gegendruck kindisch Schwäche -- Tugend verlieren -- Jage Genuß -- 
  schuld Unglück -- Verlängnung Religion stets sehen -- matt Dogma -- 
  unselig Volksverführer Eurem Gewissen -- 
  39. Constantin Valerius -- 
  schreibst -- Freund -- wahrscheinlich Sinnesänderung zürnst -- 
  lässt Gelegenheit entgehen -- Krisis einzuwirken -- befind zuverlässig -- 
  Rette retten -- fühlen -- Hand verschwinden -- fang -- Schicksalstragödie glauben -- denken lösen fremd Geist -- 
  Gehörst platt republikanisch Partei -- warst -- wahrhaftig war_es -- Gegner -- stattesen Entwickelungsgang -- Modifikation etc. -- brauchen -- 
  Hippolyt tragen eigentlich -- schreiben -- schreiben Zeile -- tobt herum liegen starr ausstrecken schweigen -- 
  politisch Sinnesänderung -- mitteilen -- tödlich schweigen -- erkälten -- entsetzt -- untergeschlagen arme stehend schwarz tiefbrennend Auge Innerste Seele hineinsehen -- -- Verachtung springen lachend Mundwinkel -- sprechen Wort -- 
  -- sagen -- 
  -- Wofür Freund -- 
  -- Hippolyt -- sprich -- -- 
  -- -- schwach Mensch -- deutsch Wicht -- Träumen buhlen Sonnenlicht bleich -- Valer -- reuen -- euer Kreis verbringen -- sprich -- -- -- 
  hinweg -- 
  Beispielloser Übermut Ausländers -- zornig Wort Luft -- 
  heimkam -- wiederholen Zorn -- Vorwurf -- 
  scheinen zuzuhören -- werfen rasch unwillig Blick -- werfen fremd Frage -- Abend Billet Gesandtenballe verschaffen können -- 
  liebeselend -- blass Gesicht umherirren -- lassen absteh Polemik -- fragen teilnehmend -- Sache Julie stehen -- 
  vieler Mühe folgend Tatbestand ermitteln -- Kriminalist Wichtigste abfragen -- Wort antworten -- erzählen -- 
  eintreffen Julia -- erfahren -- erwarten -- 
  Bildsäule stehen Nacht Barriere -- Wahrscheinlichkeit passieren müssen -- 
  nachts -- Falkenauge erkennen -- springen hinten Wagen fahren Hotel -- öffnet Schlag -- heben heraus -- 
  heftig drücken -- erkennen rufen -- 
  verhinderte bitten -- Zutritt Haus gestatten -- 
  verneinen entscheiden -- 
  -- -- -- loslassend -- -- sprech mindestens 5 Minute allnächtlich 12 Korridor Stock zünd Haus ermorde samt Vater -- -- 
  Werk Minute -- rufen -- verschwinden -- 
  wild unzivilisiert Mensch zutrauen -- er_es -- würf Erde Monde Kopf Liebesgrille halber -- 
  Mädchen arretieren lassen -- -- antiromantisch Mädchen -- 
  süß -- toll lieben -- 
  mehrmals sprechen -- weinen beschwören -- ungestört lassen -- 
  Träne fruchn -- lieben Julie grenzenlos -- Woche hingegangen -- 
  Wille -- berlin Bekanntschaft erneuern Julien Vater Aufwartung -- 
  hoffentlich bekomm Weise Karte Balle -- 
  Freude -- schön Mädchen sehen -- 
  -- -- 
  bunt Wirtschaft -- 
  melden annehmen -- 
  Julia schön liebenswürdig -- 
  sitzen Haustoilette Fenster lesen -- 
  leicht weiß Morgenkleid fliegend Ärmel -- schön voll Arm spielen -- umflog poetisch schön Glied -- dunkel Locke hüpft Schulter -- 
  herzlich freundlich behandelt Aufgeschloßener -- liebevoll Seele alt bekannte -- vorwerfend -- spät fragen -- 
  warm heimatlich tun erstarrt Brust - Weltgeschichte trocken Odem Weiber -- Freund -- Welt weiber Rechenexempel -- langweilig Schulstube -- 
  treten offen Fenster lebendig Rue Honore -- 
  -- ander Paris -- Auge widerspiegelen -- Lippe -- 
  toll Stadt behagen -- wüst regellos durcheinander -- -- Pedant -- -- Regel entdecken -- unruhig Mut -- deutsch Gott schön Ordnung Harmonie -- Goethe flüchten Iphigenia -- Tasso lesen -- Ruhe verschaffen Getümmel -- -- 
  Liebenswürdig Mädchen -- harmonisch klingen Streben jetzig Wesen -- 
  sprechen freudeglühend -- angenehm überrasch -- hüpfend Jugendjahr Besonnenheit finden -- lächelen meinen -- Habest necken jung Matrone nennen -- 
  -- -- fahren fort -- Weib schön unbeteiligt Stellung gesellschaftlich Stellung Passendere erwähl Prinzip Ordnung -- Einfachheit Ruhe -- 
  Einfachheit Ruhe Element Schönheit Streben -- Endziel -- 
  Mann schaffen -- zeugen -- produzieren -- reproduzier -- ordn Geschaffen -- 
  halten töricht -- Frau Goethe unerquicklich Lärm -- Unruhe -- Wechsel fern halten -- Aufopferung Reiz -- Empfänglichkeit Gabe verwöhnen -- fein Organe -- klein Luftströmung beben -- abstumpfen -- 
  halten Goethe Art Halbgott -- der h. glauben -- gute Weibe aufnehmen edl Männlichkeit verherrlichen -- heben -- 
  plump handeln taugen -- -- 
  -- spielt fleischig Hand -- weich senkend schön Arm schließen -- Blätter Tasso Auge ruht schön Prinzessin Leonore -- 
  fühlen Tasso's Vergehen umarmt -- schön Hand verführerisch Arm küßen -- 
  Idee eingehend beschreiben Entwicklung allmählich Reaktion -- nennen -- Freute erwähnen mehrmals -- Mäßigung -- sauber Klarheit -- geläutert Schönheitssinn könnest -- 
  bitten -- wiederzukommen Vater kennen lernen -- freuen -- Gange politisch Ausbildung zuzuhören -- 
  nennen Hyppolit Name -- entfärbt Träne treten Auge -- 
  bitten -- mitbringen -- 
  schwanken -- mitwisser erriet weiblich Takt sogleich -- heimlich Band -- schnell nah bringen -- 
  verlegen -- zupft Bänder -- Erde -- faltet Schoß Hand starr Verschlingung -- 
  heben langsam Kopf -- wehmütig bittend -- Lasse -- fürchten -- 
  vertrauen überwältigen -- ergriff Hand küßen schnell -- ziehen schnell Artigkeit gestatten -- hinweg -- stehen empfehlen -- 
  Gang Pairskammer halten -- -- 
  Haus ankommen finden Billett Balle Abend -- 
  Hippolyt schmerzlich drein -- erzählen -- 
  -- 
  -- schwerlich hingehen -- 
  glänzend Ball -- 
  notabilitäten jung Frankreich -- 
  Lafitt regelmäßigen ehrlich Gesicht unveränderlich festgeordneter Frisur spielen Premier fein französisch artig Rolle -- 
  Bestrebung verdanken Ludwig Philipp königlich Bett Palais royal -- all Vermögen alt Bourbone Schanze schlagen -- klassisch brav Mann -- gestehen Feind -- 
  klassisch -- Zug -- falt Gesicht romantisch -- 
  Gefälligkeit -- Artigkeit abgemachen -- Gleis bringen -- russisch gesandter -- schneeweißen Kriecher Pozzo di Borgo -- Abend sprechen -- Galanterie -- flammend Kriegserklärung übergeben -- Prise Tabak anbieten -- 
  Gesicht steinern glatt Galanterie -- Kopf Louis Vierzehnten zierlich Epoche Herz jung französisch Jugend -- 
  unterhalten Julia Mann -- glauben -- frech Tribunal schreiendsen Ungerechtigkeit Tod verurteilt -- höflich verteidigen -- 
  wilde Kammerdebatt -- insolentest Gegner bleiben Mann artig -- verbindlich - Klassicitität -- sogar erstarren -- 
  Julie entzücken ziemlich deutlich -- stehen -- Form erheischen -- freuen -- Glatte endlos tief See -- 
  Land Mann -- stolz Frankreich Lafitte -- 
  Unweit sitzen alt Drüben -- Friedensnapoleon -- langweiligsten -- einförmig Freiheitsmann La Fayette -- schlecht Marquis alt -- gut Bürger -- 
  Mann Weg -- Härteste tadelen unbegrenzt -- 
  Klassiker unwandelbaren Freiheitsidee -- Klassiker romantisch französisch Revolution -- unverwüstlich Jugend romantisch Anstrich -- 
  nehmen politisch Welt Frankreich Unsterblichkeit Platz -- Goethe deutsch literarisch Staat behaupten -- 
  beid Klassiker romantisch Odem -- 
  begierig -- Erde Tribut Tod zahlen -- 
  Natur sparsam Leute leicht scheinen -- Herz Kopf schaffen -- Goethe lang leben bekunden -- wichtig Menschheit La Fayette -- 
  letzterer platt praktisch Amerikanismus eigentlich Armut -- 
  sehen Kopf -- nüchtern -- prosaisch amerikanisch -- 
  Geist formlos gutmütig Gesicht -- Zug tatkräftig Verstand -- 
  Manier entzücken -- Feinheit französisch Stil -- liebenswürdig Artigkeit -- nehmen demokratisch Bonhomie -- amerikanisch Gleichstellung Niedrig -- Poesie Gleichheit neunziger nehmen Beisatz Künstlichkeit -- Geckenhaftigkeit -- namentlich alt Leute finden -- 
  La Faytte's Poesie -- abstrakt Begriff -- konventionell Form Blut warm Leben bringen -- abstrakt Lehre Freiheit Zivilisation -- Mensch -- 
  Julia lieben -- -- arm Vater hängend -- stehen -- wohlwollend alt Kämpe -- 
  Humanität überwältigen gestehen -- Revolution sauber -- ordnen sanft denken -- Koryphäen Lafitte La Fayette ausdrücken -- 
  Hippolyt stehen erzählt Freiheitskrieg Südamerika -- Zeitlang beigewohnen -- 
  Lafitt glich fein Hand Unebenheit -- Hyppolits Feuereifer diplomatisch Kreis wiederholt Male erzeugen -- 
  La Fayette lächelen breitschulterig Mann -- untergeschlagen arme stehen blitzend Auge stechend herumjagt Kreis -- werfen giftig polemisch Wort hinein -- 
  Hippolyt mehrere schnellblitzend donnernd Gewitterschlag -- 
  La Fayette besprach freundlich Wort Sturm -- 
  handeln zumeist spanisch Verhältnis -- Südamerika kommen -- 
  Hippolyt glühend Partei spanisch Kommunero -- breitschultrig Mann -- Casimir Perier -- greifen Corteschart heftigste nennen ausschweifende -- Hyppolit Zornader schwellen -- -- 
  Contretanz zusagen -- beginnen -- friedliebend Julia entführt Kampflustig -- 
  Perier ernst fast zürnend darein -- 
  Verstand denken durchwühlt Gesicht -- 
  Tanzsaal betrachtet Jugend Frankreich -- 
  Blick fallen Hippolyt Julia -- tanzen nachlässig -- Hippolyt sprechen eifrig -- erhitzen -- 
  treten nah hinzu -- Hand Krampfhaft festhielen -- 
  Tanz -- lassen begleiten Nebenzimmer -- vielmehr scheinen notgedrungen begleiten -- 
  unaussprechlich bittend Blick treffen -- folgen -- 
  Hippolyt eilt Beute Gast angefüllt Zimmer entlegeneren leeren -- 
  bemerken -- Rücken halten leer Gemach inne -- umfaßt Julie beschwören herzzerreißend Stimme -- innigst Wort -- Liebe ferner verschmähen -- sanft mild -- lieb Raserei -- -- -- 
  Julia weinen heftig -- Hippolyt lassen küßte feucht Auge -- schaueren -- streckt Arm -- taumelt weniger Schritt fallen ohnmächtig Arm -- -- 
  nähert Geräusch angrenzend Zimmer -- Hippolyt unbeschreiblich Blick -- greifen Julie -- Hinwegzutrag -- bitten herzlich -- -- eiligst Tür verriegeln -- -- -- -- hart -- Ohnmächtige nächster Gemach retten -- 
  Augenblick Tür -- Julien Vater treten -- -- 
  Julia Paris -- Hippolyt Wort sprechen verschwinden -- Hut Mantel Diener fischen -- 
  Julien Vater schicken -- 
  Leb -- kommen Deutschland -- Anstellung suchen -- 
  40. Kamilla Valerius -- 
  dummen Polen Revolution anfangen müssen -- Stadt warst -- gewiß fortgelassen -- neu Vorfälle fragen -- 
  wünsch lieb Leute -- glauben -- himmelschreiend -- wünsch Liebhaber -- 
  Nachricht -- -- 
  böse -- 
  Wetter rauh -- beinahe Haus -- Langeweile Sehnsucht größ Angst -- Angst -- 
  Höre -- 
  gestern Reisewag -- bringen lieb alt Freundin -- -- worüber freuen -- -- freuen -- -- 
  Denke -- ruhig Gespräch kommen -- Auge -- Zug Gesicht -- Blick -- Geist -- Wort wareu -- müßtest sprechen -- wärst Weib -- Rede- Tonfall -- Wesen -- Luftkreis Valerius -- Mann -- entsetzen -- Wärst verheiraten -- müssen Frau -- 
  teilen Freundin -- lächelen -- 
  erschrocken -- -- kennen -- 
  O bleiben -- kommen -- fürcht Unglück -- kommst -- 
  -- beglücken -- kommen -- kommen -- Glück sterben -- 
  Liebe erzähltest -- schmerzhaft erregen überaus selig Gedanke -- Arm legen seligweinend Gesicht eur gedrückt Schulter schmiegen -- 
  -- Liebe Besitz einzig Person -- Atmosphäre Raum -- 
  küßen -- schlimm -- schwer -- Herz sehen -- 
  glaubst -- offen Ehrlichkeit -- Kusse sagtest -- Herz jungfräulich -- Hättest Liebe gewähren genießen Liebtest Würdest lieben -- 
  klagen wein -- entführt -- leiben schön -- 
  bleibst ewig unwandelbar Stern -- ehrlich Palmerio -- 
  Komme -- kommen -- Licht Auge -- Gestalt sehen -- gleichgültigst Wort lieben -- lieb Stimme hören glücklich -- glücklich -- 
  Kommen -- -- 
  legen Brief Konstantin Fürstin -- gefährlich Frau -- 
  -- machen Sorge -- 
  Alberta still traurig -- -- sitzen fortwährend Fenster -- Reiter -- jubeln -- -- Wasser Auge -- 
  -- Bösewicht -- 
  Graf still sanft -- scheinen Kummer -- 
  Eile -- froh -- 41. Valerius Constantin -- 
  legen Williams Brief -- stehen -- wohin einseitig Fanatismus führen -- 
  Gedanke Freiheit fehlen -- Höh Tiefe -- schmal Weg -- jäh Abgrund -- Freiheit ebnen Welt wunderbar -- gefahrlos springen -- 
  irr Freiheit -- zurecht finden -- 
  absolutistisch religiös politisch Glaube kennen Irrtum -- kennen sünd Sünd gebiern Tod -- -- 
  William Opfer Absolutismus -- Leopold Spielball Gesetzlosigkeit - belgisch He Kompanie-Chirurg -- erfahren spielen abgerissen kümmerlich Rolle -- ungeheuren -- titanenartig Kraft erhalten Lebenswoge zügellos Hippolyt -- riesenhaft Geist lassen bestehen unbändigen -- Zivilisation überspringend Freiheit -- 
  scheinst tot halten -- gewiß -- Romancharakter leben Wildheit einst -- bestialisch Kraft Schranke Bildung brechen -- Anführer freiheitsbedürftig Volk -- 
  Subjektivität zertrümmeren -- ehe nützen -- 
  Stadium Danton gefährlichen fehlen -- auszeichnen -- 
  subjektiv Danton guillotiniert -- geläutert Objectvität einst Gironde lehren -- 
  einst hinreißend Vergniaud -- 
  merkwürdig Wendepunkt unser Leben eintreten -- 
  gehen Warschau -- heilig Volk Tyrann fechten -- 
  lieb polnisch Volk -- Sache bluten sterben -- 
  asiatisch Element Herrscher- Sklavenkaste -- ernstlich bekämpfen -- Zuwider -- 
  gewöhnlich Begriff Aristokratie -- meisthin Vorwurf -- demokratisch Aristokratie -- Stufe beachten Gleichheit einführen -- aristokratisch Demokratie sehen -- 
  ernstlich Annäherung allgemein demokratisch Zivilisation träge -- Absicht -- Chart 3. Mai entwerfen -- Selbständigkeit bisherig Unterjochungsperiode abrechnen -- 
  roh Asiatisch -- überwältigend Poesie Vaterlandsliebe -- Käthche Heilbronn Volke -- Zauberhaft -- Kampf rein edelster -- Gefocht -- 
  -- -- Folgendem -- 
  kehr Stadt -- finden weiblich Besuch Schloß -- tret Zimmer -- Hand Camilla's treten Clara entgegen -- 
  Freude -- Überraschung -- Schrecken -- Besorgnis pressen Name Clara -- sehen Blitzstrahl schlank Palm Kamilla zündend einschlagen -- 
  lieb Kind bleich -- Wasser schoß Auge -- lächelen Engel -- 
  Clara sanft leiben -- 
  Entschluß schnell fassen -- 
  kündigen morgend Abreise -- 
  gut Wesen leiben -- jeder beschäftigen -- -- 
  Augenblick Zufall -- auseinander sprengen -- Clara -- 
  -- -- schenken -- Valer -- -- 
  Rührung überwältigen -- weinend fallen Hals -- bedeckt Gesicht warm Hand -- küßte Auge sprechen -- 
  -- Junge -- -- sehen -- -- 
  untröstlich -- erführ Engel Poesie -- lieben küßen -- 
  -- Alberta zurückkommen -- eilt fort -- Kamilla suchen -- 
  Kind sanftlächelnd entgegen -- Hand fragen -- 
  -- -- -- 
  -- ist_es -- antworten erregen Fiber Seele liebenswürdigste Mädchen Herz drücken -- 
  halten Hand Mund -- 
  -- bitte -- bitte -- -- arm reich Mann -- -- 
  -- Reichtum lassen -- 
  -- -- -- -- -- 
  Laß Clara Liebe ahnen -- 
  -- bitten -- verstehen -- glücklich -- 
  ausgelassen lustig - Liebe -- reich -- ungeschickt Mensch dürftig -- egoistisch -- jämmerlich egoistisch -- 
  Kamilla -- bleiben -- 
  -- schlimm -- gehst -- Sehnsucht sterben -- -- 
  selig -- Seite Liebe hüllen verleben -- 
  Idee -- Kamilla Sprache bringen -- Lebensodem -- Clara neu -- alt -- Clara erwähnen -- Kamilla -- Alberta fliegen Schmetterling -- 
  Indien leben -- Herzblut austauschen -- 
  -- -- Abschied verbat sogleich -- sitzen tief Nacht beisammen -- gut Grafe küssen Vorsaal herzlich -- Reisegeld -- versprechen schreiben -- Kugel treffen -- -- 
  lieb Mann weinen segnet Vater -- -- 
  Pferd satteln lassen -- bringen lieb Zuhörerinn erhebend Gespräch weit reich Leben Tod -- Vorgeschmack -- Freiheit -- Opfer -- bringen müssen -- -- 
  erhoben Mensch tragen Leid -- Herz besitzen unglaublich Kraft -- wecken -- 
  glüht Begeisterung Edle Mädchen sein Mitgestorbe -- Tod bedurfen -- 
  hinaus -- setzen auf's Pferd -- riten Fenster rufen -- 
  öffnen hastig -- voll Licht stehen -- Herzen arm -- 
  Alberta müssen zufällig Zimmer verlassen -- 
  Mond scheinen tränenweich Gesicht -- 
  Ade -- Liebe -- sprechen -- freieren Welt -- 
  Fort riten -- -- lieben Mädchen Arm fallen -- 
  Taugt Dicht Tracht gesellschaftlich Welt -- russisch Kugel treffen -- 
  Ade Deutschland -- sehen -- 
  Kommst -- schreibst -- such Bekanntschaft Fürstin -- sagen -- Leben bleiben -- einst Antwort -- 
  wunderbar klug Brief William -- Hippolyt -- Leopold betreffend Verhältnis schreiben -- 
  gewöhnlich Maßstabe messen -- merkwürdig Weib -- allzuspitz Klugheit verderben -- 
  schreiben Breslau -- leben -- Reise -- 
  Halte Herz munt -- Freund -- laß vertrocknen -- 
  42. Oberst Kicki Grafen Topf -- 
  März 1831 -- 
  verlangen gemäß -- geehrt Herr -- Herr Valerius überall erkundigen lassen -- unvollständig traurig klingend Bericht mitteilen -- 
  umgebend Reiter Nachmittag ungefähr 2 Tapfer Grochow kämpfen sehen -- Kavallerieangriff Russe vermissen -- 
  wissen widerfahren -- freilich Wahrscheinlichste -- fallen -- tote -- Feind drang Stellung -- fast unmöglich -- Schicksal Einzeln ermitteln -- 
  Gestatte -- Herr Graf -- Versicherung vorzüglich Hochachtung -- Ehre etc. etc. -- 