jung Europa -- 
  Novelle Heinrich Laube -- 
  -- 
  Bürger -- 
  Mannheim -- 
  Verlag Heinrich Hoffe -- 
  1837 -- 
  Bürger -- 
  Novelle Heinrich Laube -- 
  Mannheim -- 
  Verlag Heinrich Hoffe -- 
  1837 -- 
  Bürger -- 1. Hippolyt Valerius -- 
  Pferd -- Pferd -- lassen Welt durchreien -- Erde rennen blitzgeschwind -- entgleiten -- 
  weißen -- -- Ver Luft hineinsingen -- 
  wissen -- herkommen -- 
  poetisch Geschick -- treten verborgenst Gedanke innere plötzlich sangbar Vers Lippe -- 
  Geheimnis Poesie Welt -- wissen Mensch -- sogenannter Wahrheit -- Gedamken Zufall göttlich Ordnung -- 
  schön -- frisch Sonnenmorg -- riten taublitzend Fläche -- Auge fernen -- dampfend Berg richtend -- 
  Kraft Jugend -- Frisch Morgen fühlen Reiz Dasein -- schworen lustig hinauf Himmel -- Welt Freude schaffen -- Tummelplatze kecken -- mutig Mensch -- beweisen fröhlich Wanderlebe lachend -- munter Tod -- 
  alt Europa -- morsch Hülle schütteln -- Verjünge helfen -- jung -- romantisch Narr -- 
  -- Freund -- leben -- Schmetterling schön Wort Puppe locken -- -- geschehen -- interessant -- sehen überall Jugend sprießen -- 
  Tausendfach irren -- leben -- -- empfinden Richtung Existenz -- Interesse -- Tod finden töten -- nächster Planet fortsetzen -- 
  übermütig Jugendplan -- Welt umgestalten -- aufgeben -- erschrock Mannigfaltigkeit Welt -- Unerschöpflichkeit Verhältnis Zustand -- 
  kleinmütig verzagen -- Freund -- -- 
  Pfui -- mutlos Brief -- Warschau schreiben -- 
  Kopf Höhe -- 
  finden nächster Schritt Absolut -- worin Schönheit Herrlichkeit zusammengedrängen -- Zauberwort -- Geheimnis lösen -- 
  begonnen Lauf -- -- laß brausen -- Freund -- laß brausen -- -- Weg -- Kind Weiber kehren -- Wetter losbrechen stürzen fallen -- 
  -- -- kommen revolutionären -- erwartet -- manchmal ansehen -- treiben Kobolde Spiel -- schlecht alt -- üppig Kaufmann Geldbeutel Hand widerwärtig alt adlig Stammbaum -- -- Freund -- -- 
  Gedanke -- Theorie behalten -- müssen Vernünftigkeit Erde -- Erde Grund -- 
  Gedanke Geist Gott -- 
  Sommer 30 -- Paris Leben schreiben -- 
  gestehen -- Freund -- deutsch Mädchen -- zauberisch Julia ursprünglich Kraft zerbroch -- erzählen -- 
  Weiber -- 
  gestehen -- alt somit unmächtig -- 
  Julia fabelhafen Vertrauen Kraft rauben -- Zauber Jugend erschüttern -- 
  Mädchen -- Widerstand -- 
  Nacht -- vergeblich aufgeboten -- erweich -- rannen toll Straße Paris -- stüirzen -- Glut kühlen -- Eitelkeit Zuversicht Herz treffen -- 
  kenn sentimental Liebesjammer -- deutsche ausführlich beschreiben -- woraus Art Poesie -- Wehmut Träne kommen Hilfe -- wild -- unbefriedigt Kraft brechen -- müssen vertoben -- 
  O grausam Wirtschaft -- 
  Ruhe wiederkommen -- umsehen -- graut Wesen Frankreich -- 
  Lüge Kampfplatz behaupten -- lauter Täuschunge lassen leichtsinnig -- töricht Volk herumschaukeln -- schneiden durch Herz -- Jubel ansehen -- Anblick Königs erheben -- 
  Bürgerkönig Ludwig Philipp groß Repräsentant jetzigen -- Gott geben -- -- 
  Held Durchgangsepoch -- Wind beflügeln -- Ruhm gewiß Größe versagen -- 
  alt Bourbonentum -- -- dran -- bezwungen -- Jakobiner unterwerfen -- Liberalismus bewältiget -- 
  Ludwig Vierzehnten Jahrhundert nennen -- Aristokratie stürzen Abgott Adel -- Demokratie unterdrücken Bürgerkönig -- 
  besitzen Eigenschaft -- Held neust Art nötig -- klug -- klug -- beinahe klug Talleyrand -- merken lassen -- klug -- 
  vermeiden ferner extrem -- setzen Krieg Frieden Karte -- öffentlich -- spielen privatim -- sicher Partie -- 
  Repräsentativsystem -- König hinderlich -- Klugheit bequem Regierungsart -- 
  öffentlich Partei Nachteil -- tragen Minister Schande Verlust -- Thron desavouieren -- zeigen bescheiden -- privatim vorteilhaft Ding vorbereiten -- siegen Ministerium -- schließen emphatisch Sieg -- zucken Achsel Privatpartei -- bedauern fremd gesandter -- Hand binden -- 
  Hälfte achtzehnt Jahrhundert regierter Abenteurer Art keck Lüge Jntriguen Europa -- Stelle berechnenden Person berechnet Begriff treten -- herrschen gewiß Staatsalgebra -- kurz Fortschritt -- erwarten -- Paar Formel ziehen -- studieren -- Wissenschaft fertig -- Ursprung Beikram Seite werfen -- 
  Adel stürzen -- Despotismus Reihe -- stürzen Jakobiner -- Jakobiner unterlag Soldat -- Soldat überwältigt Geld -- 
  Geld herrschen -- Bildung -- Herrschaft befestigen glauben -- stehen Solde Geld -- 
  Ludwig Philipp König Geld -- Börse bedeuten Frankreich Generalstaat -- 
  bleiben alt Poesie Herrschaft -- 
  Tapferkeit -- 
  gewiß Tapferkeit finden -- 
  Erfolg Sieg hoffen -- Ludwig Philipp Thron Leibe verteidigen -- Hinsicht Held -- 
  Tapferkeit poetisch Eigenschaft -- nennen -- Tapferkeit Kaufmann -- gut Warenball schlagen -- Kampf aufgeben -- bedenklich -- Vermögen retten -- 
  ritterlich Element Streit entdecken -- romantisch Fratz Schlachtruf -- -- Sieg Tod -- König -- -- -- -- -- Parole -- 
  Glaube -- törichterweise Ludwig Philipp anklagen Stellung -- 
  -- 
  Zustand Stellung angewiesen -- Richtung Partei nähmen -- hoch Potenz jetzig Klugheit bewundern -- 
  verarg Einzeln -- herrschen -- Trieb tief eingepflanzt enthalten Keim Fortschritts -- bekämpfen Einzeln -- Ludwig Philipp Demokrat -- bleiben übrig -- Hofmann Volks -- Kaufmann Nation -- Handelsmann repräsentativ- Regierung -- 
  Notwendigkeit Stellung liegen Kummer -- drücken -- 
  entsetzlich Prosa beugen Boden -- 
  Poesie Rittertum stürzen -- Poesie Liberalismus vorläufig bringen -- 
  -- -- Geldinteressen -- unterstützend -- herrschend Stelle einnehmen -- 
  Frankreich -- Flügelmann Europa -- Horoskop Europa's -- 
  sinken englisch Aristokratie Zahl britisch Kaufleute -- -- 
  eigentlich Geld wesentlich Moment englisch Lord -- 
  Besitz Losung -- Kultur -- gelten -- ebenfalls richten -- 
  Erfinde Poesie Besitzes -- breit Prosa -- 
  -- Vorwurf machsen völlig Stillschweigen lang -- -- 
  fing -- einherzutapp -- einherzuschreit Welt -- 
  Freund herumzerr trunken Bewegung -- 
  fest -- -- 
  Brief treffen -- öfter schreiben -- wissen -- Grünschloß schicken -- sicher Hand -- 
  Warschau -- 
  denken -- Warschau russisch -- ist_es -- Leopold -- seisen Brücke -- wissen wohin -- brutal Eitelkeit Person Starost -- gelingen -- gemeinschaftlich unternehmen -- 
  auseinander -- homerisch treiben einzelnkämpfen -- laut Niederlage modern -- Person gelten -- 
  hätten Leute -- tapfer gewaltig Achill Ajax -- schnell Diomed -- gewandt Ulysses -- Hälfe -- grau Heroen Troja erobern -- List Götter mußten_es -- 
  Griechen Troja wahrlich Ähnlichkeit polnisch Held -- Homer Wunsch zügelnd Alleinherrschaft erscheinen -- 
  Epos langweilig Beigeschmack -- dawider -- -- kurz -- wandelbar Interesse modern Dichtungsart verdrängen -- polnisch Krieg besungen -- Epos gut Form -- zugestehen -- 
  freilich anderer -- naiverer bisherig Stanzenepos -- 
  Poloniade lesen -- schreibst -- Langweilig -- 
  kommen -- 
  wissen -- 
  Polen leiden -- Fremde Stolz -- bedienter -- abstoßend Nationalität -- Krieg erwarten -- 
  weißen -- handeln Begriffen -- besonderer Vorliebe -- -- objektiv Freund -- 
  schreibst Goldrolle -- letzter kurz Brief Warschau schicken -- 
  Irrtum -- Billet -- 
  erzählen -- 
  verlassen Paris -- 
  Unger -- Schmerz schied Franzose -- 
  bleiben liebenswürdigste Volk Welt -- Irrtümer Täuschunge -- erleid -- keim Liebenswürdigkeit -- 
  gewiß Ritterlichkeit Mißgriffe erzeugen -- letzter -- 
  Held schlagen -- verziehen großmütig Held -- 
  modern Wirrwarr Berechnung Geld Lebhaftigkeit bunt interessant ausbilden -- Schimmer Poesie behalten -- 
  Freiheit entglitten -- Gleichheit Stürme retten -- reich Bankier ärm Journalist -- repräsentieren Monsieur -- gesellig Duldung allerlei Rückhaltsgedank -- Gesellschaft Deutschland finden -- -- Sache -- Absolutes -- 
  Mann gelten Mann -- Wort absoluten Wert beachten -- Rücksichte -- 
  Geld mächtig -- allmächtig -- 
  Keim allerlei -- lockende Zustand liegen überall -- nirgends Tod Erstarrung -- 
  Königreich betrachten -- diplomatisch Erwartung Niederlanden aufwachsen -- 
  wild Pflanze Belgien eigentümlich Reiz -- 
  Polen verzeihen ärgst Stabilitätsmänner schwach Stunde Revolution -- 
  Geschichte -- sagen -- national -- tief Element -- 
  Belgier -- Name unbekannt neu -- Name Ligurien -- Batavie dergleichen -- französisch Paroxysmus neunzig hervorwuchsen -- 
  klagen Volk Holland -- fahren fort -- Zeichen eigensinnig Übermut -- frevelhaftest Revolution -- dagewesen -- 
  interessieren -- 
  glauben mutwillig Freiheitssympathie finden -- 
  ordinär -- anständig Mädchen -- denken -- gut Ehe verweigern -- eigensinnig -- kapriziös -- wild Ding -- selbstständig Geschöpf Laun geltend -- 
  weißen -- Mädchen interessantesen -- 
  Natur -- üppig Natur -- Ursprüngliches -- kalt Produkt beschränkt Erziehung -- 
  riten Spätherbst nördlich Fläche Frankreich -- hinab Meeresniederung -- hell Mittage breit -- glänzend Straße Brüssel -- 
  vornehm -- blendend Stadt -- 
  betrachten lächelnd Kanonenkugel -- dicht Schar Haus kuckt -- unwillig Zeuge lärmend Septembertag -- entschlossen Holländer -- schimmernd Stadt Preis erobern -- 
  bringen Pferd -- eilt Park -- 
  mal -- Kämpfen Freiheit grollt -- schön -- stattlich Baum -- majestätisch Schatten ausbreiten -- zerstören -- verstümmeln -- 
  stolz -- ausgebildet Baum fertig abgerundet Mensch -- Verstümmelung erinnern Barbarei -- 
  schön -- spät Jahreszeit gegenden bringen -- Park erfüllen Spazierende Fuß -- Roß Wagen -- 
  gewiss Freiheitsübermut liegen Gesicht -- 
  gelungen Revolution stolzer gewonnen Schlacht -- glauben Schulmeister überwinden -- dünken bekanntlich gelehrt Gewaltiger -- 
  Menschenschlag Belgien scheinen abgesondert voll Eigentümlichkeit -- glauben Menge historisch Schattierung herauszublicken -- spanisch -- verschlossen Feuer Zeit Philipp -- französisch Lebhaftigkeit -- nördlich behaglich -- saftig Fleisch -- gemischt Charakterlosigkeit dergleichen Anblick zusammenfaseln -- 
  jung Mann -- Dame hertänzelt -- einrechnen -- nah heranschreten -- desto beschäftigter -- beweglich französisch Gesicht schwarz kraus Haar -- weiß Hut hervorquollen -- schwarz -- unruhig Auge -- denken -- Klassifikatione lachen müssen -- Männche unser Leopold erkennen -- 
  schnell fertig -- sehen -- Hals fliegen -- tausend Frage ausstoßen -- Dame vorstellen -- Werk Minute -- 
  Dame Frau Tochter reichen -- vornehmen Advokat Welle -- 
  Familie angeseh rühmt spanisch Grande vermischen -- 
  Leopold schnell Gewandtheit alt spanisch Name vorstellen -- beinahe vergessen -- 
  Junge denken -- klangvoll Name gefährlich können -- 
  empfehlen vortrefflich Familie -- hochangesehen Hausfreund -- 
  Frau van Welle dreißig alt strotzend flamändisch Schönheit hoch -- voll Wuch -- feurig Auge -- schweigsamen dennoch innerlich lebhaft Temperament -- 
  -- üppig Form Ruben -- Frau Promenade -- Haus Bett -- Advokat wünschen -- 
  Stolz -- eitel Tochter wunderlich Verlegenheit -- nahenden Liebhaber Tochter wünschen -- 
  Herr van Welle lang -- trocken Gesell buschig Backenbarte -- einzig Schönheit -- 
  neu Element -- Eintritt Haus bewegen -- 
  Denke Wohnung -- äußerlich unscheinbar -- verschließen aussehen -- Jalousie verstecken -- stehst van Wählens Haus -- 
  Blank schimmernd Klöpfel hängen dunklen -- hellackiren breit Haustür -- 
  klopfen -- Tür öffnen Druck -- fern Bedientenzimmer ausgehen -- treten weit Hausflur -- ringsum -- Treppe -- Tür -- Diele glänzt Glätt Sauberkeit -- 
  Besucher -- Lokalität -- -- wissen -- Treppe Vorderhaus Jahr -- Fest betreten -- führ Prachtzimmer -- Geschichte Familie entfalen -- Kunstarbeit -- forterben -- Schlösser deutsch Ritterfamilie -- 
  Blick breit viereckig Hof -- 
  Quader pflastern -- offen Saal -- Markusplatz -- Seite flügeln Haupgebäud -- hinten eigentlich Wohngebäude begrenzen -- 
  Glastür bunt Glase führen letzterer -- unmittelbar Salon -- Familie gewöhnlich aufhalten -- 
  patriarchalisch Stille ringsum ausgegossen -- tief Familienfried scheinen lagern -- stürmisch Jugendgedanke kommen frivol -- Mal Raum treten -- 
  Salon sitzen Frau Haus Tochter -- 
  weiblich Arbeit beschäftigen sprechen selten -- 
  Aussicht Garten -- Frühlinge berühmt Tulp Niederlande blühen -- 
  Möbel Salon modern -- massiv kostbar -- dunkel -- samten Tapete bedecken Wand -- schwer rotseiden Gardin golden Troddel beschatt Fenster -- prächtig -- gediegen -- atmen vornehm schweigen Ruhe -- 
  Mutter empfangen Besuch zurückhaltend -- würdevoll Artigkeit -- Tochter erröten -- Haut fein durchsichtig -- Blut gering Bewegung sichtbar -- 
  fünfzehn alt Mutter -- 
  Form schön ausgebildet -- unterbrechen - 2. Hippolyt Valerius -- 
  schreiben sagen -- einzig Wort Weisheit Mensch -- wissen Himmel -- 
  -- zweifeln anfangen -- bezweifeln -- 
  weißen -- Sache -- skeptisch -- solch Stunde -- Welt fraglich -- 
  Gott -- Satz -- Wahrheit Welt -- Gegenteil plausibel -- 
  schrecklich Triumph Bildung -- deutlich hervortritt -- Volk Vollendung erreichen glauben -- begreiflich -- Welt Geist -- 
  letzter Wort Probe traurig Exempel -- Paar schreiben -- Gedanke Geist Gott -- Ding Logik -- -- Sklave -- Sklave -- unsichtbar Kette -- Tobe Wüte vergeblich -- 
  Erinnerst Sophisten Griechenland -- Schulweisheit vornehm wegwerfend ansehen pflegen -- 
  Leute entsetzlich historisch Moment -- 
  Gründer eigentlich Bildung -- wandt Philosophie -- emanzipiert denken täglich Gebrauch -- Grenzstein Griechenland -- 
  unhistorisch Plumpheit nachsagen -- Sophist Griechenland Untergang herbeigeführen -- 
  produzieren sowohl -- Produkt -- 
  Kreis Griechenland lebendig Entwicklung vollenden -- fröhlich Jugendjahr -- Jahreszeit Weltgeschichte warten Wunsch -- 
  -- Freund -- manchmal bedünken -- Welt Punkt -- 
  Altertum schließen -- Mittelalter -- äußerlich Kaiser Max -- Berliching Sickinge sterben -- 
  Weltperiode sterben Jahrhundert -- 
  Christentum -- Fahne mittleren -- -- Weisheit alte -- Lebensgefahr -- göttlich Element Humanitäit allgemein Kultur aufnehmen -- Griechenland Denkgesetz -- beginnen unzuberechnend Gestaltung -- stehen mitten Wirrwarr -- unser Hand entschlüpfen Urteil Ding Gedanke -- 
  traurig Satze -- 
  sagen schreibem -- einzig Wort Weisheit Mensch -- wissen Himmel -- 
  anstecken -- Freund -- dein Warschauer Brief -- 
  denkend Mensch -- Parteiunge lebhaft Anteil nehmen -- lesen denken Faust -- 
  Gott Damk -- tun selten -- hart Stoff -- 
  Rasches wirken beschleunigen Zustand -- umsichren -- desto kräftig Besonderer -- Nächst wirken -- unschlüssig stehen bleiben -- begegnen -- 
  nächster -- klar ausgesprochen Ziel Mensch Freiheit -- schaffen herbei -- sehen -- entstehen -- -- Schlag Welt Trümmer -- entstehen -- -- Leopold war_es -- Beschreibung Margarethen -- van Wählen schön Tochter -- stören -- 
  Ermesse -- gewöhnlich Manier schön Weiber leben -- alt sagen -- bezaubernd -- jung -- Engel Leben -- Herz Hand bitten -- 
  Geschwindigkeit Prinzessin heiraen -- hübsch Mädchen -- 
  Absicht ungeschickt Roué -- schützend Ägid baldigen Hochzeit dreist Liebeswünschen folgen glauben -- Gott bewahren -- Leopolds schnell erregt -- überwallend Herz -- augenblicklich -- vollkommen Ernst -- Wunder -- nirgends schön schnell Wort nehmen -- 
  nächster Güte Herzens -- nächster vierzehn heiraten -- 
  neuerdings Junge leiben gewinnen -- erinnerst -- Zeitlang leichtsinnig Faselei -- immerwährend Lüge völlig zuwider -- 
  eigentlich -- platn -- berechnenden Leichtsinn Art Poesie -- jung bewegen fortwährend Welt herum -- leben König Arthurs -- Begebenheite täglich Verkehr Mund gewöhnlich Begriff Lüge -- Unwahrheite -- romantisch -- beleben tot Einerlei unser gesellig Treiben -- 
  tun solch verschollen ritterlich Interesse manchmal Not -- froh -- Leopold Täuschunge hingeben -- 
  -- -- springen Zimmer -- schreiben -- Hippolyt -- schreien -- spanisch Blut -- Enkel Cid -- romantisch Geschäft -- siegen Kaufleute alt herrlich Welt bunt -- unerwartet wechselnd Erscheinung -- 
  Hippolyt -- Liebe lassen Romantik untergehen -- 
  Tallon Margarethe entführen -- Hahn Aeskulap -- Zauberer Merlin -- Scherz -- Posse -- kommen -- sollst selber hören -- 
  weißen -- einladen -- übermorgen früh Wählen Felde Waterloo begleiten -- Tallon Partie -- Vorwerk -- belle Alliance warten Wagen Napoleon Rappe -- Brüssel Krönung führen -- Herr Tallon schön Margarethe Valencienn Hochzeit bringen -- 
  Lache -- setzen Hut -- Folge -- sollst selber hören -- 
  brauchen Paar Wort abg brochn Schilderung zuzusetzen -- Sache übersiehsen -- 
  Leopold -- liebenswürdig Begriff Liebe -- fügen rührendst Gutmütigkeit Stellung -- -- Margarethe verdrängen -- 
  zart -- unermüdlich Zudringlichkeit Mädchen erwünschen -- unangehmen Bewerbung Herr Tallon Weg treten -- Margaretha leiden -- 
  zudem mißfallen Schelm niemals Weibe -- 
  Tallon rätselhafen Erscheinung -- Revolution Belgien selten -- 
  wissen genau -- hergekommen -- wissen genau -- -- zeigen überall entschlossen Revolutionär -- furchtlos gewagtest Schritt raten gefährlichst Gelegenheit vorangehen -- 
  außerordentlich Bildung Geschmeidigkeit -- Mann dreißig -- ausdrucksvoll Gesicht stechend schwarz Auge -- 
  -- -- Vorfall Revolution tapfer unerschrocken beweisen -- spielen Rolle glänzend Ehrenbürger Staat -- Lebensart Gewohnheit bezeichnen reich Mann -- 
  Mann Wählen Haus willkommen -- 
  Herr van Welle gehören Advokat abstrakt liberal Partei -- Ziel Republik -- 
  Anführer Richtung de Potter -- 
  Leute Protestant Aera -- bar -- kühl Rechtsverstand Panier -- Prosa Gebieterin -- 
  Herr van Welle Tallon vollkommen de Akkord -- Salon nieder -- Europa regieren einrichten -- 
  schnell Seitenblick -- Tallon Frau van Welle werfen -- stolz Lächel beantworten -- unterrichten aufmerksam Zuschauer -- Tallon's Glaubensbekenntnis mager Idee erschöpfen -- 
  Frau van Welle katholisch -- ultramontan katholisch -- gehören fanatisch Glaubenspartei -- protestantisch Republikaner Sturz holländisch Herrschaft verbinden -- 
  Held Erzbischof Mecheln -- 
  still Stunde Herr Tallon katholisch revolutionär -- Revolution Geschäft rührig Leute Tallon -- 
  Margarethe lieben orangengelben Westen -- Politik fragen -- selbstständig Reich Belgien -- lächelnd meinen -- Prinz Oranien sitz Pferd -- alt Bekanntschaft zerrissen -- Thron Brüssel setzen -- Hof notwendig -- Brüssel Brüssel -- Kaufleute klagen Abend Theestund -- 
  Margarethe lächeln Herr Tallon -- 
  Trügt -- Bursch Italiener -- obwohl Franzose ausgeben -- 
  Italiener Agent Weltgeschichte -- -- Einzeln -- Cäsar -- Papismus -- Machiavelli -- Bild -- Oper -- Napoleon -- stammen Dorther -- 
  Familie siehst groß Belgien -- Tallon Revolutionär Profession Neigung -- Nous verron -- 
  -- heiratsbewerbungen Mädchen scheitern -- revolutionär Interesse Belgien nehmen -- Tallon ohnehin Lust -- Land verlassen -- tief Leidenschaft liegen offenbar schwarz Auge -- Leopold Geschichte Entführung unmöglich -- folgen -- 
  Halt -- sprechen unterwegs -- treten Laden -- Kauf Bluse -- echt belgisch aussehen -- erfahren -- 
  Wille -- werfen blau Hemd -- führen Menge Straße Wirtshaus -- 
  hören Weitem Lärm Zecher -- 
  Hotel heißen Revolution -- gut König Wilhelm -- -- Journal Mode -- gut König Wilhelm Guillaume le Bourreau nennen -- ändern Wirt Hotel ebenfalls Devise -- 
  Schild ändern -- neu lassen -- kostspielig -- streichen Auktorität journal Wort König -- setzen beliebt geworden Stelle -- 
  siehst wunderlich Überschrift Gasthof -- gut Henker Wilhelm -- -- 
  Bild Künstler vornherein vortrefflich geraten -- mindest Abänderung bedurfen -- treten Herein -- Findest echtesten Wollene -- Flammländ Brabancon -- sollst Leben fluchen gehören -- 
  wundern -- Leopold Detail- Lokalkenntnisse kommen -- 
  Beweglichkeit überall herumschnüffeln -- weißen ohnehin -- Revolutionskampfe Arzt figuriern -- Gasthof Hauptdepot -- 
  treten niedrig Schenkstube -- setzen dunkelst Winkel -- 
  Wirt -- Wange Backenbart Fett Wohlsein glänzen -- fragen unser Begehr -- -- sieh -- Herr Doktor -- sprechen -- Samtkäppche greifend -- Leopold -- schön -- langweilig Friedenszeit Haus verschmähen -- -- Herr Doktor echt Volksfreund -- tun apart -- gemein -- Unterschied -- -- Herr Doktor -- 
  Unterschied -- entgegnen Leopold -- setzen -- Herr Motte -- helfen Flasche fein rot ausstechen -- erzählen Krieg Frieden -- teuer Metze Hafer -- Hehe -- alt Spaßvogel -- munter Septembertag -- he -- Charles -- rot hinten Ecke Keller -- -- 
  Hole Teufel Holländer -- Herr -- glauben -- Herr Doktor Wallon lachen bringen -- braun Arm Leib schneiden -- drüben Park arm Junge zerschossen -- Doktor -- -- Permiß -- freundschaftlich ausdrücken -- Spaß Hand -- rot -- Wirt einschenken -- Leopold sonnverbrannt Gesicht aufmerksam -- nächster Tisch sitzen -- 
  Tallon Spitzbub -- horch -- beschäftig Wirt -- flüstern -- 
  Bursch sitzen schweigend Schnappsgläser blies Rauchwolke Thonstummeln -- Mund halten -- 
  -- Terrain rekognoszieren -- Tabakswolke gestatteten -- 
  Belgien rauchen allgemein Frankreich -- 
  Tisch besetzen -- Bluse machen Gestalt einförmig -- Durcheinander Dialekten verwirrt Seite -- klar gesondert Vorstellung -- 
  schwarz Krauskopf -- eintreten -- erregen allgemein Aufmerksamkeit -- rufen trank -- bon Jour -- Jacques -- 
  bon Jour -- Jacques -- scholl Seite -- allgemein werdend Gespräch rauh -- hart klingend Provinzialfranzösisch -- 
  neu angekommen Jacques sprechen geläufig -- 
  -- Franzose leben -- -- rufen Blusenmann -- 
  -- Franzose leben -- -- setzen anderer hinzu -- -- Belgien Belgien lassen -- -- 
  Jacques werfen unwillig Blick -- -- Franzose großmütig -- 
  Land Bidassoa Rhein -- brauchen Franzose -- 
  -- leiben -- Jacques -- -- erwidern Opponent lachend -- 
  mißtrauisch Volk -- sprechen Jacques -- Volk -- Hallo -- schreien Mund Stube -- aufgesprungen -- Bluse Waffe hervorblitzen -- -- unverschämt Franzose -- -- brummt Wirt -- 
  Jacques schlagen Gelächter -- greifen Glase -- Drohung -- Seite fliegen -- kümmern -- rufen -- Messieurs -- leben nördlich Italiener -- 
  Brummend setzen -- -- nördlich Spanier -- -- sprechen Opponent -- -- Juan Meravilla heißen -- - heilig Mutter Gott -- rufen -- klingen spanisch -- -- heilig Mutter Gott Belgien -- -- erinnern groß sonnverbrannt Bursch -- Jacques setzen -- -- helfen -- Höre -- Highman -- dergleich Anzüglichkeit katholisch Religion verbitten -- Spanier -- -- -- spanisch Schafskopf -- bleiben dumm Zeug Haus -- euer Mutter Gott kümmern heutig Tag vernünftig Mensch -- Eurer Pfaffe Wille Blut abzapfen lassen September -- -- drohend murren erheben mehrere Ort -- -- Highman Mensch Gewissen -- -- murmelt Herr Motte -- Wirt -- -- Wohlsein -- Herr Doktor -- -- setzen hinzu leern schlürfend voll Glas -- 
  sehen Vetter Mott -- rufen Highmans -- wissen heilige behandeln -- trinken Glas Rotwein -- -- Wirt Henker -- gut Religion -- 
  -- gottlos Mensch -- -- brummt Motte -- -- englisch Matrose verkehren -- verlernen Bete Singe -- -- 
  trinken lernen -- Mott Henker -- Religion -- aufgeklärt Geist -- drüben Luxembourg nennen Saufen -- schön Wort -- lustig Alt-England -- -- Teufel holer Alt Neu-England -- rufen spanisch Belgier -- -- Waterloo Holländer bringen -- -- -- stockblind Spanier -- -- unterbrach Highman -- weißen -- Waterloo -- 
  denken -- Frage wörtlich meinen können -- schweigen -- 
  verwandte Auge Ohr Highmens -- Entging -- leise -- Jacques wendend -- Frage wiederholen -- draußen -- setzen hinzu -- -- übermorgen Geschäft -- -- sogenannter Meravlla aufstanden -- dicht herangetret -- Nähme Nähe Aufmerksamkeit besonderer Anspruch -- 
  Holla -- schreien plötzlich -- Orangemann -- 
  Wort fahren -- stürzen hinzu -- -- 
  -- 
  nieder Orangist -- 
  -- Highmans achten -- inne -- gelten -- spanisch Belgier Hand ausstrecken -- 
  werfen Unsanft -- fragen -- Narr einfielen -- 
  -- -- nieder -- Belgier -- -- rufen zornig -- halten Entfernung -- -- Bluse schwarz Halsbind tragen Orangeschleife -- -- 
  wild Geschrei erheben -- Haufen drängen -- 
  erinnern -- Margarethe vorher Scherz Schleife Halstuch stecken -- schnell Ankleid -- Leopold drängen -- verräterisch Parteizeiche vergessen -- 
  Herr Motte -- Wirt erheben ebenfalls feist Leib Stuhle -- unverkennbar Angst Falt Bluse hinein -- glücklich September -- -- murmelt -- Orangeband -- 
  Herr Doktor -- Gesellschaft patriotisch renommiert Gasthof -- -- Wirf Lappe weg -- flüstern Leopold -- stören Herr Mott Rede -- 
  haufen stürzen gelb Band -- 
  weißen indessen -- Träger zufällig Paar gesund Fäuste besitzen -- werfen nächster Stürmer Boden -- bewaffnet halbleer Weinflasch -- 
  augenblicklich Pause treten -- Wort folgendermaßen -- 
  Herr Belgi Spanier -- nennen -- Orangist -- verhaßt Schleife zufällig schön Dame Halstuch befestigen -- sonstig Bedeutung -- stehen Augenblick -- entfernen -- drohend Stellung werfen -- zwingen -- 
  Haus Oranien gleichgültig -- zwingen lassen gleichgültigst Handlung -- 
  setzen ruhig Platz -- Wunsch willfahren -- -- nähern -- Schlag Hirnschädel -- 
  Herr Motte -- bedeutungsvoll Seitenblick entfernen -- Herr Juan Mehrvilla fluchte heilige -- setzen -- Verwunderung tun Übrig Gleich -- 
  Jacques -- Highman Nachbar merkwürdigerweise Anteil Vorfalle nehmen -- Leisem -- eifrig Gespräch begreifen -- 
  ratsam -- lang weilen horchen -- bezahlt Zeche Charles gehen -- 
  Herr Motte stehen Hausflur scheinen warten -- 
  schlau Miene schüttelt Wort heraus -- ungefähr andeut -- kenn Lauf Welt -- Gastwirt unparteiisch Punkt -- -- Schilde -- -- setzen hinzu -- erkundig -- Änderung erwarten -- 
  sehen -- Henker draußen hingeschrieben -- Highman Spanier -- Kopfe nehmen -- Augenblick wissen -- -- 
  wissen -- vornehm Herr Prinz Oranie -- Gott schützen mögen -- Geld Seele -- können euer Herrlichkeit armen betriebsam Bürger Wink geben -- -- Mittag Punkt zwölf -- Herr Motte -- -- -- Leopold fortziehend -- 
  Herr Motte stehen abgezogen käppchen Henkerschilde -- fort -- 
  europäisch Politik schwer beunruhigen -- 
  eigentlich erfahren -- Highman' Frage -- Waterloo -- Leopold Aussage Beziehung stehen scheinen -- 
  Theezeit Wählen Haus -- 
  Herr Tallon zuvorgekommen -- Gespräch wendeen Seite Partie Waterloo -- veranstalten -- 
  politisch Beziehung lassen warten -- Herr van Welle sprechen König Pharamund -- Gründer salisch Gesetz -- stolz -- gewaltig Chlodowigs Chlotar -- Belgien sitzen -- 
  -- sprechen Emphase -- Frankreich erobern -- Belgien Ursitz Merowinger -- heutig Tags Mittel -- Grenz- Sammelpunkt romanisch germanisch Volk -- 
  still Frau Fräulein van Welle eingeschoben -- lassen politisierend Herr Zimmer auf abgehen -- glänzend dunkelblau Auge Margarethen -- weiß schön Hand Mutter -- 
  Wunder -- Malerschule ausbilden -- 
  finden anderswo lockenderer -- schönerer Fleisch -- lebhaft Inkarnation -- Fleisch -- Geheimnis -- schaffen Form -- sänftigen heben Gedanke -- spiegeln Blut Leben Mensch - asketisch Leute plastisch Kunst verdammen -- konsequent -- 
  Schönheit Laokoon beruhen Gesetz Schönheit marmorn Venus -- 
  Gott schön Leib schaffen -- sehen -- 
  protestantisch christlich Gesittung Ähnliches Pensionsschulmeisterei -- Kind frisch Luft gestatten -- kümmerlich Leben nötig -- 
  worin liegen -- alt Frauenzimmer Reiz jung Mann -- 
  Tatsache abzuleugnen -- jung Bursch zumeist Frau 30 verlieben -- 
  behilflich entgegenkommen -- blöden Mädchen -- lösen Rätsel keineswegs -- 
  Mysterium reife verbergen liegen -- 
  gehören eigentlich jung Bursch -- Interesse schön Frau van Welle erwehren -- obwohl Margarethe schön liebenswürdig finden -- 
  wunderlich Verhältnis Bewerbung lähmen -- zweifellos Einheit Ganzheit früh Wunsch lähmen -- war_es -- Kraft Zuversicht Gelingen einflößen -- 
  verlieren Charakter Zustande -- Heil -- beruhen Gleichartigen unser Charakter fließend Handlung Folge -- 
  geläutert stimmen fühlen -- siegen Margarethen poetisch Jugendwesen völlig -- 
  Abend -- 
  Bild -- Beschreibung stören -- 
  Schlank -- gewöhnlich zusammengedrückt Figur Interesse erregen -- Wuch Freiheit -- Idee Körper -- Leib schön Säule -- weichen -- rund Begrenzung ringsum aufwärts Luft Himmel streben -- 
  Form Margarethen -- Schulter -- Hüft -- außen streben -- fein -- jugendlich -- sagen unschuldig runden -- Spur sehen -- einst überreif -- stark -- überfüllt aussehen -- Weiber üppig Vegetation eintreten -- Mädchen lockend Höhenduft Lebensmorgen ausgegossen -- fern -- ersehnt Berg liegen sehen -- süß Kind wohltuend Sehnsucht erblicken -- Sehnsucht wunderlich Gemisch -- eigentlich fremd -- 
  keusch -- unschuldsvoll Element -- deutsch Mund führen -- gewiß echt germanisch -- -- innig -- tief Liebesgedank gestorben Engel Desdemona regen -- Margaretha dunkelblauen Auge vertrauensvoll anblicken -- 
  Teil Anfang -- unwiderstehlich -- Wahl überlassen -- psychisch Mysterium Liebe fehlen -- 
  beglückend Wohlbehag -- Seite Mädchen empfinden -- Stunde hingeben -- sehen -- Kind Flügel wachsen -- blau Auge glänzend -- Wort Wesen kühn -- bemerk Wetterleucht unser Horizont -- glauben manchmal -- Gewitter -- Blitzstrahl -- entrinnen -- fahren Hernieder -- 
  deutsch Gewohnheit annehmen -- unbestimmten Dämmerzustand lieben -- Wesen stimmen -- Mittelzustand überspringen -- 
  niedrig Lehnstühle veraltet Form -- Salon benutzen -- 
  sitzen deutsch behaglich rothsammtn Polstern -- sitzen wohlig Glückspilz Thetische Frau -- lassen Leopold Mutter unterhalten erzählt Tochter Märchen Geschichte -- 
  stark kräftig fühlen -- wild katalonisch -- manchmal nanntest -- Herrgott herausfordern -- Erde Hand legen -- geben dunkel -- farbig Teint Weibe Vorzug -- erscheinen nördlich-europäisch weiße schwächlich krankhaft -- bild -- solch weiß -- blass Geschöpf Gegendruck -- Widerstand Kraft -- müssen zerbrech arme -- 
  braun -- weltstürmend Kraft Julien Widerstand brechen -- wissen -- alt Fülle -- elegisch weiß Teint mächtig schwach Hippolyt -- 
  Margarethen Haupt durchsichtig heiter Abendhimmel -- sehen klein Gedanke Ader hüpfen -- klar griechisch Antlitz liegen aufgeschlagen Buch -- 
  Haar -- -- einfach -- platt Wort hinschreiben -- erschricksen Illusion zerstören -- Leute eingebilden -- rot Haar allemal garstig -- 
  gut Leute -- 
  Brandrot -- schattenloser Haar widerwärtig -- veröden Gesicht -- 
  Margarethen Locke -- dicht -- glänzend Locke -- Gold- Kastanienbraun schimmernd mischen -- Schöneres sehen glauben -- 
  farblos -- matt Blond tief Goldfarbe völlig vernichten -- schattig Kastanienrot -- dunkel Augenbraue heben weiße Antlitz überaus -- 
  bleiben merkwürdig Spiel Natur -- Temdrei Kategorie -- 
  Rußland Gewicht spezifisch schwere -- rein politisch -- Italien französisch -- Forderung Kultur anschließen -- sogar Reich Kunst Museum -- 
  deutsch französisch Maler -- deutsch französisch Musiker mitunter groß italienischen -- 
  glaubst -- all Redensart -- selber machen -- machen -- 
  Wahrhaftig -- aufrichtig Maß schwer -- sprechen gelernt -- gebildet Mensch -- anderes -- selber -- 
  eigentlich leben tief bestialisch Drang -- entsetzen -- fänd rücksichtslos Wort -- 
  herrschen -- despotisch herrschen -- -- verarg Staat -- Herr -- abstrakt Forderung kleinsn Zipfel hingeben -- -- Kraft -- Gewalt -- erfinden Tausenderlei -- ewig hinaus -- fühlen Drang -- befriedigen -- 
  Gesetz -- Regel -- 
  Weg treten -- Weg stoß Seite -- 
  rein Zufall -- demokratisch-revolutionaire geraten -- bestehen fronde -- halten aristokratisch Aufstande -- Louis quatorz -- Stuart -- treiben sanft -- heftig -- 
  tüchtig Revolutionär persönlich Drange stacheln -- schwach furchtsam bedeck Drang Prinzip Grundsatz -- entstehen bloß Partei -- wirklich -- ursprünglich Revolutionär Held bemächtigen -- Trieb kräftig genügen -- 
  Prinzip Waffe -- Furchtsame Dogma -- meister Leute selber fürchten -- 
  lüge lüge -- Räsonnement ergehen -- eigentlich Seele fremd -- Grund suchen -- Poesie -- heischen sicherlich -- Übrige Kleidung -- woran gewöhnen -- 
  schwatzen Revolution -- Ludwig Philipp -- Belgien -- deutsch Bürgersleut Wetter schwatzen -- gestrig Bostonpartie -- Kuppelei jung Leute -- zufällig Verfänglich -- Revolution -- können Staat Gutem eingesperren -- -- Politik indifferenen -- all Zeug interessieren -- sprech treiben -- nirgends Zugang finden -- selbsteig Welt Genug erschütternd anzufassen -- 
  wissen -- 
  Prinzipienmenschen bilden karren -- Leute Schlag genießen -- herrschen -- leben -- Kugel treffen -- 
  -- Frau van Welle -- leise -- kümmern Politik -- Schönheit -- Herzen Kummer Leben bereiten -- 
  unmächtig -- fragen Partei -- eher -- Mittelmäßigkeit assoziieren -- Prosa -- bleiben -- 
  -- 
  -- Hole Theater -- letzter Akt Stück lieben -- -- 
  prächtig Anblick -- hoch -- voll Frau schwer seiden Gewänder -- schweigend ruhen Schönheit Antlitzes tief See -- Grund bewegtest Geheimnis Leidenschaft schlafen -- zuweilen treten solch leis Druck unbekannt Tiefe schwarz Auge schön Frau van Welle -- 
  abholen -- 
  zeitig Theater -- sitzen voll Putz -- Soirée fahren -- Abend besuchen wollen -- vornehm irisch Familie -- Tags Brüssel verlassen -- empfang letzter Mal -- 
  interessant Katholik -- Mann kennen goutiert -- Lust -- vorstellen -- spanisch Kind willkommen heißen -- Leute halten Paar Monat -- zubringen -- offen Haus -- 
  Frau glich schön Rubenssch Bild spanisch Königin -- mal -- prächtig Nacke Schulterbau feist fleischig -- Rubens -- gesund kräftig weiß Teint Frau schön -- 
  krankhaft weiße -- bleich nennen -- 
  üppig -- warm kräftig Atmosphäre Weibe -- 
  drängen Abfahrt -- 
  vortrefflich Bedienten -- Italiener geboren Bedient Kuppler -- 
  Wort -- Wagen heben -- lassen krumm Straße Brüssel fahren -- finden -- ehe Hotel Irländer kommen -- 
  Frau van Welle stürmisch Umarmung stürmisch -- heiß fest entgegen -- weisen indessen wildest drängen fern entscheiden -- verheißen -- einsamsen Rendezvous Zimmer Haus öffnen -- 
  interessiert Irländ katholisch Belgier -- Revolutionsspielerei einleiten -- 
  Erwählt auffallend schön -- drängen drängen -- Wagen lockenden Leib küssen -- 
  mager Brüsselerin -- Spitze Reiz tragen -- tippen Dame Nacken -- belehren lächelnd -- Schultereinfassung hinten zerrissen -- Kammerjungfer müssen leidenschaftlich -- 
  -- Werteste -- -- erwidern lächelnd Dame -- gehen -- Zuschnitte Gesellschaft ungewöhnlich früh -- Blut heiß Giacomo kennen Brüssel -- gut Stunde Wählen Haus ankamen -- 
  -- verstehsen -- Leopold's Rechnung -- übermorgen -- Waterloo fahren -- liegen Nacht - Adieu -- Schlaf suchen -- 
  schreiben mehreren -- Ostende -- angesichts Meeres -- 
  Höre -- begeben -- 
  -- -- wählens -- finden schön Frau Hause Salon -- sonnig Herbstnachmittag -- Margarita Garten -- Herr van Welle Kaffeehause -- 
  winken beredsam Auge -- steigen Treppe hinauf -- gehen prächtig Gemächer Vorderhaus -- rastet schön Eckzimmer -- 
  -- üppig Gemälde flamändisch Schule lachen silberweiß tapeziert Wand -- Sonnenschein blitzen einzeln Ritze geschlossen grün Jalousium -- 
  zeigen unbemerkbar Tapetentür -- Korridor Nebenhauses führen -- nötig Instruktion -- verheißen abend Schlüssel -- unbewohnt Nebenhaus Tür Korridor öffnen -- 
  einst Burgherrn Schloß -- lebelustig Weiber verborgen Gang Tür -- 
  offenherzig reizend Innigkeit -- vertrauen -- Tallon umsonst lebhaft Gunst streben -- domestiken bestochen -- verführen -- Ärgste treiben -- 
  -- fühlen sicher -- abscheulich Jakobiner Näheres ahne geheim Zugang Gemächer -- 
  Bewerbung Gehör erreichen -- gemein Mensch Margarit wenden -- Greuel -- Frau van Welle -- Innerst empört -- Mensch längst Haus jagen -- Nähme Mann jammervollen Politik fanatisch Interesse -- eher äußerste -- ehe Mann Tochter berühren -- Auge wohlgefällig weilen wünschen -- 
  Welle betrügen -- öde -- kläglich Mann -- vergeben Beichtvater -- weder Herz vergeben frevelhaft Verbindung -- 
  halten -- Mitteilung Verdacht Waterloo-Partie beunruhigen -- genügend Kraft bewußt -- solch abenteuerlich Unternehmen zersprengen -- 
  Abends -- finden Familie -- Leopold Tallon Saale -- suchen emsig halb Tete-a-tete Frau van Welle -- Schlüssel erhielen -- 
  scheinen unruhig -- erstaunen wagt Tallon wunderlichst Sticheleien -- gestrig Spitzendam sprechen -- giacomo ausspionieren -- 
  bornieren Interesse politisch Gewäsch -- Welle -- unberührt bleiben -- bleiben -- 
  Frau van Welle zuflüstern -- können sehen -- Schlüssel spurlos fort -- argwöhn Tallon -- Weg räumen müssen -- 
  ruhig feuerspeiend Berg -- inneren ungeseh fulminant Ausbrüch bereit liegen -- erscheinen Frau -- 
  bewaffnet Giacomo tüchtig -- ungeschickt anstellte -- halb Stunde vertrödeln -- handfest Kutscher fahren Leopold Hügellehne Waterloo hinaus -- 
  Wählen Tallon -- sehen Ferne Hügel stehen -- -- Kerl springen nah Gehölz -- heben blitzschnell Margarita Wagen -- werfen Kutscher Bock -- springen Bock -- Tallon Grimassen arm Bein -- springen ebenfalls -- Peitsche fliegen -- Wagen verschwinden -- Karriere ankamen -- flog Ebene -- 
  Frau van Welle schri Furie entgegen -- Retten Kind -- 
  Herr van Welle schnupfen -- schimpf Straßenpolizei -- 
  befehlen Kutscher -- Karriere nachzujagen -- weigern -- werfen Wählens Kutscher -- jagt Pferd -- unnützes -- unpassend Zugreifen Giacomo's Zügel Pferd plötzlich falsch gewenden -- Wagen stürzen -- Tier gehen -- wissen -- Weise direkt Verfolgung -- müssen mühsam Städtchen Post suchen -- Schurk weit Vorsprung -- fahren Irre herum -- Anzeichen Ostende führen -- 
  Küste scheinen Räuber Beute bringen -- lebhaft Besorgnis -- eingeschiffen -- 
  glaubst -- welch reizend Figur geraubt Margarita spielen Phantasie - schlank -- mädchenhaft Geschöpf -- welcher ursprünglich Tragik müssen ausdrücken zart -- ausdrucksvoll Gesicht -- Brutalität verhaßt Entführer Kampf Sträube geraten -- 
  -- Ostende aufstassen -- -- traut Auge -- schlagen Täuschung Sinn -- Giacomo -- 
  Erscheinung huschen Gedränge Hafendamme vorüber Schatten -- greifen -- lichtlos Gewühle Menge Schatten verwischen -- 
  Gasthöfen -- abgehend Schiff erkundigen umsonst -- kindisch -- Leben Polizei wenden -- gewiß -- heilsam -- notwendig Institut -- Welt stehen liegen -- widerstreben jeder Institut -- bloß -- natürlich -- ursprünglich Äußerung Menschheit aufzupassen -- immerwährend -- lebendig Erinnerung -- Schema leben -- lassen wir_es -- wild Mensch zivilisiert -- vereinigen -- -- fragen Entschloß -- London -- 
  Meer -- solch Einschiffung entgehen -- Abenteurer halten gewiß Staat -- Gesetz sicher entgegen treten -- 
  neblig -- Schiff -- Schritt -- eilen Mann Richtung Hafen vorüber -- matrose -- Habseligkeiten tragen -- rufen -- wissen -- -- ungefähr -- Vorgesehn -- -- Attention -- -- klingen -- Mann wenden -- sehen -- schrei Stürz -- wenden blitzschnell geräuschlos Schlange seitwärts -- verschwinden Nebel -- hinterdrein -- -- Moment ansichtig -- nimmer lebhaft -- Finsternis stets Schritt seitwärts Blick entziehen -- 
  plötzlich -- Mal Auge bekommen -- stehen -- Jage -- strecken Pistole entgegen atemlos -- wissen -- 
  beachten Griff -- Schuß blitzt knallen Gesicht -- fühlen Ruck arme -- Kehl ruhen Hand -- 
  -- abgelegen Strandhöhe geraten -- seitab Hafen -- Meer rauschen Schritt Feind -- -- Sage -- Augenblick -- Margarita -- schleudre Meer -- -- halten halb übergebeugen hinten -- 
  Röchelt winken -- bereitwillig -- Kopf -- Faust lassen Sprechen -- lüften -- bekennen eiligst verlangter -- 
  Augenblick fühlen hinten ergreifen -- rasch gegenwirken werfen Tallon Meer -- Gegner Giacomo -- Schuft -- betrügen -- 
  -- bemerken -- getroffen -- linker Arm versagt Dienst -- Tod Leben ringen -- geschmeidig Bursch erwehren -- Meerseite drängen hinabdrücken -- 
  klammeren fest -- Gleichgewicht verlieren Hinab stürzen -- 
  kalt Woge verschlang bedecken -- Wasserdecke müssen paar verzweifelt Stöße aufraffen -- stets festhaltend Klau ergrimmt Italiener erwehren -- 
  Strom reißen auseinander -- Luft wissen -- Küste Meerseits -- Nebel sehen lassen -- landwärts kommend Welle werfen -- Arm Rudernd -- glücklich Strand -- 
  Schufte ergehen -- wissen -- blicken -- stürzen fort -- Margariten's Versteck suchen -- Meeresfrost schütteln -- warm quoll Blut Armwunde -- 
  anständig Mensch müssen umkleid -- Chirurg rufen -- Mantelsack sehen -- matros schleppen -- unterd Ratte an Land gekroch Margarit Seite bringen -- 
  empfangen Freude erscheinen -- Mensch Engel plötzlich Hölle trät Himmelsluft Himmelsglück Verdammnis böte -- Weh Wunde Fieber -- Befiel -- Sonne aufgehen -- 
  Vergib -- referiern passend -- momentan tollst Lustigkeit Paris sitzen -- Ste Pelagie kommen -- Leopold Holde übermäßig Schuld weilen -- geistreichst Schuldenmach Frankreich Konferenz halten -- Schuld -- negativ Welt -- positiv -- Gefangenschaft Herrschaft umwandeln -- 
  kommen ausgelassen geistreich Ding -- munt Ste Pelagie -- toll Einfall völlig turbieren -- 
  Preis aussetzen -- Sonne Flanellmantel umschlagen -- dreist rücksichtsvoll Erde fallen -- 
  fassen -- 
  wunderbar gestaltet Ostende -- 
  flüchtig wild Fieber werfen -- Margarita pflegen -- stehen lodernd Liebe -- wissen -- Retter -- 
  duftend üppig entfaltet Knospe -- 
  suchen -- verlangen -- erkämpf -- unbegehrt Geschenk Schoß werfen -- -- 
  -- Brüssel -- schreien -- wehren -- umklammert Schulter -- flüstern -- 
  Mutter Glück gönnen -- 
  Länge Ostende -- 
  bestellt Plätze Fahrzeug -- -- weit Welt -- tragen Meer -- Meer -- Jugend unverändert lieben -- 
  Schlankes frei Schiff -- Wind Welle kräftig Rang -- hass Dampfschiff -- künstlich Vermittlung Mensch Element -- repräsentativ Schifffahrt -- frei -- kräftig -- gefährlich Ineinand Mensch Meeres stören -- 
  Verdacht -- Spelunke Schiff Giacomo sehen -- dolchartig neapolitanisch Auge -- nachts steigen Verdeck -- Mond scheinen hell -- Meer schäumend -- frech Nachtwinde treiben -- Westen Küste lassen -- 
  Bord sitzen dunkel Gestalt -- -- Zusammenfuhr -- nahen -- giacomo -- 
  treten ruhig nahe -- fragt Tallon -- entkommen Bade -- 
  giacomo wissen -- Hin- Herfrag belehrn -- Mensch Bruder Giacomo's -- Neapolitaner Revolutionsabenteurer -- 
  log Giacomo -- -- Schußwunde Arm lähmen -- ungewohnt Schwäche beitragen -- feindselig Welt fühlen -- -- 
  fassen Schurken -- ehe versehen -- Schulter Hüfte -- schleudern Meer -- 
  Wind Welle rauschen -- vernehmen -- 
  -- kommen Abends Brüssel -- Margarita wissen -- -- lassen Haus Vater vorfahren -- ehe Äußerung -- stehen Salon Herr Frau van Welle -- 
  Verrätst -- Hippolyt -- rufen -- sinken Ohnmacht -- 
  -- Antlitz Frau van Welle Gebärde niemals sehen -- glauben -- -- wovor Leben erschrocken -- 
  unglücklich Wort Margarita's Geschichte erzählen -- Mann -- schreien entgegen -- strecken Arm -- Furie -- zerfleischen -- Mann -- bringst Greuel Familie -- -- 
  Herr van Welle eilen -- Schnupftabakdose Hand -- -- schleudern Seite -- entwich -- 
  Mal entflohen -- tollen Weibe -- 
  zufällig -- Wagen just hierher treiben -- Paris kommen -- finden Leopold -- umgestürzt Kutsche hierher bewegt lustig leben -- 
  -- Welt -- schwer -- lustig leben -- 
  3. Valerius Hippolyt -- 
  Gott wissen -- jemals Zeile erhältst -- Gott wissen -- lesen -- 
  kritzle bleistift Papierstückche -- Zufall mitunter bekommen -- schmutzig -- Gefängnis -- erreichen -- heimlich tags Zeile aufschreiben -- überschwenglich Vorteil -- 
  Woche -- Monde vorübergezogen -- langsam -- langsam -- bleich ausgehungert Wesen -- Freund -- gelitt -- leiden -- 
  geben -- Tag Gedanke aufschreiben -- Gedankenqual -- unerlösen -- furienartig Verstoßen herumzauestn -- übrig vordrängen -- 
  inneren -- stehen Geist Gedächtni Wasser -- bewegen -- Gesetz Ordnung hören -- regellos Wahnsinn erlösen -- verfallen dumpf Schwäche -- klein Geistesoperation wachsen -- 
  Blatt -- neu ergattern -- Eierkuche -- Mittagessen erhalten -- Stückchen Papier angebacken -- benutzen trotz Fettigkeit -- 
  fühlen -- Ferne -- wohltätig -- gewiß Ordnung erzählen -- Kraft gebrechen -- gezwungen Nichtstun -- ewig machtlos denken -- angewiesen -- all streng Darstellung verloren gehen -- Tappe -- greifen hierhin -- greifen -- 
  niemals schildern -- gelitten Leide -- schwer Innerlichkeit sehen unbedeutend -- Wort bekleide -- jeder Wort -- frivol -- zart Wort -- Musik wiedergeben -- jedenfalls Liebe ahnen verstehen -- 
  -- Bezeichnung verschwinden Hand -- Gedächtnis Spannkraft verlieren -- Einförmigkeit Nuance Schmerz entwickeln -- bestreben -- zusammenzudrängen -- man_es -- Menschheit müssen elektrisch Schlage Weh betreffen -- unbeschreiblich Leid Welt -- Gefängnis -- 
  -- Papier -- sehen -- schreiben -- Freude -- 
  Zweck -- leben -- -- -- vortrefflich Stückche Bleistift finden Uhrtasche Beinkleid -- niemals benutzen beachten -- 
  Geschäft -- Minute -- 
  Denke entsetzliche -- früh erwach -- Düstre Gemach sehen -- Schlaf vergessen -- entsetzen erinnern -- Leben beendigen trostlos Art -- 
  klagen -- Reiz -- Freund -- -- Geschäft -- 
  sobald aufstehen -- angekleiden kärglich Frühstück verzehren -- fertig -- liegen -- öde -- grau Unterwelt alte -- Buch -- hören -- sehen -- Tätigkeit übrig -- Raume herumzugehen -- Gedanke schweifen lassen schwindlig kopf -- ruckweis -- atemlos Dienst versagen -- 
  zwölf -- zwölf bringen Wärter Mittagbrot -- Unterbrechung -- mager Speise Gegebene -- woran Gedanke aufrichten -- langsam halb Stunde hinziehen -- eigentlich Mahlzeit Minute verzehren -- Wärter gestatten Ausdehnung -- 30 füttern -- Geschirr Besteck fort -- Mißbrauch treiben -- 
  Tür rasseln -- zwölf -- Stunde breit -- durchbringen -- flüchtig bisschen Abendessen -- Gedanke suchen Abend -- ehe Schlaf finden -- gefangener Bewegung Luft träge nähern -- unmutig -- 
  -- reihen ausdruckslos -- verrückt unbeschäftigt Gedanke -- starr Tier Wüste Winkel hocken -- 
  Folgerecht erzählen -- nützlich -- drängen bäumen Gedanke durcheinander -- wissen -- wonach greifen -- Zittre -- Bleistift beschrieben Papierstück entdecken -- alt Wüste werfen -- 
  Wache Korridor unregelmäßigen Schritt -- Fahr -- denken -- sehen Tasche -- verboten Papier stecken -- treiben halber Wahnsinn Wärter sagen -- ansehen -- unaufgefordert sagen -- denken -- rechts Tasche Papierstückche Bleistift -- -- 
  nerven- geistesschwach -- wissen Zeitlang -- sehen lebendig Leib sterben -- 
  denken heruntergekommen Leute Bekanntschaft -- fallen Eins -- Besitz -- Umgang -- Kleidung -- Augenblick leben -- trank Stahl tat Schlimmer -- enden kläglich -- Welt höhnten -- verdammen rücksichtslos -- 
  -- Elend fühlen -- nah gut schlecht Tat ruhn -- nah glücklich unglücklich Geschick -- Mangel führen nächster -- greifen nächster Rettung -- Geist Nerve schwach verwirrt -- Wahl hören völlig -- Zufall wissen -- -- Mensch verurteilen -- -- 
  -- Raum -- wissen wohin geraten -- peinlich Mühe vorgesagen -- schreiben -- Papierfetz -- erreichen -- solch halb übrig bleibend Gedanke qualten marteren -- entweichen -- halb -- Gedächtnis ohnedies täglich schwach -- 
  -- 
  Entfernung Kerker hören zuweilen Kette rasseln -- denken -- Bösewicht -- fühl Schwäche -- sicher -- -- 
  O -- Mensch -- 
  -- erzählen kommen -- Klage füllen spärlich Papierraum nutzlos -- 
  -- gefangen Idee speziell einzufang such Darstellung -- notwendig Ordnung Geschäft -- -- -- willkommen -- 
  Papierstreifchen -- um_das Licht gewickeln -- schließen -- 
  Triumph -- Wärter alt schlecht Buch geliehen -- Okulier Baum -- Vertreibung Hühnerwurzeln -- gelbmach Butter Ding Rede -- Lesbares -- -- Hilfe -- Trost -- Hoffnung -- Gedanke ausgehen -- Klettre hinauf fensterchen -- Eisenstab blechblend Außenwelt abscheiden -- schmal Stückchen Himmel hereinlassen -- les Buttermach -- les Zeile zweimal -- dreimal -- Buch hinzubringen -- 
  berauschend scheinen Traum -- solch Gartenknecht -- graben hack Gott frei Natur -- Wirtin beliebt geheimnisvoll Kenntnis -- vergilbt Scharteke erlerne -- 
  Gewinn -- hinten vorn Buch eingebunden schmutzig Papierblätter -- stehlen -- Mitte lose Druckblatt herausziehn -- Druck hinwegzuschreiben -- schwer lesen lassen -- neu Geschäft Entziffern -- reich -- Himmel -- 
  eher -- Buch zurückgegeben mehrere erkennen -- Wärter vermissen -- 
  -- schlimm Fall -- Blatt finden -- rett Bleistift -- unbeschrieben -- 
  schlimm Fasttage -- 
  gelingen -- erzählen -- Moment Gefangenschaft -- vorhergehend Umriß äußerer Welt gemein -- vergessen -- Schattierung Wand entgehen -- festhalten -- 
  fühlen -- lang Einförmigkeit dauern -- desto ausdruckslos -- gewöhne verlier Auffaßung Unterscheidende -- 
  -- abzuseh -- jetzig Form dauern -- brauchen aufhören -- 
  Oh -- Mensch hören sehen Seufzer -- erfahren -- welch entsetzlich Schmerzesabgrund liegen -- 
  -- Hof Gang -- mehrere Treppe aufwärts Gemach führen -- Tür zugeschlossen -- bemerken anfangs -- wahrhaft lebendig Gedanke letzter Verhältnis bewegen -- stundenlang Zimmerchen umh -- müde -- 
  bieten ruhen schwarz Kanapee -- -- ausstrecken -- hart Kerkergedanke aufkommen lassen -- stehen rot ordinär Tisch -- Bett dito Stühl finden -- Tisch Waschbecken dergleichen -- 
  rümpft Nase -- Gemach schmal viereckig -- auf Sofa steigen müssen -- vergittert Fenster -- Hof hinabzusehen -- 
  indessen -- Eindruck flüchtig -- Anfang denken -- dauern -- zerstreuend letzter Außenwelt beschäftigen -- 
  Gefängnisentbehrung treten mild Auge -- Feld leidig Tabakrauche angewöhnen -- Feuerzeug Pfeif -- voll Börse Tasche -- fragen -- -- grell aufstörend Gefänglich -- 
  verhören -- Inquirent artig Mann -- teilnehmend Lebensbedürfnisse erkundigen -- Bibliothek anbieten -- lebhaft Hoffnung bestätigen -- Arrest dauern -- 
  aufgeregen machen groß streng Sorgfalt nötig -- wissen -- revolutionär Grundsatz hegen bewaffnet -- polnisch Revolution anschließen -- 
  leugnen -- setzen hinzu -- polnisch Sache historisch rechtmäßig gelten -- ferner nirgends heilsam Lehre finden -- just Warschau -- 
  entgegnen höflich -- wissenschaftlich gebildet Mann -- einseh -- bestehend Staat historisch Rückforderung eingehen -- stet Unruhe beliebigst Rechtsänderung gestatten -- wissen -- Geschichte vorrückt gestalten -- niemals alt Besitz respektierend -- kommen -- all Rekrimination gestatten -- z. B. Elsaß Deutschland zurückbegehren -- römischdeutsch Kaisergewalt Österreich ansprechen -- 
  zweitens Mißliche Revolution kennen lernen -- glauben -- sehen -- Versicherung -- Gefängnis -- groß Belang -- 
  Freund Wort Schrift Revolution direkt propagieren -- Waffe Hand nehmen -- gesetzlich bestehend Traktat Europa's richten -- zugestehen -- gefallen lassen -- Person versichern -- Gleichgesinnte erfahren suchen -- bekannt Lebenstätigkeit unbekannt schließen -- mächtig trachten -- 
  Gang -- Untersuchung nennen -- human Mann -- Betrübnis eingesehen -- Betrübnis -- behalten -- 
  unruhig Gefängnis Mute -- 
  Illusion -- Paar Stunde vorüber können -- vorüber -- Gegenwart fallen unsicher Zukunft lastend -- Interesse erscheinen bedrohen -- Interesse Buch -- gütig Inquirent geliehen -- fremd künstlich vorkamen -- Ruhe Lektüre -- 
  erinneren -- einzig Stelle Gelesene Eindruck -- stehen -- Ding Erinnerung Paris -- -- schildern glücklich Mensch -- Zeichen -- Glück -- tüchtigen Unglück betreffen -- 
  Stelle wirklich Trost -- Dichter -- mitschicken -- helfen -- merkwürdigerweise Shakespeare -- Ding fallen all tobend -- willkürlich wechselnd -- Vergleichung passen -- Gedanke überstürzen Reichtume -- notwendig vorkommen -- 
  schütten -- denken -- Füllhorn Genies -- unüberlegen -- ungepflegt ungeprüfen -- wissen -- -- 
  trösten -- Tröstende glauben -- sehen -- Wort schreibenden bewähren -- 
  Goethe Erquickung -- 
  Überspanntes -- Übertriebene -- Zuverlässige einfach -- verlangen Welt messen -- Lektüre Ruhe -- 
  -- glauben leiden -- anfangen wissen -- lesen -- an Fenster klettern -- leer Hof hinabzuseh -- eintönig Schildwach auf niederschriet -- lesen -- 
  Wüst -- schlingen Unterscheidung hinunt -- frisch -- locken -- -- sehnsüchtig herbeigewünscht -- 
  Gefängnis -- meinig -- Blechkaster Fensterchen -- sehen trostlos erblinden -- mitunter sprechen -- lachen hören -- berühren unheimlich -- 
  freundlich Wärter erwidern Befrage achselzuckend -- säßen schwer Verbrecher -- 
  schaueren -- überlief Grausen -- Verbrechen Tageslicht abschließen -- 
  Gott -- sitzen Monat Blende -- -- schwach -- leben -- moralisch Moment Dämmerung kümmern -- Mensch lernen -- Verbrechermaske tragen -- halten wirklich Gesicht -- 
  vergessen manchmal völlig -- Verbrecher -- erinnern -- hoch wechselnd Staatsrücksichte -- Zustand bringen -- Verhältnis dergestalt sinken -- lang moralisch Bewußtsein Kerker gehören -- 
  -- halb Verhältnis -- 
  rufen -- verwundend Eindruck -- Abends Tür klopfen bemerken -- Licht auszulöschen -- fallen -- Wache schreien -- Licht -- -- -- Interimsgefängnisse sitzen Vagabund solch leicht Gesindel Nähe -- leichtsinnig -- roh Äußerung -- gemein Spektakel auffällig -- zuweilen Abends Besoffener solch Straßenheld einbringen -- toben Tier -- hören -- abgelegen Korridor zart Eintritt nötigen -- flucht Kerl halb Nacht wütet Tür -- zusammenfiel -- -- entwürdigen -- halten Abwechslung -- Erholung tote -- bleiern Einerlei -- umgiben -- zuweilen Rassel Kette unterbrechen -- 
  -- wüst Lesen -- Abwechslung verlangen -- Gefängnisdilettant betragen -- vornherein Freistunder bewilligen -- verschlossen Hof herumzugehen -- törichter Mensch Interesse -- heiß Sommer -- Schatten Hof -- Stunde auf abgehen -- scheinen langweilig -- dünken wild Tier -- Käfigdeckel aufschieben -- Leute rennen -- 
  Arbeitsstub Behörde nämlich -- mehrere Gefängnis sehen Hof -- ordinär gefangener spotteen -- Hut Handschuhen herumgehen -- frisch Hemd -- Manschetten sichtbar -- müssen Wache Spott Ruhe gebieten -- 
  kränken tief -- lassen Stunde vorübergehen -- abstumpfen -- täte Freistunde Wille -- 
  schmacht frisch Luft -- dür -- 
  gehen lang Bart wahrscheinlich verbleicht Antlitze Galerie umher -- zuschauen -- -- 
  Hof lang Beamter stets Pult stehen schreiben -- bilden Steif fest -- schrieben Sache -- müssen Freibrief schreiben -- stets auffallend -- Mann größerem Anteil heruntersah -- 
  Gott wissen -- Mann schreiben -- Besseres schreiben -- 
  -- -- Anknüpfung Romantik drüben Gefängnis -- 
  empfinden Öde Entbehrniß -- sehen -- Blut -- man_es verlieren -- 
  Hof Flurfenster -- Fremde zuweilen erscheinen -- wahrscheinlich -- petitionieren -- 
  finden Dame -- mitunter schön seiden Gewand -- Schleier -- 
  -- Himmel -- Leben schön Dame seiden Gewand Schleier sehen -- 
  kläglich Bedürfnis Auskommen -- Auskommen Wohlhäbigkeit -- Luxus -- gefällig Reiz -- weit Strecke liegen -- -- Strecke liegen Welt -- 
  liegen Staube -- Schmutz -- kümmerlich Ernährung -- streck Hand Wunsch seiden Gewand Bettler Goldstücke -- 
  -- Fürstin Armen liegen -- Prachtgewänder zerrissen -- 
  Fetzen glücklichen -- 
  Gelüst verhöhnen -- Harmonie Zustandes -- unter -- Einklang zerstören -- krankhaft -- 
  O grausam Wort -- tot Regel Prosa -- Tod -- -- Hand Augenblick Seidenstoff legen -- fein glatt Stoff empfinden -- Reiz Schönheit Welt -- 
  Papiervorrat -- Pause eintreten -- rüstig Darben Kreuzer absparen Rechnung -- Wärter führen -- Stückche Kuche kaufen lassen -- Haus Kuchen Sonntägliches -- Feiertäglich -- solch Eindruck besonderen -- Festlichen -- 
  Nebenher -- -- gelingen -- Platz verringern Erzählung Jntrigue -- Kuchen Papier einschlagen -- benützen -- 
  glaubst -- Schmerz Beschreibung Gefängniszeit -- bunt reich vorkommen jetzig -- zurücksehnen -- Eldorado -- 
  Bettler Reichtum Armut -- glücklicher Genosse Darbenden Wunsch hinaus -- drücken -- Berauschend total Freiheit hoffen -- Zustande schmacht -- Blende Fenster -- rauchen -- lesen -- schreiben -- schreiben ordentlich Tinte -- wirklich Feder rein weiß Papier -- tags Stunde Hof -- mitunter Mensch -- Wärter -- 
  Denke -- welcher Reichtum Folgend -- 
  Gefängnis leichtsinnigen Mädchen Straßenromantik eingesperren -- gesetzlich Gesetzlosigkeit versehen -- aufgreifen lassen -- leicht Kind -- Zwanzigern Gemache kampieren -- allerlei anderer Weibsbild -- irgendwo Netz Vorschrift verirren -- Zusammentraf -- Sange tändelen Käfig -- Langeweile eingeben -- Schließer gestatten -- Verbot Anrede unangenehm -- 
  zuweilen -- Freistunde führen -- Terrain vorüberkommen -- stehen Tür -- ausgefegen Heldinn abgerufen -- stark aufmunternd Wort Schließer Toilette beendigen -- 
  voll Blick Serail -- liegen halb entkleiden Wärme Position umher -- sitzen -- Kauert -- versuchen -- Gedrang promenieren -- schmachtend frech Eile jung Mannsbild allerlei Teilnahme ausdrücken -- 
  zuweilen schön Geschöpf -- Schließer stets schlecht Eindruck -- Unterschied jeglicher Äußerung grob Ruhe weisen -- 
  freilich Mann abhärten -- sprechen zuweilen -- stets fluch -- Pack taugen all -- Straße herumgetrieben -- unschuldig -- lassen laufen -- Mal -- ist_es schlimm -- -- Mal fort -- Zuchthause reif -- Hübscheste ärgsn -- -- 
  viertelstündig Unterhaltung -- geben lang -- Hof lassen -- Fenster -- laufen -- Frauenzimmer Bewegung -- zankt Schattenplätzche -- Häßlichst -- Gefängnis tief verlorener -- Teint aussetzen -- 
  alte zerren -- Junge neckten -- stets Töpfche Eßkrame -- erwuchs spezielleres Interesse -- 
  Wärter nämlich benutzt Garde -- Gemach täglich reinigen lassen -- munter Geschmacke wählen stets Handfeste für's Grobe Hübschere für's Leichtere -- Bett -- Staub abkehren -- 
  Mädchen Abwechslung -- kommen meist heit -- erzählten meist Kürze viertelstund Lebensgeschichte -- 
  bildschön Mädchen öfters -- -- Wärter gewiß herzlicch Interesse Schicksal -- -- Mädchen herumgelaufen -- -- gutmütig Geschöpf -- leichtsinnig Verkehr Mann betreffen -- 
  nennen Louise kümmerlich spärlich kleiden -- 
  Ausfeg manchmal Tür herumschlagen -- Wärter Türschwelle -- Korridor Augenblick sehen -- erheben gutmütig -- schön Auge sanft lockend -- liegen merkwürdiger Ausdruck -- weitläufig befragen -- 
  Sorgloser Leichtsinn unverkennbar -- zutraulich harmlos -- 
  -- diesmal Zuchthaus -- sprechen entsetzlich Wort -- einst Kaffeehause reden -- 
  schlimm -- meinen -- nickt kopfe -- 
  Backe streichelen -- lächeln -- flüstern -- 
  -- Abends Tür heraufschleichen -- -- 
  Kind -- Tür zugeschlossen -- 
  -- -- -- 
  freilich schlimm -- -- -- unten langweilig -- -- 
  -- Längere -- Mitteilung nötig -- dauern halb Einsamkeit -- müssen fort -- einschließen -- pikant Situation nachdenken -- Zuchthauskandidatin tändeln -- -- 
  flüstern -- 
  kommen Nächstens -- 
  ordentlich Romananknüpfung -- duftig erscheinen unvorsichtig Mädchen -- gemein Spitzbübin -- Lebensgeschichte erzählen -- erwünschen -- hören -- verkehrt Mensch -- 
  -- huscht Abends Türe -- klopfen leise -- keck Luise -- Schließer unten Schlüssel umgedrehen -- heraufgeschlichen -- 
  Schlüssel zweimal umgedrehtn -- leichtsinnig Kind fragen -- wissen -- Wache unterd Korridor langsam sicher herzugeschriten -- Luisa müssen fort -- 
  sehen -- gut -- treu Auge wahrscheinlich auf Zuchthaus mißen -- 
  mitunter lachen glücklich fühlen -- 
  Lerne klein schreiben -- wahrscheinlich Kosten Auge undeutlich Geschriebenes lesen -- gestern Kuchenpapiere fertig -- 
  Eindruck geben -- Stückche übrig bleibend Papier Möglichkeit Überflusse verschaffen -- Überflusses -- ordentlich zufried Verhältnis sonstigen -- 
  Verhältnis Welt -- elastisch Mensch -- -- 
  Abwechselung vorig Gefängnis fallen Länge Abgeschlossenheit schwer -- Laß gestehen -- manchmal glauben erdrücken -- einsam -- verlassen -- unglücklich erscheinen -- heißen -- dicht Träne brechen Herein -- 
  -- Kind weinen -- manchmal Stunde -- vergessen -- Kopf Wand lehnen -- rücksichtslos schneidend Weh hingeben -- Welt ausschließen -- Nacht Nacht -- -- 
  gewiß Süßigkeit frei gelassen Schmerz erschöpfen -- treten Vers Goethe Lippe -- -- bringen Träne -- 
  Durchgefühlt -- durchgeweinen jeder Wort -- klein -- möglich Bedeutung -- Lied Wilhelm Meister -- Harfner Mignon Wilhelm Schmerze singen -- 
  -- Sehnsucht kennen -- weiße -- leiden -- abgetrennt Freude Sehe an Firmament Seite -- 
  lieben kennen -- Weite -- schwinden -- brennen Eingeweid -- 
  Sehnsucht kennen -- weiße -- leiden -- -- 
  --- eigentlich Lied Prosa Absatz schreiben -- Papiermangel -- entschließen -- gute -- -- stets gewähren -- König Lump -- betteln -- 
  Wusste -- erfahren Lied -- fein -- edl Schmerz fähig -- Planet glänzend Verhältnis gelangen -- säßen schimmernder Pracht prächtig Mensch Tön -- einfach Sangesweis Liede schlüge Ohr -- o wunderbar Welt -- Träne brächen wiederum dick heiß hervor Wort -- -- lieben kennen -- Weite -- -- eilt Sänger -- helfen -- risse all strahlend Welt -- zweimal -- dreimal -- setzen Preis -- vergäße wichtig Wort -- 
  verborgen Winkel Welt Einsamkeit -- Elend -- euer eintönig Phantasie niemals erfinden -- Suchet -- helfen -- -- -- 
  -- Freund -- Mensch fertig Welt -- fremd -- Bruder -- fühlen entsetzen Unglück -- frei -- ergriff Woge -- trieben fort -- Nächst -- bedrohen -- erreichbar -- -- gehen Übrig -- Winkel vergessen -- Mensch verderben -- 
  -- -- sehen weder Sonne Menschenauge -- wissen -- wozu Leben taugen -- Verdumpft -- halb sterbend -- halb lebend -- -- -- 
  Leb -- leben -- Papier -- empfind Herz harmlos aussehend Wort -- 
  -- abtrennen Freude -- -- 
  -- Lied -- ausgeweinen -- Denke still Nacht -- einzig Freund -- 
  Sonne hinunt -- leicht -- Not -- Denke -- 
  -- Ringsum tot -- 
  Ferne lieben -- Still -- betrüben -- -- 
  Töricht Leute schmähen Freude -- Leben Freude -- Moment Leben -- dumpf -- tot Maß -- Traurigkeit -- schmerze unerkannt Freudenpunkt -- Leben -- Bewußtsein gestatten -- 
  Elend Tagesschimmer -- sehen -- körperlich Leben -- Wendung Regung empfinden -- Genug -- bekommsen essen -- -- -- bescheiden lernen -- Freudenatom halten Leben -- 
  Beispiel -- Papier -- lauter Stückche -- Stückche -- 
  schreiben -- -- 
  Weh Abgeschlossenheit -- Tränenreich damalig Gefängnis -- sitzen Tag brütend traurig -- Inquirent bescheiden -- 
  Freiheit -- denken -- Spielraum geben -- fort -- 
  Wärter gutmütig -- Möglichkeit einzugehn -- sagen -- -- -- 
  Inquirent empfangen ernstfreundlich -- deutet Hand seitwärts Hintergrund Zimmer -- 
  Dame stehen -- Gesicht -- Gedanke stürzen übereinander Herz -- finden -- Kamilla -- Situation begrüßen -- 
  welch Gemisch Empfindung -- 
  vortrefflich Mädchen Grünschloß erfahren -- begegnen -- selbständig -- aufmachen -- hierher kommen -- Herr Behörde laufen -- wirken -- dringen -- 
  weinen -- fragen stark eifrig -- worin helfen nützen können -- 
  O Rührendes -- Überschwängliches liegen stark -- liebend Herz Weibe -- 
  ängstlich treu -- wissen früh Wesen Leben -- bleiben -- wissen -- liebend -- echt -- unverfälscht Weib -- dennoch -- Unglück -- Glück niemals stören -- 
  O -- herzensreich Kamilla -- 
  Konstantie wohnen nah -- gering Anstrengung Bewegung setzen vermocht -- hierbei drängen -- schicksal Augenblick ergänzen -- Joel Krakau ankommen -- Augenblick Verhaftung -- 
  Papiermangel gestatten Strich -- 
  glaublich finden -- innerer äußerer Zusammenhäng bringen -- -- Verhältnis Mensch schattenhaft Traumgestalt vorübergezogen -- -- Mensch hoch menschlich Bezügnisse -- erzogen -- gezähmt Tier -- 
  erschrecken Wort -- damalig Aufenthalt bezeichnen -- 
  -- Mensch -- Freund müssen -- Herz besitzen -- Freund Bezug Russe -- Slodczek -- Tor Krakau's Jammer finden -- Rettet nähren -- überantwortet Feind -- Vorteil bringen -- undankbar -- selten slawisch Zug bringen -- Ausländer Jude Rücksicht wert achten -- 
  Glück rein Kosak kommen -- Weg südlich Sibirien -- Kosak wünschenswert scheinen -- 
  Kosak gutmütig -- meister Teil Sibirien verkehren -- Privatreich Stamm ansehen -- Hälfte siebzehnen Jahrhundert russisch Reiche unterwerfen -- 
  sagen -- überall geraten -- 
  Nacht geritt -- frisch Kosak beratschlagen -- Paar Minute dauern -- ursprünglich Richtung aufgeben Süden wenden -- 
  geritt -- unendlich Ebene -- vergessen -- Sonntag Montag -- Joel Wort sprechen -- blasiern -- mongolisch Wald kommen -- 
  Pferd laufen -- abends liegen Fläche mongolisch Jurt -- 
  Filzzelt -- Mongol schlafen -- stehen Kessel -- Kuhhaar auswischen -- Tee kochen -- Tee täglich Labsal -- 
  Form Ziegel -- fünfzehn Zoll -- Pfund schwer -- Tee aufbewahren -- nennen Form Ziegeltee -- 
  solch Ziegel Kessel werfen zerkocht -- schütten unrein Steppensalz hinein -- Bittersalz enthalten Chuschir nennen -- fügen Pferdemilch Butter hinzu -- Lama Jurt These -- genießen heiß -- siedend heiß -- 
  höflich Mongole fordern trinken -- Tust -- warm Nacht eiskalt -- 
  innerer Welt -- gebraucht solch vegetativ tot Leben -- Seele Geist Schlägen erhole -- 
  suchen Zusammenhäng -- Zusammenhäng arg täuschen -- einzeln sehen -- Umgebung niemals -- aufnehmen -- 
  -- reise ten Filzjurt -- nacht aufschlugen -- Weg Steppe -- erinn träg -- öd Gedanken -- herumklapperen -- Welt -- -- 
  kommen Hügel Abhange plötzlich Stadt Kirchtürme Kuppel -- sehen -- 
  gehören Fohitempel -- Stadt heißen Kiachta -- 
  Gott überall -- Mensch brauchen überall -- Furcht -- Liebe -- Gefühl -- worin Beide liegen -- Ort Religion nennen -- 
  Kiachta kommen dicht Fichtenwald -- fliegen Heimatsgefühl -- warm lüftchen -- Winter verirren -- kommen an Flüßche -- Jbitsych heißen -- schön Weide -- Pferd gras -- te lagern -- 
  glauben -- Vers -- woher kommen -- wohin gehen -- wissen -- 
  Poesie Traum -- erzeugen -- erzeugen -- 
  -- sehen Mongole bunt Kleid -- ziehen Gebirgsrück Zagan-Daba -- 
  Gipfel Berg liegen Obos -- Steinhaufe -- Buddha errichten -- Stein legen -- Halstuch aufhängen -- religiös -- 
  Wort Buddha dachen Schlegel -- wissen -- lächeln -- erinnern -- Religion Hindostan -- überwiegend Abart -- unzufrieden -- Gedanke Situation -- völlig Teilnahmslosigkeit indischen Zustand Berührung treten -- fliegen leise Komisches Lippe -- -- 
  gehen reißend Fluß Jro -- kehren Nacht -- -- Mongole -- 
  schmutzig -- roh -- gutmütig -- Eingange Kibitka -- Tür -- stehen Schrank verschieden Götzenbildern -- Tischchen -- worauf geweiht Ding -- nämlich Gerste -- Wasser -- Branntwein -- Tee -- Schüssel Asche ersetzen tibetanisch Rauchkerz -- 
  Recht Eingang Hausgerät -- Salzscheffel -- Tröge -- hölzern Tasse -- Schaumlöffel -- Mitte eisern Dreifuß Kessel -- 
  überall gastfrei aufnehmen -- Witterung wärm -- bereitet beliebt Kumys Stutenmilch Branntwein -- 
  meister Jurt finden bettelnden mongolisch Pilger -- gleich unser früh Bettelmönche -- Lama's -- Priester -- sehen -- 
  nebenher chinesisch Hausierer -- treiben Tauschhandel -- nehmen Pelz -- 
  Lama unentbehrlich Möbel Jurt -- 
  Vermittlung Mongol beten -- meist Sohn bestimmen -- 
  erinnre Eindruck dunkel -- Leute kommen -- namentlich Schmerz Herzen linker Pulsad -- dicht Hand -- 
  spielen nämlich Geig -- Kur nennen -- tief melancholisch Lied -- 
  -- Kirgisengräber vorüber -- eng Schlucht Kalkgebirges kommen Wüste Schamo Gobi -- 
  chinesisch Hausierer anschließen -- Kosak offenbar Handelsgeschäft -- 
  eingang Wüste finden Einsiedler -- ebenfalls Lama -- tragen rot Kleid kegelförmig hoch Mütze -- 
  Wohnung Höhle -- sehen stehen -- halten Rosenkranz Hand -- schreien -- 
  gerad Weg fort -- heilig Boden -- 
  Nebenher furchtsam -- Tabak Branntwein schenken -- sonstig Enthaltsamkeit höchlich lieben -- beruhigen -- 
  Nacht war_es -- Joel treten --- Einsiedler lesen Lichter Messe -- -- undenklich deutsch Sprache anreden -- 
  -- Laß heimkehren -- sprechen -- Sehnsucht Mensch -- kosaken kümmern -- -- -- Pferd finden Rückweg -- -- 
  -- brechen -- Karawane schlief -- riten -- -- Mal deutsch ring sprechen hören -- Frühling aufgeblühen -- Lauten Blume Vaterlande wacht alt Welt -- alt Traum Wunsch kommen -- Starrschlummer brechen -- strecken arm Leben -- 
  -- Joel Galizien bleiben -- bleiben übrig -- singen hoffen -- 
  Landsleute gastfrei Mongole -- Reisemittel -- warm Frühlingstage müssen letzter Kraft anstreng -- Schloß erreichen -- Schatten hoch Baum wohlbekannt Strome liegen -- 
  wissen -- Constantien gehören -- wissen -- Frühlingszeit wohnen pflegen -- Sehnsucht Herzen -- kennen -- riesengroß -- vergessen schön Weib übrig Verhältnis -- Auge sehen -- Stimme hören Weibe -- kennen -- Teilnahme zeigen ewig Wanderer -- 
  Erschöpft -- dürstend -- hungernd -- allerlei Drang peinigen an Schloßtor -- Portier Stübchen -- fallen Bank -- fragen -- Fürstin -- Antwort -- säß Tafel -- 
  Portier müssen Schreibzeug geben -- -- drängend Mitteilung müssen Fürstin sogleich -- schreiben -- beherbergen -- kommen ermüdet chinesisch Grenze vorüber -- sehnt -- bekannt Wesen sprechen -- Portier -- Brief selber auf Schloß hinauftragen -- bleiben -- Wagen herabgeschossen -- sitzen Fürstin William -- keuerteen erschöpfen Bank Portier -- brausn vorüber -- 
  alt Portier Bescheid nachgehinken -- 
  müssen vollkommen Richtigkeit -- Fürstin Hals Kopf Wagen schicken -- fahren -- -- 
  alt Mann schenken Stück Schwarzbrot Trunk -- schleppt -- herb Wunde Herzen -- 
  beginnen Gefangenschaft -- Kamilla -- 
  Blaß arm Mädchen -- -- durchdrung -- rührend Anhänglichkeit Liebe danken -- Herz gedeihen können -- 
  Einsamkeit Gefängnisses malen -- zufrieden glücklich -- häuslich Existenz führen -- Welt müssen freilich aufgeben -- Kamilla zufrieden Idyll -- 
  treten Katastrophe -- -- 
  warten täglich Befreiung -- Tag -- Wärter Mittagessen bringen -- fallen stille -- zurückhaltend Benehme -- fragt -- schweigen -- fragen dringend -- erschrecken -- -- weg -- Untersuchung groß streng -- 
  -- Fassung Augenblick verlieren -- schwach bilden -- Kultur Fassung -- glauben -- tröstet Wärter aß Mittagbrot -- 
  abräumen zugeschlossen -- gefänglich -- stürzen Jammer Sturzreg -- 
  Nachricht Aussicht Freiheit vernichten -- wissen zuverlässig -- mindestens halb Gefängnis -- 
  O -- schön Reise Gegürteter -- lassen Bett drücken Gewißheit -- Monat leiden -- aufzustehen -- 
  schwer Nachmittag Abend -- Hoffnungsmöglichkeit erwürgen -- schweigen bringen -- ergeben -- leiden -- -- Jämmerlichkeit -- kommen Gedanke Flucht -- Unruhe Schulter tragen -- erhitzt Hoffnung herschleppen -- 
  -- damalig Gefängnis liegen dergestalt Mitte fesselnd Anstalt -- Durchbruch unmöglich scheinen -- 
  freistund Hof klammeren -- Hof liegen Fluß -- Tor trennen -- zuweilen Nachmittag öffnen -- Beamter setzen Kahn -- Treppe liegen -- angeln -- schließen Kahn -- fortzurudern -- Glücklich -- wissen -- beneiden -- 
  näh Gefangenschaft frei Welt Berührung -- desto schmerzhaft prickelnd -- Vergleichung heben schwächen Eindruck -- 
  Sonne scheinen warm -- schwimm Leichtigkeit -- jenseits Flusses locken offen Straße -- kühn Entschluß retten -- bestürzt Wache -- stehen -- schnell Laden Musket kommen -- groß Entfernung Unsicherheit Schusses riskieren -- Situation beschreiben -- 
  Situation -- Entschluß schnellen übergehen -- -- mißlich -- 
  geschehen -- drüben Pudelnaß an Land kroch -- hell -- licht -- fremd Stadt -- mitten Land liegen -- 
  war_es lockend -- 
  heben Fuß -- pocht Herz -- 
  schwer solch Ausbruch -- besonnen bleiben -- Leidenschaft stacheln -- Tor zuschlagen -- denken -- Hättest wagen -- -- 
  Kümmerlich Weinrebe rankt Hof Höhe -- kärglich Beet stellen Art Gärtche -- Wärter anlegen -- zuweilen Familie sonnen -- 
  Mitglied Familie Maßen garstig -- Junge -- Regenwürmer hackt -- widrig skrofulös -- beneidenswert erscheinen -- 
  -- Aufsuchen Regenwürmer liegen frei -- beliebig Zukunft -- angeln Fisch -- wünschen solch Junge -- Begriff Staat kennen -- Gedanke -- Kollision -- Wache -- Schließer achten -- -- 
  peinigend Unruhe -- Gefängniszustand -- Verfahren warten -- überflüssig -- förderen -- unnütz Interregnum -- Gefängnis -- 
  dauert Woche -- lechzt Veränderung -- Gefängnis -- unbekannte schmeichelt tausend Möglichkeit -- Flucht hoffen -- gut Anhalt -- letzter Abend schwer Gewitter -- 
  gefangen -- Sonne geschien -- Unruhe -- Pein befördern -- lockend Welt aussehen -- desto schwer Gefängnis -- 
  -- gießend Regen -- krachend Donnerschläg -- zuckend Blitz müssen Zimmer bleiben -- gleich Gemeinschaft Welt -- beruhigend -- 
  welcher Genuß Privataberglauben Unwetter -- 
  ungewöhnlich Erscheinung müssen Wechsel Leben ankündigen -- Unglück abergläubisch -- stark -- fühllos -- arm Phantasie -- 
  jeder Möbel -- jeder Buch Bedeutung -- postieren -- wiederkehrend Beschäftigung -- aufziehen -- linker Strumpf ausgezogen -- Licht anzünden auslöschen -- Bedeutung -- Einfluß Europa rückwirkend -- 
  -- hoffen -- Gegenstand tätig -- 
  -- einförmig wiederkehren -- unverrückt bleiben -- 
  toben wild Gewitter -- müssen -- 
  -- -- 
  hinunterkomm -- Blume verschwinden -- lieb Auge -- Weg erfinden -- 
  -- -- halten gefangen -- Herz Blume -- Ist ergehen -- 
  Welt wiedersehen -- Auge erblicken -- Gott -- Blume Verzeihung blicken nicken -- 
  -- 
  Sonntag Nachmittag Abschied Gefängnis -- -- -- Dürftigen Reiche Arm finden -- hoffen Veränderung Ort Verhältnis -- 
  setzen Inquirent Wagen -- Seite zugeschlossen -- hinaus Straße -- Spaziergänger -- sonntäglich geputzt eilt Lust Erholung -- 
  schneiden tief Herz -- schlecht Maß gewöhnlich Leute -- 
  Sonne Freiheit kosten -- siehst lang Beide Mal -- weit -- -- -- Abschied nehmen -- -- -- 
  Abend Tag finden fast dunkel Gefängnis -- Verzweiflung Vorbote -- Trostlosigkeit liegen hart Lager -- Geld -- Buch -- Tabak -- abnehmen -- Beschäftigung kahl Wand -- fichten Tisch -- fichten Schemel -- blechern Handbeck -- Staube Fußboden stehen -- 
  Wärter -- -- vierschrötig Mensch kahl kopfe -- fremd grob -- 
  äußerste -- begegnen -- früh Gefängnis zurückverlangen Paradiese -- wissen -- Kräfte Woche Zustand überleben -- denken -- düstre Loch -- Winkel Gebäude verstecken -- Blechkaster verdunkeln -- gering Anhalt -- herumtappend lang Abend -- Gedanke -- Hoffnung -- 
  Untersuchung grau Gesicht Unendlichkeit ankündigen -- Zustand dauern -- Leben -- o Mensch -- Mensch -- denken manchmal -- Dumpfheit aufwacht -- Mensch treiben Unverantwortliche -- 
  sehen -- draußen warm geschäftig Leben quellen -- Herz -- Auge lechzt Welt -- wenn_es einsam Wiese -- still Forst -- beschränkt Ackerknecht -- lassen dorthin -- denken -- Hauch eu Leben Webe mischen -- 
  Umsonst Wunsch -- 
  Existenz an Gefängnis verlieren -- an toteinsam -- dunkl -- Trostlose -- 
  -- Genaues -- wissen eigentlich jetzig Gefangenschaft -- erinneren -- Starrheit Taubheit erwachen -- Mauer lehnend finden zusammenschauert -- fremd Gesellschaft Kopfe wohnen scheinen -- Ding treiben -- eigentliches wissen -- 
  finden lang Vormittage Bewußtsein Eintritt Wärters -- erkennen Grausen -- Fremd vorgehen -- unbedeutend -- höchst gleichgültig Mensch -- lang -- lang tändelnd Liebe sehen -- Novell abwesend Geist auf zusammengewachsen -- völlig liegend Objekt Unterhaltungsstoff Furcht selber bringen -- 
  dachen Schauer Wahnsinnigen -- furchtsam zusammenkriech -- Nerv nachgerade zupassend erschüttern -- eintönig Schildwachentritt Flur -- regelmäßig Ablöse Stunde -- Nachtzeit -- zerrütten -- 
  Bett stehen nämlich Mauer -- Gang bilden helfen -- Wachtmannschaft vorüber trotten -- nachts eingeschlafen -- wüs Existenz vergessen -- fahren Stunde -- Schritt tief Ohr treten -- Waffe klirrten polteren -- 
  Gott bewahr ärgst Feind Zustande -- Wort Mutter -- einst gefangener gehören -- Stunde Anruf Wache antworten müssen -- Nervensystem zerstören -- tief Erde retten -- Nähe -- Geräusch empfinden -- 
  Gemache -- dreißig Fuß -- Erdwalle bedeckt -- überfiel Zuckung Krämpfe -- Wall schreiten -- 
  Mann quälen -- fahren Bewegung Arms Beines -- 
  schlimm -- solch Leben endlos liegen -- liegen -- schlimme -- scheiden schmerzhaft Leben Jugend -- obenein Entsagung -- scheiden -- leiden -- -- -- 
  gedankenlos gebraucht Bild Prometheus denken -- Herzenskenntni Griechen bewundern -- gewaltig Mensch erschreckend Einsamkeit Fels schmieden -- -- Mensch zusammenband Gott -- einsam -- starren Unendliche -- Leere -- Leber nagen Geier -- Abwehr -- Waffe besitzen -- -- Leber nagen einsam Kerker -- wühlen bohrt -- stöhnend Seufzer Erleichterung -- 
  -- vergehen -- schreiben -- -- Papier erlangen -- versiegen -- Fetzen -- grau schmutzig -- Hand -- 
  sagen hiesig Kerker -- wissen -- geweint klagen -- Träne -- Hilfe Leide_es Nähe glauben -- Leid Vorstellung Fähigkeit Schmerz passen -- Leid bleiben -- 
  litt Dergestalt -- denken -- fehlen Buch Schreibmaterial -- können wohltätig -- Gott wissen -- lang Nacht vorübergezogen -- -- erinneren -- zuweilen Schemel Tisch stellen -- versetzt Fenster hinauf -- schmal Lücke -- bleiben -- Streife blau Himmel sehen -- dürstet -- Wüstenreisender Wolke dürsten -- 
  hoffen -- Sonne müssen Linie passieren -- sehen -- -- Gefängnis liegen tief Mitternacht -- Sonne finden -- Querhaus -- 
  bemerken -- stet Sonnenschein draußen -- wonnevoll Frühherbst -- -- leiden erhöhen -- 
  historisch Erinnerung Haus -- traurig wissen grau angestrichen -- drüben -- Loche -- -- Kerker nennen -- -- verließr -- -- alt Wort -- finden fensterchen Wort Dante's Bleistift anschreiben -- devis Gefängnis finden -- Wort -- Lasciate Ogni speranza -- voi Ch'entrati -- Lasst draußen Hoffnung -- eintreten -- lassen draußen Hoffnung -- -- kopfe einzig -- ungedacht Gedanke herumgeklapperen -- eintönig Hoffnungslosigkeit leben -- -- 
  morgens -- bekommen anderer Gefängnis -- jetzig -- liegen Durchgegang -- Wachtposten vorübertrampeln -- versetzt Fensterchen tief -- sehen Blendenöffnung Spitze Baumes -- Vorteil -- Glückliche bereiten -- 
  übrige bleiben alte -- dennoch scheinen Fortschritt riesengroß -- elendr Glück wohlfeil -- 
  dauern -- Träne -- deutlich Bewußtwerde Mangel niedriger Grad Leid nötig -- leid Raum ausfüllen -- erscheinen Klage -- 
  schmerzhafte Sehnsucht Beschäftigung -- Anhalt regellos schweifenden -- Tod hetzend Gedanke -- 
  Gedanke keuchen zweimal dergestalt Punkt Verzweiflung -- entsetzen fühlen -- Grenze -- Wahnsinn entgegenstieren -- 
  werfen auf Bett -- drücken Kopf Kissen -- Gedanke berühren -- fangen wüssen Tumult -- schreien Stoff -- springen laufen umher -- versuchen -- alt Lied eingetrocknet Kehl rast -- krächzend beginnen -- Stimme rosten Mangel Übung völlig -- 
  -- Ruhe -- -- schri Wache Fenster -- Wache Korridor -- halten verlieren -- 
  wahrscheinlich just Wachen retten -- Zorn wacht finden Stoff -- Heißhunger Gedanke gefährlich Augenblick beschwichtigen -- -- 
  wissen draußen -- -- Mangel Langeweile beschweren -- euer Tür -- euer Fenster ebenfalls -- sehen Mensch -- sehen Tier -- euer Gedanke gähnen -- wissen Leid -- 
  euer Leben stocken -- denken schrecklich Gefängnis -- 
  menschlich Geist Kraft -- Anknüpfung äußerer bestehen -- 
  schwach -- 
  riesenmäßig Gedächtnis nötig -- produzieren Geist unablässig -- Geschaffen Weise außen Erscheinung Gestalt empfangen -- verwirrn -- Last -- Geistesarm Fall sogar -- 
  Trost finden -- traurig Eindruck paar Vers gestalten -- gewonnen Form befreien gewissermaßen -- geordnet Zustand erhalten Adel Beziehung übrig Welt -- Erniedrigung meisten brauchen -- 
  behalten freilich -- alt herschreiben -- -- Vers Platz wegnähmen -- 
  entschließen -- Prosa Absatz herzuschreiben -- scheinen grob Beleidigung Schönheit -- Figur schmutzig Schlafrocke Balle -- 
  rührend Bestrebe -- all aufschreiben -- Auge bringen -- 
  Unendlichkeit Gefängnis Tod selber -- jetziger Weise Lebenlang fortgehen -- beneidenswert scheinen -- Kerker verurteilen -- berechnen -- wahrscheinlich Weise Paar frei Luft Mensch übrig bleiben -- fördern -- 
  O Vers -- 
  Stunde langsam -- glauben -- stehen still -- müd -- abgehetzt Sinn Weiß -- -- zehnmal durchirren -- jemals erleben -- vorüber schwirren -- hoffen -- streben -- wissen -- Dumpf tot Liegen - Gott -- erbarm Not Wahnsinn treten nah -- 
  Glocke läuten draußen -- Leute beten Gott -- Sturmwind hören brausen -- O Glocke Sturm -- wecken Gott -- Weckt Gott -- helfen -- Kind -- heul Glocke Wolfe -- Fenster schlagen höhnend Wind Sonnenschein draußen -- Regen Wind schlagen Blechblende -- Herbst -- beruhigen -- Hypochondristen draußen spazieren -- 
  Sonntag -- Wärter -- Schmutz unsonntägliche rings alt traurig Gestalt -- 
  Sonntag Welt -- putz Leute -- hoffen Glück Geld Freude -- Hab bestes Hemd erwählt -- Sonntag -- siech Brust -- arg quälen -- Sollst Hemde laben -- 
  nahe liegen -- gottlos Mensch -- Leute Frage -- 
  suchen Trost Gott -- flüchtest -- Welt verlassen -- Schoß Religion -- 
  gestehen -- Ausbildung jetziger Jugend Festigung Charakter verwenden -- hoch Bezug hinein gewoben -- helfen -- Außenliegende suchen -- 
  gelingen -- Mensch Gottheit Religion nennen -- innerst Faser aufnehmen -- verlassen -- Welt verlassen -- 
  niemals -- innerer Halt Leid Entbehrung erschüttern -- ziemlich allgemein Zustand -- Theologie beklagen -- Probe halten -- 
  falsch -- wünsch Glück -- Stande -- Einklang bringen -- glauben -- Traditionsgläubig fest Anhalt Seite finden -- fürcht -- übrig selbsteigenen Stütz Charakter -- selbstgezimmert -- schwach unkräftig -- 
  Manne -- Vereinigung Gegeben Selbstgefunden schaffen vermögen -- leugne -- Standpunkt Allgemeinheit unzugänglich -- unverlässig -- aufgelös theit völlig Irrreligion bewahren -- Einzeln umfassend -- gegliedert Ausbildung erhalten -- leugnen -- erfüllen -- Staat sichern halten -- Gedanke außerirdisch Art Gesetz Glaube vereinigen -- beklagen -- Vereinigung mehrere hundert tief erschüttern -- Existenz falschen nennen -- Strenggläubige falschen nennen -- 
  Spott -- Hippolyt -- -- romantisch Egoismus -- Gesellschaft bekämpfen -- frech Forderung ursprünglich Menschlich -- Anfeuerung Befruchtung Einzeln stets lebendig erhalten sehen -- Typus ausgeben -- beginnen Bestimmung ausgedehntest Weise -- Kampf bekämpftwerden -- 
  sehen Leidweise Versuch -- Tradition geistig Hilfe herstellen -- erkenn Geschichte Wesen Jugend -- solch Versuch Religion herrschend Bildungspunkt Abgesondertes erhalten -- Religion Mittelpunkt -- Blüte Bildungsnuance -- 
  Reformator Ketzer -- Katholik nennen -- Auktorität lösen -- Philosophie ergreifen -- Schlucht breit -- breit ausdehnen -- 
  schließen Philosophie Religion -- Vorausgesetzt -- -- hören -- Philosophie souverän Staat -- einverleiben -- kehren Friede -- 
  Trennunge menschheitlich Entwicklung nötig -- begehen Torheit Lüge -- aufheben -- Trennung leugnen -- 
  jetzig Welt spinozistisch infizieren Herz hinein -- Spinoza Persönlichkeit Gott -- fließend Konsequenz monarchisch Staat leugnen -- datieren modern Republikaner -- streng-monarchisch-kirchengläubig -- Monarchismus Sitt Gebrauch Puritaner verfechn -- Durcheinander bleiben niemals -- Monarchist -- glauben -- 
  datiern eigentlich Auflösung innerlichen -- alt Zustand direkt Spinoza -- 
  Kant -- innerst Grund Ausfluß Jude -- deutsch Welt tief lösen -- Anblick revolutioniert Frankreich -- 
  prosaisch Verstand irden Nützlichkeit ähnlich Großem Gewaltig stärken -- unser Deutschland sehen Matter bleich -- denken Mensch feurig -- Verhältnis Herkomme einrahmen -- hören folgend Königsberger Philosoph -- harmlos erscheinen Bezug Wirklichkeit Staat -- 
  Kant entsetzlichst Handlung Konvent erfahren -- Ludwig XVI -- betreffen -- rufen -- 
  -- Herr -- laß dein Diener Frieden Grube fahren -- Auge sehen -- 
  -- zweifeln -- tief Schlucht liegen -- dünn Pflanzengeschling sehen glauben -- -- 
  neu Philosophi Vermittlung einschlagen -- groß Einflusse -- jung -- Frieden lassen -- 
  zusammengehn Religion Philosophie nahe -- Glaube verlangen -- Gedanke ausgeschmücken -- Gedanke Thron setzen Einzig -- 
  bloß Handinhandgehn -- 
  Verhältnis Zustand schämen -- 
  trocken vernünftig -- Dogma anzugehören -- Weg Gedanken zukommen -- fühlen poetisch Ahnung hineingedrängen -- Unsichtbar vordefinieren wegdefinieren lassen -- 
  glauben Kraft Gebetes -- Unglück -- -- Kraft finden -- selber Kraft gewähren -- 
  Gottheit bloß Begriff verdünn -- launisch Despotismus ausbilden -- Einzeln schenken nehmen -- Eindruck -- glauben vielmehr -- Schöpfung persönlich -- individuell Mensch individuell Möglichkeit legen -- gesetzlich Welt -- Freiheit jeglicher Ausbildung Zusammenstellung tragen -- 
  Ehrfurcht Individuum -- Bezug Einflusse einzeln Gebet wichtig Moment -- gestatt -- millionenfach verschieden Weise darstellen -- 
  anderer gewöhnlich Ausdruck besagen -- 
  bitt Individualität -- Ansicht Gott Welt -- grenzenlosen Bewunderung Weltgebäude -- erkennen -- Bitte angemessen -- unbefangen Natur drängen -- ist_es Geschenk unmotiviert herzensstund -- Mensch Liebe sonstig edl Drange zuweilen gewähren -- geben Träne -- fühlen Seligkeit -- Moment innerlichst Erregtheit tätig -- nächster Anknüpfung hoch Welt -- 
  äußern Weise -- höchst selten eigentlich Gebetform -- äußern reinsten -- uneigennützig Liebe menschlich Wesen -- -- Offenbarung Geschichte Natur -- Verhältnis Welt -- plötzlich aufgehen -- Empfindung -- öffnen selig Auge Gott heiligsen innerer Mensch -- 
  gestehen -- kläglich jämmerlich vorkommen -- just tief Elend Gebet aufsuchen -- niemals nahe treten -- niemals -- Verleugnung -- 
  innerst Gedanke verwahrlost Mensch Göttlich -- lüg Frevel -- sünd Terminologie nennen -- Glück bekehrt Herkömmlichem -- Wesen fremd -- Unglück nimmer -- 
  geheim -- gut Stolz Lebensodem moralisch Existenz -- respektieren -- Bösewicht -- 
  Gott bitten -- Bettel erlassen -- solch Verhältnis -- bitten -- eingreifen mögen traurig Schicksal -- ruckweis regieren Welt segensreich Trost -- wehe -- leichtsinnig Mensch rauben -- Fremd -- momentan Stärkung -- sonstig Ansicht verlieren -- 
  Gott sprechen -- Individuum unverloren bleiben -- 
  -- Demut -- -- Dogma heischen -- vollkommen -- 
  Glaube -- aufnehmen -- Innerlichkeit zupassen -- Stande -- frevelhaft halten -- lügen -- 
  glauben -- Stunde elende -- antwortreich Verkehr Gottheit finden -- denken Welt Geschichte regierend -- 
  antworten heraus -- erachten richtig Verhältnis finden -- Unterhaltung alt Patriarch Erde erklären -- Erklärung brauchen -- einsiehen -- Mensch Verbindung Gott -- Mensch Mensch -- 
  brennend Busch sehen -- Säusel Lüfte hören -- Todesschweige Wüste Kerker -- 
  --- schmutzig Blatt sehen Solltest -- Würdest lächeln -- Meinung echt deutsch letzter Stückchen Papier metaphysisch Redensart verbrauchen -- 
  gesammelt Gott denken -- Art Weise -- Mensch Erde untereinander einrichten -- Einzeln ausstoßen Gefängnis Tod -- 
  nebenh Beschäftigung erfund -- täglich Flasche ordinär Bier verabreichen -- Kork Bindfade festhalten -- 
  Stückche sammle -- flecht -- Fasre -- Art Lunt erschaffen -- 
  stehen Stunde heißen Ofenröhr -- Kälter -- heizen -- wart -- entzünden -- 
  Ofen nämlich draußen feuern -- Pfeif Restche Tabak geben Fall -- Freistunde bekommen -- Hof rauchen -- Feuerzeug Gefängnissen gestatten -- rauchen streng untersagen -- Pfeife Lorgnette -- lassen -- sehen ironisch -- Lunt entzünden -- streben Beschäftigung -- 
  neu Schmerz außen hinzugekommen -- Gott Wille draußen Forderung -- Wand dick -- Schlösser Gitter fest -- werfen Skorpione Einsamkeit -- helfen -- gebieten bloß Schritt Raum -- 
  alt Vater Sonntags Kanzel kommen -- Pfarrkind treten -- fragen -- -- Reisender erzählen -- alt Pfarrsohn Verbrecher -- 
  Tritt Beschränktheit nahe unkundig Teilnahme -- unerfahren Vorwurf -- Lähmung vollständig -- 
  Vater jammern fragen -- helfen -- Antwort -- fehlen Papier Feder -- Tortur Brief Billet Camilla's hereingelassen -- mond Verbindungszeich Welt -- traurig Grabesflor -- verhängen Welt draußen weinerlich Wolke -- Welt -- schmachen -- 
  wünschen -- 
  Unglückliche Kamilla -- 
  Grünschloß Nachricht geben -- -- Himmel Erde aufgebot fremd Stadt -- dringen -- helfen -- liegen erschöpft danieder -- helfen -- -- Wand laufen -- 
  Eisenstäben Liegt weit -- offen Feld -- Liegen Freude -- liegen Leben -- Gott -- schön Welt -- Träne -- Träne -- brechet hart Stab - Ferne Sonnenstrahl -- sprechet schön Welt -- 
  schmerzen unsäglich -- Herz still stehen -- 
  Welt täglich -- Sonne untergehen -- 
  Abend Abend -- Geier dick gefress Eingeweid -- still -- Lied bleiben schlaflosen Nacht garstig Gefängnisschluß -- golden Säl Mensch -- wählen -- Vergnüglichste -- 
  weinen blass Vater dunkl Abend-Not -- fehlen Trost Rather -- Kind schrei Brot -- 
  wandeln liebesleut dunkel Straße -- kichern laut Freude -- fröhlich Lebenssinn -- 
  sitzen trüb Kammer gefangener Qual -- einsamen Jammer -- schwarz Gedanke Zahl -- 
  schweben Himmel Stern still -- 
  Menschenleben -- -- -- 
  Wißt -- Resignation -- 
  versagen Freude -- entsagen Notwendig -- leben -- 
  trostlos Vater -- verlassen geliebter Wort beistehen -- ruhig -- Schlafe -- essen bescheiden Kost -- -- resignieren -- 
  Gedanke -- Eindruck -- Paar erfüllen -- solch stechend Schmerz Gewinn Öde Langeweile -- 
  -- Hippolyt -- Redensart bekleiden -- halten Unrecht -- nackt -- schonungslos Wort wählen -- -- vorhanden -- 
  Körper verschleimt verstopfen -- Freiheit Tür -- ist_es Leben -- 
  Welt Fuge reißen -- allgemein Geglaubt Geachtet übrig bleiben -- lohnen leben -- 
  Bewahrst Nerv Strafe Stricke -- -- Hilfe körperlich Elastizität hie Reiz gewinnen -- Verworrenheit pikant Anblick ineinander dichen -- Zustande laben -- Körper blasieren -- -- 
  Ruhm -- 
  Nahrung kindisch Eitelkeit -- Teilnahme -- Freundschaft Liebe -- 
  Zufällig -- just Leute Berührung kommst -- -- scheinbar besitzest -- Nacht Laune -- Krankheit rauben -- 
  Menschenentwickelung -- erhitzest -- 
  langsam mannigfechen Werdend -- Ewigkeit bemächtigen -- Schlüsse Folgerung scheinbar Endpunkt täuschen -- Hand ewig unerklärten siehst -- 
  Poesie -- 
  Spielerei Deines Herzens -- Herz Kraft erfinden -- kombinieren -- empfangen genießen -- Kraft ausgehen -- -- 
  Elastische Fähigkeit Kraft -- bedingt -- fehlen -- groß Reichtume Blasiertheit -- künstlich Wort -- aufnehmen -- garstig Ausdruck -- Stumpfheit -- umgehen -- 
  Auge schließen -- -- schlafen -- 
  Klägliche -- schwächlich Geschöpf -- Zorn Gefängnisherren richten -- eingefügt Zusammenhäng -- Einzeln spotten -- unzulänglich Mensch erfinden -- 
  Gefängniswärt hassen -- schnell Hand weis Tadel -- -- Mann -- 
  -- -- Schritt -- -- 
  Mensch -- Mensch -- Lust -- völlig aufgeben -- Nacht Öde versinken -- 
  --- klug Prometheus -- sterben -- 
  Leben schwer -- Tod unmöglich -- 
  schlafen -- 
  Grau -- grau vorübergeschlich -- vorübergekrochen -- Geschöpf erbarmen -- mäusch -- -- 
  eigentlich Tier leiden -- Wüst hören fein Unterschied -- Ding lebendig Wesen -- unabhängig Bewegung -- Selbständigkeit Öde leer Abwechslung -- sagen objektiv Abwechslung bringen -- 
  ruhig Schmerzenslager liegen -- wagen -- Brotkrume suchen -- zerstreuen -- 
  fehlen -- knupperen Stiefel -- wissen -- Stiefel brauchen -- gläsern Auge -- Bewegung Körperchen deuten wohlbefind Behaglichkeit -- Tier beneiden -- 
  Pfui -- schwach -- 
  Kreis Existenz heraus -- Existenz verlieren -- 
  Sperling setzen zuweilen Spitze Blechkasten -- gewähren Unterhaltung -- bleiben -- gewähren Freude -- bringen Märchenwelt -- 
  Hüll weiche endlos Gewänder -- Auge Ohr verschließen -- fremd Welt sinken -- Traum Glaube gefällig Träger -- Geist Hilfe -- reiten Sanft Rücken Vogel Rock -- südlich Wüsst -- Gebirge Wasser -- nachts Stern umher -- links grüßend -- rechts -- 
  Stern nämlich wohnen verteilen Mensch -- jemals wert -- reichen Hand Vorüberflieg -- wünschen glücklich Reise -- -- Herrgott Kleinigkeit -- Märche -- Wahrheit -- neu interessant Welt -- geben Kombination -- Dichter herrschten -- Phantasie herrschen -- 
  nächster Zukunft Märchenzukunft -- stürben -- müssen finden -- 
  Gefängnis -- Fliege -- Sperling flögen -- 
  -- 
  wechseln Menschenherz -- stet erwachen schmutzig Loche unnennbar schmerzhaft -- 
  manchmal -- fest Schlaf Traum beglücken -- wachen rüstig -- erkennen entsetzen -- -- Traum märchen -- können Blasiertheit Kerker retten -- -- -- 
  Steigt herunter golden Wolke -- 
  laufen Gedanke herum -- Wort -- Welt tief Mysterium -- Hasch -- fliegen fort -- 
  lausch Stunde -- Geist nennen -- hören verworren Klang -- -- all Wissen -- -- -- 
  sprechen laut -- Empfand -- durch Herz ziehen -- solch bunt Tand -- klein armselig Lied -- 
  unglaubliche geschehen -- Veränderung -- alt -- längst gelesen Buch -- Gefängnis -- verabreichen -- 
  Lektüre helfen -- schreiben weiß Plätzch voll -- Ränd Gedruckt bilden -- Titel- Schlußblätter bieten hoffnungsreich Raum -- 
  Freude -- ereignet Größeres -- 
  Bette liegen -- Vormittag kurz -- hören Wand Geräusch Stimme -- 
  unterscheide -- Gefangener einbringen -- sehen Hoffnung deutlich herantreten -- Verbindung -- Gespräch -- Verkehr Mensch treten nahe -- -- 
  übereilen -- lassen mehrere Stunde vergehen -- 
  still tot -- klopfen leis Wand -- erschrecken signalartigen Geräusch -- bleiben still -- fasse Herz -- Wache Korridor abwärts schreiten -- klopfen stark -- bleiben still -- leise -- leise -- Ferne hören Erwiderung Klopfens -- 
  Vorsichtig -- langsam steigern setzen Versuch fort -- Winkel -- Bett stehen -- leichtest schallenden aufgefunden -- 
  Wag sogar -- heiser geworden Stimme hinein schicken -- Wache verhindern Höhe Stärke -- still -- Bemühung Jammer vergessen -- Kerker belebt Winkel -- existieren Augenblick -- Abend -- gewinnen -- wissen Name Nachbar -- Monat sitzen -- freilich verstehen -- wissen -- Mitteilung deutlich -- selig -- Klopf -- verbürgen Menschennähe -- Todeseinsamkeit vorüber -- 
  Papierlappe fehlen -- Nachbar Unterhaltung einrichten -- wobei Wort verlieren -- Anknüpfung wirklich Leben -- 
  Gott -- Trost Menschenstimme -- Gespräch Grabesschweige -- 
  gefangen sitzen -- wissen schätzen -- Menschennähe sagen -- 
  liegen groß Tag Bett -- Gesicht unten kehrend -- Stellung -- unbequem Länge -- Nachbar verstehen -- 
  Glückliche Buch -- Faust -- Dr. Katzenberger's Badereise Gerichtsordnung Heimat -- Sache fünfmal durchgelesen -- beginnen Kursus -- Anhalt gegeben Ding -- groß Wert -- Punkt -- Archimedes außerhalb Erde Umgebung suchen -- Erdball Bewegung setzen -- 
  lesen -- obwohl Wand verschlingen -- Minute Pause eintreten -- Wache vorüberschreiten -- genieße -- 
  freilich aufpassen -- Wärter Aufseher nahen -- Wir_e bemerken -- Herrlichkeit schnell -- 
  eingeüben -- Paar Wilde -- still Urwald flüchten -- Entfernung Tritt Hirsch Panthers -- Rothaut weiße unterscheiden -- 
  Signalruf annehmen -- nahen hören -- Möglichkeit Gefahr wittern -- rufen -- Hugh -- -- schweigen sogleich -- 
  Beneide Romantik -- Öde kommen -- stählen Nerv -- 
  Bett zurecht -- 
  Unterricht nächster Kammermädch -- wundern -- -- egoistisch Feind Menschenverein Gefängnis entgingest -- Kenntnis nötig -- 
  Anfang Weiber Harem erniedrigt Bettelsardanapal -- Abends zerwühlt Lager stehen -- Hand gebrauchen -- -- traurig Wände schwinden Illusion gemacht Ehre -- notwendige verhöhnen drängen herkömmlich -- nächster Bedürfnis hören -- 
  gedeihen -- 
  selten oberflächlich ausgekehren -- abgestäuben -- Luxusartikel -- Wärter -- dreißig gefangener obliegen -- -- Schmutz arg -- bleiben lähmend Schmerz -- Wäsche schmal Kostgelde -- Wärter auslegen -- abspar -- bleiben übrig -- bisweilen grau Blechhandbecke herzunehmen Tasch Handtücher waschen -- 
  Weltverbesserer bedürft Unterricht alt Weib -- 
  Leben Tasche voll Ironie -- 
  -- wir_es erzählen -- Nachbar -- Spaßhaft -- Notwendigkeit folgen -- Stelle legitim -- gerechtfertigt Objekt ausgebeuten -- 
  schlimme gestehen -- vierzehn Gespräch Bekanntschaft abgenutzen -- mitunter trockenen -- 
  Aussicht -- loszukommen -- -- kümmern Sorge -- Lied -- 
  singen gefangener -- 
  ziehen Schwan Süden Nord -- suchen alt Freund - Freund fort -- 
  ziehen Schwan Norden Süden -- suchten alt Ufer -- verwüsten -- verblühen -- 
  Heimat -- Freund Welt -- 
  Fels Kopf zerschellen -- 
  einst befreaten -- kennen -- bleiben sterben -- Welt wüst leer -- 
  Sommer scheiden -- kalt Wind fallen Dach nieder - blau Himmel Farbe Grau verblichen -- 
  Welt Letzt -- hell Milde -- wissen -- geschehen -- Bild -- 
  fühlen kalt Wind -- Sehe Blatt fallen -- fern Liebe sterben -- hören Glocke hallen -- 
  wunderst -- -- worin Mittelpunkt Elend ruhen -- Staat -- denken zusammenstelle -- wundre manchmal -- -- 
  -- 
  Staat konstruieren Sieyés -- -- mehrere Exemplar Staat Tasche -- 
  definieren Luft Sache -- glaubst -- Gedanke -- zaumlos frei geben Pferd Ukraine unabsehbar Steppe -- glaubst -- Irre müde -- 
  denken geschäftlich Leben -- tags einsam Stunde gewähren -- Darstellbare -- Innere brauchen Abwechslung -- Anregung -- schaffen -- Körper -- kräftig entwickeln -- 
  abgesondert innerer -- Schwärmerei -- 
  toben -- Staat Gefängnis brauchen -- 
  Staat erhalten -- 
  moralisch Gefühl -- -- innerst Ehre nennen -- verlangen groß Milde -- hart betreffen -- Rache unehrenhafte dünken -- 
  Gefängnis anbelangend -- unabhängig Kommission Humanität Staat errichten -- Gefängnis kontrollieren -- -- unabhängig Gericht Regierung -- Rücksicht jedesmaligen -- speziell Fall gefangener -- verfügen -- 
  Untersuchungsarreste wund Fleck -- erheischen streng Aufsicht -- strafen -- meist schmerzhaft Strafarrest -- jedenfalls Leiste -- Mitbeteiligt Untersuchungsrichter überlassen -- Erreichung Zweck fein Torturgrade Gewalt -- 
  siehsen -- bloß Administratives -- Staatsspekulation schaffen -- halten Nachst -- klug -- 
  -- säße schwerlich Loche -- 
  Kenntnis Förderung sonstig Politik benommen -- Politik liegen tot -- Staat Gefängnis erfinden -- 
  politisch Fluktuation Übel -- -- Staat erfinden -- lassen -- wachsen -- 
  echt -- historisch entwickeln Mensch -- Pflanze -- -- 
  Ereignis dasein -- Buch geben -- mitbringen -- 
  freilich lesen -- Buch -- überall Mensch -- Wand halb Gesellschaft -- Tisch gedruckt Buch -- 
  Fortschritt -- 
  Schlegel Philosophie Geschichte -- Buch -- Demütigung Mensch schreiben -- wozu Gott Stolz kühn Kraft geben verweben -- vernichten -- 
  fühle_es -- groß Gott -- Bewußtsein Tüchtigkeit wohlgefällig -- 
  Verlassenheit überheb kläglich Ansicht entmutigt Schlegel -- 
  find Buch Beschreibung indischen Einsiedler heilige -- Beschäftigung -- äußerer Einsamkeit zusammenfallen -- 
  Mensch -- fanatisch Glaube treiben -- 
  erschrecken -- klein -- skeptisch Kultur unerschütterlich Anhalt nehmen -- Fanatiker erobern Stück Gottheit Stück Tier -- 
  Leute stellen Einsamkeit hoch Postament -- mitten verzehrend indisch Sonne hinein -- strecken Arm Höhe -- erstarren -- verwächsen Richtung -- sehen blendend Sonnenstrahl unverwandt Auge erblinden -- denken Gottesgedank -- Gottheit versinken -- gelingen -- Menschengeist versänken -- 
  halb Bildsäul -- Vögel bauen Nest -- Wallfahrer beten Anschaun heilige -- 
  Schritt umhergehn -- liegen -- sitzen -- denken -- -- bequem Menschenart -- Mensch -- 
  stellen manchmal Zeitlang Fensterblende -- sehen Himmelsstreife -- strecken Arm -- denken Gedanke -- wirblig -- erschöpfen Zusammensinke -- 
  empfinden -- beneidenswern -- 
  welch kalt Strom Einsamkeit hergewälzen -- 
  Fassung -- schildern -- 
  gestern entschlossen -- klirrend Schritt Ordonnanzsoldat unser Wächter Korridor entlang -- legen atemlos beben -- Schritt Zelle halten -- Name rufen -- Schreckhaft -- 
  Denke -- Nerv zerstören -- Verhör fördern -- traurig Zustand ändernwenn gut verwandeln -- schlimmsen Fall Strafgefängnis Erholung Untersuchungsarrest - fürchten Verhör -- Ankündigung -- Klopf -- Namensruf -- hastig Ankleid -- Gang dunkel Korridore -- 
  Tritt Ordonnanz hören -- wünschen stets -- mögen vorübergehen -- denken Henker -- Todesurteil bringen -- beben -- 
  Ungestörtheit -- unbeachtet Zusammenkauer traurigen Kerkerschmutz wünschen furchtsam Seele -- Furcht Körper Seele bringen -- Mut hineinbringen -- deutlich Vorstellung Blödsinnigen -- Winkel kriechen -- sobald nahen -- 
  glaubst -- -- krampfhaft Erinnerung stolz Mensch -- einst -- zusammenhalten -- hinein klammern -- kläglich Wicht -- 
  Sporenschritt Ordonnanzsoldaten halten still Türe -- Atem stocken jagen -- klopfen -- Name rufen -- schritt Korridor -- 
  Ordonnanz bärtig -- freundlich Mann -- -- blaß -- Bart -- -- mehrere Monat Verhör holen -- 
  Tür flüstern -- 
  bring Richter -- 
  neu Schreck -- -- 
  ist_es -- -- -- Herr Oberrichter -- -- 
  lang grün Tafel sitzen -- schwarz kleiden -- Rücken Tür -- eintreten -- Protokollführer -- Zimmer -- still -- umzublicken weisen Hand Sessel -- -- Oberrichter stehen Schlag treffen -- Konstantin -- 
  zuweilen halb Blick -- inquirieren vortrefflich -- einstig Jakobiner kennen Gedankengäng -- Plan Zustand -- interessant Verhör -- 
  Stil -- Ausdrück -- Wendung -- gemeinschaftlich aufsuchen -- üben -- benützen -- 
  letzter Wort schelln -- ehe Name unterzeichnen -- Ordonnanz Gemache -- abführen -- 
  -- Wort miteinander sprechen -- 
  Leidenschaft -- Stärke Eindrucke eingekehren -- hört Begierde Tritt Ordonnanz -- Klopf Tür -- Namensruf -- o Zorn -- machen straff tüchtig Liebe -- feindlich Tat meisthin gewaltig -- 
  empfangen Vorderzimmer -- offen Stadt sehen -- Licht blenden -- Ferne erblicken harmlos -- frei gehend Mensch -- Wintersonne Glanze scheinen entgegen -- niedersinken -- bestürmen plötzlich Eindrucke -- Fensterscheibe springen trunken Drange Freiheit -- 
  -- Zimmer umher -- 
  Folgend Rede -- -- sprechen Richter -- Jugendbekannte -- 
  kenn Gedankengang -- wissen -- gewiß Stolz überheben -- -- Unterdrückt stehen -- Gewalt -- anfängen Lebensgeschichte -- gemeinschaftlich erleben -- glauben -- jetzig Stellung Unwürdigkeit sittlich Mensch zusammenhängen -- Beginn damalig Lebensansicht Anblick harmonieren -- 
  Folgerung widersprechen -- innerer Schicksal falsch Richtung geben -- falsch Position bringen -- Wort Lebensentwickelung mitteilen -- 
  förmlich Weise -- wiederangeschlagenen Tone kordial Bekanntschaft beginnen -- erklärlich -- bemerken -- Persönlich Art Form unterordne -- -- gewaltsam schonungslos unterordne -- Ansicht jetzig Punkt kommen -- Form -- eigentlich Bildung -- losgelassen -- Innerlichkeit frei gegeben Mensch ewig Feind zusammenleben -- 
  Jakobiner -- Vergötterer Revolution Paris -- erkennen langsam -- sicher -- Gesellschaft Grund müssen -- Regung unbändig Mensch Folge geben -- 
  erfindend Mensch -- Genie -- wild grausam -- entsprechen reißend Tier -- ebenfalls groß Potenz Tierwelt vorfinden -- Nachteil Umgebung leben -- überall Tod verfolgen -- 
  Schranke erfund -- Form nennen -- eisern -- desto wirken -- 
  äußerer Endpunkt Revolution gewinnen anderer Herr -- anderer Diener -- -- gelind Verhältnis -- 
  Verhältnis -- Form -- just Entstehung bedrohen -- 
  Heiligkeit Form zerreißen -- -- 
  Auflösung gebären -- just Wildheit Tor öffnen -- erfinden mächtigsen -- 
  halten gelind Verhältnis Gewinn -- 
  führen Überhebung Niedrigeren -- selten gehorch -- Leichtere leisten -- Lösung Nichtbeachtung nah legen -- 
  erwarten Maß fein Sonderung Erlaubt -- Verhältnis fein -- 
  müssen Rohheit Erde weichen -- Urelement -- 
  Hinaufexperimentiere bringen immerwährend Wechsel -- Mensch Schritt verlangen -- stellen -- bringen Blasiertheit -- 
  -- 
  Welt Unterschiede begründen -- erforderlich -- Drang -- Interesse -- aufhören -- beginnen Öde -- 
  Paris -- -- Lebtag verwinden -- 
  Verstand Kreis -- Existenz schaffen -- Schluß Notwendigkeit fest begrenzen -- Herz stammen Geburt Welt -- Jugend revolutionär -- Herz verarmen -- künstlich aufrecht erhalten -- 
  Revolution Leben verschlungen -- Automatenschatt -- ißt Trinkt -- küssen sprechen -- laufen -- mißverstehen -- 
  Herz hängen Revolution -- o -- beneid Schwärmer -- schwunghaft Leben unbezahlbar -- Schwärmerei -- richten -- wollen -- 
  unnatürlich Gegensatz -- wohinein geraten -- drängend Leben töten -- phantasieren -- täte künstlich Wahnsinn -- bewußtvoll Arm stürzen -- bemächtigen -- stark werdend -- 
  Dämon schließen -- stark Geschwung -- kalt Herz isolieren -- 
  veröden gewinnen Julia -- schön Mädchen -- Gesetz Maß finden -- beid Geburt stark herausdrängen -- Schutz suchen Wildheit Hippolyts -- 
  Frau -- gelieben -- -- tobend Hippolyto -- reizend Geschöpf Form hinein verziehen -- umgekehrt Unglück -- natürlich stark Kraft Haus zusammengeschnürt ersticken -- Mut dreist Kraft Freude -- elastisch Existenz nötig -- freuen -- Freude anständig Weib erlauben -- verlieren persönlich Lust Julien -- 
  Hippolyt ergänzen gelungen Paar bilden -- -- Anlage formell Geworden müssen versteinern -- müssen versteinern -- dasjenig -- Arm führen -- Mord eigentlich Leben -- Mord Leben -- 
  lieben -- 
  eingesehen -- -- Lebenswechsel eintreten -- Herz Kosten Bildung erwürgen -- lieben -- 
  stellen -- Verhältnis Form -- zärtlich -- Sinn Hilfe -- glücklicherweise wissen Verstellung -- einzig Glück -- blühen -- 
  Kind zeugen Haus gelten musterhaft Paar -- Welt Weg -- Opfer einzig Trost -- Drahtschnur gehen -- Unrecht -- Welt schwer fügend Ordnung tragen Schuld -- 
  sehen -- Opfer -- -- größeres -- traurig Gefängnis bereiten -- gedeihen Staat -- verderben -- 
  Glaube nehmen -- geben Tod -- 
  Gefängnis -- klein -- Menschenerfindung -- Staat notwendig -- -- 
  -- nächste -- entgegnen -- -- Wechsel Staatsansicht gewaltsam übereilen -- Mal geistig Blutumlauf Herzens gewenden Keim Tod Herz legen -- 
  -- interessieren Blasiertheit Augenblick wissen -- bloß Manier -- stören -- Verhaftung bewirken -- streng Grenze eingedrängen -- sehen -- Meinung -- 
  unser damalig Umgang liegen Fruchtknot Leben -- verdorren -- Reiz -- fähig -- gewähren Leben Verhältnis -- 
  sagen -- Standpunkt Meinung -- -- 
  Gott wissen -- Entrüstung -- 
  ärgsn betroffen scheinen Versicherung -- eigentlich Revolutionär -- Gefängnis betreten -- niemals Verzweiflung Ansicht geraten -- besonnen ruhig -- 
  totenbleich sprechen -- schied -- Dunkel -- 
  Wenige -- erwidern -- erinnern öfters wiederkehrend Wort -- 
  Befreie -- einleiten Verfahren -- 
  Ermiß -- Sturm mehrere eng Käfig durchgeleben -- 
  wohin geraten Mensch -- Heil äußerer Gegensatz suchen -- 
  Mangel Papier Folgerung Szene -- reichlich gehrt -- aufheben -- bewegen Ding -- 
  freistund -- freilich bewilligen -- o -- Ereignis -- 
  Hof führen -- hoch Mauer umgeben -- Aufseher schlagen Feuer Pfeif -- 
  Mann beneiden Stück Schwamm -- Endchen anbrannen -- 
  Instinkt lassen alsbald klein -- klein Stückche abreißen -- dunkel Kerker sparen -- 
  Wache Aufseher -- Seite Hofes Gefangener -- bärtig bleich -- blasen Stummel anscheinend Mut Rauch Lüfte -- 
  Wort sprechen -- 
  Luft dick düster -- regnen Schneite -- Gesellschafterin -- Maus -- Loch Stiefel nagen -- Übelstände -- schlürft Gefängnisfreiheit voll Züg -- Welt -- Leben -- nahe treten -- 
  Stunde Gegenfüßler Rapport treten -- allmählich Zwischenraum -- trennen -- -- Wächter Regens halber Schilderhaus gekrochen -- flüstert -- freilich verstehen -- lacht -- Trost -- 
  lachen -- 
  Äußeren sprechen Verhöhnung Kette -- heben selber -- 
  Regen plötzlich heftig -- werfen schnell Fuß -- -- fiel Pfeif Erde -- lügnerisch klug Unterdrückung -- heben -- 
  Stein -- Beihilfe Feuerschlag -- nächster Begegnung deutlich -- Hosenschnalle -- -- wahrscheinlich Stelle Stahl vertreten -- -- zucken Achsel -- zucken lachter -- 
  Plag Schnalle Tragebandes -- Feuer schlagen -- Steinch Feuer -- schnall Stahl -- schlagen Finger blutig -- Arbeit nächster Ziel -- Fortschritt Kerkerleb -- wissen -- Stunde tags existieren -- Freistunde -- 
  fragen -- Monat Welt -- gewich -- anderer Mensch kritzeln Wort -- 
  plötzlich Eindruck frisch Luft nämlich verheerend Leib stürzen -- brechen -- freistund Gefängnis -- Besinnung entwich -- Wärter -- Woche hitzig Fieber liegen -- 
  teuer Jugendlebe -- meinig -- entweichen finster unbeachtet -- 
  find Tasche klein schmutzig Blatt folgend Vers -- beziehen -- lauten -- Weiß Eure Richtertugend -- nehmen -- 
  -- Jugend -- langsam begraben -- 
  Jugend Leben Frühling Grün -- wiedergeben -- Jugendblüh -- 
  alt -- leben -- Herz schlagen kälter --- Gott vergeben -- 
  trauern -- Bedeutung Wort empfinden -- unnütz Trivial erscheinen -- Klage Zorn -- Stumpf -- Stumpf -- 
  kümmert_es -- Glanz Schmutz existieren -- kümmert_es -- 
  Gesellschafter Kerker geben -- Loch eng -- sitzen -- herumgehen -- 
  sprechen Mehrere -- Genoß -- baumstark Mensch -- sitzen lang -- tief grollt -- Abgeschiedenheit fürchten mitunter vorbrechend Wildheit -- Furcht Hoffnung abgäbe -- 
  Gestern Abend äußern -- schweigend Bett liegen -- -- wofür Augenblick interessiert -- nämlich -- 
  Kammer Licht Bett stellen -- Solchergestalt Feuer ausbräche -- müssen schwer verschlossen Zelle verbrenn wild Tier -- müssen merkwürdig Geheul geben -- 
  dreißig Tür -- doppelt dreifach verschließen -- Mann Schlüssel -- Rettung Rede -- 
  Abteilung -- tüchtig Feuerschmaus hundert Revolutionär -- Staat Beunruhigung -- 
  --- mitunter grob lustig lachen laut -- Wache verbieten -- 
  glauben -- Mensch brauchen solch Reiz -- bieten -- roh -- 
  verwundern -- -- Verbrecher Kette lustig -- Natur helfen -- Gemeinheit Rettung -- 
  wozu schreiben Gedanke spinnen -- 
  Brücke abbrechen -- Welt hinübergehen -- Bleistift -- schreiben -- leben ewig -- 
  4. Valerius Hippolyt -- 
  kommen -- hoffen wagen -- 
  Woche and Gefängnis gestatten -- Hof freistund Sonne hineinzüngelen -- -- manchmal schmerzlich Stich -- Dunkel unser Gefängnis müssen -- Mitternachtseit belegen -- 
  obwohl Stumpf gleichgültig -- Sonnenstrahl -- eigentlich Gotteslebe -- zündet Flacke ausgebrannt Seele -- 
  führen Stübchen -- Hof sehen -- Gitter Fenster -- Blende -- Morgensonne quellen warm Herein -- wunderbar Moment -- 
  alt Freudenkräft inneren rüttelen regen -- heben Drang -- jauchzen -- hart Kerkermeister Augenblick danken -- 
  kroch -- Gegrollterer -- stärk Genoß schalt -- -- unwürdig -- Gewalt dankbar Regung zeigen -- sitzen Fenster -- sonnen -- beschlich zuweilen leis geheimnisvoll Behag -- Winter scheinen sturmschlauf Welt ziehen -- Luft Befruchtung -- 
  unterhaltend Anblick Zelle -- Hof nossen gefangener Viertel Freistunde -- Stunde anderer Paar -- 
  Blaß -- verschiede tragen Unglück -- rennen stürmisch -- unaufhaltsam -- Laternenpfahl ausruhen müssen -- Rock Gesicht Auge tief zugeknöpft -- Haß hundert Falte eingeschnürt -- ruhig messen umher -- zerbroch -- matt -- elend -- gleichgültig sorglos -- 
  Unterhaltung kommen -- Empfängnis bleiben taub -- Schreibmaterial -- schreiben -- 
  verging Woche -- denken -- kalt Loche -- Blende drüben -- schlecht -- 
  -- einzig Gedanke Monden -- 
  frei -- stehen ungehindert Straße -- Führer -- -- Freude Freude spät -- bewältigen -- 
  spät Abends -- Mondschein Straße schlendert -- Freiheit genießend -- brechen plötzlich heiß Tränenstrom Auge -- fühlen Mensch nah -- dachen Weise -- schlagen Bekümmernis Kerker zurückgelassenen Kamerad Sinn -- bemerken -- Kreuzer Geld besäße -- -- weit Freiheit wissen -- wohin Haupt legen -- 
  kenn Stadt Gefängnis -- zusammenhängen -- Konstantin Nachtlager ansprechen -- brauchen reden -- -- Anderer finden -- -- Leben Weg suchen aufhören -- -- 
  Schelt -- unwürdig nennen -- Lager Brette Konstantin wenden -- immerhin -- hass Haus -- -- schilen meinetwegen -- 
  Konstantin finden -- müssen an Gefängnishaus -- Wohnung erfrag -- Verhängnisvolles -- Rat Freiheit holen -- 
  fragen -- fallen -- -- schlafen -- 
  Wahrhaftig -- -- Lager Hand -- hingestrecken -- 
  Konstantin sitzen Frau Thetische -- 
  empfangen kalt -- Julie eigentlich -- Weib -- blasieren versteinern -- mild sorglich -- beklagt bleich Aussehen -- bitten -- lang Bart abschneiden lassen -- abgerissen Kleidung -- Auge klagen -- 
  schön Tee -- reinlich -- fein Zurüstung nehmen Beschlag -- leicht Wärme Herz Sinn -- 
  Julie verlassen -- sprechen Konstantin -- Wunder Kälte -- Äußerung -- Eintritt Haus bewegen eigentlich -- erstarrt Herz Zugang -- willkommen heißen -- 
  wendest -- Elend schaffen -- Größe Deines Herzens -- Verstand anerkennen -- 
  Laß irren -- Ähnliches hörst -- 
  bleiben -- 
  Siey -- Herz -- Nachtlager letzter Zuflucht ergreifen -- 
  Gartensalon letzter verleben -- kommen -- allmählich Mensch -- 
  Konstantin Frau sehen -- zuweilen Garten -- Knosp anfängen -- sprechen Paar Wort miteinander -- 
  laufen umher -- freie hinaus -- -- Wärmer -- 
  Zettel abschreiben -- schick Pack Brüssel -- sollen -- 
  denken -- -- 
  5. Valerius Hippolyt -- 
  täglich -- -- Frühling draußen Wärmer voller -- 
  Denke -- Lied Herzen wachsen -- -- -- 
  Regen gefall Frühlingsnacht -- dringen treiben wall Kraft -- Keim bunt Pracht -- 
  Junggrün springen Zweig Sonne -- Strauch verschweigen -- Herz -- schwer -- Herz -- leer -- 
  Auge verbergen -- -- -- nennen -- 
  Herrgott steigen Berg -- Über_der Tal Ahnung rennen -- 
  neu Anfang -- neu -- 
  entsetzlich -- 
  Lied hinauf Konstantin -- lesen Kaffee -- 
  still -- Konstantin -- Beneidenswerter Mensch -- Herzen Blut -- Wärme -- Kraft -- nehmen -- Julie setzen hinzu -- bleiben verdammen -- 
  Sprich -- 
  Untersuchen -- -- -- wozu -- 
  Hm -- 
  winken -- gehen Nebenzimmer -- Julie wunderbar schön vollkommen -- blendend wissen -- blau Auge gläsern -- 
  Viertelstund vergehen -- -- hört stark Schuß Nebenzimmer -- stürzen hinein -- gegenseitig erschießen -- treffen erstarrt Herz -- 
  Eile dannen -- Kerker sehen -- halten rachedurstig Mörder -- 
  Welt -- schwer -- 
  6. William Constantien -- 
  -- durchlauchtig Frau -- Vorfall berichten -- schlagend Beweis -- behaupten -- 
  jung Rotürier -- Predigerssohn Valerius -- Warschau öfter angelegentlich Schutz nehmen -- -- voraus sehen -- Quartier Gefängnis erreichen -- Störsamen Mitglied Gesellschaft anfangen -- 
  werfen Begriff Standesscheidung willkürlich durcheinander -- Geist -- Welt täuschen -- notwendig Unterschied dreist Jugend unbequem -- 
  Einfluß -- gereizt Leidenschaft sprechen -- rasch wirksam folgenreich -- besonnen Widerlegung -- stets Opfer Resignation heisch -- Gesellschaft bestehen -- 
  bleiben übrig -- Gewalt -- 
  Standesgenoss bedenken -- riskieren -- Geist Kreis aufnahmen bürgerlich Livrée lassen -- England's Manier müssen -- Geist unterer Region Geltung erzwingen -- versiehen Dekoration hoch Stand -- geistreich Parvenü wirklich Baronet -- Zerstörende Verhältnis auflösen -- konkurrieren Range -- ererbt Vorteil -- Vorteil Geschichte nothwenigen Institut Gehässiges -- notwendig Sieg Parvenü stören -- Kampf gleich Terrain geschehen scheinbar gleich Waffe -- 
  Nachteil unterer Klasse -- Interesse Staat hoch Stände -- 
  ergänzen -- Geschichte bestehen -- gut Art -- reizen offen Leidenschaft -- erhalten aufrecht -- Einsicht niemals aufgeben -- nämlich Unterschied Verschiedenheit menschlich Wesen begründen -- geordnet Einrichtung notwendig -- 
  Ansicht einführen -- herrschend -- bleiben übrig -- Subjekt einzusperren -- England Baronet -- 
  positiv Kriminalverfassung genügend Anhalt ausgedehnt Strafe vorgefunden -- entlassen -- voraussetzend -- hart Buße beschwichtigt beruhigen -- 
  sehen deutlich Auge -- gnädigst Frau -- abzuweisen neigen -- sehen schrecklich Beispiel -- wohin Mensch geraten -- positiv Hauptpunkt Zivilisation verlassen -- dreist Hand sittlich Leben improvisieren -- 
  erinnern -- -- Grünschloß -- Mitglied unser Dichterverein -- Schluß Universitätszeit verbinden -- 
  Herr Konstantin Müller -- exzentrisch Maß -- Verirrung Jakobinertum begreifen -- ein's Mitglied -- intim Valerius -- verleugnet Adel -- Paris -- schönsen Absicht -- septembrisiren -- 
  kommen -- Antirevolutionärer heimkehren -- 
  juristisch Karriere Stellung bringen -- gemessen -- ordentlich belebt Geschäftsmann fein Mann Sozietät -- 
  Fräulein Julie -- Grünschloß kennen -- frech roh Hippolyt flüchten -- Gattin -- 
  -- Valerius Herr Müller Veranlassung Haft bringen streng halten -- 
  Freigelassen Rache wenden würdig Mann -- Abgerissen obenein mildtätig aufnehmen -- gemein Wut begnügen Opfer Haß -- vorgestern erschießen Tugendprediger Valerius Mann Frau -- entweichen -- 
  Bedient ruhig Treppe herunter seh Wort sagen hören -- 
  Lauf Arzt -- Herrschaft entleiben -- 
  nachher verschwinden -- Steckbrief verfolgen -- 
  7. Valerius Hippolyt -- 
  Grünschloß gehen -- Graf schwach alt -- wissen -- freuen verlegen -- eintreten -- 
  -- verwüsten erscheinen -- Park verwildern -- Gebäude schadhaft -- 
  Alberta gleichgültig Edelmann heiraten -- bringen Kind Welt -- scheinen gewöhnlichst Ding anmutig Enthusiasmus versplittern -- 
  Schönheit zusammengefallen -- heraussag -- alt Herr mitunter sogar kindisch -- barock Liebhabereien -- elastischen -- schwunghaften Geist unterlegen -- Weise tüchtig Mittelpunkt abgegangen -- 
  Faselei -- Charakterspröde -- interessant Kaprice -- Leute verlachen -- falsch -- Laune Art interessant -- Bezug Ausgang alt Herr unrichtig -- 
  Welt -- Welt -- werfen durcheinander -- 
  Leben schonungslos mähend Weise -- ernsthaft -- 
  traurig erleben -- Verhältnis Engel Kamilla -- vernichten -- Engel halten -- 
  -- Welt verschwinden -- Mensch wissen Geringste -- 
  sieh Mensch -- Herz blickest -- 
  traurig Gefängniszeit halten glücklich -- -- still Leben Kamilla führen -- eitel Sorgfalt Liebe danken -- Herz tun -- Gefängnis verschwinden Bild völlig -- einsam Freiheit wünschen -- Herz trösten -- Augenblick -- 
  Liebes erweisen -- Weise -- Liebhaber -- nennen Welt nichtswürdig -- -- Welt -- 
  klassifizieren Gefühl -- lügen -- 
  Rohen -- nichtdenkenden bewahren euer Tabell -- stark -- kräftig Individuum verschonen -- lähmen -- 
  Dankbarkeit Tugend Gesinnung -- Herz -- Regung empfinden -- Frevelhaft -- verlangen -- stellen Mensch fletschend Zähn -- 
  Dankbarkeit -- überall verlangen fraglos -- Last -- Mensch Fortschritt Boden drücken -- 
  Größe fast niemals dankbar -- lieb Boden Dankbarkeit ziehen -- wachsen Lüge Mittelmäßigkeit -- 
  Brief finden -- Herr Himmel -- schick Menschenbild -- laben -- 
  Mensch -- Welt erobern -- gemein Frevler -- undankbar -- rücksichtslos dein Gelüste lebst -- 
  Mußt Napoleon -- totschlagen -- Außerordentlichste frech -- einseitig egoistisch -- 
  alt Herr Steckbrief weisen -- Constantin's Tod -- -- 
  betreten -- verbergen dürfen -- Wald -- Köhler Meiler brennen -- 
  Welt schwer -- 
  8. Hippolyt Valerius -- 
  gestern liebenswürdig Pelagianer Folgend Brüsseler Leben erzählen -- angesponnen -- 
  weißen -- Wahrhaftigkeit Leopolds Sou verwetn -- Folgende ziemlich allgemein -- bestätigen Einzeln Seite -- 
  reich Handelsfrau -- Madame Joao fahren rauh Witterung eng Straße Brüssel -- Wagen entgegen -- entstehen Verzug -- 
  Prellstein schmiegen -- spärlich Lumpe bedeckt sitzen Mädchen -- 
  Wesen -- Körbchen Frucht verkaufe haltend -- frieren -- blicken wunderbar schön Auge rührend Madame Joao -- 
  fühlen Innerst betreffen rührend Blick -- lassen Kind Wagen heben -- wärmen -- finden fein gebaut -- reizend Geschöpf -- fragen Vater Mutter -- fahren -- lassen Kind abtreten versprechen Eltern jährlich Unterstützung -- 
  Mädchen Maria -- nehmen Kleid Engel -- wunderbar Auge -- unschuldig -- leiben -- Bittend -- Gämse finden -- üben gewinnendst Zauber Welt -- 
  Haut -- Farbe -- Form zartest Feinheit -- Sprache weich -- Verständnis zeigen empfänglich -- Gefühl überaus fein tief -- klein Erregung giessen schön Röte blassen Gesichtchen -- 
  Madame Joao glücklich Besitze -- vergehen Paar -- lassen Marie sorgfältig unterrichten -- lernen Leichtigkeit gedeihen gut -- 
  Madame Joao -- reich -- unabhängig Witwe jung Schauspieler hausfreunde -- Namens Jaspis -- zugetan zeigen -- täglich Haus -- 
  schön -- feurig Mann -- Seele Schauspieler -- bekunden lebhaft Vortrag Weise -- dichterisch Ausdruck -- Hand -- 
  tief Eindruck zwölfjährig Maria -- setzen Treppe -- Weggeh sehen -- ungewöhnlich bewegen -- leicht -- scherzend Wort richten -- -- Mädchen pflegen -- Locke -- Wang streicheln -- 
  vergehen mehrere -- Stille aufwachsend Neigung Maria's unterbrechen -- überglücklich Gewohnheit lustig -- Tant -- Madame Joao -- Theater nehmen -- 
  Nachmittag Kaffee Herr Jaspis halb scherzend -- Lust -- Komödie spielen -- beinahe fünfzehn -- erwachsen -- schön Mädchen -- 
  Blitzstrahl zünden Wort -- Träne stürzen Marie Auge -- fallen Tante Hals bitten -- beschwören Erlaubnis -- auf Theater -- 
  überrascht Tante -- Herzensbewegungen Mädchen sorgfältig geben -- -- Maria melden -- Jaspis studieren Paar Rolle -- Mädchen wogt Glück Bewegung -- küssen Hand -- finden -- geboren Schauspielerin -- 
  treten -- wunderbar Mädchen -- unwiderstehlich tief Ausdrucke Auge -- fein -- schön Körper -- zart -- halb verschämt -- halb herausdrängend Bewegung -- Stimme -- worin Seele selber klingen -- Furore -- 
  Jaspis aufmerksam -- rechnen -- sehen -- tief Neigung existieren -- 
  rühren -- nächster Begegnung nehmen Maria Arm -- küßen Stirn -- Mädchen erbeben zitteren Leib -- 
  Szene wiederholen Verlaufe nächster Mal -- Jaspis sprechen erklärend Wort -- sprechen direkt -- Verhältnis -- Bündnis wünschen -- Tant -- irgendwie Zustande ahnen -- warnen Marie Rückhalt Jaspis -- -- neigen -- Tändelei Mädchen eingehen -- 
  Maria krank -- Leopold Haus Witwe einführen -- 
  einschmeichelnd -- liebenswürdig Wesen erwerben groß Wohlwollen Witwe -- überflügeln Krankenbett leicht Mühe materiell Versuch übrig Arzt -- gewöhnlich körperlich Krankheitsschema Auge -- 
  weißen -- verstehen -- mystisch poetisch Weise menschlich Herz sprechen -- jederzeit charmant ideal Welt Hand -- sinnig Frauenzimmer verlangen -- -- poetisieren Marie gesund -- gefällig unterstützend Witwe Verlobter liebenswürdig Mädchen -- 
  Weile -- Komödienspiel bleiben Berührung Jaspis -- scheinen Lust ausgesprochen Besitze -- -- neidisch Menschenbrust -- Möglichkeit abschneiden -- Maria Eigentum sehen -- 
  alt halb Verhältnis wachen -- Leopold -- Wandelbare -- lassen mancherlei Seitenwege Schuld -- Tante endigen -- schicken Maria Antwerpen -- Engagement -- Publikum Enthusiasmus empfangen -- 
  stürmischen -- unruhig Herzen ankommen -- Tore Brüssel Jaspis Wagenschlag treten -- Hand hineingestrecken -- weich Stimme Lebewohl -- Mal bitte direkt richten -- heiraten -- 
  Verkehr Menge werfen Nebel Herz -- allgemein Beifall natürlich Feind halb Liebenden -- Maria gewinnen unbefangen Stimmung -- Leopold -- Antwerpe -- Stellung Theaterarzt Theaterdichter bewerben -- angenehm -- unterstützt Gesuch -- verschaffen Kontrakt -- 
  weich -- innig -- poetisch -- Lob Enthusiasmus umgeben -- brauchen Herz -- unser Eigenst -- Innerst nehmen -- 
  weißen -- verführerisch Leopold -- Maria fühlt Antwerpe Brüssel -- Mißlich alleinstehen Mädchen -- Jaspis lassen Mindest hören -- -- erobert Hand -- tüchtig -- herzlich Wohlwollen -- 
  umarmen plötzlich Wort -- herzig -- Mann -- 
  ging_es Zeitlang auf gut -- plagen alt Sucht Bewegung Unruhe -- beißend Kritik sämtlich Schauspieler drucken lassen -- erklären allesamt geharnischt Direktion -- auftreten -- Leopold Verbindung Theater bleiben -- 
  Entlassung Leopold entschließen -- 
  Maria senden ihrig -- Welt erwarten -- enthusiastisch geliebt Liebling Publikum können entlassen -- Direktion groß Verlegenheit -- Schauspieler bestehen energisch Entschluss -- Marie Entlassung zuschicken -- 
  sammeln Freund Paares -- äußerst zahlreich -- groß Theaterpublikum -- vergötteren -- schließen -- setzen fest -- Schauspielerin -- Rolle Marie auftrcen -- ausgepfiffen sollen -- bringen Marie Nachtmusik Vivat -- erwarten ungeduldig -- Rolle Maries dran -- 
  Direktion klug -- hinauszuschieben -- unterder erkaltet Interesse -- übertreibend Teilnahme bilden nüchtern Opposition -- Abend -- Nachfolgerin Maries Beifalle aufnehmen -- 
  Rohheit -- Maß liegen -- treffen Maries Herz Dolch -- treiben Abreise -- fühlen verlassen -- Unglück führen Brüssel -- 
  Tante trösten gut -- warnen Theater -- Marie entbehren -- übrig Welt prosaisch -- Brettern finden Nahrung ideal Sehnsucht -- 
  Jaspis unterdessen ebenfalls verheiraten -- bleich -- schwermütig treten entgegen -- Nebel glauben alt verborgen Zärtlichkeit sehen -- 
  Abends ergriff Hand -- bedeckt Küsse -- -- Marie -- unglücklich -- 
  Marie fallen Ohnmacht -- Haus bringen -- Stunde Lager verlassen -- entwickeln Herzkrankheit -- sterben -- 
  euer kläglich halb Zustand Verlangniß -- 
  Leopold -- besinnungslos Schmerz -- vergessen -- erzählen Sache kurz Verheiratung Novelle sonstwoh -- 
  9. Hippolyt Valerius -- 
  London -- 
  Paris verlassen -- langweilen -- für's gewöhnlich Leben fast erlauben -- reizen Widerstand -- locken ungewöhnlich Kraft -- erheben -- Fratze -- 
  reizen Widerstand Weiber -- munter gefällig nachdenken -- bleiben Liebe koquett -- 
  deutsch Weiber verwöhnen -- 
  Kaprice -- eigentlich Politik -- Volk gesellig gefallsüchtig -- dauernd Tüchtigkeit Form erzeugen -- 
  Paris Besuch -- amüsant -- Länge sehen all Wechsel -- Strebsamkeit Tändelei -- 
  Leute mag_es wundern -- -- kennsen -- abfällig Frankreich reden -- -- Meiste unser Wunsch verwirklichen -- Element -- entstehen -- herumspielt -- zusagen -- 
  Küche -- Späße Köche anhören ansehen -- essen schmecken -- 
  Wunsch -- Plan -- Ansicht Staat Leben -- quellen tief -- stark Leidenschaft -- -- Welt mißbrauch -- Grund gehen -- französisch quell Leidenschaftlichkeit -- Geschmack -- 
  Republikaner gehen -- finden Haß Zorn stolz Wut Unlauterkeit herrschend -- Stelle -- Amt -- Auszeichnung käuflich feil Bessere -- Überzeugung -- würdig Verhältnis -- spielend Kauf geben -- 
  Haß Deklamation verbrämen -- unschöpferisch -- eigentlich Leben Leute kleiner Verhältnis getadelen -- Reichtum Welt kynisch -- fesselten -- 
  oberflächlich bleiben -- Liebhabereien Avantüren gewöhnlich Beschlag nehmen -- Grund -- immerwährend deutsch Anekdot Zunge behalten -- Geschmack verleiden -- 
  deutsch Professor zerkauen politisch Unterhaltung Zeitung -- Hand halten -- nachsehen -- Gegner entrüsten -- 
  -- Herr -- Zeitung gefressen -- -- -- -- Drum -- -- -- erwidern -- -- -- schmeckt Papier -- -- -- 
  schmecken Journalpapier -- 
  Kammer überleben -- Paar wirklich -- ursprünglich Potenz übrig -- Ludwig Philipp -- sind_es Paar Schriftsteller -- freilich traurig Ausdruck Feder angewiesen -- 
  schreiben -- Feder Einerlei -- -- notwendig Wendung unmächtig Zeitgenosse -- Kraft erwachen Enkel -- 
  ist_es Lamennais -- Sinn -- dämonisch Potenz -- hierher gehören Dudevant -- herzlich aufrichtig -- liebenswürdig beschränkt Béranger -- laut -- naiv Notier -- 
  Geist Talent -- Ursprünglichkeit abwenden -- tief Fessel Ziererei Manier -- 
  Wichtigkeit -- Frankreich Weltgeschichte zuerkennen -- gebieterisch Wichtigkeit -- Mittelpunkt europäisch Bewegung -- Gedanke -- Volk eigentlich Schalksnarr Weltregierung -- Herrgott Komödienhaus -- 
  Franzose Schafott Kugel rennen schleppen -- treten Harlekin Seele -- Tollheit Ärgste tun lassen -- Don Juan -- Ergötzen Parterres -- Paar Weiber verführen -- Teufel holen -- Vorhang fallen -- 
  denken -- tot Franzose -- Anno 91 Bühne sterben -- Schauspiel agieren -- leben -- schön Sonntage Blumensträußen Kothurnschritt dastehen Marsfelde -- Bewunderung Europa's angratulirtn -- 
  Verhöhnung Illusion Volke Unrecht langweilen -- 
  letzter Abend -- gestehen -- Weiber Mann frisch interessant gelten -- Constantie -- stören Eitelkeit -- knirsch Welt -- altert -- unbefangen -- 
  -- schön Dame vornehm Welt lassen harren -- ergeben -- treff Gesellschaft -- schön Abend -- versuchen Außerst -- 
  Bedienter Hotel schicken -- Wagen Stunde bestellen -- beorderen -- 
  Gesellschaft aufbrichen -- begleiten Vorzimmer -- Abend sanft zurückhaltend -- Diener -- Equipage fehlen -- hängen Mantel -- berühren schön gewölbt Schulter Fingerspitze -- Überwindung kosten -- 
  nämlich Paris ungewöhnlich Manier -- verschließen -- Hals verhüllen -- kleiden -- obwohl schön Wuch -- voll Hand -- weiß -- schön Hals -- Umriss fein Hülle sehen -- just Büste schön müssen -- 
  sagen -- Diener warten ungeschickt Wagen -- bringen Hinunter -- Equipage fehlen -- Aufsehen -- entschließen -- steigen -- 
  denken -- Situation benutzen suchen -- wehren -- stürmisch -- Widerstrebende locken meisten -- reißen Kragen Achsel -- finden Nacken -- Schulter -- Brust voll duftend schön Leben -- 
  -- Monsieur -- lächelnd -- fahren Haus -- Liebkosung bequem -- 
  geschehen -- sämtlich Dienerschaft eilt bestürzt herbei -- entschuldigt Ausbleibe Wagen erhalten Befehl -- ziehen Mantel fest Schulter -- wenden lächelnd -- 
  danken -- Monsieur -- Artigkeit -- grüß Margarita schlafen -- 
  siehst -- Leben -- Ursache -- desperat -- 
  kenn Existenz -- Glück getragen -- Genuß beschwingen -- Leben stellen -- 
  -- Treulosigkeit reden -- 
  Herz treu -- -- Desdemona -- Julien sicher -- fügen -- Treue lernen -- 
  alt wild Schule -- sterben darben -- 
  flatterhaft Paris höhnen -- Nero begreifen -- Regung Dienst Stadt anzünden lassen -- 
  -- St. Pelagie besuchen -- sehen -- helfen -- Welt Kampf -- 
  jung langweilig -- theosophisch Zeug Kopf setzen mystisch Redensart -- fortfähren -- Kurzem fromm -- 
  -- befinden -- 
  Sage Gotteswill -- Idee Freiheit -- 
  britisch frei Nation Erde -- Teufel freist Nation -- 
  -- verhaften -- drucken lassen -- -- dergleichen -- 
  Freiheit -- 
  Sache Religion Moral borniert -- -- 
  Poesie kirchlich Glauben Mühe ausgetrieben -- Exorzist Geist austreiben -- notwendig Übel Religion -- Priester -- Handwerke -- Pompe Anmaßung beibehalten -- 
  prächtig Kristallkuppel -- Gold Edelsteinen dekoriern -- bewahren grau -- traurig Luft -- 
  Kuppel -- Million Dissenter -- Sekte bischöflich Kirche trennen -- Aschfarbe traurig -- 
  phantasieentkleidet -- mager Ding -- leidenschaftslosen öde Formel herrschen tyrannisch Fanatismus -- Puritaner Holz Leder -- 
  Puritaner Kampf -- Kampf Leben Tod -- Vermittlung Fanatismus -- erhitzen förmlich dürr Rute -- 
  Atmosphäre Land -- freisn Land Europa -- entgegentriten -- traurig Dorfschule -- abgeschaben Präzeptor Stock schwingen -- Kopf scheu stumm Boden senken laut Reget -- 
  Sonntag England ansehen -- Bann Interdikt Erde lasten -- furchtsam Stille schleichen Straße Feld Wald -- Wind erschrecken -- Blatt bewegen -- trübe -- neblig Luft Hilfe -- Dante's Hölle wandeln traurig Gefängniswort hören -- 
  -- lassen draußen Hoffnung -- -- 
  Gott -- Sonne schaffen -- lustig Wald -- springend Reh -- jubelnden Vogel -- Schönheit Freude -- -- 
  Jehova -- rachlustig -- Heiterer schön -- 
  Nation -- Solchergestalt innerste Leben traurig -- dunkel Höhle vergräbn -- freisten -- 
  Wahrlich -- Bauer Bastanthal -- ärgsn Aberglaube Mönche hängen -- Rey netto Willkür untergeben -- leben golden Freiheit gottfurchtsamen -- gottdürftig Brite -- 
  Traueratmosphär borniert Gedanken -- innerer Mensch dahier beugen -- durchdringen hoch Tätigkeit Volk -- 
  Literatur Moralkodex konstruieren richten -- frei Schönheit -- Schönheit bestehen -- alt Großmütter Hornbrill -- Review kritisieren Altklugheit -- Künstler Haar Berg stehen -- eigentlich Brit -- inkonsequent Kreis Land verlassen -- Gemälde -- Statue Wohlgefallen anschaun -- 
  Titian Fleisch Moral -- borghessisch Fechter moralisch Anstand -- leisten Volk bildend Kunst -- -- 
  Liebhabereien Einzelner -- mitunter kolossal erscheinen -- reich -- Einzeln -- eigentlich nationale schaffen -- 
  Bildung frei unbefang -- Parlament Anderer moralisch religiös Jargon einstimmen -- fürchten -- fürchten teils borniert Genosse -- teils Volke -- 
  wagen -- Schritt -- Volk niedrig hölzern Kirchstühl hinwegsähen -- halten freiste Volk geläufig Formel ärgst Sklaverei borniert Gedanke -- 
  Shakespeare ignorieren -- Garrick eminent Talent verführen -- rein Englisch allgewaltig William ausgeprägen -- wunderlich Ding hören -- jedenfalls englisch Dichter Deutschland bergehoch groß richtig würdigen England -- 
  Shelley ausgestoß Tod jagen -- Byron Tod martern -- frei England -- 
  Ordinär bürgerlich Verwaltung -- gut Leute schlecht Musikante Haus -- unbefang -- dreist frei Volk Welt -- beschränken -- Nächst -- Hausbacken -- Entwicklung Art vorsichtig Schritt Schritt Tappende meinethalben -- 
  unausstehlich -- interessieren Gedicht Freiheit Schönheit -- ABC -- lesen sing Größe Lust Mensch -- warten -- Million beschränkt Volk lernen -- 
  Lüge Prüderie Moral -- 
  Eroberunge England Weltteilen -- unmoralischen Anspruch -- Blut -- Strömen Bluts verfochten Anspruch Amerika -- auswärtig Politik trivialst kaufmännisch Vorteil lächelnd Hintansetzung Prinzip -- Verwünscht seisen heuchlerisch -- puritanisch Albion -- Seele Gräuel -- 
  vergessen -- gewaltig Napoleon echt puritanisch Grab ärgern -- Hudson Lowe Sohn -- Größe ordinär Egoismus -- o -- fort Feder -- 
  sagtest -- müssen Nation Freiheit reden -- haßt Grund jeder Gesetz -- geni -- Zügellosigkeit -- meinethalben -- 
  genieren all euer Gesetz -- 
  Staat -- 
  arm -- 
  erfinden -- 
  ärgsn Unband -- preisen -- zivilisiern -- 
  weite Förderung Staat aufnehmen -- bloß klein -- 
  -- Valerius -- sprechen -- 
  ungeduldig -- zornig -- all Hindernis -- beengen -- Schädel -- Eisen -- rennen -- meinig zerschellen -- ingrimmig -- 
  tobe -- Einzelheit fassen -- 
  10. Hippolyt Valerius -- 
  Unzufriedenheit England schließen bereitwilligste Anerkenntnis einzeln Engländer -- 
  find Person außerordentlichen Tüchtigkeit Potenz -- festen -- Mut -- Charakter Kühnheit gehärtet Mensch sehen -- richtig -- genau Betrachtung erkennen -- 
  dichen -- Gefestet -- stählern Innerlichkeit -- Herr Himmel -- welch Reich Titanengewalt Insel -- Nation kaufmännisch -- Kaufmann bleiben geboren Feind Poetischen -- Genial traditionell Illusion -- Genius unser romantisch Wunsch niemals Prozent suchen Wechsel ausstellen -- 
  engländ Handel groß -- -- Netz Erdteil Ozeane werfen -- Handel Erwerbe -- Kramgeschäft -- -- uneigennützig -- grandios Bewegung menschlich Seele -- Götter Menschheit schaffen -- 
  Engländer heraustritt Bannkreise eng Sitt -- eng Glaube -- großartigst Frechheit fähig -- 
  frech -- Gewalt -- außerordentlich Götter rauben -- Griechen Prometheus -- nennen Außerordentlich -- 
  Engländer Republik erfund -- schreckend Königsschafotte -- Cromwell Kralle Zeuge erziehen helfen -- England besitzen -- stürmisch Welt modern Politik wecken -- Albion prosaisch niedergehalt Geburt dürren Puritanismus -- Verheiratung Kaufmann -- 
  modern Republik innerlich frech Forderung -- heischt Genialität jeder einzelnen -- 
  Engländer Meer bezwungen -- tausend tausend Lord schaffen -- Souveränität Imperator tragen -- uneingeschränkt Mensch fühlen -- 
  Shakespeare zeugen -- ordinär Schauspieler Poesie Universum Brust reißen -- Gibbon zeugen -- Christentum verfluchen -- Chesterfield zeugen -- Tugend Klugheit zerdrücken -- Shelley -- Gott leugnet sanft Herz -- Byron -- Gesellschaft schlagen Fäust -- Ambra dufteten -- 
  finden Riesenpotenz einzeln Engländer -- mitten Stadt Old Bailey -- Aufenthalt frechst Gemeinheit -- beiläufig Mord -- unbezwungen -- London Freudenmädchen -- deutsch Herzogtum Einwohner -- schön gemeinst Welt -- finden England vernünftig berechnend Kaufmann großmütigste -- erschütternd unbefangen Anerkennung Ungeheure -- Teilnahme verwegenster -- Rakete Mond schießen -- machen -- Engländer klammeren kaltblütig dein Raketenstock -- 
  Fähndrich -- Geschlecht Tantalus -- Götter frech verkehren -- Engländer -- Schlaff werdend Seele -- Hilfe -- wunderbar schwellen -- verkehren Lord Baronet Weise -- mitunter schreien alt Mensch jauchzen Genug -- 
  legen Brieflein Leopolds -- mitgeschicken -- Sieh -- anmuten -- Faselei unausstehlich -- 
  11. Leopold Valerius -- 
  lang drück Hand -- Liebwertester -- 
  -- Warschau scheiden -- Lebensverhältni Hippolyt innerer Gedanke -- Beachtung geheimnisreichen -- tief liegend Mensch schlüpfen -- weißen -- Hippolyt schöpfen Geist Welt sinnlich Herz -- 
  brouilliern -- geraten Ste Pelagie -- artig Aufenthalt -- Zerstreuung bieten Einsamkeit -- -- 
  sitzen Leute -- Million kommandieren -- Bezahlung Schuld verpflichten glauben -- Weltliche tausendfach Deutung -- 
  Aufwand -- Quelle fließen -- trinken -- singen -- spielen -- lieben -- lachen -- ziehen Beschaulichkeit Ernst -- 
  -- fremd redenden Mensch Identität Gott menschlich Gedanken aufgehen -- glücklich beruhigen -- still heit -- wehen Hauch Himmel Kopf -- Herz -- 
  Valerius -- wärst fähig würdig -- Glückes teilhaftig -- Glückes -- Jneinanderlebe Geist Sinn Welt Geist Sinn hoch Existenz bieten -- 
  glücklich -- Vers kommen -- Gedicht Komposition -- Gottheit säuselnd Engelschar hinschweben -- Engel ewig Ton geben -- Herr Heerscharen loben -- versuchen Weise -- entstehen Musik verschiedenartigen Äußerung -- 
  fliegen Zeit -- Land -- kehren Mensch -- -- schweben Nacht Häuptern singen Herr -- glücklich Mensch nächster Musiker -- träumerisch Vernommene fesseln suchen -- Welt überliefern -- 
  verbreiten Himmel -- verschieden Apostel verstehen Sprache -- reden -- Dichter deuten -- tun -- Walzer Geschichte Mensch -- leicht Sinn Ewig durchschaukelt -- Symphonie Versuch -- Himmelsgegend bemächtigen -- Schluß Gedicht -- letzter irdisch Musikfest -- profan Mensch Welt nennen -- lösen verschwebend Harmonie -- Mensch Ton -- Sinnesrichtung entwickeln Tonart -- vereinen Herzschlag Menschheit Takt -- allgemein Aufgehn Gottheit Weltenchorus -- unendlich -- zart Gemüter geahnt Symphonie Sphäre -- 
  Land Wein erfund -- irdisch Entzückung überirdisch gelangen -- 
  jung Gräfin Champagne -- Lilli -- versorgen Champagner -- 
  lieben Küs -- unvermuten Universum begegnen -- 
  Ste Pelagie finden -- wohin still Klause flüchten -- Welt Fallstricke legen -- Revenu unvermutet ausbleiben -- 
  schwärmen dichten gerung Aufgange Niedergange -- still -- Priester Weihe segnen -- verwandte Schuld bezahlen -- Staub Haus Füßen schütteln -- erwarten täglich -- Palm Ausgang senden -- 
  -- 
  jung Mann anschließen -- Frankreich gehören -- unruhig -- haltlos Welt religiös Mittelpunkt führen -- 
  -- lebhaftesen Kind Welt müssen gewinnen -- groß Bewegung -- groß Empfänglichkeit herrschen -- Glaube müssen Welt Sturm Drange sinnlich Leben leugnen -- just Fittiche hindurchführen -- 
  Frau kennen lernen fallen -- hellblau kleiden -- halb elegant -- halb orientalisch -- Ste Pelagie halten -- Proselyt -- Geld hinreichend -- versehen Gesellschaft angehören -- 
  befreien -- versprechen -- Mittel lösen -- 
  -- 
  wack Lichtblaue Wort halten -- 
  sogleich Fairy gehen -- gespeist -- Manuskript Druckerei Gesellschaft bringen -- Frau ausgewesen -- 
  verwandte -- Zimmer lassen -- Ehe Geheimnis -- 
  Lilli aufgeräumen -- obwohl erzählen -- Gut Champagne betrügen -- 
  Vorurteil -- sogleich Fähigkeit Kenntnisse Kontribution setzen -- tanzen Singt charmant Bühne fällen -- 
  Lichtblau -- Proselyt Personal -- 
  -- 
  Lilli vollkommen -- -- Geld liebend Nebensach -- Liebenden Welt leben -- Nebensach -- müssen Talent verdienen -- 
  verwandte -- vortrefflichst Pierrot Welt -- Unterricht geben -- wirken leidlich Arleqin -- 
  Himmelblau -- Weise Einwirkung Personal intim -- 
  Gage klein -- Direktor meinen -- fortstreben -- wachsen -- 
  sobald Musikhimmel Lettern stehen -- send Exemplar -- Druckerei scheinen langsam arbeiten -- 
  leg Rezept cotelettes -- -- Dejanira -- süperb Speis -- denken -- 
  Adieu -- Million -- Myriadenmal Adieu -- 12. Hippolyt Valerius -- 
  England starre Gesetz Religion Moral -- Ausnahme nirgends schmecken -- jung Geschlecht hungrig durstig -- Gesetz Tod Jugend -- Wildheit Gesetz -- glauben -- leben Gesetz zehmen -- 
  Kreis -- Tollheit herum bewegen -- zeichnen Lord Henry -- Landsitz schreiben -- 
  Jagd Ausruhn mühen Vergnügen --- saftgrün weit hügelflächen jag Morgenwind -- Nebel jagen -- langgestreckt Pferd weifen -- Atem Kraft Götter -- Wort Gefahr sprechen -- stürzen -- mögen helfen -- Jockey Hund wissen -- 
  Körper strecken prusteen Frisch zehrend Klima -- Leiber aufgeschossen -- Hautfarbe klar fein rot behauchen -- Mal -- weiß Mensch unkräftig erscheinen -- 
  Lord Henry solch lang schmal Engländer schweigendem länglich englisch Gesicht -- schön Ähnlichkeit kopf hiesig Pferd -- 
  still verschließen -- heraustritt energisch donnernd Windstoß ruhend Luft -- Meinung -- Empfindung -- 
  Wort Eurer Sprache -- lieb -- Empfindung -- sprecht Gefühl -- -- Gefühl -- Empfindung -- 
  vulkanisch Vergangenheit Henry's schweigend Oberfläche Geschichte ruhn -- erzählen -- spüren -- Berührende finden -- steigen Anteil Drang kochend -- gewaltig Strudel -- Jockey humoristisch Verhältnis trocken schildern -- lachen tüchtig -- 
  nah verwandte Jugend liebend entbrennen -- Berserker -- werfen -- Weg stehen -- donnernd -- blitztreffend Durcheinander erzählen -- Mädchen Welt verschwinden -- wissen wohin -- 
  wissen -- Gräuel -- Punkt Verwandtschaftsliebe anrühren -- Zivilisationsfrevel -- Empfindung -- Ursprung Zivilisation ruhen -- kräftig Mensch -- nervenspitzen Furcht Artigkeit erziehen -- Empfindung fragen -- Schoß Weib stammen -- Auge lieben -- Arm begehren -- 
  tun alt Volk -- Mensch fehlen -- 
  Skrupel -- 
  O -- sanftesen -- 
  Herz Liste Tabell Übervölkerung fragen -- 
  Griechen brandmarkt Umarmung Mutter -- jeder Volk individuell Idiosynkrasie -- -- -- Volke füg einzeln Sitt -- empfinden Idiosynkrasie -- euer Formel -- 
  glauben Lord Henry denken -- 
  Tour Pferde Provinz -- 
  -- 
  gestern Vormittag kommen Ausgang Eichenwald -- Sonne spaltet Nebel -- stattlich Schloß liegen Hügel -- gotisch Bauweis stammend -- glänzend erhalten -- donnert Meeresbrandung -- Lord Henry rufen Reitknecht -- Vorauszujag -- Besuch Lord Roldan melden -- 
  Henry's Name -- fragend -- -- alt Lady -- -- -- -- hassen Name -- hören -- Todfeind reden -- sitzen nahe -- Aussicht alt Abtei entzückend -- reien vorüber -- Stück Rindfleisch essen -- 
  Lady schön Tochter -- sagt_es -- sehen -- alt London -- -- 
  steinern Halle Tisch führen -- denken fortwährend Walter Scotts -- sehen hoch Bogenfenster Meer hinaus -- seitwärts grün waldig Bergufer -- 
  Schloß ruhen Seite Fels -- senkrecht Meer aufsteigen -- Wogenbrausen Tafelmusik ewig Element -- Welle erdteil Planet -- 
  alt Lady hoch -- vornehm Frau -- höflich Buch -- sprechend -- strengsen Zensur Buch erlauben -- -- erwarten -- artig bescheiden -- sprechen Walter Scott Romane -- 
  reizend -- unbefangen romantisch Interesse Engländern leben -- erfunden Person Geschichte -- jeder Wort -- sprechen -- Wendung -- Sache nehmen -- finden freundlichst Boden -- finden wecken Reiz Geschichte -- 
  arm -- 
  Lehrgedanke Faktum -- Schilderung -- Begebenheit unterstützen rechtfertigen -- meinen unnütze treiben -- Töricht nennen Romanhaft -- besitzen rein Roman -- verdorben reinen -- bloß Bild -- Bild -- 
  einladen -- lang bleiben -- 
  abends Tee erscheinen Tochter -- Schlank -- fein färben Pfirsich -- lang Augenlider reich Haar -- zurückhaltend -- naiv -- ernsthaft -- Tiefe durchschlagend Lustigkeit -- kalt -- durchfliegenden Spur tief Innigkeit -- Miß Anna -- 
  -- 
  -- 
  Lord Henry -- Engländer Scheitel Sohle -- fällen alt Lady -- Anna fällen -- Lord außerordentlich -- 
  sehen scheel -- -- lach Lordschaft -- -- 
  Hui -- 
  erfahren -- Dame -- gestern Abend klar Luft lassen Boot Brandung herumwerfen -- sehen scharf Falke -- entdecken Fenster schwarz gekleidet Figur -- Lady -- Anna -- 
  sagen wir_es -- harmlos -- Rückkunft Lady -- 
  -- Abends erscheinen schwarz Dame -- Henry fahren Sessel -- Miß Mary schaueren -- Jugendliebe -- 
  alt Lady scheinen Sichere bemerken Szene -- 
  schwarz gekleidet Mädchen wunberbaren Eindruck -- bleich Schnee -- Duft rot Blut schimmeren bleich Wang -- weiß Hand -- 
  Dunkles Haar dunkel Auge heben lebendig Grundton kühn Schmerzgesang schwarz Samt gehüllt Figur -- 
  jung Mädchen -- fein Zug Leide_es schweben zaren Antlitz -- erhöhen vornehm Tragik Erscheinung -- sagen -- reizen historisch Kolorit Roman -- 
  weißen -- Jugendfrische Weibe spät Reiz vorziehen -- gefüllt schön Fleisch gewähren -- Trieb Knabe -- Wachstum Auge -- reif letzter Schritt welken -- Herbst tragisch -- Winter Tod laueren Schulter -- voll Leibes lockend Haut sehen Falt lauschen -- nächster Erbe -- Unerfahren sehen -- 
  jung Form zeugend Kraft -- gesund Sehnsucht -- echt Drang zeugend -- erfüllt Form Mattigkeit Beendet -- 
  dennoch sehen schön Gefühl wunderbar Weib Miß Mary -- erkennen -- Zauber ruhen -- mächtig -- mächtig -- Zauber jung Sinneswelt -- Atmosphäre weben -- Kraft erfahren Herzen -- Kraft historisch Welt -- 
  deutlich inne -- gefährlich -- Würdest sagen -- 
  Mangel -- 
  Miß Mary sprechen Erschein -- Stimme wanken unsicher angeschlagen Harfensait -- Henry -- beherrscht Engländer -- mühsam erregt innerer Sturm niederhalen -- 
  -- 
  vergehen -- geschehen äußerst -- Wort Langeweile unbekannt -- tief rastlos bewegen -- drängen murmeln tief Meeresstrom innerst Raum Welt -- Wirklichkeit unten Felsenabhang wühlen -- 
  halb Somnambulismus -- Lady ahnen unklar Gefährliches -- wissen wahren Weise -- lieben Henry -- Anna lieben wahrscheinlich -- Miß Mary schweigen Sicherheit -- 
  zuweilen plötzlich Röt bleich Antlitz treten -- Wachtfeuer auflodern sehen -- nah Todfeind verkünden -- fliegen Schauer zart Leib -- kalt Luft rasch heiß Mittag fliegen -- 
  dämonisch Verhältnis Henry -- 
  glauben -- lieben -- eher Arm weich glücklich -- manchmal Strahl -- Blick ruhen -- selten geübt Auge erkennen -- elektrisch Kraft -- äußern -- samten Kleid streifen -- schön Finger Hauch treffen -- 
  Hand prächtig Trauerlied voll melancholisch Lockung -- weiß Seide -- köstlich Stoff binden -- wollüstiger Schmerz locken weiß Hand -- 
  Weißt -- ursprünglich Neigung Hand Locke schamhaft Mädchen treiben -- flüchtig Gedanke geliebter berühren -- 
  wissen -- unbekannt Mächt -- 
  dämonisch Verhältnis Henry außen stark -- schließen stark Kette fest -- schaueren -- Wehre -- Hand sinken -- stürzen Arm -- wissen -- Verderber -- 
  sehen -- 
  Henry -- 
  Dämon unterwerfen -- schlimm -- englisch Eigensinn -- Tod Möglichkeit hinaus -- schließen -- toll Verhältnis Verhängnis -- Henry lieben offenbar sinnlich Liebesneigung Glut Miß Anna -- bezaubern -- schlagen Faust -- selber Äußersten schmerzen -- -- streben Mary -- Mary -- 
  -- 
  -- -- 
  lieben Anna -- Mary besitzen -- -- Wolke reißen -- 
  sitzen Morgen Fenstertür Saale -- schmal steinern Sitz über Meer hängen -- tief tosend Element gleichsam verhöhnen -- 
  Mary sprechen gewöhnlich -- sprechen -- schweigen meistens -- entzücken Anna -- Anna lieben zärtlich -- verheißen Leidenschaftlichkeit -- womit zuweilen ausdrücken -- geliebt Manne Himmel Feuer Hingebung -- 
  umarmt Mary mehrmals lustig -- alt -- streng Lady zugegen -- 
  plötzlich stehen Lord Roldan führen Seite -- kühl trocken sprechend -- Herr -- kokettieren Frau -- -- -- 
  -- fragen lächelnd -- 
  Herr -- erlauben -- lächeln -- 
  Item -- fordern -- Abend bestieg Boot -- wohlgeladen Pistole -- überlassen stürmisch Brandung -- 
  verabreden -- schießen -- nah Stande Welle Ruder Boot -- 
  Sonne scheinen klar -- See -- Welle werfen nahe aneinander -- trennen -- 
  gleichzeitig blitzt Schuß -- Knall hören Wogengebrause Pistole -- treffen -- Ruder mächtig bleiben -- unrettbar verlieren -- 
  Meer schleudern auseinander -- wissen -- Kugel Ziel finden -- unverletzt -- 
  dauern -- ehe deutlich erblickten -- Lord Henry greifen Pistole zielen -- 
  Schuß fallen -- -- Lord Henry Ruder entglitt Raum Bootes zurücksank -- gehend Woge fassen Fahrzeug schleudern dannen -- 
  strengt Kraft -- erreichen -- Opfer übermütig Eigensinn -- feindselig Betroffenheit lieb gewaltsam Natur -- setzen Leben -- wild Element Beute lassen -- 
  Kraft erschöpften -- Zustand Schwäche -- verhassen -- treten -- Geist schlagen umsonst unmächtig werdend Körper hinein -- beschämt Welle -- werfen plötzlich Henry Boot entgegen -- springen Ruder hinein -- überlassen Kahn Meere -- 
  Lord Henry liegen blutend Boden -- behen Taschentuch Wunde legen -- wenigster schmerzhaft scheinen -- 
  lachen -- -- Kaprice vernichten Mensch -- 
  Leben -- rufen Henry -- schalten -- wechselnd Wille heischt -- Leben sorgen -- leben -- Bürde -- bewachen -- -- eingeschränkt Besitz Knecht -- 
  Meer hinausgetrieben -- Abend fallen dunkel herab -- arbeiten -- Schweiß Strom stürzen -- Stern gehen -- Henry totenstill -- Wunde müssen kalt Nachtluft heftig schmerzen -- verraten Laute -- 
  brechen -- Boot an Ufer werfen -- bleiben schwer Last Henry's -- an Schloß tragen -- 
  lassen geschehen -- schleppt -- Schulter stützen -- Kraft -- 
  streng Umgangssitt Land drücken schwer -- 
  Miß Anna verging Angst -- leidend Henry sehen -- pflegen -- 
  verlassen Zimmer -- Machtlose streitig -- Miß Mary Auge -- sprechen -- -- Schwäche Mensch -- 
  wiederherstellen -- Zimmer umherzugeh -- Mal -- frei -- rasch Bewegung Luft schöpfen -- lassen Pferd satteln jagen umh tief Abend hinein -- 
  wilde Eifersucht Neuem erwecken -- Gedanke -- Miß Mary -- ergreifen Waffe -- eilen Zimmer Meerseite -- Mädchen wohnen -- dringen unbemerkt Gemächer -- hören Anna Mary sprechen -- -- beruhigen schleichen Saal -- hören Eingange Lady -- Preis Welt sehen -- Tür Zimmer Mädchen -- Verdacht -- Indiskretion -- Sittenbruch -- Engländer empfinden Todsünde -- 
  Ausweg übrig Fenstertür meere -- Ellen bergendem Holz -- niederkauern schmal Steinplatte -- draußen Meere hängen -- Nacht dunkel -- 
  ergreifen hastig Ausweg ziehen Tür leise -- Schloß werfen -- Letzterer geschehen -- ausgesperrt -- saal öffnen -- 
  peinlich Moment -- Lady leuchtend Diener Saal entlang -- bemerken entsetzlich Situation -- schmalem Raume -- Anhalt dicht tief Abgrunde -- 
  Lady Tür -- schilen Diener -- Gebotene beingen -- Tür schließen -- drücken fest Schloß - Rückweg abschneiden -- 
  Lady Nebenzimmer -- Neuem scheltend -- dorthin Tür -- Diener beteuern -- -- 
  Nebenzimmer Lady Schlafgemach -- Kammerfrau -- Herrin entkleiden -- Hoffnung schwinden -- Fenster Tür einzubrechen -- Rückzug gewinnen -- Geräusch Lady wecken -- entsetzen inne -- Kammerfrau Nähe schlafen -- 
  Lady dürfen äußerer Fall Mißlich erfahren -- niemals Dienerin -- 
  still Schloß -- Licht verlöschen -- reich -- stolz Lord ergeht hart -- Wind Regen Meere -- überfallen -- Frost erhalten -- 
  Unbeweglich stehen -- 
  aufrichten -- fest Anhalt nirgends -- ziehen Gefahr siren -- Körper wüssen Schwindel Abgrunde -- Krankenzimmer Leichtigkeit Nachtluft -- Regen unbequem Stellung vernichten -- -- 
  entschließen -- hinabzuspringen -- stolz -- frech Lord -- dickst Taue Menschenverkehr zerreißen -- Spinnwebfad Ehrensitte dergestalt umrankt -- eher -- Schatten Anstand Wirtin opfern -- 
  Geheimnis speziell Zivilisation -- 
  spät Haus -- Licht Henry's Zimmer -- meinen -- Bett -- willkommen -- gestört Nacht fest schlafen -- verriegle Tür Gemach liegen tief Schlummer -- 
  Henry Reitknecht -- umsonst Gepocht gelärmen Tür -- Herr vermissen -- Rat -- 
  erinnre -- Augenblick erwachen beglückwünschen -- Sturm Regen -- Fenster schlagen -- Trocken Sicher -- 
  Lust Leben -- Geschöpfe innewohnen -- groß Empfindung -- treiben Lord Henry Entschluss Versuch -- Pistole -- Zimmer mitnehmen -- liegen Steinplatte -- unternehmen Gefährlich -- bücken -- erstarrt Hand greifen -- 
  gelingen -- schoß Kugel -- -- mitten Schloß Tür hinein -- aufzuspreng -- tüchtigen Rucke Saal -- rasch -- ehe Weg treten können -- Gang -- Zimmer -- 
  Schuß versagen -- Henry zwingen Sinn Ruhe -- Gleichmut -- ziehen Gewehr langsam -- drücken -- knallt krachen -- gelingen -- 
  geraten Bewegung -- stürzen hinzu -- finden Unerklärlich -- mutmaßen Richtung -- Henry -- Wendung geben -- werben nächster Hand Miß Anna -- entdeckt Lady wahr Name -- 
  Bestürzt erfreut treiben augenblicklich Reise London -- Hochzeit halten -- 
  Bestürzt Mary' Wille -- einst just Henry retten -- erfreuen -- Anna glühend Liebe Lord brennen -- Schwiegersohn gefiel -- 
  Mittag -- fahren gen London -- müssen Henry's Bitte weichen -- müssen -- Mary bleiben -- weder sehen -- 
  -- 
  Woche vergehen -- Ehepaar schwelgen Flitterwoche -- charaktervoll Bild Mary vergessen verzaubert Einsamkeit Abtei -- Stunde Gedankens werfen auf Pferd -- riten Nacht -- hinaus Felsenschlosse -- 
  Walde Hügel lassen Pferd Bursch -- eilen hinauf -- begegnen -- Saal -- Mary sitzen Fenster schaut Meer hinaus -- dunkel Haar hing auflösen bloß Nack schwarz Samtkleid herab -- glich Balladenkönigin -- heben staunenden Ruf arm -- -- 
  Kleid schwarz -- Leib wissen -- Hand kalt -- Herz heiß -- wehren -- Rang küßen -- 
  Dämon -- Kralle tief herein strecken Welt -- glauben mir_es -- 
  schüttelt Weib Arm -- gönnt Ruhe -- Glück -- Träumen rang Henry -- 
  ergehen -- Seite liebend geliebt Weibe Nachtzeit treiben -- flog Abtei -- Jagdausfluge zweien zurückkehren -- stehen Mary offen Fenstertür Saale -- Steinschwelle -- Meer hängen -- Samtkleid heingen zerrissen Schulter -- Haar fliegen auflösen Wind -- singen Liederverse Ophelia kennen -- 
  grausig -- entfloh Mal -- 
  Lord Henry sehen Alt-England -- 
  fatumhartes Wesen -- arge Ding sehen -- Mensch Unglück nennen -- unbefangen bleiben -- Welt stark Nerv -- Meinung notwendig -- 
  Tier Wald setzen -- Haut wehren -- 
  schaueren -- Eingange Eichenwalde umwenden -- verödet Abtei -- zürnend Meer hören -- 
  liegen sonnenfröhlich -- 
  unser Fuß hineingesetzt -- Dämon unser Schulter kommen -- verwüsten -- 
  Welt Gesicht Gesicht stehen -- hinblick -- richt Unglück -- helfen anrichten -- 
  Glück -- Tod -- Glück richtig Verhältnis -- 
  habe_es verlieren -- pah -- 
  -- 
  Mühe entrinn alt Lady -- verzweifelnden -- ungewiß Verlassenheit hinstarrenden Anna -- 
  jung -- rot -- lebenswarm -- vertrauend -- hingebend -- schön -- -- Lieb vernichten -- 
  Wenn_es rühren -- Valerius -- -- 
  -- 
  erschrecken -- fliehen -- bedauer -- Leben passen -- 
  verfolgen -- unglücklich Weiber -- Auskunft geben -- Auskunft suchen Lord Henry -- 
  stolz -- schweigsam Ladies -- schwarz gebunden Velinbücher -- Sitt golden Spang verschließen -- nördlich Reife behauchen -- morgenländisch glühend Märche ruhn -- betrachten kalt scheu neugierig -- 
  Vereinigung Blick echt englisch -- 
  Welt Untersuchung entgehen -- schließ Genosse toll Leben -- brauchen kräftiger Bewegung -- nachdenken unabänderlich Geschehen bieten -- Nacht springen gaslich Straße hinaus Nacht -- Landhaus besuchen -- fröhlich Wirtschaft gedeihen -- 
  Mädchen Afrika -- Bajader Ostindien -- verschloßen Amerikanerinn -- verschleiert Ladies -- verlarvten Kind begegnen -- Prinz Heinz Reizloser liederlich leben -- 
  Mädchen -- Perle nennen -- wunderbar fesseln -- obwohl niemals Antlitz zeigen -- kleiden frei prächtig Jndierin -- tanzen Tamburin Entzück -- Übrig Antlitz sehen nennen schön erstaunen -- Übrig reden finden liebenswürdig Berausche -- zeigen Antlitz -- gönnen Wort -- suchen -- hören -- verständigen reizend Pantomin -- 
  Perle -- reizest Äußersten -- erhöre -- erfüll Reiz -- 
  schütteln Kopfe -- 
  jagen hinaus -- finden -- Perle -- mystisch beleuchtet Zimmer -- deutsch Romanschreiber Liebesabenteuer schildern -- 
  Umsonst drohen -- bitten -- flehen -- verhüllend Schleier Gesicht ziehen -- Wort sprechen -- umsonst -- 
  Sanft -- hingebend -- wiegen süß Verlangniß -- überschütten Neugier Wollust -- 
  darein verlieren verlieren glauben -- raffen -- reißen Schleier Haupt -- erblicken -- erfahren -- 
  Moment bleiben Freiheit -- Margariten schön -- tödlich drohend Antlitz sehen -- nächster Augenblick Anstrengung Leben kämpfen -- 
  behend schlang leicht Schal Halses Nacken schürzen -- schnürt Kraft -- erdrosseln -- Ring Leben Tod stark -- wütenden Mädchen -- 
  mühsam überwältigen Luft schöpfen -- liegen zitternd Boden -- zitternd gewaltsam Anstrengung Wut -- Bajadere -- halb erstickt Stimme -- machen Leiche -- verfolgen -- erwürgen -- 
  eilt dannen -- 
  schreiben amerikanisch Schiff -- Wind harren -- Anker lichten -- 
  Strande -- Boot springen -- Neuem Margarita -- sicherlich -- obwohl dicht Mantel Schleier verhüllt -- Wort sprechen -- deutlich klein Silbe vernehmen -- 
  -- hingehst -- Rache -- Versuche_es -- rachlustig Mädchen -- Ozean schwimmen -- 
  Leb -- sanft deutsche -- 
  13. Valerius Hippolyt -- 
  Natur scheiden -- gibst grob sinnlich Weise Gelüste fraglos -- Unterschied übrig bleiben bloß Animalischen -- 
  Bildung gemeinschaftlich Natur -- Sinn Körper heischt einschränkend ordnend Geist zulassen gebieten -- Ehe geordnet Art Leib Seele bewerkstelligen lassen -- hinaus Mensch Tier Wald Wüste -- überheben Weise -- Sinn raffinieren -- 
  möge hie einzeln Mensch Gattung übrig bleiben -- Wissenschaft Kunst Urpflanze -- Urgeschöpf aufbewahren -- stets echt Bild -- wonach Ausbildung regeln -- mög Geist meinig Erquickung -- Spekulationswecker aufsteh Mensch -- teilnahmsvoll Verhältnis -- -- zivilisiert Welt vernichten -- Gegende ausziehen -- Wolf erlegen -- 
  Fahre -- 
  gedenken -- Liebe -- Welt -- innerlichst Menschenbedeutung erkennen -- 
  Wundre -- beklagen -- 
  Beschränkung dulden -- dulden Liebe -- vereinsamsen Lust -- vereinsamen vogelfrei Schütze -- zielen -- vereinsamsen Tod -- 
  Fahre -- 
  sehen einsam erschlag Meeresstrand fern Weltteil liegen -- zornig Seele ringen mühevoll stark -- widerspenstig Leib -- stürzen drohend all hinaus -- Verbindung Gottheit suchen -- unmittelbar Verbindung -- 
  Armer Hippolyto -- 
  tragisch Mensch -- mittelbar Gottheit bemächtigen -- Aussicht vorhanden -- Unmittelbarkeit Leben eintreten -- 
  Armer Hippolyto -- 
  -- -- einst erheben Freiheit -- Freiheit Zivilisierte frei Gesetz -- erheben wahrhaften -- echt Verkehr Geschlechtern lügenhaft Ehe -- lügenhafen -- Wahrheit Wesen aufgehen -- Erfüllung Menschentum gewinnen -- 
  Geliebte zurufen -- bezeichnen wahr Standpunkt -- -- 
  verehelicht Person gelten Kampf -- Ehe -- 
  Halten Ehe -- Herr Himmel Hand erhalten wahrhaft notwendig Wechsel irdisch Welt -- Wechsel Nacht -- Schnee Blume -- schütteln Person -- Lüge Institut Frevel treiben -- schützeen -- Unwahrheit Verbindung fesseln zertrümmeren -- kämpfen Verehelichte -- halten Tür Erfindung -- vermengen Ehe -- 
  -- Verhältnis Weibe anderer Krieg -- Raubzug -- 
  weib heißen -- Mann loben -- 
  weib Lust -- Weib Herz geben -- Ewigkeit -- dergleichen -- brauchen -- Vernichtest Weib -- 
  Fahre -- 
  Schrecken ereilen frei Welt Amerika's -- 
  Freiheit Rechenexempel -- schlimmeres -- deswill Europa fliehst -- 
  durchwirkt alt Welt Zahl -- unpoetisch Behelf -- abstumpfen -- Mannigfaltigkeit entschädigen einzeln mißfällige -- drüben amerikanisch Anfänglichkeit stehen nackt einzeln Pfahlwerk -- überkleiden -- Pfahlwerk gespeeßen -- 
  Rechenexempel -- Pfahlwerk Freiheit poetischen Gelüste unerträglich bekleidet -- geschichtlich Moos bewachsen Untertänigkeit -- bloß Begriff Rezept -- Gewohnheit Speise -- Speise brauchen Mensch -- 
  Fahre -- 
  Grünschloß nächtlich Weile Gebirge wandeln -- Kohlenbrenner Berg durchstrich aufwärts abwärts -- 
  abgelegen Tale sitzen morgens laben hart -- schwarz Brot -- Schnappsack finden -- Sonne scheinen -- Vögel singen -- Leib gesunden kräftigen -- Geist -- denken -- ei -- klug Welt -- wird_es -- -- laß gewähren -- glauben -- betrachten -- Sinn -- dichen Neuem -- -- 
  Welt scheitern -- Versuch verjüngt Maßstabe -- hark Erde -- pflanz Kohl -- wirken Nachbar -- such Nächst -- wagen langsam äußerst vorsichtig Schlus -- Forderung allgemein -- 
  treten Bauer -- Holze -- grüßter -- fragt -- feirig -- werben Faust Tageszeit -- 
  Garten -- Baumschule -- dergleichen verstünde -- -- sehen -- meinen -- -- Feldarbeit -- -- 
  Verstand -- schicken -- gedieh Frucht -- Abends schwatzt Bauer lassen erzählen Ratschlag geben -- erquicken -- Geist sehen -- unbefangen Geist -- absetzen Erfahrung Gedanke -- 
  Freude Genugtuung -- Erfolg unparteiischen -- laß sagen naiv Geist Bauersmann sehen -- sprechen Kategorie -- Jargon Kultur -- treten bildend Verhältnis -- erkennen -- 
  -- 
  bestimmt Ziel rennen -- verfehlen -- lassen Arm sinken -- glauben -- umsonst gestrebt gewagt -- Zufall aufmerksam -- Besitze kommen -- Fuge -- bewegen -- Finger -- raffen erraffen -- fein Sommerfäde hängen bleiben -- Fäde -- Verkündigung still glücklich Sommer -- 
  Welt besiegen -- einzeln Leitgedanke -- einzeln Weisheit siedeln Seele -- Herrschaft -- ausgezog Kampf Streit -- finden Herrschaft -- Aplomb -- Entsagung -- heraus Herrschaft unser Geist wachsen -- größ dicht -- äußerlichn -- 
  Bauersmann erzählt Herr -- welcher Gärtner gewinnen -- Herr -- finden Leichtigkeit hoch -- richtig Bezug -- Charakter verleugnen -- System aufgeben -- Welt Einzelheit Resignation erobern -- 
  gefallen -- -- Fassung -- Verhältnis -- erscheinen -- -- meister Beziehung -- Welt existieren -- tausend Welt aufgefund -- Verhältnis -- Beziehung bringen -- -- Reizend -- Aufgabe -- 
  Weise Gärtner Gutsherr Wunder -- müssen auf Schloß -- müssen Verwaltung übernehmen -- Regiment Obstbaum Bauer wachsen Solchergestalt reißend -- Schloßherr -- jung Wacker -- einräumen -- wissen -- Gärtner -- bewegt Geschichte -- schweigen -- 
  Polizei Staat drüben -- Mörder Constantin's Julien's halten -- quälen -- Stille bleiben -- 
  schaukelnd Schwerte -- Bewegung bannen -- sehen ruhig -- vermocht -- resignieren -- stark -- besitzen -- 
  Durchreisend erkennen -- denunzieren -- denken -- geschehen -- 
  hinaus -- Gouverneur Distrikt -- Gutsherrn unterrichten -- lassen -- Regiment anvertrauen -- ablehnen -- Unsicherheit offen Meer werfen -- fühlen -- Kraft Ruhe jung schmächtig -- mögen hoch Breiter mögen Rinde wachsen -- 
  fast berauschn -- Weg Schritt rasch sicher Herrschaft führen -- berauscht -- jung -- 
  -- Philister -- 
  arg -- mancherlei Hoffnung -- sogar mancherlei Überschwenglichkeit schlagen Flügel -- 
  lieben -- -- fürcht -- schön Keim Nachtfröste verdorben -- 
  verschwieg Tal -- freilich Verschwiegenheit wünschenswert -- Tal Ruhe warm Fruchtbarkeit Paradiese aufgefunden -- Bau zierlich -- heimlich Haus -- bezahlen Geld -- wachsen täglich runden schließen frei Schatten dunkel Kastanienbaum -- Sonnenherz Spalte frei lassen -- 
  glaubst -- Freude gewähren -- solch Besitztum schaffen -- wunderbaren -- Reiz -- 
  Egoismus -- o lassen Sünd -- stellen unbedingt Verlangnis -- kategorisch -- -- 
  groß Freude -- Hippolyt -- 
  sogar Spekulation wagen -- industriell -- all Erfahrung ausrechnen -- walden -- Gutsherr -- -- 
  gelingen -- Gewinn Tal -- Haus bauen -- rü Besitzung Stück Stammvieh Sorte -- Pferd -- Ochs -- Küh -- Schaf -- Ziege -- denken -- vollkommen Wirtschaft -- 
  unglücklich Weltreformator beschränkt Landwirt -- Besorgnis Kalben Kuh -- spott -- gesund beschäftigen Treibe -- Welt sterben -- o -- geschäftig -- 
  Triumph -- gelingen -- 
  Herr Tales -- Besitz -- Wort -- unbekannt bleiben -- rankt weich -- verführerisch Arm -- groß -- erwerben -- 
  Geschenk berauschen -- Erworbene beglücken fesseln -- 
  Regen -- Himmel fallen -- Sonnenblick -- durchdrängen Wechsel verheißen -- wichtigeren Bezug -- wirken gedeiher Frucht -- bestimmen jedesmalig Anordnung Geschäfts -- gehör Familie Gott -- Erde Verwaltung übergeben -- 
  -- draußen -- umherschweif lose besetzt Erde -- bleiben Spekulation -- stürmisch -- allgemein brausend -- bleiben ungestört nächster Sorge -- Verteidigung Ruhenden -- Gemisch bild Welt -- verachen Kein -- 
  Weg Eigentume -- entweichen Spekulation -- Ruhenden kreiset Blut -- klein Schritt -- 
  trotz arbeiten unablässig -- laß klein Schritt -- 
  furchtsam -- 
  sagen -- Erfahrung -- Gedanke aufdrängen -- Mut lassen Allgemeine aufstellen verlangen -- Verdienst Fehler Einzeln -- Mut einzelnen anderer -- 
  herausgehen eigentümlich Bildung Anlage Mensch -- forciert -- ungedeihlich -- 
  habe_es Schrecken eingesehen -- 
  Höre -- Haus Land bestellen -- Abkommen -- Bestieg Klepper -- zauberkreis Welt hineinzusehn -- 
  Baust Irrtum -- sprechen Geist -- befängst Abgeschiedenheit -- betrachten rasch fremd Welt prüfend Blick -- 
  Meile liegen Bergstädtch -- Straße kreuzen -- mancherlei Fremde finden -- reg Menschenverkehr bewegen -- dorthin riten -- siedeln -- Woche zuzuschauen -- 
  finden -- 
  treten Gesellschaft -- Hals fliegen Kamilla -- 
  Leute kuckn -- stecken Kopf -- verwunderten -- fragen -- 
  arm Mädchen verwandte hierher flüchten -- leben still anspruchslos -- erscheinen -- natürlich Gedank -- aufgesucht -- fliegen Frühlingswind Herz -- fragen -- beachten -- lieben -- Mädchen -- 
  Antipathie Ehe -- -- Valerius -- widersprich -- wissen -- stören -- kommen Geliebte -- -- Geliebte -- nimm -- 
  kümmern Welt Liebe -- laß Leute reden -- lächlen -- 
  furchtsam -- Form -- Geklatsche unterwerfen -- 
  scheinen -- Ertrug -- Finger weisen -- kläglichst -- ordinairsten Weiber Stuhl wegrückn -- Kamilla setzen -- Kamilla -- Engel Troß -- Futter Hebamm -- Geschöpf -- wissen -- Begriff -- bloß Form -- hoch -- innerer Wahrheit -- wirklich Sittlichkeit -- wissen -- ertragen -- 
  leiden Folterqual Kamilla -- 
  -- feinfühlend Empfand -- 
  Abends öffentlich Salon -- allgemein Fest feiern -- setzen Tafel -- speisen -- bleiben Ecke Platz leer -- -- ordinär Kaufmannsfrau Plebejist Form Gesinnung sitzen angrenzend Stuhle -- sehen -- stehen Sessel -- legen -- setzen Platz -- einnehmen -- 
  Frage höflich -- Stuhl besetzen wollen -- 
  -- erwidern lauter Stimme -- Liebhaberin sitzen -- Reputation leiben -- 
  all Blut treten Gesicht -- Herz -- erinneren -- Wut empfinden -- fassen Hand -- hören sehen -- Schreie vergehen -- ziehen Höhe -- führen Schritt Stuhl -- sagend -- madame -- verkaufen Bindfade -- bleiben unbekümmert -- Kamilla Hand -- setzen -- 
  O Zustand -- 
  Rottenfeuer Tafel herum -- laut -- leise -- durchweg Ausbruch drohend -- -- schlingen Gift hinunt Essen -- Rache -- fremd -- schreien -- 
  Kamilla -- Engel -- rächen Brutalität Pack -- fremd Stimmung jetzig Wesen -- desto verheerend toben umher -- 
  Kamilla verschwinden -- Thorschreiber Bündel Arm grauend fortwander sehen -- schicken Boten Richtung -- jagt Seite -- umsonst -- 
  wissen obenein -- mittellos hinausgegang fremd -- feindlich Welt -- Verzweiflung -- 
  Zettel Nachttisch bleiben -- folgend -- 
  -- Wesen -- Valerius -- illegal Verhältnis ertragen -- leidest -- sollen glücklich -- 
  gehen -- Folge -- -- -- fändest -- 
  Herzinnigste -- unverbrüchlichst Liebe Ewigkeit gewiß -- such Eheweib -- beglücken -- 
  schläfst fest -- schreiben -- Küsse leise -- schluck Tränenstrom hinunt -- wecken -- gehen -- 
  Tod beten -- 
  -- -- geheim Faser Herzens Kamilla -- 
  Woche vergehen -- Nachforschung bleiben vergebens -- 
  14. Hippolyt Valerius -- 
  Meer -- 
  ziehen eintönig vorüber -- Nacht blitzend Himmel steigen herauf -- langsam unmerklich entfern europäisch Sternbild -- Meer rauschen streichen -- heben fallen -- wünschen -- Elementar- Verhältnis Welt -- stärken -- 
  einförmig öde -- -- 
  brauch Welt -- -- rot blinkend Mars -- find Genug -- Sonne find Leben -- 
  drücken brennt -- Mensch niederwirfen -- Gestirn -- daheim -- -- lieb -- versengend umarmen -- -- -- 
  Groll Galle Wildheit bleiben Herz -- Meereseinsamkeit helfen -- europäisch Land bleiben liegen -- sehen -- bewegt -- schwarz Ameisenhaufen -- zucken Hand -- hoch Woge fassen schütten -- übrig unbelebt Boden -- 
  Welt bilden -- -- 
  Geschichte Philister Welt erfinden -- Zivilisation -- fertig -- Million kleiden -- -- denken -- wünschen -- handeln -- -- Gleichförmigkeit euer einzig Beisammenlebens - traurig -- mordender -- 
  überzeugen -- unterst Klasse Erdentwickelung erfüllen -- kläglich Ziel erreichen -- Hut -- Decke bringen -- -- bedeutend Entwicklung beginnen -- schmacht -- Entwicklung Mannigfaltigkeit -- Tausend -- Millionenfaltigkeit -- 
  Mensch -- Geschmack kleid -- wirklich Eigenheit reden -- echt Herz -- Einzelheit ohnmächtig Haufen erschricken Schaden leiden -- 
  euer Menschheit Hammelherde -- gleichmäßig blöken -- Begriff Menschheit Greuel -- erleben -- Jahrhundert hinaus Nivellierung pachten -- revolutionieren Gleichmacherei -- euer Langeweile gähnen breit Wüstenmaul Sahara -- arabisch Pferd abwechselnd Kraft jagen -- anderer Ziel erjag Tod -- 
  prächtig Wort erfund -- Leute -- -- Leute -- liegen euer Weisheit -- euer Glück -- 
  -- Leute -- rechnen -- brauchen Körper -- Nase -- Magen Gebräuchliche -- reichen -- Euren -- 
  Stark schwach -- schwach stark -- Fahrwasser hinausgreifen -- Tod -- heiß Sonne -- verkohl -- Tod -- ehe Mittelmäßigkeit fortvegetiern -- 
  begreifen -- fürchterlich Vorwurf -- euer Poet Poesie suchen -- -- euer Welt -- 
  idealisiert -- poetisch Welt erfehen -- Abonnementsbillet verschafften -- 
  verderben euer Zivilisation Klugheit -- euer Lump erkennen -- Abonnement all Verwaschung verstehen -- Poet schelten -- euer wirklich Existenz -- euer armselig Gleichmäßigkeit Dichtung erheben -- 
  -- Freßt Staub -- euer Muhme -- Schlange -- -- 
  Verbrechen Eurer Welt -- Erziehung höflich Kaufmannssohne verbieten -- einzeln ausnahmsweise erlauben -- 
  wissen Verbrechen -- 
  fähig -- hören -- Mensch -- Zahl Begriff -- 
  Mensch liegen jeder Verbrechen -- vollständig Mensch -- 
  erreichen Eurem Katechismus -- 
  Verbrechen flüchten euer Tugend -- Fähigkeit Verbrechen Urkraft -- euer Gleichmacherei leiten richten -- töten -- vermögt -- bleiben stark -- göttlich begreifen -- geknebelt Urkraft äußern gewaltsam -- Verbrechen -- Verbrechen -- zufällig euer Gesetz flüchten -- streng Tugendhaft Verbrecher Tugend -- richten Tugend Unheil -- 
  geschehen -- ungeheuer Kraft Alls lauter Dorfschulmeister -- 
  manch sanft Pferd sehen -- störrisch Woche Hand Schenkel pedantischen -- hart-dogmatisch Reiter -- 
  Tränst kandaret verbrecherisch Tugend zurecht -- 
  habe_es beschließen -- Fuß betreten Boden Europa's -- gefall Yankee -- gehen Rothäut Wald -- wohlgefallen -- 
  Kultur -- Verdorbene -- 
  nachts -- Verdeck umhergehen schleichen -- -- verhüllter Gestalt -- begreifen -- Wort -- unheimlich -- ausdrücken -- empfinden -- Hals schaffen -- 
  schleichen leise -- fast unhörbar -- dennoch erinnern ehern Tritt Komturs Don Juan -- 
  deutsch Auswanderer Schiff -- wandern -- 
  Gott -- Kind Acker -- 
  ABC Staatsnot lassen sagen -- Robespierrianer -- Welt -- 
  -- -- gleichgeschlag -- Bäumche -- groß -- Strauch -- niedrig -- beliebt -- vertilgen -- hoffen -- Rechnung Amerika finden -- 
  erwarten -- erwarten -- -- -- erwarten -- 
  euer Revolution prosaisch euer Alt -- Paar Probeexemplar Amerika sehen hören -- grinst totem -- gläsern Auge -- 
  Wind streichen frisch Europa unser Rücken -- Herz günstig -- 
  Bank ankommen -- hundert Seemeile Nordnordost hinaufziehen -- Amerikaseglern Gefahr drohen -- 
  walten dicht Nebel -- fahren halber Nacht -- giebt's einsameren -- großartiger Tod -- 
  Dunkelheit mitten Weltmeer verschwinden Atom -- 
  O kläglich -- kläglich Zustand Mensch -- 
  tyrannisch -- Fordernder -- greifend Geist geben -- Wechsel Orte reichen -- Geschöpf verschwinden -- jach unbemerkt -- 
  Betracht -- Welt verarmen -- 
  mittelalter Teufel -- lieben Teufel -- sogenannter Frechheit flüchten -- Torheit Klugheit glauben sehen -- Hilfsmittel -- bekannt Welt Gedanke Kraft zureichen -- Brücke groß -- brennenden -- 
  Welcher Anreizung -- verschreiben -- 
  vergessen Verhältnis -- prosaisch nivellieren -- euer Titanenelement verwässern -- 
  manchmal -- dicht Nebel Meeres -- sitzen Borde Schrei Wasserewigkeit hinaus -- Dämon -- einlassen -- wahrlich Ort wüssen -- schweifend Urgeist -- 
  Versuch -- totenstill Nacht Einsamkeit Teufel rufen -- direkt Volkssprach rufen -- klar -- verständlich Stimme -- Teufel -- Hole -- 
  liegen Reizung -- 
  wüsst Wasser schweigen -- 
  Kapitän Reisebeschreibung -- lesen -- 
  find Folgend -- Sultan eifrig Gläubiger -- Jerusalem -- Moschee Gottesdienste einrichten -- alt Salomonische Tempel gestehen -- Christ beten -- lassen Moschee unten Rosenwasser abwaschen -- Stäubchen übrig -- Christ verunreinigen -- 
  -- religiös Moment -- -- gewohnen -- nennen -- Eurer positiv Überlieferung -- entsagenden -- zerknirscht Demut verbinden -- Bezug Gottheit fordernder -- trotzig -- dasjenig -- Griechen Prometheu zusammendichten -- Sultan -- 
  Gott charakteristisch bilden ankleiden -- Stäubchen vorenthalten -- 
  euer Glaube fassen -- schließen -- schweifen Erklärung -- Glaube -- erklären -- 
  wundern -- Verwirrung umhergeworfen -- weder klassisch Religion -- klassisch Staat -- klassisch Poesie -- 
  Blick Seite Mensch -- Pole Herzens -- Ströme Welt -- bewegen -- 
  Selbstsucht Selbstaufopferung -- 
  ungeheur Altertum schaffen -- Christentum eintreten -- beinahe zweitausend Geschichte erzeugen -- 
  dreist -- neu Geist erheben -- halb -- halb Altertume stammen -- Philosophi bilden -- eigen Fuß erheben -- Selbständigkeit positiv Religion Anspruch nehmen -- selbstständig Staat unterhandeln -- 
  Pyilosophie unchristlich -- christlich Resultat -- 
  Weltgedank durchgehend Selbstaufopferung erschüttern -- morden Größe Prinzip -- Selbstsucht -- heraus -- neu Element bringen -- neu erzeugen -- Kampf kläglichen -- 
  kläglich -- geteilt Wahrheit Herzen herausgehen -- Geordnetes lügen -- beschönigen -- 
  beschränkt Mensch -- furchtsam Frech abteilt -- euer Herz Mut euer Gedächtnis -- Besserum halten Gesellschaft -- verlieren Wahres -- beschränken -- Gott Ungeheuer -- 
  Geduld Kraft schwinden -- Ungeheuer entstehen -- -- 
  herrschen -- herrschen -- Wort toben Kampf Welt -- 
  Meer -- Ohnmacht bewußt Mensch -- meer weiten bäumen eindringend Gewalt -- heulend schüttelnd ringen Sturme -- zerschellend stürzen Gestein Land -- 
  liegen kraftlos Brett Balken -- -- preisgeben -- 
  15. Valerius Hippolyt -- 
  gehst Grab -- gehst Grab -- Genoß Jugendzeit -- 
  Ozean werfen -- Arm stark -- Kraft -- Mensch Element ringen -- Tod gewiß -- Gemeinschaft Mensch mächtig -- Gesellschaft erfinden -- Herr Welt -- höhnst Tötest Gesellschaft -- 
  letzter Brief England erhalten -- Tragödie -- raffinierst Tallon Lord Henry Äußerung Herzens Leibes -- erinnerst Lothario's Wilhelm Meister -- inne -- Blutsverwandtschaft Theresa -- erinnerst -- fliehen -- 
  -- empfinden -- ähnlich Zivilisationsgefühl -- achten -- Zivilisation erschlagen -- tun -- werden_es Rothäute Amerika's -- Gesellschaft -- 
  Geschöpf treten -- entstehen Verhältnis -- Verhältnis brauchen Gesetz -- 
  traurig bewegen -- 
  Hippolyt -- letzter -- Geschichte -- Herz -- Geist hängen -- -- -- plünderen -- verwüsten -- 
  Konstantin erstarren Schied -- William -- Wärme nah -- treten -- kalt Hochmute einseitig -- unbedeutend Herr -- Welt entwickeln -- Leopold bleiben -- -- müssen -- Narr -- Spital -- Joel -- schön Herz -- schachern -- grausam Welt -- Weiber sterben -- Verdorbe -- zerknickt -- kämpfest letzter Verzweiflungskampf Leben Tod -- grün -- still Tal retten -- verarmen -- Herz erkalten -- hüpfen -- Blick -- Hoffnung entzünden -- bau Welt -- traurig -- 
  Mensch -- gewinnen -- wissen untergegangen Welt -- neu -- kenn kahl Valerius -- vorne anfangen -- tausend Klammer gemeinschaftlich Geschichte fehlen -- Besuch -- 
  Gott wissen -- Glück -- Leben schwer -- schwer -- 
  still-heit -- gedenken -- schreiben -- 
  Besitztum gedeihen -- Leute suchen -- Haus wachsen Ecken weich -- -- Freund -- gestehen -- Philisterkorn fangen -- wuchern -- 
  Rett -- vermögen -- Ursache -- Ursache herb -- fürcht -- abhelfen -- 
  lieben -- 
  Bewegung Teilnahme -- fragen -- -- Wachstum Empfindung Nacht -- Frisch -- Wogende -- Heiß Kalte -- Überraschung -- aufgehend -- Träne aufgehend Herz -- Rausch stets interessiert Gemüt -- -- -- -- 
  rauh Wind Meeres -- dumpfig Luft Kerker -- Herz verhärtet verdumpfen -- mühsam erhalten -- retten -- ziehen -- auskommen -- 
  warm Träne fließen lang Papier -- weinen unser Genie -- aufgebröckelt feindlich Welt -- -- -- 
  Welt -- führen Tod -- lächeln -- tun -- 
  glücklich -- alt Kumpan -- Brief ausdrücken -- Gedankens erwehren -- letzter -- schreiben -- 
  weit Weltmeer blutig Groll scheiden -- schlagen Brücke hinüber -- 
  Nimm letzter Strich Bilde Leben -- Linden Kastanie spinnen -- außen letzter Faden -- Faden Besorgnis abreißen -- Gericht nämlich Constantin's Hinterlassenschaft klar -- Täter -- Mann durch Fenster Katastrophe erblicken -- Scheu Criminali Zeugnis zurückhalten -- 
  lösen zornig Welt -- warm Sommerabende promenieren getrost Waldberg -- Grenze bilden -- 
  Jenseits Grenze stehen Jagdschloß -- hinabsiehen weit Land -- Fenster stehen jeglicher Abend Mädchen blitzend Auge -- lachen -- tollen -- witzig munt -- Geschichte hören -- still weich -- glauben -- 
  Vater -- lieben -- Kopf schütteln -- gehen Abend -- 
  Sinn Tracht Welt Handdrücke -- Streichel Mädchen-Wang -- unruhig Kopf ruhen Mädchen Schoß -- 
  Hippolyt -- 
  Bleiben Bewußtsein Welt -- finden Stern -- gehören -- entgegengesetzen Pole Welt -- 
  stirb -- 
  Hippolyt -- 
  O Wunsch Mensch -- Seele Erinnerung -- Zusammenhäng trug Zustand -- Leib ausgespannen -- 
  Gott -- jauchzen geläuteren entgegen -- 
  Hippolyt -- -- Wort ordnen -- stirb -- 16. Margarita Valerius -- 
  neu York -- 
  Auftrag -- nachfolgend Papierstücke Hippolyts senden -- wissen -- stets einzig Freund Welt nennen -- geben Schiff -- 
  Welle lüstern -- nehmen Schlußworte gewaltig Mensch freundlich -- 
  -- fürchterlich Enttäuschung -- 
  O fürchterlich -- 
  mach starr Faust -- Pluto -- Fratzenbild Welt Scherbe schlagen -- 
  Freiheit hoffen finden -- finden bettelhafte Armut -- Frechheit Armut -- 
  Gold suchen -- Leben -- Reichtum Mensch -- Lust -- Klage -- Sehne -- Feind -- ewig Herz -- schaukelnd Gedanke -- Titanengedank -- Wollust -- Verzweiflung -- Roman Mensch -- lohnen -- morgens aufzustehen -- Abends niederzuleg -- jenseits Meeres lassen -- frei -- Freiheit -- 
  Tier frei menschlich Sorge -- oh -- -- 
  -- fühlen -- Tod -- Mal Leben -- giftig Reif Auge -- Herz fallen -- innerst Kern lösen gähnend Stück -- träumerisch -- melancholisch -- schreiben einzeln Papierstreife -- fliehen Mensch -- such Buch -- liegen verschlossen Zimmer -- fürcht Natur -- meere zittre -- 
  zitter -- Hippolyt -- Spiegel zuhängen -- sehen -- erröte -- -- 
  -- Kerl -- Stiefel putzen -- plump -- einfältig Kerl -- behandeln -- Seigneur -- hattest -- Valerius -- gleich Berechtigung verleumden -- Gleichheit machen -- 
  schwarz -- 
  O frech Frevel Freiheit -- 
  Bedient Europa's Geld sparen Staat errichten -- 
  Bedient -- Aristokrat -- Antlitz färben -- Hund -- Fuß treten -- zertreen -- 
  Prosa Europa's Herrschaft gedeihen -- ersticken -- -- 
  -- Geschichte -- frei Wissenschaft -- frei Kunst -- 
  frei Handel Freiheit -- Gott Pappe -- allerlei Buchbinderausgabe -- Gott -- Geschmack zutrauen -- -- Welt -- alt Paar Zahl erben -- Geld einbringen -- unnütz -- nützen -- überflüssig -- 
  O schön Freude edlen Bildung -- Fuß stoßen -- Kaufmannsschule -- Welt ausgeben -- rächen -- -- 
  übrig Zettel Trubel letzter verlieren gehen -- hören Erzählung letzter Andenken Freund -- 
  Schiff hierher -- Rache treiben -- vernichten -- 
  Schiff -- obwohl mehrmals Gelegenheit bieten -- rückling Bord stoßen -- fürchten -- 
  -- -- Weib -- zerschmettert Titan jammerter Seele -- weinen -- Spaziergang wagen -- 
  stolz Gestalt knicken -- wild Kopf neigt Brust -- schwarz Haar ergraut -- -- kühnen Auge verschleieren suchen Boden -- Lieblingstier -- mutig Ros -- weichen scheu Weg -- 
  -- 
  Trüber regnerisch -- Herz bewegen fühlt Mitleid Weh -- hinantrat -- Schleier zurückschlug -- -- Hippolyt -- versöhnen -- helfen -- trösten -- 
  schrak -- Hand -- küßen -- fallen Träne -- einzig -- Leben weinen -- 
  Nachmittag -- Arbeiter kehren heim -- plötzlich drang Geschrei Zugang nah Stadt -- Neger stürzen Pfeil heraus -- Schar Weißer drein -- schwarz Vorsprung -- fliegen Hirsch nah Wäldch -- dicht -- fallen -- Schuß -- arm Flüchtling springen Höhe -- stürzt Boden -- 
  wilder Freudengeschrei stürzen groß werdend Menge Opfer -- vorüber -- 
  entsetzen erkennen -- Gewehr tragen -- raucht -- Tallon -- Verhaßten -- 
  werfen eilig Schleier -- Veränderung Hippolyt vorgehen -- 
  elektrisch Schlage Gestalt aufrichten -- Auge blitzt -- Muskel zucken -- Gewaltiger sehen stehen -- Schritt straf Gang Haufen -- 
  Leichnam hergefallen -- deutsch Arbeiter Paar Worte Mitleids äußern -- fallen schreien -- -- linchn -- linchn -- -- Hippolyt Löwe Haufen hineinspringen -- links rechts roh Maß schleudern -- deutsch Arbeiter Seite reißen -- donnernd Stimme vorwerfen -- nichtswürdig Gesindel -- Menschenrecht Freiheit Füßen treten -- 
  stürzt Gebrüll -- Hippolyt entreißen Büchse -- schlagen mäht Athlet -- schaffen zweimal -- dreimal frei Bahn -- ring -- stehen zürnend Halbgott -- 
  Tallon zurücktreten -- tückisch Schlange -- Büchse laden -- schlagen -- sah_es -- stürzen hinzu -- spät -- 
  mitten Brust treffen stürzen stolz Leib Hippolyt's nieder -- furchtbarem Geheul schlagen Menge -- 
  -- Abend -- Rotte zerstreuen -- Regen goß -- schön Leib Hippolyt's zertret -- Kleiderfetzen nackt Negerleichnam unterscheiden -- 
  Nacht sitzen weinen -- -- Raubvögel scheuchend verstümmelt Rest -- Dolchstich empfinden -- gelieben Raserei -- -- morden -- 
  Wald hinüber -- 
  solch Menschenbild bestehen Welt -- tut_es -- verlieren Mädchen weiß Rothäut Einsamkeit Grund - Kloster -- Urwald besiegen -- Raum sterben -- 
  Inhalt -- 
  Seite 1. Hippolyt Valerius 3 2. Hippolyt Valerius 21 3. Valerius Hippolyt 67 4. Valerius Hippolyt 170 5. Valerius Hippolyt 176 6. William Constantien 179 7. Valerius Hippolyt 184 8. Hippolyt Valerius 188 9. Hippolyt Valerius 197 10. Hippolyt Valerius 210 11. Leopold Valerius 214 12. Hippolyt Valerius 221 13. Valerius Hippolyt 248 14. Hippolyt Valerius 265 15. Valerius Hippolyt 276 16. Margarita Valerius 282 