Jenny -- 
  Verfasserin -- Clementin -- -- 
  -- 
  Leipzig -- F. A. Brockhaus 1843 -- Jenny -- 
  -- 
  Jenny -- 
  Verfasserin -- Clementin -- -- 
  Stamm -- Erlöser -- Madonna -- Apostel hervorgegang -- tausendjährig Verfolgung Glaube Sitte Vater treu bleiben -- tausendjährig Druck hervorragend Größe Wissenschaft Kunst erzeugen -- ebenbürtig -- 
  Verhältnis Jude Preußen v. Rönne Simon -- 
  -- 
  Leipzig -- F. A. Brockhaus 1843 -- 
  Berghof -- prächtigen -- Meer gelegen Landhause Kaufmann Meier -- finden Jenny -- 
  Clara Horn -- Jenny hinausgefahr bang Herzklopfen Ankunft Eduard's harren -- 
  wiedergeseh -- Rate gehen -- Begegn können -- 
  Eduard Berufe Mutter -- verweilen -- Hoffnung -- Clara sichtbar -- erscheinen -- 
  resignieren fühlen -- Fassung gewiß -- Beisein Mutter Eduard Mal sprechen -- -- Sehnsucht reg -- benutzt Versprechen -- Jenny Berghof besuchen -- Voraussetzung -- Eduard Abend zubringen Anwesenheit Familie ruhig Haltung -- 
  Clara Eintritt erregt Freude Dame -- allgemein Frage Ergehe -- finden bleich leidend -- 
  versichern indessen -- vollkommen fühlen -- Unterhaltung -- wozu Herr Meier -- ebenfalls anwesend Clara ungewöhnlich Aufmerksamkeit behandeln -- hülfreich Hand bieten -- 
  Jenny täuschen -- benutzt Gelegenheit -- Clara entfernen -- erfahren -- Szene Garten Eduard Freundin vorgehen -- -- teuer Person Beistand Trost gewähren können -- 
  berichten -- jung Mädchen innig Freundschaft fassen -- fast aussprechen -- berühren -- 
  Jenny kennen William's Neigung Freundin -- Werbung Scheu -- Clara Rückkehr denken -- Mädchen begreiflich Rücksicht jemals Grund berühren -- Clara Verbindung abneigen -- 
  Jenny Freundin heit Eduard unverändert ruhig sehen -- indiskret halten -- Verhältnis drängen -- verheimlichen -- Clara's bleich Antlitz -- Eduard's düster Stimmung leiden Seele lesen -- lang überwind -- eigentümlich Lebhaftigkeit knien Clara nieder -- bitten -- arme umschlang -- -- Sage -- Clara -- geschehen -- 
  gelitt -- bleich traurig aussiehst -- 
  fehlen Eduard -- 
  Sage -- Ärgste fürchten -- liebst -- leiden lassen -- -- 
  -- weißen -- -- antworten Clara -- -- laß schweigen -- 
  Helfen -- -- einzig -- sollen -- -- Eduard paar Minute lassen -- herauskommen -- 
  -- -- 
  Jenny versprechen -- traurig sitzen beisammen -- Hufschlag Pferde Ankunft Reiter verkünden Pause bang Erwartung Herr Meier Eduard -- 
  gewaltig Fassung rang -- deutlich innerer Aufregung -- -- Clara begrüßend -- Hand ergreifen küßen -- 
  Clara's Auge schwamm Träne -- Anwesenheit Vater zurückhieln -- anscheinend bemerken -- 
  halten Brief Hand fragt Tochter -- Erlau's Abreise wissen -- Eduard Brief melden -- Freund Abschied nehmen -- 
  Jenny verneinen -- Herr Meier -- 
  -- Schreiben Erlau's treuest Abbild -- hören -- lauten -- 
  -- Eduard Meier -- Befehl -- Currend übrig Volk senden -- 24 Stunde Abwesenheit Entfernt erinnern -- -- 
  -- Doktor -- ziehe Taschentuch hervor trocken verwunderen hoffentlich weinend Auge -- erfährst -- längst Tor hinaus -- Lebewohl sagen -- 
  behaupten -- treulos desertier --- langweilig Kampagne norddeutsch -- nebelgrau Winter voll rührend Geduld lobenswert Teilnahme durchgemachen -- Eure steifgeschnürt -- gebildet Schöne tanzen sehen -- hundert Gesellschaft gelangweilen ruhig Eurem sogenannter vernünftig Treibe wirken -- Eurer Ästhetik Politik -- euer Diner Zweckesse -- euer Verein all tausend Narrheit zuschauen -- -- Hand Zaume halten -- täglich hundert Karikatur zeigen verlangen -- 
  Karikatur Bastard Kunst -- unwürdig Sohn -- Mutter verleugnen -- Vater ehrlich Name hergeben -- 
  Wehe -- euer unverbesserlich Geschmacklosigkeit verleiten -- nahe -- Irrweg führen -- 
  fliehe wend Schritt Gegenden -- blau Himmel lachen -- Regier Fürst denken Pfaffe überlassen -- bezahlen -- Gewerbschein lösen brauchen -- verlangen -- ruhig Sonne liegen paradiesisch Wonne dolce far niente befleißigen -- 
  -- Eurem gepriesen zivilisiert Leben verlangen hören -- 
  Sollt schreiben -- wissen -- -- -- vermeiden -- schreibkundig Hand brauchen -- Blüte Freude pflücken -- Weg winken -- 
  Winter liegen -- Pinsel einzeln Lichtstrahle wiedergeben -- Eis Schnee unvergeßlich Seele dringen -- 
  Nacht Stern -- nordisch Eis blitzen sonnenhell Brillant funkelnd hervor -- Auge erfreuen -- beleben -- erwärmen -- Verschmäht -- 
  somit lebet -- 
  Eduard -- dein übrig Freund -- Genießet spärlich Sonnenlicht -- -- wachset Gedeihet -- Art -- Berghof Sonne untergeh Mond Horizont emporsteigen Sehet -- beten -- Götter reichst Segen Fleckchen Erde -- Oase Wüste -- Tal beglücken mögen -- Schutz sorglich Liebe schön Rose Saron erblühen -- 
  möge Apoll Pfleger süß Duft lohnen -- Seele Sohn hauchen -- -- gänzlich Erstarre traurig Farblosigkeit Eur Land beschützen -- 
  nochmals lebet -- -- 
  -- Abschiedskompliment -- Kind -- -- Vater -- -- Danke sorgen -- Brief Erlau's Wunsch näh Freund Haus mitteilen -- 
  freuen jung Mann Wille -- solch rasch Entschlüs fähig -- Italien Frage Vollendung geben -- berufen -- 
  Gib Brief -- Mutter Theresa zeigen Abreise liebenswürdig Wildfang erzählen -- -- 
  -- kommen -- -- rufen Jenny -- Vater -- Wunsch gemäß Eduard Pein Wiedersehens fortgeholfen -- entfernen -- 
  Clara halten -- sprechen -- 
  -- -- lieben Jenny -- bleiben -- -- 
  Bruder sagen -- brauchen -- wenigster Geheimnis -- -- 
  -- Clara -- -- rufen Eduard -- -- Gott Wille Ruhe -- töten -- Augenblick Seele entfernen -- 
  O -- Glück -- -- wiederzusehen -- Stande -- Leid vergessen -- treffen -- -- 
  -- leiden -- -- erwidern Clara bebend Stimme -- -- Freund tragen versuchen -- ändern vermögen -- 
  bleiben -- -- -- fassen Eduard's Jenny's Hand -- vereinen Herz drücken -- -- Jenny bleiben -- viele -- Achtung -- -- Liebe -- 
  genüg erheben -- -- schließen -- verbergen weinend Gesicht Jenny's Brust -- zärtlich weinend schmiegen -- 
  Eduard bog Mädchen nieder -- Hand Clara drücken lang Kuß Stirn -- 
  -- möge Friede -- -- seufzen -- stumm sitzen beisammen -- 
  versuchen Eduard Frage -- Clara abend Stadt zurückkehren -- Gespräch anzuknüpfen -- 
  -- -- -- antworten -- -- zweifle -- sprechen -- Berghof -- Mutter Ankunft Vetters erwarten -- -- stocken -- Eduard Jenny errieen Fehlender -- 
  -- stehen Schwer bevor -- -- Jenny -- blicken ängstlich Eduard -- totenbleich unwillkürlich ausrufen -- 
  -- -- -- 
  -- Onkel herstellen -- -- fahren Clara fort -- -- wissen -- zuletzt sehen -- William zurückkehren -- 
  sagen -- herkommen -- entfallen -- -- 
  entstehen -- drückend Pause -- sprechen -- scheut -- Gegenstand reden -- beschäftigen -- 
  Eduard bestimmt Entschluß fassen -- Clara beschwören -- stumm Resignation aufgeben -- Beisammensein vermeiden -- bitter -- Trennung müssen -- 
  dazustehen geliebter -- entsagen -- Herz bezwingen -- Schrei Schmerzes -- glühendst Wort Leidenschaft ausbrechen -- finden Eduard unerträglich -- 
  süß entstehend Neigung geschien -- Wort zart Regung geliebt Herz verstehen -- ehe entscheidend Geständnis Lippe entfloh -- qualvoll dünkt Zwang -- leidend Untätigkeit -- peinlich erwarten Kommende verurteilen -- -- Begegnung Leben rasch handelnd entgegentreten -- 
  erscheinen Reinhard -- -- Berghof angelangen -- Braut suchen -- Erlöser drückend Bande -- 
  Familie beisammen Stunde Mitteilung Art vergehen -- Eduard Clara allmählich schmerzlich Empfindung befreien -- erdulden -- Vater Genugtuung -- Teilnahme -- Unterhaltung Übrig mischen -- -- Eduard heiß ersehnen -- Trennungsstunde schlagen -- 
  geleitet Clara Wagen -- letzter Abend -- Stadt verleben -- dumpf Gram -- empfinden -- müssen Schmerz Stunde Glück erscheinen -- 
  schmerze liegen Bewegung Leben -- fühlen Entsagung Leichentuch Zukunft gebreiten scheiden wortlos vernichten -- 
  verabreden berichten -- Jenny' Taufe vollziehen -- Abfassung nötig Glaubensbekenntniß führen ernstlich -- erneuert nachdenken Punkt -- 
  Mensch lebhaft Phantasie -- allmählich bestimmt Ideenkreis hineinzudenken -- Richtung Grund ausstatten -- Gebäude errichten -- Schein Festigkeit Vollendung tragen -- wirklich Basis Überzeugung Desjenigen -- aufführen -- 
  Dichter -- namentlich Jugend -- Geschöpf Geist lebend Mensch unterscheiden vermögen -- Kind spielend fest erfunden Verhältnis Puppe hineindenken -- unwillkürlich Erfunden Wirklich vermischen trennen -- gewiß Art Jenny religiös Erkenntnis -- 
  vergebens versuchen -- Symbol Christentum Verstande erfassen -- bemächtigen einst plötzlich Einbildungskraft -- Überraschung gewahr -- viele denken Folge Veranlassung ausmal -- deutlich Vorstellung ausbilden können -- woran Glaube fehlen -- 
  Christus -- eingeboren -- gekreuzigen auferstanden Sohn Gott -- fest Gestalt Wunder -- Gott Olymps -- Goethe göttlich Mahadö -- opfernd Geliebte verklären Flamme emporheben -- 
  -- trotz historisch Kenntnis mittelaltrigen Johannes Faust -- gänzlich unsterblich Gestalt goethesch Faust verlieren -- letzter poetisch Schönheit Gedanken erscheinen -- 
  bildet Mensch Jesus -- Apostel beschreiben -- mystisch Christus -- spät christlich Philosoph Dreieinigkeit denken -- 
  wähnen -- Erscheinung bestimmt Form leben -- Christus Wunder glauben -- Sinn -- Reinhard verlangen sodaß voll vertrauen behaupten wagen -- bloß christlich Moral -- Menschwerdung Christi vollkommen Wahrheit -- 
  Trugschlüssen stimmt Idee -- willkürlich Anfangspunkt System finden -- annehmen -- obgleich -- 
  sicher Ruhe -- hintergehen -- täuschen Reinhard unterrichtend Pastor -- obgleich Letzter unerwartet Veränderung Ansicht Schülerin überraschen scheinen -- 
  -- Woche Clara's Eduard's Lage beunruhigt Teilnahme Anspruch -- Entdeckung Theresen Liebe Reinhard Erlau unerwartet Geständnis vielfach beschäftigen Gedanke Forschung Christentum abgezogen -- Taufe festgesetzen Termin herannaht hinlenken -- 
  Glaubensbekenntnis niederschreiben -- eigentlich streng Glaube enthalten Dogma binden müssen -- nachdenken fest Punkt richten -- fing Luftgebäude künstlich Überzeugung schwanken -- Schöpfung regen Phantasie zerfließen hell Strahl Geist -- 
  bemerken Jenny entsetzen -- 
  Ruhe Heiterkeit gewinnen Täuschung -- unbewußt hingegeben -- 
  frommt Einsicht -- Beide schonungslos raubt -- alt Chaos Zweifel stürzen -- -- Reinhard trennen -- Übertritt Christentum zweifeln Lüge -- 
  vergebens Vorstellung zurückrufen -- Stunde geläufig klar -- gelingen -- erwachsene gelingen -- Empfindung hervorzuzaubern -- Kind gewiß -- Wagen dahinfahrend wähnen -- Baum Haus Vorüberflieg sehen -- Still stehen -- 
  Gegenteil unumstößlich beweisen -- fest Wille Trugbild erwecken -- 
  Moment hoffen -- Wahrheit verblenden -- liebgeworden Täuschung festhalten -- Wahrheit siegen -- 
  Prüfstein -- siegen -- Jenny sträuben vergebens Gewalt -- 
  Überzeugung -- Geist Christentums Hauptsache -- -- Ausweg Besorgnisse zeigen -- Anfang Redlichkeit scheuen -- 
  -- 
  -- unaufhörlich Glaube christlich Dogma behaupten -- plötzlich erklären -- täuschen können glauben -- 
  eigentlich liebsten tun -- Unfreiwilligkeit Täuschung zweifeln -- annehmen -- Ansicht behaupten -- Zweck erreichen -- beschwör Mut fehlen -- 
  Reinhard Vater -- Eduard Licht erscheinen -- bringen Verzweiflung -- abgeseh Trennung geliebter -- unvermeidlich -- weigern -- Christin -- 
  schauderen -- Wahrheit Reinhard wählen -- fühlen -- bedauern müssen unglückselig Alternative -- leiden -- falls entschließen müssen -- geliebter Überzeugung opfern -- 
  beklagen -- Joseph -- ungern Christin -- Erlau -- lieben -- 
  -- Therese -- 
  -- Therese freuen -- Hoffnung erblühen -- -- kennen -- Therese eigensüchtig -- Trümmer Jenny' Glück- Liebestempel eifrig bürgerlich Wohnhaus gründen -- 
  geschehen -- Therese ernten -- Jenny Herzblute säen -- -- durchzudenken -- religiös Ansicht -- entscheiden Überzeugung gelangen -- Dogma Nebensach betrachten -- -- Reinhard's Meinung schonen -- Glaubensbekenntnis stand bringen -- Spitzfindigkeit alt Jesuit Ehre -- 
  groß Geschick vermeiden -- Lehren Kindschaft Christi -- Erlösung Tod gegeben Genugtuung erwähnen -- Zweifel Glauben Reinhard veranlassen -- einverstand Glaubensbekenntnis erklären -- Jenny innerst Beschämung vorlegen -- 
  geliebter Beifall -- Freude Erkenntnis Dolchstoß Gefühl -- 
  lieben -- Freute -- Betrog -- Heiligste -- 
  -- Reinhard's vertrauen unwürdig hintergehen -- Wahrheit stehen -- Gedanke Raum geben -- Christus verschieden Weise glauben -- unaussprechlich lieben glücklich können -- 
  begreifen -- freisinnig Mann Punkt unerbittlich Strenge -- 
  Liebe häuslich Glück -- Jenny Jesus Mensch -- Christus Gott halten -- Lehre befolgen -- 
  indessen führen Gedanke Punkt -- Reinhard nimmer zugeben -- Christin lassen -- Wahrheit bekennen -- verlieren -- -- 
  verzagen -- Kampf ermüdeen -- Schwäche Mut Trennung geliebter fühlen -- Feiglinge selbstmördern -- Moment Entscheidung Feigheit zurückhielen -- 
  gewohnen -- Erzählung Dichter Edelmut erhaben Motiv Held stoßen -- sodaß nackt Prosa Leben fremd widerwärtig erscheinen -- 
  Jenny Auge Leser Gunst sinken -- behaupten -- zuletzt Schwäche Furcht -- abhalten -- Äußerste wagen Glück opfern -- rechtfertigen -- 
  Natur mitteilend -- teils Verhältnis -- teils Schuld Gewebe Heimlichkeit Täuschunge verwickeln -- Auge erniedrigen -- 
  Clara ruhig ergeben Entsagung leuchten -- Freundin -- bewußt -- Unvermeidlich würdig tragen eher Glück -- Achtung entbehren -- 
  -- fragen -- Reinhard hinträte erklären -- 
  -- lieben -- ahnen -- Zukunft knüpfen -- Christin Sinn -- Wonne entsagen -- hoffen -- 
  Therese lieben -- glauben Christus -- mögen Glück gewähren -- Hand Jüdin annehmen -- -- 
  innerlich gehalten Rede zerfließen Jenny Träne -- 
  Schmerz -- empfinden -- Moment traurig Entscheidung kommen -- fühlen lebhaft -- obgleich Art Beruhigung Akt Großmut liegen -- Nebenbuhlerin ausüben -- 
  stellen Kummer -- schön Leben fern Reinhard vertrauern -- Theresen Seite vergessen -- heiß bitter floss Träne -- 
  Eltern sagen -- 
  Kreis bekannte denken -- 
  welch widersprechend -- tadelnd nachteilig Gerücht können verbreiten -- 
  höchst Glück religiös Überzeugung blutendem Herzen opfern -- Neid böse Wille innerst Verhältnis Leben drängen Motiv Handlung suchen -- Spur Seele -- 
  Therese bereit -- Reinhard beweisen -- Mangel Liebe Furcht beschränkt Verhältnis Leben ländlich Zurückgezogenheit Lösung Bündnis veranlassen -- Religion Deckmantel gebrauch -- 
  Jenny Reinhard -- -- Verachtung blicken -- stoßen -- -- einst lieben -- stets warm Neigung gehangen -- trotz innerer Kampf -- trotz warnend Stimme Gewissen lassen Jenny Taufe bestimmt Stunde ansetzen -- beschließen -- gekünstelt Glaubensbekenntnis -- beschwören -- Meineid begehen -- unauflöslich Reinhard verbinden -- leiden fürchten -- Trennung geliebter notwendig Folge müssen -- 
  Reinhard -- Mutter Clara Zeuge Jenny's Taufe -- Pfarrerin Zweck Berghof kommen -- paar Woche bleiben versprechen -- 
  Reinhard frei Geschäft Stadt -- Braut verleben -- -- -- Taufe Mutter alt Onkel fahren verweilen -- Entscheidung Anstellung definitiv erfolgen -- 
  obgleich paar Monat Abreise Pfarrerin verflossen -- finden Verhältnis Sohn Jenny wesentlich verändern fast umgekehrt -- 
  Reinhard's Eifersucht legen -- Erlau erregen -- äußerer Verhältnis Zukunft -- Reichtum Braut ausgesöhnen -- überzeugen -- Familie Wert begreifen -- überschätzen absichtlich prunken -- Jenny's religiös Erkenntnis Ansicht anschließen -- vollkommen glücklich -- innerer Zufriedenheit gelangen -- Verlobung fliehen -- 
  innerer Ruhe heit -- Nachgebender Mitteilender -- jemals -- 
  tausend Aufmerksamkeit Jenny's Eltern -- behandeln Eduard zartesn -- ängstlichst Sorgfalt -- Verlust trösten -- Größe Reinhard empfinden -- Liebe Gram sprechen -- 
  Jenny unabläßlich beschäftigen -- -- Kleinigkeit erfreu Begebnis fröhlich -- scherzhaft Seite hervorheben -- 
  Theresen Neigung dienen -- verheimlichen -- -- Glück erhöhen -- Eitelkeit -- bewußt -- schmeichelen Jenny' Eifersucht wohltuend Beweis Liebe geben -- 
  fühlen gewiss Weise Theresa verpflichten -- behandeln freundlich Zuvorkommenheit -- täglich Beisammensein stellen zutraulich bequem Verhältnis -- Theresen Seite Unbefangenheit verlieren -- ruhig Reinhard überlassen -- 
  Freude Pfarrerin Verwandlung bemerken -- Stimmung Sohn erleiden -- Rätselhafter erscheinen Jenny -- 
  düster Ernst -- krankhaft Reizbarkeit bemächtigen -- Therese Letzter dulden -- sodaß alt Dame bedauern erregen -- 
  Jenny Liebe Bräutigam scheinen grenzenlos -- Augenblick trennen -- unruhig -- -- vermissen scharf Auge Pfarrerin -- trotz Heftigkeit Leidenschaft -- Jenny's Liebe verraten -- innig Hingebung -- Reinhard zeigen -- 
  liegen Betragen -- Art Jenny's -- unheimlich -- fast dämonisch vorkommen -- wovon bestimmt Rechenschaft geben -- -- Jenny unersättlich Hang Zerstreuung erfüllen scheinen -- Umgebung Ruhe lassen -- 
  Fahrt Wasser Land -- Besuch Nachbarschaft stundenlang Spazierritt wechseln schnell -- Jenny -- eifrig verlangen -- Genuß finden scheinen -- 
  Reinhard lieben Natur Art Bewegung Freie -- lassen bereitwillig finden Vorschlag Art -- Jenny -- fieberhafte Unruhe auffiel -- eher nachließ -- körperlich erschöpfen zusammenbrechen stundenlang vollkommen Abspannung weichst Stimmung verharrn -- 
  Bat -- anstrengend Lebensweise abzustehen -- Ruhe Erholung gönnen -- reißen gewaltsam Apathie empor -- versichern -- weder krank ermüden -- bestehen -- letzter Sommer Berghof Reinhard -- nennen -- Eile genießen -- 
  wild treiben -- zuletzt Jenny's Mutter beunruhigen -- Pfarrerin -- erscheinen Theresen still -- häuslich Tätigkeit wohltuend -- 
  allmählich fast häuslich Regiment bemächtigen wissen Sicherheit bequem Angenehme verschaffen -- verlangen -- 
  namentlich alt Dame unentbehrlich -- Reinhard umhin -- lobend gestehen -- selten Talent besitzen -- materiell Wunsch Umgebung erraten befriedigen -- 
  Gewöhnung Komfort Leben Reiz gewinnen -- angenehm erscheinen Weise -- Therese bereiten verstehen -- 
  Jenny Äußerung -- Therese Liebe erkoch erwirtschaften -- begegnen allgemein Tadel -- Verhältnis Freundin Pfarrerin mißfiel Rätsel -- Reinhard ausnehmen -- Schattenseite Jenny' Charakter entschuldigen -- 
  Jenny' geäußert Wunsch Therese Taufzeug -- scheinen besprochen Vorsatz aufgeben -- erklären -- Pfarrerin Rede stellen bemerkbar -- Zurücksetzung Therese höchst empfindlich müssen -- 
  -- täte leid -- können entschließen -- unmöglich -- aufzufordern -- 
  entschieden Äußerung veranlaßen Pfarrerin -- Jenny dringen -- nah Erklärung erlangen -- 
  behaupten -- Therese irren -- Abneigung fühlen -- fast Haß grenzen überwinden können -- 
  zufällig Augenblick Therese gleichgültig Frage Auftrag Jenny' Mutter hinzukommen heftig -- kurz Antwort Jenny abfertigen -- Zimmer verlassen -- benutzen Pfarrerin Gelegenheit -- Theresa sprechen -- Grund Jenny' gereizt -- launenhaft Stimmung kennen -- 
  -- -- -- -- -- wissen Bestimmt -- fühlen -- Betrag verdienen -- dulden -- Andenken früh Verhältnis nachsichtig -- -- 
  -- wissen -- lieb Kind -- Verstimmung Jenny's bemächtigen -- 
  Beruhigung -- Entferntest Veranlassung ahnen -- -- 
  -- Jenny sehen -- lieb Frau Pfarrerin -- Berghof -- -- antworten Therese -- -- Vermutung -- mitteil -- heilig versprechen -- -- Sohn schweigen -- -- 
  Pfarrerin zaudert Augenblick -- bitten Therese -- Mitteilung unterlassen -- nötig Jenny' Glück -- Herstellung -- 
  -- sonderbaren Lage -- -- antworten Therese -- -- wissen -- Pflicht -- Geheimnis verraten -- Kenntnis zufällig gelangen -- dürfen -- Unheil vermeiden -- teuer Freund drohen -- -- 
  Pfarrerin unruhig -- Therese fahren fort -- -- Abend -- ehe Berghof ziehen -- zeichnen Jenny Erlau Balkon Treibhause Ansicht Gegend -- Bräutigam bestimmen -- 
  Anfangs heit -- Steinheim Jenny rufen ebenfalls herbei -- Arbeit zeigen Unterhaltung nehmen lassen -- 
  -- gewöhnlich -- Reinhard beisammen -- ziemlich fade Wendung -- 
  Gespräch langweilen -- sodaß Jenny aufmerksam -- Conversation Bräutigam zusagen -- 
  verdrießlich heftig -- bleiben -- -- 
  -- -- lieb Therese -- -- Pfarrerin Tone Vorwurfs -- -- annehmen -- gering Tadel Jenny's Wesen -- Verhältnis vollkommen verändern können -- Tadel Freundlichkeit ertragen pflegen -- stets angenehm auffallen -- -- 
  -- O -- Gott bewahren -- 
  glauben -- -- erwidern Therese -- -- halten begreiflich -- übel Laune richten -- zufällig Streit Stunde -- entschieden traurig Folge Jenny -- -- 
  -- Therese -- -- unterbrechen Pfarrerin ernsthaft -- -- halb Rede scheinen Geheimnis mitteilen -- verschweigen -- 
  gehen -- bitten -- voll Wahrheit enthüllen -- entscheiden -- Jenny -- Tochter lieben -- -- -- 
  Therese scheinen schwanken -- rasch Bestimmtheit -- 
  -- -- Frau Pfarrerin -- 
  glauben -- Erlau's Abreise Veranlassung vollkommen Veränderung -- Jenny vorgehen -- -- 
  -- Unglück -- -- rufen alt Dame erschrecken -- 
  -- bringen Vermutung -- Therese -- -- 
  -- bloß Vermutung mitteilen -- -- antworten Therese -- -- fest Überzeugung -- -- 
  Steinheim Balkon verlassen -- hören -- Treibhause beschäftigen -- Erlau lebhaft Jenny sprechen -- obgleich weder verstehen -- vernehmen -- Erlau Liebe gestehen Lebewohl -- Hoffnung Nähe leben können -- 
  nächster Abgereist -- Abschiedsbrief bringen -- behaupten Jenny -- fragen -- Reise wissen -- -- 
  wahrscheinlich Reinhard bestimmt Bildche Andenken schenken -- Abend sehen Rede -- 
  nächster ziehen hierher Jenny's traurig Stimmung -- wissen -- Zunehmen begreifen -- -- 
  Pfarrerin schweigen scheinen Rate -- sprechen -- 
  -- Gott verhüt -- Behauptung -- 
  glauben -- Jenny vollkommen Gefühl täuschen können -- fest Liebe Reinhard überzeugen -- -- 
  Indes Herz tausend befremdlich Eindrücke zugänglich -- unmöglich -- Widerstreit Gefühl Seele arm Jenny erheben -- leidenschaftlich Weise gewaltsam bekämpfen hoffentlich bekämpfen -- 
  Unruhe entstehen -- danken -- lieb Therese -- Geständnis -- -- Geduld -- Unfreundlichkeit geliebt Kind ertragen -- 
  Ein heilig Pflicht an Herz legen -- Lassen weder Jenny -- Sohn ahnen -- Vermutung Art hegen -- -- 
  -- glauben -- fragt Therese -- 
  -- Rechn fest Verschwiegenheit -- -- Sohn Glück abhängen -- lebenslang verpflichten Opfer schwer fallen -- -- 
  Pfarrerin umarmt Gerührt umhin -- versichern -- Achtung hoch Grade gewinnen -- Schonung wissen -- Jenny behandle -- 
  -- Lasse vereinen -- -- sprechen -- -- wirken -- Jenny außusöhn Glück erhalten -- Sohn Zukunft erwarten -- 
  innig Anerkennung danken -- Sohne verpflichten fühlen -- tragen Weise -- Schuldner -- -- 
  Therese versprechen Dame schied wiederholt Umarmung herzlichsten gegenseitig Versicherung -- 
  Therese Unterredung Beweggründe Handlung täuschen -- absichtlich Werk gehen -- schwer entscheiden -- 
  Jenny's Liebe Reinhard zweifeln -- Neigung Erlau glauben -- Wunsch -- Reinhard Jenny Reue bewahren -- antreiben -- Pfarrerin Bericht erstaten -- lassen dahinstellen -- 
  jedenfalls eigensüchtig Motiv -- zweifelsohne Seele regen -- deutlich bewußt -- sodaß Lobsprüche Pfarrerin ruhig Gewissen annehmen Jenny still Größe erscheinen -- leicht -- fügsam nachgebend betragen -- 
  Vorsatz getreu -- schweigen Pfarrerin gänzlich Entdeckung -- Therese -- 
  Jenny leid zürnen -- zweifeln -- Erlau Eindruck Jenny's beweglich Phantasie verleiten -- Reinhard untreu -- Erlau Hilfe kommen -- 
  leiben künftig Schwiegertochter -- verbergen -- stets denken Sohn äußern -- Frau unruhig Geist -- solch -- heftig Leidenschaft Hoffnung ruhig ehelich Glück berechtigen -- z. B. Mädchen Theresen soliden -- glänzend Eigenschaft -- 
  zittert Gedanke -- Sohn können Zufall Neigung Braut Erlau unterrichten -- fühlen beruhigen -- Taufe bestimmt kommen Aussicht -- Sohne Berghof Monat verlassen -- 
  -- hoffen -- Jenny Ruhe -- Reinhard Kampfe Herzen erfahren brauchen -- 
  Herr Madame Meier -- Eduard -- Joseph -- Pfarrerin -- Therese Clara ernst Haltung Zimmer beisammen -- freundlich Strahl untergehend Sonne hineinfielen -- 
  rund -- kostbar Teppich behangen Tisch -- silbern Becken silbern Schale stehen -- Mitte -- 
  improvisiert Hausaltar stehen Jenny' Lehrer -- würdig Pastor -- erwartet -- Übrig -- Eintritt Schülerin -- 
  wünschen -- letzter Stunde Taufe bleiben -- Bräutigam ersuchen -- rufen -- feierlich Handlung bereit -- 
  treten Reinhard's Arm Zimmer fallen Totenbläss schön Zug -- Nähe Pastor stellen Reinhard zurücktreten -- 
  kurz Anrede geistliche sprechen Jenny Glaubensbekenntnis empfangen Taufe -- 
  scheinen furchtbar ergriffen Bebter sichtlich -- Taufwasser bleich Stirn berühren -- 
  Tran Auge kommen -- Muskel Gesicht zucken -- bebend Ton Stimme -- Glaubensbekenntnis ablegen -- Herrschaft fest Wille trotz bieten -- 
  kurz Zeremonie vorüber -- Jenny Christin -- 
  unbeschreiblich Innigkeit ziehen Reinhard Geliebte Herz Träne reinsten Freude -- zärtlichst Dank glänzt Auge -- 
  kurz Moment ruht -- erhol Kraft gewinnen -- Herz -- fliegen -- innerer Impuls treiben -- Mutter sinken -- bitterlich weinend -- arm -- 
  ruhig Zuschauer interessant Schauspiel -- Taufe Seele anwesend Person lesen vermocht -- verschieden Gefühl bewegen -- 
  Madame Meier zerfließen Träne -- vorkommen -- tret Taufe fremd Element Tochter -- 
  Eduard Clara -- stehen -- schmerzlich Gedanke vertiefen -- Blick zufällig treffen -- wenden schnell -- fürchten -- ernst Feier beredt Sprache Auge entweihen -- 
  Pfarrerin danken Gott -- gedeihen -- beten inbrünstig -- Herr mögen ferner Paar beschützen störend -- nächster Zukunft drohen können -- gnädig vorüberführen -- 
  innerer Gebet verhindern -- Theresen Unruhe bemerken -- Blick Reinhard Braut abwenden -- fast bleich -- Gewalt Jenny's Seele lesen scheinen -- 
  Joseph entgehen ängstlich Späh Theresen -- -- Jenny' qualvoll Aufregung befremden -- 
  finst Szene Auge -- erwarten -- Reinhard Taufe Braut Arme schließen -- fahren Hand Herzen -- flüchtig Schmerz empfinden -- 
  Vater vollkommen ruhig heit bleiben -- freuen Reinhard's -- glücklich Mensch Sonne dünken -- stolz -- voll Freude äußern -- Übrig -- Therese aufnehmen -- wohltuend -- besänftigend Eindruck hervorbracht Jenny's Träne verbergend Schmerz siegen beginnen -- 
  Weile lassen Herr Meier erregt Empfindung Raum -- beruhigen -- -- Tür Zimmer öffnen -- Garten hinaustrat Übrig auffordern -- begleiten -- 
  drückend warm Zimmer -- Sonne brannt Scheibe geschlossen Fenster -- 
  Erquickender erscheinen frisch Abendluft -- -- Duft prächtigsen Orangenblüt balsamisch durchzogen -- entgegenströmen -- 
  Reinhard -- Aufforderung Vater folgen -- 
  verlangen sehnlichst -- Braut -- wenden -- sobald tunlich -- entlegeneren Teil Parke -- 
  ankommen -- setzen nieder Schatten mächtigen -- Efeu grün umrankt Kastanie schweigend Reinhard innigst Liebe Jenny -- -- bleich ermatten -- geschlossen Auge lehnen dringend Ruhe bedürfen scheinen -- 
  Spannung letzter -- vollbringen -- nachgelass Erschöpfung Platz -- 
  Reinhard zart Mädchen arme halten -- geschlossen Auge -- ruhig -- regungslos Züg weiß Kleidung schön Leiche glich -- fahren schmerzlich Gedanke Seele -- können sterben -- trennen -- niemals wiedersehen -- 
  Schrak -- 
  Ahnung -- fragt -- fast kindisch Furcht lassen Möglichkeit wähnen -- Geliebte können arme sterben -- 
  Behutsam küssen plötzlich Jenny' Wimpern -- zärtlichst Wort bitten -- laut sprechen -- sagen -- leben -- Glück fühlen -- 
  -- -- leben -- Gustav -- -- antwortet Frage schlagen lächelnd Auge empor -- 
  -- leben -- 
  lieben -- 
  O -- 
  Gott wissen -- Stunde Zeugnis geben -- 
  lieb Leben -- Seele -- -- Seele -- 
  -- -- fragt lehnen -- Sprechens aufrichten Hand fest ineinander falten -- 
  -- Fragst -- Gustav -- lieben -- -- fahren Pause fort -- 
  -- Ton Stimme hören -- süß Leben -- 
  sahsen heilig -- verklären -- fürchten -- könntest Erde verlassen arm Heimat -- Himmel -- zurückkehren -- Antlitz treu Bild -- -- 
  -- -- hinüberschlummern -- -- seufzen Jenny -- -- voll Besitz Liebe -- -- 
  -- Liebe jemals fehlen -- -- rufen Reinhard fast entrüsten -- 
  sehen -- Jenny -- einst -- -- Liebe zweifeln -- flieh vergessen -- 
  -- Liebe Herrscher Schicksal setzen -- treuesen Sklave -- 
  weißen -- -- -- wärmer werdend -- -- König knien -- Weib jemals Fuß sehen -- glauben -- Gott beugen -- Knie -- bekennen -- fußfällig bitten -- lieb -- treu bleiben -- zweifeln -- Glück Leben beruhen -- -- 
  niedergesunken halten arme umfassen -- Auge hingen -- 
  Jenny glauben Wonne vergehen Glück Gegenwart -- drohend Zweifel Aufstieg -- Reinhard Innigkeit lieben -- Neigung wanken -- einst erfahren -- täuschen -- Liebe bewahren -- -- 
  -- Gustav -- -- -- -- Vergiß Stunde -- Glück vergessen -- einst kommen -- Irre Würdest -- Liebe wert schien -- Gustav -- Barmherzigkeit -- denken Stunde -- laß erinnern Stütze Erinnerung finden -- -- 
  -- bedeuten -- -- fragt Reinhard verwundern -- -- glauben -- jemals Fürsprecher bedürfen -- Liebe -- -- 
  -- geben Gott -- -- rufen Jenny -- 
  -- Gustav -- einst schwach tadelnsweren finden -- lieben -- weisen Solltest -- mögen Neigung treu Schutz -- mögen deutlich -- lieb Opfer scheut -- erduld -- -- 
  entsagen -- -- niemals -- fehlen Kraft -- -- 
  -- verstehen -- Herz -- -- Reinhard -- vergebens Sinn Rede suchend -- Zusammenhäng Verhältnis stehen -- -- schwören -- Lauterkeit Seele -- Reinheit Dein Herzens zweifeln -- sollst Liebe finden -- gebühren -- Nachsicht -- -- jemals Brauchtest -- verzeihen -- Liebe bleiben -- -- 
  -- Schwöre -- Geliebter -- -- flehen Jenny Angst -- fürchten -- können Neigung ändern -- 
  -- schwören -- -- antworten Reinhard reichen Jenny Hand -- fest halten -- leidenschaftlich Lippe drücken Wort -- 
  -- ruhig Gustav -- -- -- losließ -- 
  Stunde vollkommen Glück verging Liebenden -- doppelt erscheinen Trennung -- bevorstehen -- Reinhard nächster Reise antreten -- 
  übrig Familie vollkommen vergessen -- Pfarrerin suchen -- alt Pastor Lebewohl sagen Stadt zurückkehren -- 
  Clara's erst Besuch Berghof William zurückkehren -- 
  Ankunft bestimmen angeben -- finden zufällig weder Tante -- Clara Haus -- Diener Herr Horn Comptoir weisen -- Bemerke -- Frau Kommerzienräte überraschen -- finden -- Ankunft erwarten -- 
  erwarten Person -- sehnen -- gehören peinlichst Gefühl -- lang Trennung berühren -- 
  tausendmal vorstellen -- Wagen einsam rasch dahinflog -- Tante Clara entgegeneilen Willkommen Brautkuß Lippe Cousine küssen -- 
  Stadt empfangen Onkel freundlich -- zerstreuen Geschäft -- unterbrechen -- eilig Frage Befinden Vater -- Reise Aussicht nächster Handelsjahr London -- jung Mann bemerken -- Onkel abzufertigen wünschen -- 
  ziehen begeben Zimmer Dame -- Heimkehr erwarten -- 
  eigentümlich Empfindung beschlich -- Räumen befinden -- -- Furcht Hoffnung bewegen -- scheiden -- 
  Ankunft London Kommerzienräte schreiben kurz -- herzlich Brief Clara beilegen -- beantwortet -- eigentlich Werbung gedenken -- hauptsächlich Teilnahme Krankheit Vater ausdrücken -- bedauern plötzlich Abreise traurig Umstand Hoffnung -- dennoch Wunsch fügen -- 
  William gehören Mensch -- lieben -- mündlich schriftlich Gefühl aussprechen -- überraschen Clara's Zurückhaltung -- 
  wissen -- lieben -- Tante Hand Tochter zusagen -- Versicherung geben -- Clara Neigung erwideren -- erklären -- lesen fröhlich vertrauen weniger flüchtig Brief -- Clara erhalten -- -- Herz begehren -- 
  -- Augenblick leicht Tritt geliebter hören hoffen -- lebhaft Ungeduld entgegen harren -- fallen -- Clara tun -- lieb Zustimmung Ansprüche versichern -- 
  setzen sinnend Platz nieder -- häufig Clara arbeitstisch einnehmen -- 
  nähkästchen -- Eduard Verlosung gewinnen William's Beisein Clara schenken -- erkennen -- 
  abgenutzen müssen brauchen -- enthalten verschieden Apparat weiblich Arbeit visitenkart Doktor Meier -- Bleistift Datum letzter Wort schreiben stehen -- Bedauert -- Einladung Frau Kommerzienräten Horn annehmen -- 
  politisch Broschüre liegen aufgeschlag Kästchen -- gehören ebenfalls Doktor Meier -- Hand geschrieben Anmerkung verrien -- 
  elegann Kleinigkeit -- William Cousine schenken -- scheinen Gebrauch -- stehen kalt Ordnung Nippe Etagere aufrichten -- Hand Hausmädchen säubern Clara's Auge niemals treffen -- 
  William wehe unmutig nachdenkend -- fast erschrak -- Stimme Tante hören -- 
  Eilig stehen Dame entgegen -- 
  -- -- willkommen -- Sohn -- -- umarmt Kommerzienräte fügen -- Clara wenden -- hinzu -- -- -- -- 
  echt Romanmutter -- -- zärtlich Erguß Eurer Herz stören erwart halb Stunde Zimmer -- -- worauf rasch entfernen -- 
  klug Frau -- förmlich -- abgemessen Leute -- -- unbefangen herzlich erscheinen -- gänzlich Rolle fallen ungeschicktest Verstoß begehen -- 
  Clara William stehen verlegen -- Letzter peinigen müssen -- fühlen -- unvorteilhaft Mann Fall erscheinen -- 
  indessen fast Stelle ergehen -- zärtlich Braut -- liebend begrüß -- sehnsüchtig verlangen -- Mädchen finden -- scheu Zurückhaltung behandeln offenbar eher erschrecken -- erfreuen Anwesenheit -- 
  finden Clara verändern -- teils peinlich schweigen brechen -- teils leidend Aussehen beruhigen -- fragen freundlich -- 
  -- warst krank -- Klärch -- 
  finden schön Röt Wang verblichen -- 
  freuen -- beisammen -- -- 
  -- O gewiß -- -- Cousin -- -- antworten -- freuen Herzen -- Vater herstellen zurückkehren Konntest -- -- 
  -- Cousin -- -- rufen William scherzend -- 
  -- Klärch -- klingen cousinenmäßig Braut -- Cousine längst Mund Hand Willkommen reichen -- -- 
  Wort schließen Arm drücken -- trotz Widerstreben herzlich küssend -- Brust -- 
  -- Ah -- leben -- -- -- -- wissen -- Braut wiedersehen glücklich -- 
  Clara -- freuen Eltern -- Frau begrüßen -- 
  Vater -- Kraft erlauben -- Hochzeit gegenwärtig -- versprechen -- warten -- Erholung beeilen -- -- 
  -- vorgeschritn -- fragt Clara -- froh -- Gespräch bisherig Richtung ablenken -- 
  William deuten Frage Sinn antworten tändelnd -- -- -- Fräulein -- Hochzeitskleid bestellen Reisekostüm anordnen -- lieb Deutschland Sitten -- Trauung Engländerin steigen Wagen -- unser Honigmonat Hugheshall verleben -- -- 
  Freude Herzen bemerken William -- fast ausschließlich Kosten Unterhaltung tragen -- Clara verhehlt Spannung Wort zuhören gleichgültig Frage werfen -- 
  -- Bruder -- unterbrach Erzählenden -- 
  -- übel Sache -- -- erschricken - ziemlich leichtsinnig Verhältnis einlassen -- bindend -- Ohr -- lieb Bräutchen -- -- Mutter sprechen -- -- 
  -- kommen -- -- bitten Clara -- besorgen William's Mitteilung hinsichtlich Ferdinand -- froh -- Tête -- Tête entgehen -- -- William bemerken -- Mutter erwarten dürfen -- 
  Frage -- Kommerzienrät Neffe richten -- Ergehe Sohn -- 
  Abwesenheit Monat Monat ausdehnen -- obgleich Herr Horn Heimkehr wünschen -- 
  Ferdinand nämlich London unbegrenzt Verschwendung hingegeben Mr. Hughes -- anzeig Summe -- jung Horn entnehmen -- mehrmals hingedeuten -- geraten -- jung Mann Deutschland zurückzuberufen -- 
  -- Ferdinand gesund -- -- berichten William -- fügen gewiß Zurückhaltung hinzu -- -- zweifle -- freiwillig sobald zurückkehren -- wünschen -- lieb Tante -- -- 
  -- -- glaubst -- -- abhalten -- 
  fesseln -- -- 
  -- Schwäche -- falls Leidenschaft nennen -- Nachsicht müssen -- würdig Gegenstand zugewenden -- -- 
  Kommerzienräte wechselt Farbe befehlen Tochter vorwand Auftrages Zimmer verlassen -- 
  nötigt William -- setzen -- beschwören -- Hand ergreifen -- rasch unumwund Ärgste sagen -- 
  Qualvolle Angst Mutter bewegen William -- schonendst Äußerung mitteilen -- Ferdinand Ankunft England Bekanntschaft Frau hoch Schönheit -- verworfenst Sitte -- erklären Geliebte Hange Verschwendung bestärk -- früh geliebter -- Lord D. -- jung Mann Stande -- ruinieren verlassen -- -- 
  -- Ferdinand vorgespiegeln -- -- erzählt William -- -- seinetwill Liebe Verehrer brechen -- -- behaupten -- Ehe versprechen -- Ferdinand unglücklich Stunde töricht -- schriftlich Zusicherung geben -- Gegenwart Bekannten wiederholt Erfüllung dringen -- Vergleich Abfindung hören -- -- 
  William halten inne -- zitternd -- eiskaln Hand Tante -- angstvoll halten -- deutlich verkünden -- entsetzlich Nachricht Herz verwund -- 
  -- -- -- -- bitten -- Zaudern Neffe bemerken -- 
  -- Hältst -- Sohn ehrlos -- Heirat verworfener denken -- -- Mutter -- Weib Tochter aufdringen -- -- 
  -- hoffen -- -- antworten William -- -- Ermahnung gelingen -- zurückzubringen -- freilich weder Vater -- -- -- 
  -- -- befehlen -- -- rufen Kommerzienräte -- -- gehorch -- -- 
  -- -- lieb Tante -- -- bemerken William -- -- -- falls sogar gehorcht -- Unannehmlichkeit aussetzen -- lästig Verhältnis Nähe ziehen -- zweifle Augenblick -- Frau Erlaubnis hieherfolgen Erfüllung Wort dringen -- 
  Geduld -- schreiben -- Verhältnis wissen -- mißbilligen -- vermeid Strenge -- offen Widerstand -- unüberlegt Schritt treiben -- wohnen -- 
  sogar -- überließen Manne -- obgleich Vater raten -- mitteilen -- -- 
  -- lohnen Gott -- -- alt Dame -- 
  -- sieh -- Sohn -- Sohn -- bekennen -- weißen -- niemals vernehmen Ferdinand Vater stattfinden -- 
  Mann vergessen -- einst jung Nachsicht bedürftig -- 
  Kommerzienrat scheinen -- Ferdinand -- erinnern -- -- fahren fort -- plötzlich umgestimmen Gedanke -- Liebling Ferdinand können irgendwie Tadel Vater ziehen -- -- Ferdinand schlimm -- glauben -- 
  versprich -- Vater sagen -- Antwort Sohne erhalten ermächtigen -- -- 
  William Tante ersuchn -- lassen -- Mitteilung unangenehm berühren sammeln wollen -- Mittagstafel Manne Besorgnis geben -- 
  Kränkung -- Stolz erleiden -- Schreck Unruhe -- empfinden -- lebhaft -- gewohnt Selbstbeherrschung verlassen nervös Zufälle ergreifen -- nötigen -- paar Zimmer hüt Clara's Pflege Wartung unentbehrlich machen -- 
  bekommen William Braut -- betrachten Clara -- sehen -- 
  müssen Betrag auffallen -- offenbar zurückhaltend befangen -- jemals zeigen -- 
  begreifen -- Onkel Wort Verhältnis sprechen -- -- Geheimnis behandeln müssen -- obgleich gewissermaßen Umstand entschuldigen gebieten -- finden streng Beobachtung Etikett nah verwandte -- einig glücklich Verbindung -- übertrieben -- 
  -- sobald Kommerzienräte sichtbar -- Bekanntmachung Verlobung Clara dringen -- jetzig Stellung höchst unbequem hoffen -- ungewöhnlich Schüchternheit Braut geben -- beiderseitig Verhältnis Geheimnis -- 
  abend Zustand Madame Horn bessern -- Clara ausdrücklich Befehl verlassen müssen -- Bräutigam unnötig entziehen -- -- innig erfreuen -- -- Vorschlag -- Berghof fahren -- 
  wünschen -- Clara mögen Krankenstube Mutter verleben frei Luft erholen meier'sch Familie besuchen -- sehen -- 
  Clara lehnen Beide bitten William -- Zimmer folgen -- sprechen müssen -- 
  niederlassen -- beginnen Clara -- 
  -- wissen -- William -- -- sagen -- erfahren mußt -- 
  herzlich vertrauen entgegengekommen -- -- unbeschreiblich freundlich -- danken -- -- 
  stocken -- William verwundern -- 
  -- Versprechen -- -- schön -- Liebe begehren -- -- 
  -- -- -- fallen Clara -- -- beunruhigen -- 
  Glaube -- William -- erkennen treu Anhänglichkeit tief Beschämung -- Herz -- -- 
  -- liebst -- -- rufen William -- sagen -- Clara -- 
  schlägst Hand -- gleichgültig -- Zuwider -- -- 
  -- -- -- gewiß -- -- 
  leiben -- William -- Herzen leiben -- überzeugen -- Frau schön Seite -- Frau -- -- 
  -- liebst -- -- fragt William heftig stehen -- 
  leises -- hörbar Clara's Lippe Antwort -- tief betrüben scheinen -- bleiben schweigend Clara stehen fragt -- mühsam Schmerz bekämpfend -- 
  -- wissen Glücklich -- liebst -- 
  Verdient Glück -- rauben -- -- 
  -- wissen -- William -- -- antworten Clara -- glücklich -- -- Vereinigung -- -- 
  Äußerung enthüllt Erstaunt plötzlich Geheimnis -- leise Ahnung -- 
  Eduard -- Cousine lieben -- Braut verlieren -- 
  schmerzen tief -- Tone Vorwurf fragen -- 
  -- erfahr -- Liebe glauben -- Hand rechnen -- 
  Durftest handeln -- 
  Mutter zuversichtlich Wort geben -- -- 
  -- Vergib -- William -- -- bitten Clara -- -- verschweigen -- weniger Woche gestehen -- ewig vergessen -- 
  wissen -- -- Großmut erflehen hoch Gunst -- Anspruch Hand entsagst beistehst -- Verzeihung Mutter erlangen -- 
  unerbittlich dringen -- Wort lös Hand geben -- Wert -- weißen -- -- 
  William ruhig niedergesetzen düster sinnend nieder -- 
  widersprechendst Gefühl wogt Brust -- 
  paarmal -- Gedanke Wort geben wollen -- unterdrückt -- finden -- Aufstand -- Clara Hand reichen -- -- 
  -- siehst -- vorbereiten -- darein finden -- fallen schwer -- plötzlich lieb Hoffnung scheiden -- 
  ford Entschluß -- Versprechen -- nimm Wort -- -- Mutter -- Schritt zwingen -- glücklich -- freiwillig tun -- -- 
  -- -- edl Mann -- -- rufen Clara Enteilenden -- letzter Wort verlassen -- Eduard aufsuchen erklären -- wonach lebhaft verlangen -- 
  treffen Doktor glücklicherweise Stadt Haus -- einsam Gäng Garten umherging schnell William entgegeneilen -- 
  jung Mann reichen Hand gewohnt Gruß -- plötzlich ziehen Hugh Hand Eduard -- Absichtlichkeit Handlung bemerkend -- fragt -- glühend Röte Gesicht überflog -- 
  -- Clara -- -- 
  -- kommen wissen -- -- antworten -- 
  -- sagen -- -- 
  Augenblick bedürfen Eduard -- sammeln -- sprechen sicher Stimme -- 
  -- -- denken -- Angelegenheit -- nahe berühren -- Werk -- heilig -- -- 
  Unwahr -- Großmut rühmen -- fühlen -- 
  lieb Clara -- wissen -- Leben setzen -- besitzen -- -- Ehre opfern -- 
  mögliche versuchen -- vergeblich versuchen -- fügen widerstrebend Gedanke -- Clara entsagen -- -- 
  -- erzählen -- -- Anspruch Clara kannen -- -- Freund halten -- -- 
  -- William -- ahnen -- Clara bestimmen teuer -- wissen fast gewiß -- Hoffnung Wunsch täuschen lassen -- dennoch sträuben vergebens Neigung -- Clara erriet teilen -- verbergen streben -- 
  Kampf Liebe -- Weib unerbittlich Kampf -- Kampf Leben Tod -- 
  -- 
  Unglückliche Meer schiffbrüchig umhergetrieben -- letzter Brett sicher verderben trennen -- untergeh -- verdammen -- -- retten -- unwillkürlich Trieb Selbsterhaltung hinunterstoßen -- Gefahr -- sinken sehen -- -- 
  -- Gleichnis schön -- -- William höhnisch -- -- Stimmung -- poetisch Produktion bewundern -- bitten -- unumwunde erklären -- Betreff Cousine handeln gedenken -- 
  Eduard Bezwang aufbrausend Heftigkeit antworten ruhig -- 
  -- handeln -- Clara fordern -- verantworten -- bitte -- bemerken -- Rücksicht gekränkt Gefühl Anspruch -- Clara glauben -- Erklärung veranlassen -- Tone fordern berechtigen -- 
  hören ruhig -- 
  -- Hoffnung verlieren -- Clara gewinnen -- Schmerz Liebe gestehen -- scheid -- schriftlich -- 
  Befahl bleiben -- obgleich Hoffnungslosigkeit Liebe vollkommen überzeugen -- 
  bleiben -- wünschen -- Unglück -- treffen -- leicht tragen hoffen -- plötzlich gewaltsam trennen -- 
  selten niemals sprechen -- Annäherung erlauben -- wagen -- klein Anspruch Clara -- bieten -- -- ermächtigen -- 
  wissen -- dringen -- Clara verheiraten -- 
  schwer Gedanke -- -- -- Festigkeit wanken -- Stimme zitteren -- -- schwer -- Geliebte Weib vorstellen -- schwer -- -- 
  sammelt -- reichen William Hand -- 
  -- Hand -- ruhig arme -- jeder Mann sehen -- wert verdienen Mädchen Clara -- -- -- 
  William Eduard's sichtbarem Schmerz Offenheit überwinden -- 
  schlagen dargeboten -- 
  -- lieb Clara -- -- Widerstrebe folgen -- -- Gedanke -- glücklich -- treten -- jemals Frau denken -- 
  überlegen -- 
  Möglichkeit -- -- Clara's Hand erlangen -- treten -- -- 
  -- Aussicht -- -- -- antworten Eduard schmerzlich -- bestimmen -- -- Emanzipation unser Volk -- Ferne liegen -- stehen Ansicht Clara's Eltern entgegen -- 
  Clara Hoffnung nehmen glauben -- -- 
  -- -- -- rufen William Freude -- deutlich hervorbrach -- obgleich Zartgefühl Freund verbergen trachteten -- 
  Eduard sitzen kehren wortlos -- Freund ehren -- ebenfalls schweigend -- Totenfeier innig Gefühl -- 
  verging -- William erheben -- Fortgehen anschicken -- Eduard Lebewohl -- 
  -- -- -- fragen -- schwer Traume erwachend -- -- Händedruck trennen -- rasch Dahineilend -- 
  -- Gesicht verlieren -- rufen -- -- Braut -- -- 
  Todesstoß zucken Gewißheit Herz paar schwer Tropfen fallen Auge -- 
  gelten verloren geliebter -- 
  -- netz Träne Erde -- -- -- schmerzlich lächelnd -- -- Keim Freiheit Wurzel fassen -- Baume erwachsen -- einst Schatten finden -- -- 
  Kommerzienräte einigermaßen erholen -- Gedanke Ferdinand -- unablässig beschäftigen -- 
  schreiben -- Schwager William Grund unterrichten -- abhalen -- Deutschland zurückkehren -- 
  beschwören -- loszureißen -- Opfer Geld -- Weibe befreien -- einzig Absicht verbergen können -- unvorsichtig -- Zweck bedeutend Summe Privatvermög übergeben -- Vater Verhältnis erfahren brauchen -- 
  aufrichtig Besorgnis Mutter -- Furcht öffentlich Beschimpfung stolz Frau einzugeben vermochn -- stellen beredtest Wort harrten angstvoll ungeduldig Antwort -- 
  Termin -- bringen -- verging Brief Ferdinand erscheinen -- 
  tödlich Ungewißheit treten übrig Angelegenheit Auge Clara Verlobung Rede -- 
  Kommerzienräten Verhältnis längst entscheiden -- William Clara freundlich beisammen -- genügt -- gesellschaftlich Rücksicht Bekanntmachung Verbindung denken -- stimmen -- 
  William genehm -- 
  Clara Freund Abzutret vermocht -- glücklich -- 
  -- denken -- dauernd fest binden -- 
  Clara rasch Schritt beunruhigen -- sprechen Liebe -- schonend Betragen -- zart Rücksichte tun deutlich -- 
  Unbefang brauchen -- doppelt Verhältnis -- fast unausgesetzt Nähe -- 
  lesen -- begleiten Spaziergängen -- verhehlen -- William's Unterhaltung jetzig Lage Zerstreuung abhalen -- gänzlich Gram Eduard's Verlust versinken -- 
  Eduard fast täglich -- flüchtig Zimmer Mutter sehen -- Zustand Behandlung nötig -- 
  vermeiden -- besuch -- Aufenthalt Familie Berghof bieten Entschuldigung Kommerzienräte -- wissen -- Abend fast ausschließlich verbring -- wiederkehrend Unwohlsein Mutter Clara abhielt -- Berghof fahren -- klein Promenade William's Begleitung beschränken -- 
  Woche vergehen -- William -- Clara ziemlich heiter Stimmung -- entschließen -- Unterredung Eduard sprechen -- 
  -- Aufklärung Verhältnis Eduard schuldig -- lieb Clara -- -- -- 
  -- Kampf entschließen -- Glück -- Liebe -- hinzugeben -- dein Besitz verzichten -- glaubst -- wenigste schmeicheln -- 
  Entsag vermocht -- glücklich Eduard wissen -- liebst -- Eduard -- -- 
  Clara reichen bewegen Hand -- 
  -- helfen -- Edel -- -- 
  -- lindern -- tröst -- -- fallen Wort -- -- vergönnen -- 
  Eduard fühlen -- Mutter darein willigen -- unvermählt lassen -- Hand verzichten -- 
  glauben -- Mann -- wählen -- lieben -- -- größerem vertrauen abwarten -- gerecht Schmerz gemildern Stande -- Glück glauben -- unmöglich scheinen -- -- 
  Clara schütteln schweigend Kopf -- William -- bemerken -- fahren freundlich fort -- 
  -- kommen kalt Fürchtest Ruhe -- Zuversicht -- unabwendbar Trennung Eduard fügen treu Liebe gelingen müssen -- erheitern -- froh seh Bewußtsein -- hoch Mann -- groß Glück -- -- 
  schildern Clara -- sehnsüchtig Mutter Tochter erwarten -- Himmel verweigern -- lieben offen arm Haus Eltern empfangen -- enden scherzend Bemerkung -- -- -- Eltern Versicherung geben -- groß Schatz Kontinent Haus bringen -- zurückkehren sagen -- 
  eitel Tor -- Liebe sprechen -- -- -- 
  unwillkürlich lächelen Clara -- William lang halten -- Fröhlichkeit Liebenden springen -- Arm -- küssen rufen -- -- entstehen -- -- ertragen Anderer -- Monat glücklichst Bräutigam halten -- einemmal Cousin -- 
  Kuß glücklich stehlen -- geduldig warten ruhig dein Zorn ertragen -- -- 
  zornig Clara Ausbruch -- grell Widerspruch Wort stehen -- verlassen -- Wort sprechen -- 
  indessen bleiben Unterredung Wirkung -- 
  Verständig ruhig -- Clara -- leugnen -- William -- behaupten -- Mutter Heirat bestehen -- geläng -- Verbindung Cousin befreien -- Betrag aufrichtigen verdienen -- 
  -- Eduard Wahrheit gemäß Aussicht Hoffnung -- Eduard William zugestehen -- verletzen -- wissen weshalb -- 
  Eduard's Treue -- Schmerz Trennung zweifeln -- Begriff -- ehrenwert -- vermeiden -- unzufrieden -- William -- obgleich fühlen -- handeln -- -- 
  Gedanke -- Eduard trennen -- fassen tief Wurzel -- William nah rücken -- liebend Hingebung bleiben Ziel Augenblick Gesicht verlieren -- 
  streben -- Neigung geliebter gewinnen -- schwer Pflicht -- Tante eigentümlich Verhältnis Clara täuschen -- nötig -- Kommerzienräte vergebens Antwort Ferdinand harrt gereiztest Stimmung Welt -- 
  Sohne wiederholt Male schreiben -- Schwager wenden erfahren -- Ferdinand Empfang Briefe geliebter verreisen -- Nachricht hinterlassen -- wohin gehen wohin Brief Haus nachsenden sollen -- 
  scheinen -- bemerken Schwager schließlich -- auf Besitz groß Summe kommen -- Reise -- 
  Kommerzienräte tödlichsten Unruhe -- entschließen -- Manne Geheimnis enthüllen -- unangenehm Szene -- Heftigkeit beide Teil hervorrufen -- werfen Mutter auf nieder -- 
  langen Brief Ferdinand -- Eltern -- William richten lauten folgen -- -- mühe unterziehen -- bitten -- Mutter Mitteilung -- geheim halten wünschen -- 
  scheinen -- dergleich Commission Vergnügen -- entschuldigen -- ersuch -- Eltern unterrichten -- vorig Woche verheiraten Frau Paris gehen -- 
  bleiben -- Summe -- Mutter schenken -- ausreichen -- Paris Weise leben -- Frau gewöhnen -- 
  Danke Mutter -- -- Wunsch erratend -- Bitte zuvorkommen -- schnell Ausführung Entschlusse schreiten -- unwiderruflich -- Glück sichern Erfüllung Pflicht Frau -- Liebe glänzend Zukunft aufgeben -- 
  Versuch -- Verbindung lösen -- vergebens -- Gesetz gültig vollziehen -- Folge -- Frau Haus kommen -- nötig Schritt -- obgleich -- Mutter Vorurteil schreiben -- Anwesenheit Frau -- Lord Dienst Gemahlin erkoren -- Schimpf Familie -- 
  streiten ersuchen nochmals -- Auftrag ausrichten -- 
  nähern Freund melden -- 
  Frau wünschen Clara Glück -- genießen -- -- 
  William erschrocken -- obgleich töricht Entschluß unerwartet -- 
  wissen -- Eindruck Neuigkeit Tant hervorbringen müssen -- -- verheimlichen -- Ferdinand Freund schreiben Verhältnis Stadtgespräch -- 
  Familie hoch Aufregung -- 
  Kommerzienrat wüten tobt Frau -- unglücklich Verblendung Sohn verziehen -- gestehen -- Ausführung wahnsinnig Heirat geben -- 
  Clara weinen -- Bruder bereiten -- müssen Aufmerksamkeit Mutter richten -- Brief vollkommen vernichten -- 
  Kommerzienräte versichern -- Schimpf überleben -- ungemessen Verzweiflung -- Eduard unruhig Zustand -- 
  bitten William Clara -- Mutter Weise besänftigen -- Frau Alter Konstitution Nervenzufälle -- wiederholen bedeutend zunehmen -- traurig Ausgang nehmen können -- 
  Anfänglich Vorstellung -- Einwand verlieren -- gelingen William -- leidenschaftlich Frau Trost geben -- Hindeutung -- Clara's lieb Sorgfalt -- schön Licht zeigen -- Glück -- Mutter verkennen dürfen -- 
  bekommen Idee Kommerzienräte plötzlich Wendung -- 
  -- -- -- Sohn -- -- -- -- Clara schwer versündigen -- Kind lieben -- 
  vergelten -- Stolz -- -- euer Verlobung feiern -- Leute glauben -- Schand -- Sohn bringen -- niedergebeugen -- 
  sehen -- Clara Freude bleiben -- weder schwach -- alt -- Unglück beugen lassen -- 
  Hole Clara -- Rücksprache nehmen -- -- 
  William beabsichtigen setzt Verlegenheit -- -- Clara planmäßig Werk Seite halten -- 
  versuchen -- Tant beweisen -- gleichgültig verhalten Nachricht Ferdinand unerwartet Vermählung mißdeuten können -- bereden -- -- leidend Clara betrüben Bruder -- fest feiern -- voll Freudigkeit begehen müssen -- 
  erlangt kurz Aufschub -- 
  offenbar Aussicht -- William Clara's Glück eröffnen -- fast wunderbar Wirkung Tante -- 
  erklären -- wohl fühlen -- Erstand Lager söhnt Manne -- Clara's Dotierung aussprechen -- erhöhen wünschen -- Beschränkung Ferdinand Gunst dringen -- 
  Entging Clara -- ängstlich Erwartung Stunde entgegen -- Gegenstand Mutter Sprache müssen -- bleiben -- 
  morgens lassen Kommerzienrät Clara gewöhnlich rufen -- 
  Krankenstube verlassen sitzen gewiß feierlich Toilette Sofa -- 
  Freundlich reichen Tochter Hand -- nötigen -- setzen -- -- Augenblick Anfang Unterhaltung nachdenken -- 
  -- Kind -- -- -- verkannen -- Sanftmut Schwäche gehalt Herz Unrecht tun -- Plan ansehen unser Haus Ferdinand basieren -- 
  Hoffnung betrogen - Sohn -- -- 
  nervös Zittern fahren trotz Mühe -- verbergen -- sichtbar Glied -- 
  Clara bitten -- Schon -- versuchen Wort Gunst Bruder einzuleg Mutter vorstellen -- unbesonnen Handlung traurig Folge -- glauben -- 
  Kommerzienräte lassen enden -- 
  -- verstehst -- -- heftig -- -- Schmach vertilgen -- Weib Name Familie -- Name tragen -- 
  Fürcht -- Ferdinand Mangel leiden -- Vater enterben können -- neulich drohen -- 
  -- bedürfen -- -- Lord D. Weibe geboten -- einzig Bedingung -- unser Name ablegen -- Deutschland -- Weibe hören -- 
  Ferdinand tot -- Sohn -- -- wiederholen nochmals -- 
  Rede heftig brechen zuletzt krampfhaft Weinen -- erleichtern scheinen -- sodaß fortfuhr -- 
  -- Zukunft angewiesen -- 
  Sohn Erbe Haus William versprechen -- unser Name euer führen -- 
  Ehecontrakt aufnehmen euer Hochzeit -- 
  Ruhe -- ehe einzig Angelegenheit beenden -- Erde Freude -- letzter Freude machsen -- Segen bringen -- 
  Gott geben -- Würdest glücklich Mutter -- -- -- 
  erschöpfen fallen Kissen Sofas sprachlos stehen Clara Seite -- bemühen -- Geruch stärkend Essenz beleben -- 
  vornehmen -- Mutter sagen -- William lieben heiraten können -- fassen -- heftig Zorn Ergebung tragen -- 
  -- Mutter liegen -- gewohnt prächtig Kleidung -- stolz Zug brechen leiden -- fehlen Mut -- entschieden Weigerung betrüben -- 
  Aufschub für bitten -- Kommerzienräte vorstellen -- leidend Zustand Aufregung gestatt William bereit -- warten -- Mutter kräftig -- 
  hören -- Moment Eduard Zimmer treten -- täglich Morgenbesuch -- richten Kommerzienräte lebhaft Frage empor -- 
  -- sagen -- Doktor -- glauben -- Freude Nerv schaden können -- -- 
  -- Geringst -- -- antworten unbefangen -- -- glauben vielmehr -- Erheiterung Gemüt Genesung beitragen -- Arznei -- -- 
  -- -- Verlobung Tochter feiern -- -- 
  Eduard erbleichen schweigen -- 
  Clara flehend Blick -- Atem stocken -- Antwort hing Zukunft -- 
  Kommerzienräte scheinen glauben -- Arzt überlegen -- Anwesenheit groß Gesellschaft zulässig -- 
  -- sprech feter -- eng Kreis Verlobung lassen -- 
  Fest -- Eltern Jenny's Verlobung veranstalten -- freilich denken -- Clara Entschädigung Haus Schwiegerelter Glanz Fest Überfluß finden -- still Einwendung -- -- 
  -- -- Einwendung -- -- antwortet Seufzer blicken Clara -- erstarren Stuhl lehnen -- Bewegung unterliegen -- 
  Kommerzienrät Eduard's Erlaubnis erhalten -- Klingel ziehen Diener befehlen -- Herr Hugh bitten -- Wunsch erscheinen -- Eduard Hand alt Dame halten Frage Zustand richten -- 
  -- -- -- Doktor -- -- unterbrechen -- böse -- 
  gestehen -- Freude gut Arznei -- William sagen -- Erlaubnis geben -- Verlobung feiern -- -- 
  -- Eduard -- -- rufen William -- 
  ehe Wort hinzufügen -- springen Eduard Clara Hilfe eilen -- totenbleich Türe zuwanken -- 
  plötzlich bleiben stehen rasch -- Selbstbeherrschung -- täuschen müssen -- Verhältnis kennen -- 
  -- Braut unwohl -- William -- begleiten -- -- 
  Augenblick William Clara's Seite -- letzter Kraft verlassen -- sinken halb ohnmächtig arme Bräutigam Brust -- Eduard's Mutter Gegenwart weinen heiß Träne schwer -- 
  Abend fahren Eduard Berghof -- 
  -- Clara Horn Braut William -- -- -- begrüßen -- 
  -- freuen -- -- antwortet Vater drücken Eduard Hand -- Dame näh Mitteilung ban -- 
  Vater Sohn Angelegenheit sprechen -- Gegenstand lebhaft Erörterung -- bang Besorgnis schwer Kampf -- 
  fahren Eduard Haus Kommerzienräte -- Gesundheit Pflege erforderen -- Zeuge Clara's Verlobung -- Vorwande verweigern -- wofür William Clara wissen -- 
  -- Brautpaar -- bedürfen Kraft -- äußerlich Fassung erzwingen -- Geist fehlen -- 
  William stehen edelst Weise -- 
  begleiten Clara Berghof Gewandtheit -- fein Schicklichkeitsgefühl wohlwollend Herz entsprungen -- wissen Eduard Clara schmerzlich Berührung bewahren -- 
  Dame Unterhaltung Haus nötig geworden ausstattungen Bräute beschäftigen -- ziehen William Freund -- 
  -- Eduard -- 
  Clara verlangen äußern -- sprechen -- zusagen -- Gelegenheit geben -- 
  anderer Meinung -- Clara bitten -- Erfüllung Wunsche entsagen -- 
  zugeben -- -- schnell fortzuhelfen versuchen -- überreich schmerzlich Eindrück -- 
  Tante überreden -- Hochzeit beschleunigen -- vierzehn spätestens vollziehen -- -- 
  -- billig Ansicht vollkommen danken -- -- Clara's Gefühle schonen -- -- antworten Eduard -- 
  -- Eduard -- -- William -- -- bitte -- 
  unser Begegn selten Mensch halten -- -- lassen entgelen -- glücklich -- 
  Frau -- lieben -- Freund verlieren -- gewinnen glauben -- -- 
  -- -- Gott -- sollsten -- rufen Eduard -- hingerissen William's Wort -- 
  -- Glaube -- William -- Grund Seele -- wundre -- -- Hoffnung Vergangenheit plötzlich scheide -- Gegenwart Zukunft umwölkt erscheinen -- Gedanke -- Glück -- hoffen -- vertrau Glück trösten -- Bewußtsein -- Clara Würdigst verlieren -- Freund bleiben Leben -- -- 
  Arm Arm kehren Übrig -- Steinheim finden -- angelangen -- 
  -- schwören -- -- -- -- längst hierher kommen -- fatal Hitze vollkommen Nervenabspannung Weg brächt -- Stadt still einsam -- Pompeji Ausgrabung -- -- 
  -- bringen Neuigkeit -- Landleute wissen -- 
  denken -- stolz Engländer entführen Clara nächstfolgend Woche -- -- bemerken Jenny -- 
  -- -- -- stolz -- Einzig verlieren -- England beneiden müssen -- -- rufen Steinheim -- Posa's Wort parodierend -- galant Clara verneigen -- 
  -- Hitze bekommen -- Jenny lächelnd -- -- vergessen -- Mr. Hugh ebenfalls mitnimmen -- bleiben -- fürchterlich Mangel Galanterie rächen -- -- 
  -- gehören Rache christlich Tugende Frau Pfarrerin -- -- fragt Steinheim -- Jenny -- Erwart -- erwidern -- Frage fallen lassen -- wenden Herr -- seitwärts lebhaft konversiert -- 
  kehrt Dame -- -- behaupten -- -- Mann säßen -- furchtbar Zugwind wehe -- Witterung Tod -- 
  lachen -- Clara willkommen -- 
  Anwesenheit -- Unterhaltung -- freilich geliebt -- -- betreffen -- ziehen Aufmerksamkeit -- größ Zirkel -- ungestört Erinnerung versenken -- Kreis erleben -- unwillkürlich Geist aufdrängen -- 
  -- sehen Hochzeit -- fragt Madame Meier -- scheiden -- 
  -- O -- gewiß -- -- antworten Clara -- -- komm Abschied nehmen -- Trauung abreisen -- 
  denken -- -- -- bitten unterdrückt Wei lang -- tief Blick treffen Eduard -- verstehen -- 
  William stummen Szene schnell -- führen Braut fort -- 
  Trauung Ehepaares vorüber -- jung Frau Reisekleidern Augenblickes gewärtig -- Diener melden -- Abreise bereit -- 
  Gast entfernen -- Jenny Eduard bleiben -- 
  kehren -- vorging -- wünschen sehnlich -- letzter -- schwer Kampf Clara vorüber -- 
  Kommerzienräte sprechen Schwiegersohne empfehlen dringendst Vorsicht jung Frau -- Hand Hand Vater sitzen -- einzig Freude verlieren -- 
  treten Dien Herein elektrisch Schlag durchzucken einfach Wort -- 
  -- Postillon anschirren -- -- 
  Weinend schied Eltern einzig -- schön Tochter -- weinend sinken Jenny arm -- gewaltsam losreißend -- Eduard vorüber -- Manne folgen -- 
  halten -- leise -- 
  -- Eduard -- -- -- 
  führen Freund -- 
  Stunde Trennung bedürfen keiner Geheimniss -- Entweihung rein Liebe -- überraschen -- ehrend schweigen -- sehen Clara's Eltern -- Eduard jung Frau tief erschüttern Herz ziehen lang Kuß Stirn drücken -- 
  -- Gott segnen -- -- rufen -- schließen nochmals Clara William Arm -- 
  -- -- Eduard -- vermach Eltern -- -- Clara hörbar -- -- stehen -- -- 
  -- William Arm tragen -- -- Wagen -- Auge nachsehend Freund entziehen -- 
  Clara's Abreise scheinen Eduard plötzlich ermannen -- 
  ernst -- tief Trauer gewichen -- 
  Leben -- Freude bieten -- nützen -- vermögen -- umsonst Hoffnung opfern geliebter entsagen -- 
  fing vorwärts Leben blicken -- neu Eifer medizinisch Studie Bestrebung -- Verein gleichgestimmt Mann Befreiung Glaubensgenosse -- 
  Herr Meier finden erwarten -- erhabenste Verhältnis bilden schön Vater Sohn -- rasch Tätigkeit Ruhe Weisheit Vater segensreichst Einfluß übn -- 
  Eduard Leidenschaft Clara beherrschen -- leben -- Joseph Steinheim zusammenkommen -- Rückkehrenden Freude aufnahmen -- 
  erfuhren -- Forderung Eduard Regierung stellen -- abschlägig Antwort -- -- errieen -- bewog -- Angelegenheit heimlich betreiben -- 
  -- unerschütterlich Konsequenz -- ruhig Weg -- -- Eduard -- -- halten -- 
  -- ermüden -- verzagen -- abweist -- -- 
  -- jüdisch Unverschämtheit nennen -- -- bemerken Joseph -- 
  -- immerhin -- 
  Beharrlichkeit liegen Hoffnung -- unablässig stürmen -- Verschanzung fallen -- Wahrheit verstecken möchten -- fallen -- 
  -- -- 
  -- Kette Himmel schließen -- -- unterbrechen Steinheim -- ernst Unterredung -- Herz liegen -- übel Angewohnheit überwinden -- 
  glücklicherweise gewöhnen -- beachten -- 
  Joseph Eduard hören -- überlegten -- -- Eduard's persönlich Wunsch abschlägig bescheiden -- bitte Jude Regierung wagen sollen -- 
  Stritt kommen überein -- Eduard Jenny's Hochzeit -- allzu fern -- Residenz begeben versuchen -- erreichen -- 
  Beschlus verlassen Steinheim Eduard -- Umgebung aufmerksam anfehen -- Joseph -- 
  -- Jenny's Hochzeit erwähnen -- sagen -- -- Mädchen Auge verlieren -- qualten Jenny -- lieben Reinhard -- scheuen Leben Land -- -- 
  finden geistig Weise verändern -- überraschen -- gänzlich entgehen -- -- 
  -- -- -- Joseph -- -- helfen -- qualten -- wissen -- enden -- -- 
  -- meinst -- -- fragt Eduard bestürzt -- 
  -- überzeugen -- Jenny Glaube christlich Dogma Christin -- Gedanke -- Meineid geschworen -- peinigen verfolgen Gewissensangst -- schützen wissen -- -- 
  -- Wäre_es -- 
  -- -- 
  bringen Vermutung -- -- 
  -- Jenny's Wesen Unterhaltung -- -- 
  bringen absichtlich Gespräch Religionsverschiedenheit gestehen -- -- Christin -- kommen manchmal ausschließen verstoßen -- 
  -- Eltern gehören -- obgleich Reinhard Taufe nah bringen fühlen -- 
  fragen -- Eide denken -- 
  glauben -- sogenannter sünd sünd Gott -- äußern Art -- Geist lächerlich kindisch erscheinen -- vollkommen -- innerer Verwirrung -- Zwiespalt finden -- herzlich leid -- 
  zuletzt -- können Gedanke fassen -- Eltern Kirchhofe ruhen -- 
  stellen -- Torheit -- -- obgleich Jude -- können fern Freund Ruhestatt finden -- gewiß höchst gleichgültig -- begraben -- 
  bleiben -- schrecklich -- Stimmung -- Vernunftgrund fruchtlos bleiben müssen -- -- 
  -- arm Kind -- -- rufen Eduard -- -- -- -- 
  -- überlassen -- 
  überzeugen -- Ausweg finden -- 
  abwarten hoffen -- finden -- -- äußer Anlaß Unentschlossenheit Hilfe kommen veranlaßen -- erklären -- eigentlich Quelle Leiden -- -- 
  -- laß gemeinschaftlich wachen -- -- bitten Eduard -- -- Augenblick verfehlen -- Jenny glücklich -- -- -- 
  -- Leidensgefährte -- -- -- Joseph Miene Tone -- eigentümlich Gemisch Spott Schmerz ausdrückten -- 
  -- behüten -- -- fürcht -- glücklich -- -- 
  Joseph's Vermutung -- 
  glücklich Jenny Reinhard's anbetend Liebe fühlen -- demütigen Gedanke -- Unwahr -- 
  frühst Kindheit Lüge Unedles -- verächtliche darstellen -- entsetzen gestehen vermögen -- tief verwickeln -- 
  Zustand Seele -- verstehen -- schwer beschreiben -- 
  fühlt Element -- gebären -- Atmosphäre -- atmen -- entreißen -- 
  lehren -- -- -- Wahrheit Stern -- jeher Auge lenken -- 
  Gott Wahrheit -- -- schön -- Vater stets -- tun -- bleibst -- Gott Kind lieb Kind -- 
  Stundenlang Erinnerung freundlich Wort -- glücklich fühlen -- quälen -- 
  anfangen -- Unwahr -- -- unfreiwillig Selbsttäuschung Vater Erlaubnis erlangen -- Christentum überzutreen -- glauben wähnen -- 
  tausend Zweifel erwachten -- Anstrengung aufwand tausend Scheingründ Lehre Reinhard's Pastor motivieren streben -- -- -- wissen -- niemals glauben -- Vernunft sträuben -- dennoch -- trotz innerer Gewißheit -- Christin -- Vater -- Reinhard hintergehen -- Verbrechen -- dessentwillen verächtlich vorkommen -- Sünd -- Gott vergeben -- 
  sünd -- fragen -- 
  Reinhard glücklich Unwahrheit -- elend müssen -- Gott Unrecht strafen -- heiß Liebe begehen -- 
  Augenblick fühlen frei rechtfertigen Liebe -- Kampf -- kosten -- lieb Überzeugung handeln -- 
  Liebe Opfer bringen -- schwer -- überwinden -- -- Gott verlangen -- Idee Ruhe -- gestehen -- Unwahrheit -- 
  -- glücklich -- -- Christin -- liegen Selbstsucht Handlung -- Bemerkung -- fast Gewohnheit -- Bedürfnis täuschen -- vermehren Seelenpein Grade -- jeder ruhig Urteil rauben -- 
  Furcht Strafe Gott bemächtigen Seele -- mystisch Lehre Christentum glauben vermögen -- überlassen fast willenlos Aberglaube alt Testament -- Gott Rächer zeigen Böse strafend fernst Glied -- 
  Reinhard -- -- ziehen verderben -- Strudel erfassen -- verbergen -- glauben -- 
  beginnen -- 
  lieben verzeihen -- 
  heillos Kampf lieb Glaube geraten -- teur Haupt elend herabbeschwören -- ruhen lassen -- Strafe -- Gott Sünde rächen -- -- 
  Verfassung Seele vermehrt Briefe Reinhard's leiden -- 
  sprechen heißeste Liebe voll unbedingt vertrauen -- 
  schildern Glück Ehe -- Seite erwarten -- -- gleich Ansicht -- gleich Überzeugung gründen -- gemeinsam Streben Vollkommenheit -- Himmel Erde bieten müssen -- melden Entzück -- Ordination bestimmen -- sobald Weihe -- zurückkehren -- heimzuführen -- 
  Mutter -- Ordination beizuwohn wünsch -- Hochzeit Berghof -- 
  wünsch Mutter Braut Abendmahl nehmen -- Jenny empfangen -- Hochzeit abzureisen -- Mutter Stadt bleiben -- Wonne Beisammenseins ungestört genießen lassen -- 
  Jenny Herz schlagen freudig langersehnt Nachricht entgegen -- 
  selig drücken Blatt Lippe -- 
  sicher Hoffnung nah Vereinigung geliebter Augenblick Gedanke Seele geschwunden -- beginnen Brief nochmals lesen -- kein Wort verlieren -- glücklich machen -- 
  fallen Blick Stelle -- 
  -- wünsch Hochzeit Abendmahl nehmen Weise heiligst -- innigst Gemeinschaft treten -- geliebt Weib -- unauslöslich -- untrennbar verbinden -- -- -- 
  Hand entsinken Blatt -- vernichten -- 
  mal -- Taufe -- freventlich Spiel treiben -- Reinhard Heiligste Welt -- vermögen -- 
  -- fühlen -- entscheidend Moment kommen -- gewaltsam Entschluß Achtung herstellen Gewissen Bezug Reinhard beruhigen -- geschlossen Auge Labyrinth stürzen müssen -- Geliebte untergehen -- 
  Kampf furchtbar -- 
  siegen Wahrheit -- auflösen Schmerz schreiben durchwachter Nacht -- hell Tageslicht Fenster scheinen -- folgend Brief Reinhard -- -- einzig Geliebt -- 
  unaussprechlich glücklich sein -- Brief Nachricht Hand kommen -- Jenny sterben -- 
  Würdest weinen -- Gustav -- 
  Würdest trauern -- Andenken lieben -- liebst -- -- glücklich Gedanke -- geschied Ruhe -- 
  sterben -- letzter Mal dein arme liegen -- voll -- Liebe beglücken -- 
  Denkst -- wünschen -- glücklich -- ahnen -- Augenblick -- jetzig -- bevorstehen -- -- 
  -- Erinnerung Stunde beschwören -- lieb Nachsicht -- geloben -- stoßen -- -- Geliebt -- 
  -- fast Kindheit kennen -- anbetet -- -- 
  Gustav -- 
  Lehrer kennsen Seele -- weißt -- Geist glühend Wahrheit dürsten -- Herz Liebe verlangen -- 
  verstehen -- mußt Mitleid -- sagen -- Wahrheit lieben -- Überzeugung zwingen -- Liebe fügen -- 
  vermögen lang -- -- 
  -- Augenblick Augenblick zögeren -- Bekenntnis -- fürcht -- tief betrüben -- dein Auge heruntersetzen können -- 
  Feuerzung heilig Bande erinnern -- vereinen -- Wonn -- verdanken -- vorschweben -- -- -- 
  -- glauben -- Christus Sohn Gott -- auferstande -- sterben -- 
  glauben -- Tode bedürfen -- Gott Vergebung Nachsicht erwerben -- 
  Dreieinigkeit -- lehren -- ewig unverständlich Gedanke -- Boden Seele finden -- 
  glauben -- Wunder -- geschehen -- Wunder -- Gott -- -- einzig wahr -- täglich unser Auge tun -- 
  Christus -- erhaben -- göttlich Mensch Erinnerung Abendmahl nehmen -- Zeremonie entschließen -- unheimlich Form erscheinen -- innigst Verbindung Gott findest -- -- 
  -- -- 
  Überzeugung stark Liebe -- -- 
  furchtbarem Kampfe Christin -- Taufe Wahrheit Herr Täuschung -- Angst Verzweiflung erhalten streben -- Deinetwille -- 
  Lüge lang -- glauben -- Ausweg -- Gefühl unaussprechlichst Liebe -- ewig unverändert -- werfen Brust -- 
  Sollst sagen -- Friede machen Liebe Glaube -- wiederfind Gewühl Kampf -- -- 
  -- liebst -- Mitleid -- kommen -- kommen Laß Mund Wort hören -- Seele Ruhe geben -- sagen -- lieben -- Christus glauben -- verlangen -- 
  -- Liebe -- -- -- lieben -- Mensch lieben vermögen -- kenn Glück Liebe -- 
  Schreibe -- 
  dauern -- kommen -- sehen Antwort finden -- langsam tot Letter lesen -- Qual -- ersparen -- liebst -- 
  -- 
  wissen -- liebst -- Glaube -- sagen -- wiedersehen -- -- 
  Adieu -- 
  Gustav -- 
  Geliebt -- Lehrer -- Freund -- Gatte -- Welt -- 
  Laß Ankunft warten -- -- Minute Jahrtausenden -- sehen -- -- 
  Jenny Brief falten Diener besorgt -- scheinen -- -- eigentlich denken -- 
  -- sagen -- nochmals überlegen -- 
  werfen -- rasch handeln -- beschwören Diener -- beeil aufzubiet -- Brief zurückzubringen -- 
  vergebens -- 
  Post abgegangen -- Widerruf -- 
  -- -- Gott erbarmen -- -- rufen Jenny stürzen weinend Eltern -- unabänderlicher erfuhren -- leidend -- aufboten -- Ruhe Trost geben -- 
  zärtlich -- Augenblick besorgt -- versichern Mutter -- Jenny können unmöglich zweifeln -- Reinhard lieben -- heg vertrauen -- aufgeklärt Mann Braut Meinungsverschiedenheit irren -- 
  erinnern -- duldsam Reinhard Pfarrerin zeigen -- ehe Verhältnis Jenny Rede -- sprechen fest Überzeugung -- Reinhard weniger Jenny glücklich sehen -- 
  weint Tochter -- Herz fern Hoffnung -- beruhigen streben -- 
  -- Täusche Jenny Erwartung -- erfüllen -- müssen Reinhard kennen -- -- Vater -- 
  -- fürcht -- -- -- 
  -- Gott Himmel -- tun -- rufen Jenny -- 
  -- geraten -- -- antworten Vater -- -- dein Zustand -- 
  Durftest denken -- Ehe treten -- Reinhard's Ansicht innerer Bindungsmittel fehlen -- 
  Durftest namentlich täusch Gesinnung -- 
  Pflicht erfüllen Bewußtsein -- tun -- Kraft finden -- Schwerste tragen -- -- 
  Jenny trostlos -- 
  Brief schreiben -- 
  -- widerrufen -- -- -- fragt Vater -- 
  Jenny müssen zugeben -- -- 
  -- schreiben -- -- -- 
  verlangen -- Reinhard reisen -- sprechen -- Einwendung besiegen -- erklären Vater untunlich -- 
  -- Sieh -- geliebt Kind -- -- -- -- Kreis Widersprüchen geraten -- gewaltsam Ausweg -- 
  Reinhard duldsam Andersgläubig -- Frau dulden -- lieben -- Ich_es -- 
  -- -- Mittelpunkt Seele -- vollkommen abweichsen -- 
  überwinden schweigen -- Notwendigkeit -- Frau Hut -- heilig Interesse sprechen -- Störung Eure Glück -- absehen -- Gesinnung Verhältnis Geistlich schroffer Widerspruch stehen -- -- 
  Innig ziehen leidend Kind arme -- versuchen -- trösten -- 
  -- Blick fest Inneres -- -- -- -- Quelle Trost finden -- fehlen -- Schmerz treffen -- Unglück drohen -- verschuldet -- 
  leiden Gott beistehen -- -- 
  tief Trauer scheinen Haus liegen -- 
  fürchten -- Jenny Weise verletzen -- wehe -- 
  schon -- Größe Liebe fühlen lassen -- Empfand -- Therese -- obwaltend Verhältnis Geheimnis bleiben -- wahres Mitleid Jenny -- still Ergebung fassen versuchen -- heftig Charakter rührender erscheinen -- 
  traurig Reinhard Mutter -- 
  Jenny's Brief Blitzstrahl heiter Himmel treffen Anfang Empfindung -- kein Gedanken mächtig -- 
  Bewußtsein -- unersetzlich Unglück treffen -- stehen klar Seele -- 
  -- -- geschehen -- -- fragen sitzen starr Betäubung -- Pfarrerin hinzukommen Schrecken Ausdruck tief Jammer Zügen Sohnes erblicken -- 
  fragen -- geschehen -- Antwort reichen Reinhard Jenny's Brief -- Matrone schmerzlich Eindruck verfehlen -- 
  -- Hoffnung -- -- rufen versank früher Brüte -- 
  -- -- Jenny -- -- -- -- heiß Herz -- -- 
  -- Trost finden -- -- meinen Pfarrerin Bitterkeit -- 
  Schrecken erholen -- erneuert Deutlichkeit Theresen Behauptung einfiel -- Jenny lieben Erlau glücklich Reinhard's Liebe fühlen -- 
  Pfarrerin verständigen -- welterfahren Frau -- Christin Mutter tief verletzen Glaube Sohne -- 
  unzählig verschieden Verhältnis Leben kennen lernen -- 
  Kreis bekannte Jude -- Christentum übergetreen glücklich ruhig leben -- 
  Jenny -- wahr Erbauung Jesu Lehre sprechen -- Heil finden Stande Quelle -- Segen Menschheit geströmen -- 
  Jenny -- obenein Reinhard Lehrer -- innig fromm Überzeugung gewinnen müssen -- 
  Grund Jenny' Zerrissenheit glauben -- -- schaudert Leichtsinne -- Mädchen Meineid begehen -- 
  heilig Ding spielen -- bieten Gatten Sicherheit -- 
  Gott Ehemann versündigen -- Erlau's würdig Betragen abhalten -- Bräutigam untreu -- 
  Schmerz leiden Sohn ungerecht -- gekränkt Muttereitelkeit gewinnen Vernunft Sieg -- Sohne Zweifel Jenny's Aufrichtigkeit Unterredung Therese mitteilen -- 
  tun -- Unheil bereuen Anfing -- anrichten -- 
  Funke -- Pulvermine fallen -- zerstörend Wirkung hervorbringen -- Wort Mutter Reinhard -- 
  tief Wehmut Jenny's denken -- 
  leiden fühlen gleichmäßig vereinen -- Beredsamkeit Welt wünschen -- Jenny Überzeugung geben -- -- Trennung verhindern -- jetzig Verhältnis unvermeidlich -- 
  -- Erzählung Mutter -- erwacht Eifersucht auf -- 
  alt mißtrauen fing reg Furie verfolgen unablässig Gedanke -- Spielzeug Hand Mädchen -- verwerfen -- sobald neu Wunsch gleichgültig früheren -- 
  grenzenlos lieben -- bereit -- -- Stolz -- Ehrgefühl opfern -- Almosen Hand Vater ihretwill erniedrig -- Ziel wähnen -- Hand Hoffnung -- geheimst Wunsch legen -- besitzen Anderer Herz entziehen Hand Vorwande -- Auge verächtlich -- 
  Jenny verlieren scheinen Glück Pein -- -- -- jung Seele Keim schöne pflanzen -- schön Werk Schöpfer angebeten -- 
  warnend -- beruhigend Seite gestehen -- Verwirrung Leidenschaft schnell zurecht finden -- deutlich verraten -- selbständig urteilen -- Jenny's Brief Zustand Herzens -- Zweifel Wahrheit Worte -- Mutter Argwohn regen -- 
  Entrüstung achtet heiß -- flehend Bitte Jenny's -- sehnlich verlangen -- Reinhard's Eigentum bleiben -- Gedanke -- Jenny weigern -- Reinhard's Frau -- schlagen Hand Sohnes -- Gustav Braut abweisen -- gegenwärtig erbittert -- Grund -- Sohn stolz -- Verbindung höchst Glück erstreben -- 
  geschäftig -- tröst -- halten Unrecht -- begehen -- steigert leiden -- -- Eifersucht gekränkt Stolz treiben -- Aufregung leidenschaftlich Schmerz Antwort schreiben -- 
  -- Mädchen -- Seelenstärk besitzen -- vertrauend Mann -- glühend Liebe Zweifel Todsünde halten -- heiligsen Eide täuschen -- Kraft finden -- Trennung ertragen -- Männermut unterliegen drohen -- 
  -- Kraft Reue bewahren -- -- 
  Anfänglich -- sagen -- Mutter -- Blatt lesen -- beeilt -- abzusend -- Gesinnung entsprechen -- 
  anderer Geist -- unsäglich Traurigkeit Reinhard -- 
  entreißen Blatt Hand Mutter -- öffnen nochmals Fuhr fort -- 
  -- Jenny -- tun -- 
  anderer Spiel -- Herz -- 
  wissen -- wissen -- Argwohn Betrog -- 
  täuschen -- 
  Bande lösen -- Gewissen verlangen -- zerreiß -- Herz bluten -- 
  fühlen -- Weib nennen -- heilig Glaube -- verkünden berufen -- Spott -- 
  lieben -- segnen -- Möglichkeit gelassen hättest -- -- 
  sagtest -- Erlau liebtest -- beglücken können -- 
  Opfer schwer -- 
  liebtest gelobtest Treue -- verlachst Glaube schwörst -- Christus alleinseligmachend Tod Vater Himmel vereinen -- 
  Jenny -- durftest grausam Ideal zerstören -- anbeteten -- 
  konntesen Seele -- heilig -- Gott vertraut Pfand -- versinken lassen -- 
  Sage -- täuschen -- unmöglich -- wolltest -- 
  Liebe entschuldigen Lüge -- Lüge -- ewig trennen -- unwiederbringlich Glaube verlieren -- heilig Wahr anbeteten -- 
  Leb -- -- nimmer vergessen -- groß Glück tiefste Leid Leben geben -- 
  Leb -- Jenny -- klagen -- Unglücklicher -- -- Glauben Stütze finden -- 
  O -- Gott -- Glaube geben Seligkeit -- Liebe finden -- -- 
  Brief Jenny's Hand -- 
  vermögen lesen -- Hand zitteren -- Buchstabe schwamm Auge -- 
  reichen Vater -- -- Brief fragen bebend -- -- -- 
  Sage -- -- lesen -- -- 
  verneinend schüttelt Vater Haupt -- Brief beenden -- Tochter -- gewaltsam zusammennahmr Todesangst durchflog -- 
  tief Ohnmacht -- einzig Glück -- Stunde -- senken nieder -- 
  erwachen -- lesen Brief -- begreifen -- Reinhard Liebe zweifeln können -- Gedanke bedeuten -- Reinhard Erlau's Wille aufopferen -- 
  -- Trennung Reinhard's Gesinnung denkbar -- halten -- trotz Andeutung Vater -- 
  -- Geliebten verachten -- Glaube -- Hoffnung -- Last -- bleiben Leben -- -- rufen -- 
  -- Jenny -- -- Vater verweisend unaussprechlich Liebe -- ziehen Tochter Arm rufen Mutter herbei -- lieb Kind beschatten möchten versengend Strahl Schmerzes -- treffen -- 
  Tiefem Kummer schwand Stunde Jenny -- erwarten -- Reinhard Erkenntnis -- bereuen -- Wiedervereinigung unmöglich -- dennoch -- sehen -- Frieden scheiden -- 
  vergebens -- 
  verlangt Jenny -- Geliebten schreiben -- sagen -- lieben -- -- Argwohn Bezug Erlau unbegreiflich schmerzlich -- 
  bitten -- mögen Beruhigung gönnen -- 
  Vater fühlen schwer kränken Reinhard's Betragen Jenny -- Vater fragen -- -- Erlaubt Stolz -- Mann nähern -- verkennen -- -- 
  -- fühlen Stolz -- -- antworten Jenny -- Bedürfnis Liebe -- hoch Stolz -- 
  Achtung erhalten -- Unwürdig denken -- glauben -- lieben -- -- 
  -- -- -- Vater -- -- Reinhard leise verlangen Erklärung aussprächen -- Wunsch Rücksicht Billigung geben -- 
  Manne -- Braut unwürdigst Wortbrüchigkeit zutrauen weder Liebe -- Schwüre glauben -- Tochter bitte Vertrauen erniedrigen -- 
  Reinhard's krankhaft Ehrgefühl -- Forderung Nachsicht -- verdienen Achtung liebtest -- indessen scheinen fast Wohltat -- Verhältnis lösen -- nimmer glücklich konntesen -- -- Reinhard gering denken -- augenblicklich tun -- -- Heftigkeit Urteil verblenden -- Ungerecht Braut vermögen -- 
  ford Beweis Liebe -- Versuch machsen -- Reinhard verständigen -- friedlich Lösung Eurer Bande herbeiführen -- ausdrücklich verlangen -- 
  warst Reinhard's Braut -- Tochter -- Ehre deiner Vater heilig -- mußt Opfer bringen -- -- ford -- bringst -- -- 
  geschehen -- 
  Reinhard Jenny sehen -- niemals finden Erklärung Brautpaar -- glühend Sehnsucht innigst Vereinigung streben -- plötzlich schmerzhafte Weise trennen -- 
  still einsam verlebt Sommer Berghof -- Therese Ereignissen Mutter zurückkehren -- 
  behaupten -- Haus nötig -- Madame Meier -- Therese Wunsch aussprechen -- verlassen -- Anwesenheit Jenny angenehm scheinen -- 
  spät kehrt Stadt Jenny müssen allmählich Verhältnis hineinleben -- fremd -- Beziehung Reinhard nehmen -- 
  diesmal silvesterabend erscheinen -- vorig glücklich Mensch Meiersch Haus vereint -- Familie Steinheim's Besuch -- Jenny's schmerzlich Erinnerung schonen -- obgleich bestreben erkennen -- Freund -- froh Stunde verleben -- böse treu Gefährt -- 
  Baden-Baden kennen -- erinnern einzeln liegend Haus Klosterwiese schön Eiche -- 
  Schatten Baum sitzen Junimorg Jahr 1841 Dame zeichnen -- 
  -- fein Figur -- 
  rabenschwarz Locke fallen Papier nieder verbarg Gesicht Arbeitenden -- berechtigen -- schön Zug erwarten -- schmal Hand graziösen Fuß Gesicht schließen -- 
  sechsjährig -- hellblond Knabe spielt Entfernung versuchen vergebens -- Aufmerksamkeit Dame ziehen -- 
  nah rufen -- -- Look my Dearest aunt -- theren Comes Papa and Lord Walter -- -- -- 
  -- Dame erheben -- Kommende begrüßen -- springen fröhlich fort bieten Herr fremdklingend Deutsch Willkommen guten -- 
  -- Mutter Zimmer -- Richard -- -- fragt Vater Knabe -- 
  -- -- -- antworten Jenny Meier -- Zeichnerin -- -- -- Hugh -- Clara Wärterin Luch entgegengegangen -- neu Fortschritt erzählen -- -- 
  wundre -- begegnen -- 
  Goldbrünnlein warten -- -- 
  -- O -- Schade -- -- rufen Hughes -- -- Stadt gehen verfehlten -- 
  sogleich zurückkehren -- holen -- denken -- bleiben Fräulein Meier -- Walter -- erwart Rückkehr -- -- 
  -- groß Vergnüge -- -- antwortet angeredeter -- -- Fräulein Arbeit stören -- -- 
  -- -- beenden -- -- Jenny freundlich -- 
  -- -- Herr Graf -- beicht -- letzter sehen -- -- 
  Walter -- begehrn Hugh Knabe -- Mutter Schwesterche holen -- 
  Graf Ausflüg Streifereie umgegend erzählen -- vergönnen -- flüchtig Umriss Zeitraum ausfüllen -- Hälfte Erzählung liegen -- 
  Schmerz Trennung Reinhard Jenny's Seele innerst Tiefe erschüttern prüfend Herz blicken lassen -- Grund Reinhard's unerklärlich Betragen finden -- 
  scheinen leicht -- Unrecht -- Fehler zeihen -- Reinhard Schuld beizumessen -- 
  wahr Frauenlieb klagen -- geliebter -- 
  menschlich Herz eigentlich Acker -- durchwühlen brauchen -- köstlichst Schatz entdecken -- 
  Jenny finden -- Unrecht -- Herz suchen -- Kraft -- Leben ertragen -- trotz Schmerz lieben -- 
  gewinnen -- fremd Glück Leid Wohlwollen Menschheit Trost Verlust finden -- unersetzlich scheinen -- 
  Herr Meier beruhigen fähig -- Wechsel äußer Gegenstand zerstreuen lassen -- Vorschlag Reise -- Beginn Frühjahr antreten -- 
  südlich Frankreich -- verleben Winter Paris besuchen Italien folgenden -- 
  -- Jenny Maler Erlau wiederfinden -- Name Ferne ruhmvoll erklungen -- Meisterwerk Paris bewundern Gelegenheit -- 
  wiedersehen Moment tief Bewegung -- 
  erlau -- Vorsatz getreu -- Verbindung Freund leben -- wähnen Jenny längst Reinhard verheiraten Entdeckung Gegenteil erfüllen freudigst Hoffnung -- 
  Stunde Jenny's Führer Wunderwelt -- Italien Auge erschließen voll Zauber lebhaft fühlend Mensch ausüben verfehlen -- 
  Jenny Wonne ungetrübt genießen -- 
  gewahren Schmerz -- Erlau Leidenschaft erloschen -- täglich Beisammensein heftig entbrannt Hoffnung nähren -- Jenny erfüllen vermögen -- 
  veranlaßn Herr Meier -- Jenny's Wunsch -- Italien verlassen rufen Erlau's Erklärung hervor -- entschließen -- Meiersch Familie folg Heimat zurückkehren -- 
  Jenny erwarten -- halten Pflicht -- jungfräulicher Schüchternheit überwinden frei erlau gegenwärtig Verhältnis erklären -- 
  gestehen -- -- genesen unsäglich leiden -- Gedanke Liebe unmöglich -- 
  beschwören -- Ruhe Wille -- folgen -- 
  -- wert -- hoffen -- Liebe einst Freundschaft erwerben -- erlangt Versprechen -- England William's Clara's Nähe leben -- versichern -- Jenny Italien ausdauern -- 
  trennen Mal Jenny kehrt Abwesenheit anderthalb Heimat -- 
  finden äußerer Verhältnis verändern -- 
  Eduard ruhig ernst Bahn -- vorgezeichnen -- 
  berühmt unermüdlich ärztlich Beruf -- unverwandt Fortschritt Volk Auge -- frei Entwicklung -- frei -- zeitgemäß Verfassung vaterland Raum finden -- 
  eifrig bestreben Erreichung Ziele beitragen -- Gesamtheit nützend -- Volk erlösen -- verbinden gleichgesinnter Ständen -- 
  Land erkannt Fähigkeit hoch Uneigennützigkeit Charakter -- Hoffnung -- erlangt Emanzipation -- Ehrenstelle erwerben -- Einfluß -- Furcht Verantwortung -- kühn Wort freisinnig Schrift häufig unterwerfen -- 
  genügt Bewußtsein achtend Anerkennung Mitstrebende -- 
  -- leben väterlich Haus -- 
  -- Tätigkeit absorbiert Alleinsteh fühlen lassen -- Mädchen finden -- Neigung erregen -- unverheiraten bleiben -- 
  Eltern Clara's -- scheidend Sorgfalt empfehlen -- treu geschätzt Freund -- 
  -- wissen -- verdankt Glück Tochter -- vollkommen übereinstimmend Ehe William schön erblühen -- 
  Eduard's Brust schütten Kommerzienräte Kummer Schicksal Sohnes -- unsten Deutschland Frankreich durchstreifen -- Frau beherrschen -- unwürdig Leben führen -- 
  Ferdinand fühlen Elend Schande -- stürzen -- schwach -- Sklavenkette brechen -- entehrt -- 
  ausdrücklich Wunsch Hornsch Familie -- Eduard Verbindung treten -- gelingen -- Ferdinand vertrauen gewinnen -- Hoffnung -- einst -- Verloren Familie wiederzugeben -- 
  herzlich Freude empfing Eduard treu Joseph heimkehrend Liebe -- 
  Anblick Raum -- glücklich unendlich gelitt -- erwecken Jenny's Brust wehmütigsen Erinnerung -- sobald Eduard -- wagen Reinhard fragen -- Briefe tun -- 
  wissen -- Amt antreten ungeteilt Liebe Achtung Gemeinde erwerben -- 
  Therese mitteilen -- Mutter Abreise Meiersch Familie sterben -- 
  Therese Gouvernantenstell Land annehmen -- Jenny Brief -- schreiben freundschaftlichste Anerbietung -- Antwort erhalten -- 
  unerwartet treffen Nachricht -- Therese Vermittlung Pfarrerin Stelle -- Nähe Reinhard's Wohnort -- erhalten weniger Woche verloben -- 
  Jenny erfahren -- ziehen trübes lächeln Mund -- Eduard drücken schweigend Hand -- 
  Joseph scheinen Jenny' Zufriedenheit gleichsam Zweck Leben -- beglückender Eintracht -- friedlich Ruhe schwand Meiersch Familie Rückkehr -- 
  trefflich Mann Jenny werbend nahen -- Wunsch Jenny' Eltern unterstützen -- Erfolg Bemühung krönen -- 
  Wagt besorgt Liebe Mutter -- zuweilen Vorstellung -- bitten Jenny -- mögen Nachsicht -- unmöglich -- Wunsch erfüllen -- hegen -- 
  -- zufrieden glücklich -- lieb Mutter -- -- -- -- -- Vater -- Eduard -- Joseph -- Herz begehren -- lieb Schonung -- 
  Haus Mann finden -- lieben -- -- 
  Zumutung Gespräch Art Jenny sichtlich lang verstimmt -- Herr Meier -- Frau anriet -- Jenny dringen -- ruhig Zukunft erwarten -- Erinnerung Reinhard Einfluß Jenny verlieren Vorschlag Freund leicht Gehör finden -- 
  Zeitpunkt Madame Meier erleben -- plötzlich -- schmerzlos Tod entreißen Familie -- 
  tief Verlust empfinden -- Engverbunden fest aneinand schließen -- Lücke ausfüllen streben -- Herz entstehen -- bedürfen Erwähnung -- 
  stehen Jenny Spitze Haus -- Vater weisen -- 
  Bewußtsein erheben Auge tilgen Wunsch Herzen -- Vater leben Alter verschönen -- 
  religiös Zweifel -- einst Glück Jugend untergraben -- längst glücklich besiegen -- 
  nachdenken Beistand Vater Standpunkt Gottesverehrung führen -- Erziehung hingeleiten -- 
  geistig frei klarst Bewußtsein -- zärtlichste Tochter -- Trost Leidenden elegant -- geistreich Wirtin gestfreien -- vä terlich Haus -- erscheinen Jenny -- Schmerz Tod Mutter mildern -- 
  finden Woche Vereinigung Clara Baden -- 
  Wunsch -- sehen -- Freundinn mächtig -- Umstand Art Erfüllung unmöglich innig Freude treffen achtjährig Trennung Baden-Baden -- 
  rendez-vous gegeben gemeinschaftlich Heimat Dame zurückkehren -- Clara's Kind Großelter vorstellen -- 
  anfänglich Erlau -- England ansiedeln ehrenvoll Stellung erwerben -- William Deutschland begleiten -- 
  unruhig -- rasch Lebhaftigkeit Jüngling Manne erlosch Wunsch -- Vaterland Freund sehen -- aufgeben -- englisch Gesandtschaft Orient anschließen -- Hang Ungewöhnliche voll Befriedigung finden hoffen -- 
  befreundet Familie -- sobald baden angelangen -- absichtlich Wohnung außerhalb eigentlich Stadt nehmen -- Besitz gemietet Haus frei -- ländlich Natur -- 
  leben Jenny zufrieden -- William Ankunft erzählen -- Freund -- Grafe Walter -- erwarten -- Genosse Aufenthalts Baden ankündigen -- 
  Graf Walter gehören alt Familie Deutschland -- 
  meister Jünglinge Stand früh Militär treten -- Regiment Vaterstadt Clara's kommen elterlich Haus fast Person Erzählung -- Hugh befreunden -- 
  Dienst verlassen -- bedeutend Reise -- Übernahme Gut landwirtschaftlich Beziehung vorbereiten -- England gehen -- auf William Clara zusammentreffen -- 
  bitt Gast -- England verweilen -- rechnen -- -- teils London -- teils reizend Hugheshall verleben -- anmutigst Erinnerung genußreich Leben -- 
  Willkommener -- zufällig Begegnung Freund ufern Rheines -- unabhängig -- Beziehung -- lassen bereitwillig finden -- Sommer Baden zuzubringen -- 
  Jenny flüchtig sehen -- obgleich nah kennen -- erinnern dunkel -- Liebe Jenny' jung Theologe gehören -- 
  Clara -- Anfrage -- Detail Jenny Lösung Verhältnis erfahren -- Clara's William's Erzählung -- gespannen Bekanntschaft Mädchen -- Gatten Interesse sprechen -- 
  trotz günstig Vorurteil -- finden Jenny -- erwarten -- Herr Meier Jenny wissen William -- Grafen Kreis gewinnen -- Umgang hochgebildet Mann Freude gewähren -- 
  Walter Jenny verlangt Bericht ablegen -- bitten Erlaubnis -- Arbeit besehen -- beschäftigen -- ankommen -- 
  bereitwillig Skizzenbuch zeigen Gruppe Bäumen -- vorher Nähe Wasserfall entwerfen -- 
  -- ausdrücken -- -- Jenny -- -- schön -- Baum lieben -- 
  geben Bild unser Leben -- fest Erde wurzeln -- sehnsüchtig Himmelan streben -- Spiel sonnenbeschienen Blatt liegen hoch Genuß -- 
  schönsn Traum Kindheit -- rosigst Märche gaukeln vorüber Wunder Feenwelt scheinen -- flüsternd Kose Blätt hören -- -- 
  -- echt deutsch Empfindung -- -- bemerken Walter -- -- vollkommen begreif Teil -- 
  glücklich -- Park herrlichst Eiche besitzen wissen Voreltern -- Baum pflanzen -- 
  Quelle Genusses -- Natur -- umgiben -- 
  schreiten fort -- leben -- Antwort Frage -- Zeichen wahr Dichter -- Sprache verstehen -- Natur Mensch sprechen -- -- 
  -- Glaube -- -- fragen Jenny -- -- Einwirkung Natur Gemüt Mensch Zeit bleiben -- -- 
  -- sofern gewiß -- -- antworten Graf -- hoch -- heilig Empfindung Seele anregen -- 
  Gefühl Lauf Zeit ändern -- wechseln Eindruck -- -- 
  heit Griech schön Bäume Wald lieblich Dryade -- Liebe umfingen -- 
  deutsch Mittelalter predigen Ernst -- düstern Dome lehren -- sprechen Kreuz -- Holze zimmern .. -- 
  -- -- fragt Jenny lebhaft -- 
  -- weisen hinauf Region Klarheit -- predigen Freiheit Licht himmelan strebend Zweig -- -- Walter schön Erhebung -- 
  -- -- Jenny erfreut zuhören -- fahren Weile fort -- -- Heine Meer -- Carl Beck Baumwelt begreifen -- 
  verstehen -- Ästen rauschet Gelispel Zweig tönen -- halt Dichter -- Natur alt längst vergessen Ammenmärche -- Gedanke vertraut -- 
  scheinen jünger Talent Fall -- 
  -- wollen neu -- kräftig Leben Poesie entfalen -- hoffen -- Menge veraltet -- stereotyp geworden Bild -- jetzig obenein ungenügend verkehren -- -- 
  -- Verkehrt -- -- wiederholen Jenny fragen steigend Interesse -- -- rechnen -- -- 
  Walter sannen Augenblick -- -- 
  -- gewöhnlichsten nennen -- 
  Bild Baume Schlingkrautes Ehe -- 
  glauben -- Fräulein -- 
  müde ewig Eiche -- zärtlich Efeu schmiegen -- Ulme -- Reb vertrauend emporranken -- 
  ehen -- 
  Baum -- angeboren Naturtrieb kühn emporstreben kümmerlich Pflanze umrankt finden -- weder zurückzuhalt Aufzuschwing gedeihen vermögen Höhe -- schaffen -- 
  schlimm -- -- Dichter dürfen Bild brauchen -- Ideal schildern -- innigst Vereinigung leben -- 
  Gleichnis falsch -- Schloß verwundern Jenny -- sprechen -- Stift aufnehmen groß Eifer zeichnen -- 
  Minute reicht Grafe -- scheinbar Zerstreutheit verletzen schweigend sitzen -- Zeichnung fragen -- 
  -- Graf Walter -- befriedigen Gleichnis -- -- 
  kunstgeübt Hand vortrefflich Skizze entwerfen -- 
  kräftig -- üppig Baum stehen dicht nebeneinander -- frisch fröhlich emporstrebend -- eng verschlungen Äst -- 
  Las Wort -- 
  -- gleich Tiefe -- frei vereinen Äther empor -- -- 
  Walter betrachten Bild Freude -- Ausdruck hoch Bewunderung Jenny' glühend Gesicht -- 
  -- vermögen wiedergeben -- tief empfinden leben -- 
  schenken Blatt -- Zeichen -- Gesinnung Beziehung übereinstimmen -- 
  bitte -- lassen -- -- 
  -- -- -- antworten Jenny -- -- Zeichnung fällen -- scheinen -- finden -- schön Vorbild dedizieren -- Clara geben -- Manne Kind Brücke -- 
  Vater -- 
  Las entgegengehen -- -- 
  erfreulich Anblick -- Familie sehen -- Wiese dahinschritt -- 
  William dreißiger -- Bild selbstbewußt -- kräftig Männlichkeit -- England häufig finden -- 
  blühend schön Mutter führen Lucy Mitte -- Versuch -- Füßch fortzukomm Gewalt Bruder nachlaufen -- fröhlich jubelnd voranspringen -- 
  anmutiger Bild ehelich Glück finden Walter's Auge suchen Jenny -- plaudernd arm Vater hing beschäftigen -- 
  niederlassen lieblich Kind vertändeln -- William Walter -- 
  -- wünschen -- beisammen sein -- ehe Plan enthüllen -- ausbilden -- 
  vorschlagen -- -- einst England -- Hausgenosse -- flüchtigen unser Beisammensein genießen -- 
  finden Raum niern -- 
  Dienerschaft -- Equipage hinreichend Platz -- erfreuen -- Gast sehen -- bedürfen Versicherung -- -- 
  Herr Meier vereint Bitte William's -- überlegen -- Walter Vorschlag unbedingt sichtlich Vergnügen -- 
  Entwurf -- einrichten wollen -- nötig Ruhe Freiheit gönnen -- Länge behaglich Existenz denkbar -- Trennt -- übereingekommen -- Walter sollen Lauf Tag Hotel verlassen -- Freund etablieren -- 
  fortgegangen -- bemerken Jenny -- Art fallen -- Walter William's Erbiet annehmen -- 
  Anderer Einwendung -- Bedenken äußern -- können beschwerlich zuletzt Danksagunge erschöpfen -- Einladung annehmen -- 
  Walter -- 
  denken offenbar Augenblick -- zusagend -- -- überzeugen -- -- Umstand -- 
  -- kommen Freude -- -- -- liegen Einfachheit Angenehme -- -- 
  -- -- -- bestätigt Herr Meier -- 
  sprechen fest zutrauen Freund -- Überzeugung -- wissen -- willkommen künftig Wirt -- Versicherung -- verpflichten -- 
  charakterisieren edl Gemüt -- frei -- durchgebildet Sinn meister Art -- Dienst empfangen Gefälligkeit annehmen -- 
  schicklich Weise leisten -- erlernen -- -- 
  -- -- jeder Mensch Sache -- -- wenden William -- 
  -- erdrücken Art -- dienstwillig gefällig zeigen -- -- 
  -- -- -- erwidern Herr Meier -- 
  -- Tugend -- Pflichterfüllung -- Opfer auslegen -- wohlwollend Charakter einfach erscheinen -- 
  bereit -- dienen gefällig -- empfinden -- Freude liegen -- gönnen Genuß Übrigen nehmen Hilfsleistung Gefälligkeit unbefangen -- erzeigen -- 
  wissen -- Geben selig Nehmen -- Befriedigung Gewährende gewiß -- Empfangen -- 
  vertrauen Person -- Art -- annehmen verstehen -- innerlich Vorbehalt -- Gegendienst möglichst Quitt vergelten -- 
  vertrauen fast niemals betrügen finden Walter auf Bewährung -- 
  täuschen finden -- zusehen -- bereit -- -- -- 
  Wort erheben Herr Meier entfernt William -- nötig Anordnung treffen lassen -- 
  Jenny Clara wiedersehen baden erfreuen -- Lieb -- verbergen bleiben -- eigentlich gemeinsam Berührungspunkt fehlen -- Basis Freundschaft -- 
  Monat verleben Reihe verflossen -- sodaß trotz fleißig Briefwechsel Dame ziemlich fremd ineinander finden wissen -- 
  Clara's Erscheinung Glück Zufriedenheit ausdrücken -- Zug Wonne aussprechen -- Gattin Mutter empfinden -- zeigen geistig Richtung gewiß Ruhe -- abgeschlossen Begnüge -- 
  hoch Schatz Leben erreichen -- obgleich Außenwelt abgestorben -- interessieren eigentlich -- William berühren wünschen Ansicht zusammenhehen -- schön Frau Art lebt Manne Kind -- 
  Jenny hingegen -- Eduard gewöhnen -- nehmen Wichtig -- 
  weiblich Schwärmerei hehen Planen Hoffnung Eduard's -- seinetwillen -- -- 
  geistig künstlerisch Beschäftigung füllt groß Tag gewohnt Lebhaftigkeit strebt Kenntnisse -- hoch -- vielseitig Ausbildung Anlage -- ungenützt fühlen -- 
  schmerzlich lächeln Clara treiben Jenny's -- 
  glaubt Erfahrung -- Frau lebhafte Teilnahme Erscheinung Außenwelt Zeichen innerer Unbehagen -- Surrogat -- Glück entschädigen -- -- 
  Jenny hingegen erscheinen Clara's Wesen Resignation -- bewunderten -- glauben -- Stande -- Glück Zufriedenheit finden -- 
  verschieden Ansicht gegenseitig Schonung Pflicht -- Versuch verständigen -- Erfolg bleiben -- vermeiden Unterhaltung Art Jenny nahe -- Beisammensein Clara einförmig finden -- Walter's täglich Anwesenheit erwünscht Abwechslung Leben -- 
  stet Begleiter Promenade -- Umgegend Baden unwiderstehlich locken -- 
  lassen sorglos eigentümlich Denkweise Walter -- Jenny' hoch Wert täglich erkennen schätzen lernen -- äußern William Clara -- Jenny Frau interessant bedeutend erscheinen -- 
  -- schön -- -- fragt Clara -- 
  -- schön -- -- antwortet Graf -- -- anziehend -- Auge ansehen glauben -- weinen -- Mund -- einst Schmerz gebeben -- 
  solch feucht verklärt Auge fühlen Beruf trösten -- vergüten -- ruhig heit Jenny erscheinen -- -- Zukunft Viele -- müssen Glück früher Leid entschädigen belohnen -- -- 
  -- klingen warm -- Graf -- William scherzend -- -- fast -- abneigen sein -- Entschädigung übernehmen -- 
  Hüt feucht verklärt Auge -- -- 
  -- Unrecht -- -- entgegnen Walter -- Wort Sinn unterlegen -- 
  Jenny Meier innig Bewundre -- lieben -- Umgang anziehend erhöhen Reiz -- scharf ausgeprägt Charakter -- selbständig Wesen -- -- 
  Augenblick Richard herbei rufen -- -- O Tante Jenny sehen -- Fenster -- -- 
  folgen dorthin erblickt Jenny -- jung leichenblass Frau nieder Stand unterstützen -- Kind Arm tragen -- 
  Walter fliegen Treppe hinab -- beizustehen -- Mittag -- Sonne brennen glühend heiß Jenny scheinen erschöpft ungewohnt Anstrengung -- 
  -- führen Frau Haus -- -- Jenny -- Walter -- -- behutsam -- 
  Kind behalten -- -- 
  Walter erfüllen Wunsch -- arm kranke sorgen -- erzählen Jenny -- ohnmächtig Weg finden -- Bemühung Leben rufen unsäglich Anstrengung hierher bringen -- mittagsstund Straße kommen -- Hilfe bitten -- 
  -- Mensch sehen -- -- -- 
  -- blickt Seite -- rufen laut unerträglichst Stutzer hülfreich Götterbot -- Augenblick erscheinen -- -- 
  -- -- -- meinen Clara -- 
  -- arm Frau glücklich hierher bringen Bemerkung entgehen -- -- -- 
  -- bieten einfach Handlung Anlaß -- -- Jenny unbefangen -- 
  unmöglich Frau hülflos liegen lassen -- Stadt Beistand holen -- 
  zudem schreiend Kind nehmen weißen -- lieb Klärch -- Urteil Menge gleichgültig -- -- tun -- Vater verantworten -- -- 
  Jenny' Wort -- Wesen liegen Moment soviel Natürlichkeit edl Stolz -- Walter Entzück betrachten -- obgleich Gedanke unangenehm -- Jenny Situation beobachten falsch beurteilen -- 
  -- Seite Widerspruch Sitte sogenannter zivilisiert Welt stoßen -- -- Walter Herrn Meier -- indes kommen -- 
  -- dienerinn Haus Unglücklichen begegnen -- annehmen -- schön lobenswert finden -- tadeln Fräulein Jenny -- unbarmherzig vermögen -- -- obgleich Dienst -- leisten -- groß -- müssen Beschwerlicher scheinen -- -- 
  -- billig Handlung Tochter unbedingt -- -- fragt Herr Meier -- 
  Walter stockt Augenblick meinen -- 
  -- handeln vermocht -- -- 
  -- wünschen -- -- alt Herr -- -- Jenny Probe Art stellen -- Mädchen gewohnt Sitt Stande abweichen sehen -- 
  dennoch ehr Gefühl -- Augenblick rücksichtslos handeln vermögen -- qu -- dira L'on -- denken -- Schuld -- Jenny Urteil Leute anschlägen -- 
  Verhältnissen Pflicht -- Kind gewiß Grade gleichgültig öffentlich Meinung -- allemal Einfluß groß -- glauben -- -- 
  Clara -- Anfang Äußerung bereut doppelt -- Herr Meier Erklärung bewegen -- vermeiden -- Eduard suchen -- Clara -- 
  -- Versteht falsch -- 
  Tadle Jenny -- 
  Verderbtheit bange -- unlauter Motiv -- Schaustell Last legen können -- 
  Frau gewöhnen -- innerhalb unser schützend Haus denken -- erschrecken -- außerhalb handelnd erblicken -- -- 
  -- Entschuldige -- Klärch -- -- Jenny -- schweigend Unterhaltung zuhören -- nahe beteiligen -- -- kennst alt Wahlspruch -- 
  -- Tue -- sollen -- kommen -- -- -- 
  -- Mut Jugend fühlen -- 
  Wort entfernen schnell -- Schützling sehen -- lassen Walter Bewegung -- 
  mal -- jüdisch Familie nah Berührung Jenny's Geist Schönheit -- Vater Weisheit ziehen -- Fremd Eigentümlich besaßen -- 
  jeher wissen -- Jenny Jüdin -- fern Verhältnis gestehen -- fast denken -- können edl Unglück liegen -- Jude -- 
  alt Herr schlicht Äußerung tönt -- Glückliche -- Schmerzensschrei Volk entgegen Mitleid knüpfen -- unbewußt -- neu Band -- Jenny fesselen -- 
  widmen ausschließlich wahr Freude -- -- lebhaft bewundert -- Zahl schön liebenswürdig Frau -- Baden vereinen -- schön liebenswürdigsen erblicken -- 
  Verhältnis Jenny Vater zeigen -- frei Vorurteil -- -- allmählich Jenny erfahren -- Ihrig empfindlich gelitten -- 
  scheinen Ehre finden -- Jenny' unausgesetzt Begleiter -- erklären -- Gesellschaft alt Herr Meier Tochter fast vorzögen -- 
  Walter's Selbsttäuschung -- Gefühl -- handeln antreiben -- Gerechtigkeit -- Genugtuung frei Glückliche Unterdrückt halten -- 
  glauben -- politisch Überzeugung -- Achtung Menschenrecht folgen -- ritterlich Pflicht Edelmannes erfüllen -- ungerecht Vorurteil kämpfen -- 
  Onkel -- bekannte Walter's Verhältnis Meiersch Familie unterrichten Unruhe erwähnen -- schreiben folgend Brief -- 
  -- gewöhnen -- teur Onkel -- Besorgnisse Vorwurf verstehen -- schonend Liebe Linie schreiben -- unangenehm Empfindung ersparen -- 
  les wohlwollend Rat -- Heimat zurückzukehr Besitzung fern bleiben -- Besorgnis -- Heimat einziehen -- Gattin bringen -- -- ehemalig Vormund -- väterlich Freund -- willkommen -- verheiraten alt Geschlecht fortgepflanzt wüßten -- -- 
  -- Fürcht -- 
  Liaison Kaufmann Meier Tochter innig -- denken -- dauernd -- indes Gedanke -- Fräulein Meier heiraen -- vollkommen fremd -- 
  wissen -- glauben fürchten -- Vorurteil Art abhalten -- Mädchen Gräfin Walter -- lieben -- 
  lieb Jenny Meier -- bewundre Freundschaft -- Umgang erfreuen -- 
  -- schön liebenswürdig hoch Grade -- gewiß Jugendlichkeit -- weiblich Weiche fehlen -- Mädchen ungern vermissen -- 
  wissen Sicherheit -- fällen -- leiben -- Anspruch -- -- dünken -- Geringst -- Meinung Gunst Mannes erwerben -- 
  fälln -- -- -- gelten -- 
  Gestehen -- eigentlich Art -- lieben -- 
  liegen Männliches -- interessant -- Umgang erleichtern -- Vertrauen -- Freundschaft erwecken -- Liebe -- -- 
  -- treffen Familie Meier zufällig Vermittlung gemeinsam Freund Erbiet -- Wohnung teilen -- 
  veranlaßen vermutlich Gerücht Verlobung Jüdin -- erschreckt -- 
  diesmal -- sehen -- Sorge ledig -- Heirat schließen sehen -- stark aristokratisch Ansicht verstoßen -- 
  Zukunft bringen -- einstehen -- 
  Scherz -- 
  wissen -- Urteil -- Beruf fühlen -- Waffe kämpfend Vorurteil auftreten -- Mitteilung -- Fräulein Meier Jugend Verhältnis Bruder -- Name -- 
  Vorurteil -- Drache -- vertilgen -- Ritterpflicht -- zerstörend wüten -- Ungeheuer vermocht -- -- beweisen -- Ritter -- St. Georg -- Lindwurm töten -- 
  ergreifen -- Jenny Stolz Unglück sprechen hören -- Tausend teilen empfinden -- obgleich Christentum übergetreen -- Grund Seele Jüdin bleiben -- 
  gestehen frei interessant -- Wesen Erscheinung -- Rätsel -- anmutig beschäftigen -- 
  verein Geist Mut Mann unendlich Güte -- überraschen -- zuletzt -- trotz männlich Klarheit -- liebenswürdig weiblich Schwäche lebhaft Gefühl Sieg Verstand tragen -- -- 
  -- sehen Weise -- ruhig Charakter Fräulein zergliederer -- Herz frei -- 
  geübte Anatom vermöchte -- Klopfe Herzen Hand unsicher -- -- 
  unbesorgt -- Freund -- finden unser Kreis liebenswürdig Gattin lang sträuben -- Kette anlegen lassen -- beglückend -- Freund William schön Frau bemerken -- -- 
  Woche schwanden anmutigst Weise -- 
  Walter überlassen steigend Interesse -- Jenny fesseln Umgang Bedürfnis -- entbehren -- Walter werter Freund -- 
  entziehen Ankunft Freundin -- Geheimrätin Meining -- Jenny Gesellschaft Hausgenossen -- 
  Frau Meining -- alt Jenny -- bejahrt Mann verheirat -- Berlin Arzt bedeutend Stellung einnehmen -- 
  Jenny kennen lernen unbedingtes vertrauen fassen -- hoch sittlich Wert Dame vollkommen rechtfertigen -- 
  fast Sommer pflegen Geheimrätin Baden leben -- Besitzung -- Mann fürstlich Herr Reise folgen -- Aussicht -- Jenny treffen -- bestimmen -- Lieblingsort besuchen -- 
  diesmal unpäßlich baden angelangen -- Reizbarkeit Nerv nötigen -- für Gesellschaft fern halten Jenny beschränken -- Freude Geheimrätin Ihrig teilen -- 
  willig lassen gewähren -- Graf Walter Mißvergnügen Jenny's häufig Abwesenheit verbergen äußern Abend Herr Meier -- Abwesenheit liebenswürdig Tochter gefallen lassen -- 
  Clara lacht Herr Meier bemerken -- 
  -- uneigennützig -- Freund -- Glück kennen -- Zufriedenheit Kind empfinden -- 
  arm Leidenden Zerstreuung gönnen -- Jenny' Gesellschaft gewähren -- -- 
  -- bleiben Fräulein Jenny ungewöhnlich -- -- Walter -- Anstalten -- Abend trennen -- Jenny' Rückkehr erwarten -- 
  -- Tochter Wagen bestellen -- 
  Geheimrätin leiden Schlaflosigkeit Jenny versuchen -- gelingen -- leis -- gleichmäßig vorlesen Weise Schlaf wiegen -- 
  wünsch liebenswürdig Frau Nacht -- -- 
  Wort entfernt Herr Meier -- Clara William ziehen lassen Walter -- 
  früh -- Ruhe begeben -- 
  hinab frei -- Stunde Kühlung genießen -- fühlen verdrießlich -- unruhig Spannung -- 
  -- stehen vorabend Epoche Leben -- erwarten -- müssen besonderer Ereignis begegnen -- 
  fragen -- bewegen -- worauf sehnsüchtig harren -- 
  müssen bekennen -- wissen -- 
  vergebens versuchen Zustand bekämpfen -- -- glauben -- körperlich Erregtheit Ermüdung abzustumpfen -- rastlos schnell vorwärts -- 
  befinden kurz Ausgange Lichtentaler Allee -- Nähe Haus -- Frau Meining wohnen -- 
  meiersch Equipage halten Türe -- 
  Fenster Geheimrätin matt beleuchten -- 
  zerstreut bleiben Walter Weile stehen -- Fenster empor schicken plötzlich Rückkehr -- 
  paar hundert Schritt -- Bank werfen -- Allee befinden -- tief Hinträumen Versank -- dennoch Fußtritt jeder vorübergehenden emporschrecken -- 
  allmählich Allee einsam -- 
  Nonnenkloster Stadt schlagen zwölf -- 
  hört Rolle Räder -- fahren blickt Gegend -- woher Ton scheinen -- 
  täuschen -- 
  weiß Kleid schimmern glänzend Dunkelheit empor -- eilt Gestalt entgegen -- Herz schlagen hörbar -- Jenny stehen -- 
  -- -- Graf Walter -- -- überraschen -- freundlich -- legen Arm Grafe -- schweigend bieten -- 
  empfinden -- vertrauen Art liegen -- Frau Arm Mannes lehnen -- begreifen -- Walter glücklich fühlen -- Jenny' Arm ruhen -- 
  gewiß Gleichgültigere -- Sitt -- fremd Dame Arm bieten -- fast süßere -- gleichgültig Sitt Person traulich Gewohnheit -- wissen -- nahe gehören -- 
  unverstand dunkel Ahnung Walter schlummern -- fühlen plötzlich unwiderstehlich Wahrheit -- 
  Jenny lieben -- freundlich sorglos -- müssen -- Schutz Stütze annehmen -- Sonne Liebe glorreich Bewußtsein fragen innerlichstselig -- 
  -- -- -- 
  schweigend legen Strecke Wege -- Walter vermochen sprechen innerer Wonn -- Jenny fühlen geborg Schutz Mann -- zufried Gedanke Erleichterung -- Freundin verschaffen -- willig weich Ruhe überlassen -- schön Sommernacht verführerisch einludn -- 
  allmählich Walter's schweigen peinlich -- 
  -- Stimmung mitteilen -- fühlen beklommen -- ängstigen -- Veränderung Situation bringen -- -- 
  -- schwül Zimmer Frau Meining -- dringend Notwendigkeit fühlen -- abzukühlen unser alt Diener Fußweg einschlagen -- 
  Nacht wunderschön -- -- 
  -- O -- unaussprechlich schön -- -- wiederholen Walter früh Stille treten -- 
  Jenny Unruhe steigen Minute Minute -- 
  bilden -- Unruhe motivieren -- Vater Unglück begegnen Walter entgegengeschicken -- Kenntnis setzen -- 
  -- Vater -- verlassen -- -- fragen Bebend -- 
  -- munt -- Ruhe begeben -- ehe Fortging -- -- antworten Graf -- Jenny -- Augenblick Wohnung erreichen -- Arm Grafe sinken tief aufatmend Sitz Türe nieder -- 
  weinen -- bewegen Herz -- aufsteh Zimmer Vater -- überzeugen -- -- erschöpfen Beängstigung Weg -- Glied rühren vermögen -- 
  schweigend sitzen Walter -- 
  tief Stille herrschen ringsum -- Rauschen Blatt -- leise Riesel Oelbach tönt Ohr -- 
  Balsamisch drang Duft frisch gemäht Grases Wiese empor Jenny's Seele finden Ruhe Friede feierlich Stille -- Wonne hingeben -- 
  tauchen plötzlich licht Schein nördlich Horizont -- Hell Heller -- sodaß Himmel durchleuchten verklärt scheinen -- Lichtmeer Ursprung herrlichen Erscheinung bezeichnen -- 
  einzeln Strahl schießen blitzschnell Zenit empor -- wechselnd Farbenspiel überirdisch Pracht -- verschwammen Lichtmeer -- glänzend Flammenstreif tauchen hervor -- 
  schön Nordlicht -- sehen bewundernd hing Jenny' Blick erhaben Anblick -- 
  Hand falten unwillkürlich bebend Stimme -- 
  -- sprechen Offenbarung -- 
  göttlicher -- unwiderstehlichere geben -- -- 
  glauben -- sprechen -- 
  Gott -- 
  Gott -- anbet -- kein Mittler -- sinnverwirrend Lehre Kreuz Blut Tod bedürfen -- fühlen lassen -- Liebe -- -- 
  Träne seligst Begeisterung fließen Jenny' Auge -- 
  Gedanke -- anbetend Verehrung -- tief Demut Gott Seele -- Walter Ausruf Entzück Jenny niederwarf gefaltet Hand glühend Lippe preßen -- 
  Erschreckt unangenehm leidenschaftlich Berührung Andacht stören -- stehen Jenny Tone Vorwurfs -- 
  -- entweih Stunde -- 
  Knien Geschöpf -- Schöpfer Offenbarung würdigen -- -- 
  Schritt rasch Haus -- Türe Diener Eintritt warten -- 
  Bestürzt Walter -- 
  Herz voll grenzenlos Liebe verlangen -- feierlich Stunde geliebter geben -- Übermaß Gefühl niedergesunken -- 
  beten -- Schöpfer -- kalt tadelnd stoßen -- 
  werfen -- blöd Träumer Jenny gestehen -- Mann Seligkeit fordern -- begehrn -- gewähren vermögen -- 
  -- -- -- -- -- -- 
  brennend Lippe drücken -- Schlag Herzens fühlen -- wissen -- -- lieben -- 
  -- -- 
  Walter halten inne -- 
  lieben -- Beweis glauben -- 
  Liebe unerwideren bleiben -- müssen Gegenliebe finden -- 
  Hoffnung Mut voll vertrauen glücklich Ausgang nächster Jenny Liebe gestehen Vater Hand Tochter fordern -- 
  vernichten Hoffnung vorig Tag -- 
  Walter Zimmer betreten -- versammeln pflegen -- verstört Zug Dame -- Ruhe erschüttern -- unangenehm Ereignis hereingebrochen müssen -- 
  Clara scheinen geweint schüttelte traurig Haupt -- Herr Meier tröstend -- 
  -- froh -- Kind -- Verhältnis Entscheidung kommen -- 
  augenblicklich Schmerz denken -- Gott gut Zukunft gewinnen -- -- 
  stören -- verlassen Graf Zimmer William -- schreibend finden -- 
  erfahren -- Stunde Brief Eduard's ankommen -- allgemein Aufregung verursachen -- 
  William richten lauten -- 
  -- Freund -- 
  Mache fassen -- Mitteilung hören -- -- obgleich erwünschen Folge -- Augenblick tief Betrübend -- 
  Ferdinand -- krank beklagen -- -- 
  -- vorgestern Nacht schellt Türe -- 
  öffnet -- wecken -- Kranker begehren -- 
  treten Fremd fragen -- wohin verlangen -- erkranken -- 
  -- krank sterben -- tot -- -- antworten unbekannte -- 
  prüfend -- 
  verfallen Gestalt -- üsirt Zug -- fast ergraut Haar -- obgleich Mann alt scheinen -- gänzlich Verfall rechtfertigen -- 
  -- kennen -- kennen -- -- fragen höhnisch -- 
  erkennen -- trotz fast unglaublich Veränderung Äußeren -- 
  Ferdinand -- -- 
  -- nötigt -- niederzusetzen -- 
  fragt Frau -- 
  -- Nenne Weib -- -- rufen Gesicht zucken Krampfhaft -- 
  -- Weniger -- Almosen hinwarf -- vermögen begnügen -- 
  Vorwurf -- Anspruch bringen Verzweiflung -- 
  krank -- Fieber Besinnung Zeitpunkt benutzen -- Rauben -- besitzen -- verlassen -- 
  verschenken -- verschwenden -- 
  Schloß fliegen konvulsivisch Zittern Zug -- -- 
  -- -- körperlich Erschöpfung auf Höchste steigen -- redet -- Nacht bleiben -- ruhen -- können nötige überlegen -- 
  betrachtet mißtrauen -- befremden -- aussuchen -- -- 
  -- Familie Horn verhaltungsbefehle holen -- -- 
  wissen -- beikommen -- 
  gelingen -- beruhigen -- 
  lassen Mahlzeit auftragen -- bedürfen dringend Erquickung -- 
  gierig greifen Speise brechen -- gesättigen -- laut Weinen -- 
  -- komm Heimat -- -- rufen fing -- erzählen -- gestern fast Nahrung nehmen -- Postwag verlassen -- Scheu -- Nähe Vaterstadt bekannte begegnen -- 
  -- -- wovon Mahlzeit bezahlen -- -- -- 
  nehmen -- ehe verlassen -- 
  Bewußtsein erwachen -- -- Bettler -- 
  Monden Kredit erschöpfen -- borgen -- 
  erfahren -- Russe folgen -- nachgestellt glänzender Aussicht versprechen -- erwarten -- 
  Ring -- ablegen verkaufen -- bieten -- verfolgen -- Torheit Unternehmen -- 
  wiedersehen -- 
  unbezwinglich Sehnsucht treiben hierher -- 
  sterben -- einst glücklich -- -- 
  -- Erschöpft fallen Sofa -- absichtlich schweigen -- Schlief -- obgleich heftig fiebern -- 
  unverkennbar nervöses Fieber deklarieren Krankheit Steige -- 
  klar Augenblick -- Phantasie sprechen tief Haß Mutter -- Unglück zuzuschreiben scheinen -- 
  besonderer Zufall treten -- Zustand gefährlich -- hoffen -- herstellen -- 
  indessen halten ratsam -- Eltern Anwesenheit Ferdinand verbergen -- körperlich geistig Stande -- wiedersehen ertragen -- 
  -- Trennung Frau erfolgen -- Leicht -- allmählich Eltern früh bürgerlich Verhältnis geben -- -- 
  -- Beruhige Frau sagen -- Pflege Sorgfalt -- Zustand erfordern -- fehlen -- 
  Bürge hoffen -- tröstlich Nachricht geben -- -- 
  Entschlossenheit -- William's Wesen charakterisieren -- erklären Lesung Brief bereit -- Clara's Vaterstadt reisen -- Eduard Sorge Unglücklichen aufzubürden -- strömend Träne beschwören Clara -- nehmen -- vergönnen -- Pflege Bruder übernehmen Rückkehr väterlich Haus einleiten können -- 
  William neigen -- Unmöglichkeit -- Kind schleunig Reise -- erforderlich -- scheinen Clara's Wünsch Hindernis Weg legen -- Jenny Vater Zustimmung erbieten -- Kind Obhut nehmen Haus bringen -- 
  beschließen -- Nachmittag abzureisen -- traurig Stimmung Clara Stunde entgegen -- Mal Liebling Herzen trennen -- William Jenny Mut zusprachen nötige besorgen -- 
  müssen Walter's persönlich Wunsch Ereignissen Hintergrund treten -- 
  Jenny scheinen vorig Abends vergessen -- 
  eifrig Clara bemühen gönnt eher Ruhe -- Freundin wohlversorgen Weg Heimat wissen -- 
  lassen Kind Zimmer bringen -- richten gehörig treffen Theestunde Grafe Vater -- 
  fühlen -- gestern Verhältnis Walter ändern -- 
  wissen -- lieben -- obgleich wert -- Liebe willkommen -- 
  Ton Unterhaltung finden -- zerstreuen -- verdrießlich -- beherrschen wissen -- entfernt Vorwande -- Frau Meining Besuch zusagen -- 
  Walter -- Jenny's befangen Wesen -- Zurückhaltung entgehen -- glauben leidenschaftlich Betragen verletzen benutzt Abwesenheit -- Vater Bitte Jenny's Hand auszusprech -- erklären Liebe Entschuldigung Ungestüm finden -- gestern erschreckt -- 
  Herr Meier gleich Lage -- überraschen Walter's Antrag -- 
  fragen -- Graf Liebe Tochter besitzen -- 
  -- glaub Zuversicht -- Freundschaft Achtung gewiß -- hoffen -- Liebe erwerben -- -- antworten Walter -- 
  -- Familie Schritt unterrichten -- -- Walter -- -- 
  -- -- wissen -- unabhängig Herr Handlung -- -- 
  -- Erklärung geben -- -- Herr Meier -- -- gestehen -- Meinung Ihrig -- 
  fürcht -- wünschen -- Werbung ungeschehen -- 
  wissen -- Jenny lieben -- -- hoffen -- frei -- Trennung ertragen -- folgen Rate -- Walter -- benutzen William's Abreise -- gleichfalls verlassen -- geben Wunsch -- Erfüllung Kummer -- -- 
  -- verweigern Jenny' Hand -- fragt Walter erbleichend setzen Ton -- tief gekränkt Stolz anhören -- hinzu -- -- vorbereiten -- -- 
  Ruhig Herr Meier Walter's Hand ziehen Sitz nieder -- aufstehen -- 
  -- verstehen falsch -- -- -- 
  glauben -- Betrag zeigen -- -- edl Mensch halten -- 
  wissen -- Stellung Welt Ansprüche ehrgeizigst Vater genügen müssen -- 
  Jenny Range erheben -- gräflich Waltärsche Familie Tochter Jude würdig -- 
  Jenny bewahren schwer Pflicht -- Frau Vorurteil Familie Standesgenoss schützen -- -- 
  -- glauben -- Wille Kraft fehlen -- -- fragt Walter -- 
  -- Glaube -- Jenny' persönlich Wert Einwendung besiegen -- Onkel Verbindung -- 
  einzig -- Meinung Wert -- Ansicht schonen -- Schritt billigen -- Jenny kennen Liebe -- 
  glücklich -- denken -- -- Leben schön -- Gattin fehlen -- Glück teilen -- 
  führen günstig Geschick Jenny -- 
  lieben -- Hand höchstes verdanken -- verweigern -- Vorurteil frei glauben -- Rohheit Niedrigst verzeihen -- -- 
  -- Gott -- -- -- Herr Meier ernst -- -- Gatte willkommen Jenny -- -- Tochter groß Zuversicht vertrauen -- -- 
  Erklärung voll Achtung bürgen -- 
  Wort reichen Walter Hand -- herzlich drücken -- 
  -- Antrag Verhältnis Jenny betreffen -- folgen -- 
  gelten Glück Tochter -- Walter -- 
  Trauen -- Welt Mensch lang kennen -- -- 
  betrachten frei Verpflichtung -- 
  Übereile -- 
  Lasse -- Ansicht Onkel hören -- prüfen Meinung Kreis -- angehören -- Wunsch hegen -- Jenny einverstanden -- Herz Bund segnen -- Bezug vollkommen Zustimmung -- 
  zufrieden -- Walter -- fragen -- 
  -- -- -- antworten Graf -- ungern Gedanke finden -- Ziel hinausgeschoben sehen -- obgleich fühlen -- Herr Meier Denkart handeln hoch schätzen -- 
  Widerstrebe verstehen -- Jenny erklären -- Onkel Absicht Kenntnis setzen Antwort erhalten -- verlassen Greis -- Onkel schreiben -- 
  Herr Meier ziehen -- Eduard seinerseits Geschehen benachrichtigen -- 
  glänzend Verhältnis -- trefflich Charakter Walter's aufmerksam -- 
  -- dennoch widerstreben innerer Überzeugung Verbindung fast -- Reinhard -- Unterschied -- Besorgnis Verhältnissen gelten -- Reinhard Charakter Mannes betreffen -- 
  gleichgültig Urteil Mensch -- Lob Tadel Umgebung kalt lassen -- Jenny's Glück hart Probe -- erleben müssen -- Walter's Entschluß Standesgenossen tadeln verletzen sehen -- 
  Verlobung bringen geistig Beziehung traurig Konflikt -- schwer überwindend Mißverhältnis äußerer Umstand versetzen unglücklich -- -- 
  Jenny beurteilen -- fühlen Scheu Walter's unverkennbar Neigung -- Mut zutrauen -- Liebe Werbung widerstehen -- 
  Walter's persönlich Eigenschaft Stellung Welt Mädchen schwer -- keiner Eitelkeit frei Walter Mann -- lieb Zutraue erwecken -- 
  überzeugen -- Heirat Stande -- teil Nachricht -- gerne sehen -- hindern vermögen -- dein Ansicht dürfen Verhältnis willkommen -- 
  Gott geben -- Besorgnis trüge Jenny glücklich -- verdienen -- -- 
  Ansicht Jenny' Scheu Bewerbung Walter's Mißtrauen Vater täuschen -- 
  Jenny Huldigungen gewöhnen jung -- Annäherung Mann Liebe erblicken -- 
  Verhältnis Walter -- Gesellschaft behaglich frei fühlen -- Sicherheit glauben -- Ansprüche begegnen -- -- geachtet Freund willig zugestehen -- 
  plötzlich Überzeugung Gegenteil Bewußtsein -- Walter's Liebe Kampfe aussetzen -- -- Hand verlangen -- Rücksicht weltlich Stellung verzichten -- 
  verstimmt Gedanke -- langen -- Walter Unterredung Vater -- Frau Meining -- Jenny's beweglich Gesicht Spur innerer Unruhe bemerken -- 
  fragt Ursache -- obgleich Jenny anfangs Tatsache leugnen -- freundlich bitten Dringen Seite Geheimrätin -- -- Entdeckung -- Liebe Mann besitzen -- denken -- unangenehm -- -- 
  Geheimrätin verwundern -- lächelen meinen -- 
  -- -- bemitleidesen -- Liebe erwiderst fällen -- 
  Leben neu -- verstimmen -- -- 
  -- Gegenteil -- -- antworten Jenny -- -- leiben wert -- tun wehe -- -- 
  -- Jenny -- -- Geheimrätin -- plötzlich ernsthaft -- -- vertrauen erzwingen -- neigen -- gewähren -- 
  sagen -- beruhigen -- Mann -- lieben -- verheiraten -- Weise binden -- Unruhe erregen -- 
  Frage beantworten -- -- 
  -- -- -- -- Engel -- -- rufen Jenny -- feierlich Ernst Freundin lächelnd -- 
  -- frei unumschränkt Herr Wille -- zweifle -- Hand antragen -- -- fürcht Vater ungern sehen -- -- 
  -- arm Stellung deinen ungleich -- -- fragt Frau Meining -- 
  -- Kennst Vater -- -- entgegnen Jenny Tone Vorwurfs -- -- glauben -- dergleichen irren -- 
  -- Gegenteil -- Walter -- lieben -- Liebe fürchten -- -- 
  -- Walter -- -- rufen Geheimrätin erfreut setzen hinzu -- 
  -- Unwahr -- 
  Walter's Liebe unwillkommen -- gleichgültig -- -- 
  -- behaupten -- -- antworten Jenny -- 
  -- Verlobung Reinhard gelitt -- ruhig Glück gewöhnen -- genieße -- Gedanke zitteren -- Stürme aussetzen -- 
  Liebe Vater Bruder -- Joseph Bruder --- Kunst Welt schaffen -- Freude finden bereiten -- 
  nenn Feigheit Egoismus -- -- sicher Hafen Meer Leben wagen -- 
  heiraen -- -- 
  -- Vater sterben -- -- 
  -- leben Brüder .... -- 
  -- wahrscheinlich dein Entschluß teilen -- -- fallen Geheimrätin Wort -- verheirat -- vernünftig Entschluß entzögest Best Fördertest -- 
  hundert Mal hoch Ansicht sprechen -- Ehe hegst -- 
  erhaben Walter's Idee schildern -- neulich Unterhaltung erzähltest -- Gegenstand -- 
  Gleichnisse zeichnen -- Leben realisieren -- stehst -- -- 
  erhitzen Eifer -- sprechen -- lehnen Fauteuil lächelnd -- Jenny nachdenkend schweigen -- 
  -- Leben wiederholen -- 
  Tante Freude -- sehen -- Ermahnung probieren -- -- ehe verheiraten -- 
  denken -- finden willig Ohr -- -- nehmen glücklich -- -- 
  -- sagen -- Clementin -- -- rufen Jenny -- -- erzählen -- Kampf Hochzeit Pflicht Liebe bestehen -- -- 
  Clementin streichen Hand hoch -- zart Stirn unbeschreiblich Weichheit Demut -- 
  -- halten schwach -- 
  vermögen -- mußt vermögen -- 
  Sollst kennen lernen -- Wonn -- Neigung Glücke opfern -- neu -- bess Glück finden -- 
  Pause fahren fort -- 
  -- -- -- 
  Opfer Neigung Rede -- 
  liebst -- frei Walter wert -- 
  drücken ängstigen -- -- 
  -- Gedanke -- können ehrgeizig Motiv unterlegen -- -- Jenny lebhaft -- -- Walter's Hand annehme -- -- gestehen -- Möglichkeit -- können einst bereuen -- Bürgerlich -- Jüdin -- heiraten -- Zutritt zirkeln Hofes versagen bleiben -- anderer Ereignis unangenehm erinnern -- 
  -- Walter Gleichnis nennen -- kümmerlich Pflanze -- Höhe emporranken -- gebären -- 
  Liebte Walter -- schwach -- Vernunft verleugnen -- nimmermehr -- 
  Walter Gefährtin wählen -- Vorzüg Ranges Geburt -- gleich Höhe erwuchs -- 
  Mensch verdanken -- jemals bereuen -- geben -- -- 
  -- Hand geachtet Gatte entehrt Gabe bereuet -- -- Walter -- ruhig Überzeugung -- -- Clementin -- fühlen -- Punkt liegen -- Jenny's Weigerung Walter's Wunsch ausgehen -- 
  kennen Walter -- erfreut Gedanke -- Jenny verbinden sehen -- wünschen womöglich beitragen -- 
  vermeiden diesmal -- Jenny empfindlichst Seite angreifen bemerken ablenkend -- 
  -- einzig Grund -- besorgt -- -- 
  -- -- -- antworten Jenny -- -- Grund -- 
  fehlen Fähigkeit -- Leben aufgehen lassen -- 
  Existenz fest bestimmt -- abgeschlossen -- 
  gewiß Freiheit gewöhnen -- entbehr Ehe aufgeben müssen -- 
  -- Reinhard lieben -- lieben -- 
  fehlen Jugendlichkeit -- Frisch Herzens -- fühlen tief -- 
  lieben -- -- 
  -- lieb Walter -- -- wenden Frau Meining -- 
  -- sicher Mädchen -- Liebe kennen lehren -- 
  Mann -- Schule Leben Hofe Prüfung bestehen -- 
  ruhig Mann reißen Leidenschaft blindlings -- tun -- überlegen -- versprechen -- halten -- 
  Frisch Herzen betreffen -- Liebe Mensch -- 
  Geschlecht -- jeder Erfahrung vorigen -- gleich fast -- jeder Geschlecht Torheit Weisheit -- Jugend -- Blüte -- Individualität -- Blüte -- rein schön -- obgleich Asche geschieden Generation erwuchs -- 
  Mut -- Herz -- 
  falsch Stolz besieg Übrig vertrau Liebesfähigkeit Liebebedürftigkeit Frauenherzen -- -- 
  innig Umarmung beendet Unterhaltung -- Frau Meining Entschluß hervorrufen -- sobald -- Gesellschaft anschließen -- Jenny Walter schnell Ziel bringen -- glückversprechend scheinen -- 
  freudig Hoffnung Anregung Nerv -- Arznei vermögen nächster Mal Walter's Besuch -- fast täglich Wohnung -- Ergehe erkundigen -- 
  Gefühl -- Jenny beunruhigten bewogen -- Walter entfernen -- 
  Furcht -- Frau Meining gestehen -- Verbindung -- Kreis Mesalliance nennen -- Walter's Frau leben bestimmen -- bekannt -- Scham -- Neigung fähig -- entscheiden Walter's Gunst geltend -- 
  trotz klar Verstand besitzen Jenny Schwärmerei tieffühlend Herzen Treue Andenken geliebter Jugend pflegen -- Reinhard's Verheiratung Gedanke ausgebilden -- nunmehr Anspruch Liebesglück -- Leben Beziehung beenden -- 
  Idee -- -- entsagen -- Witwenschleier schmücken -- Abzulege entschließen -- 
  fühlen wachsend Neigung Grafe -- kämpfen -- Unrecht -- scheut -- Ihrig sagen -- 
  -- lieben -- -- wahrhaft -- Verbindung Walter -- trotz Bedenken wünschen -- bloß Konvenienz ausgeben -- kränkend -- 
  innerer Frieden Zwiespalt Seele doppelt Unruhe anstrich Kälte -- Walter Irre drohen -- ohnehin Sorge Clara's anvertraut Kind krank Frau -- Weg finden -- Grund -- Grafe sehen -- Fall -- 
  treten Art Spannung Walter Jenny -- Gleichviel leiden scheinen -- Frau Meining gelingen -- Walter's vertrauen gewinnen -- 
  bitten -- Geduld -- Jenny lassen -- klar -- 
  -- Glaube -- Graf -- -- -- deutlich Frau Bewußtsein Heiligkeit Ehe -- langsam entschließen -- Schritt -- 
  Jenny stehen Bang zögernd Schwelle Tempel -- hüpfend sorglos überschreiten -- 
  Lasse irren -- 
  intrigant halt Unrecht -- Leute Entschluss überreden -- Neigung Eigentümlichkeit widerstreben -- 
  -- Jenny -- mißverstanden Gefühl abhalten -- Glück Glück Mann gründen -- leiben -- -- Walter -- 
  Freundschaft Übriges Mädchen zwingen -- glücklich -- -- 
  -- hart Wort -- -- bemerken Walter -- -- Jenny's Hand weder Überredung -- Zwange verdanken -- -- 
  -- zufrieden -- Jenny gestehen lernen -- Neigung zwingen -- -- -- fragt Frau Meining freundlich -- 
  -- Jenny überzeugen können -- -- erwidern Walter -- -- ewig danken -- -- 
  -- Lasse -- Freund -- -- wandt Geheimrätin -- 
  -- bleiben verpflichten Mann wissen -- Abspannung befreiten -- Gelegenheit geben -- Freundin Werk üben -- 
  denken Jenny Wohnung aufsuchen rechne Begleitung -- -- 
  -- wahr Glückstag -- -- Jenny Frau Meining -- heiteren Walter's Begleitung Mal Jenny besuchen Schatten Baum sitzen -- 
  -- scheinst letzter Rest Schwäche werfen arm kranke -- wagen -- gehörig Verhältnis fragen -- -- 
  -- erfahren -- -- fragt Walter -- Frau interessieren -- Jenny -- 
  -- eigentlich -- Vater Behörde wissen -- 
  traurig Geschichte -- täglich wiederholen -- 
  Tochter Handwerker Gernsbach gewöhnlich Sommer Baden -- Haus auszuhelfen -- Wohnung vermieten -- 
  arm Jägerbursche kennen lernen Wille Vater heiraten -- wohlhabend -- alt Bürger Gernsbach bestimmen -- 
  unglücklich Fall Jagd -- Folge Gewehr losging -- rauben Mann Herbst Leben -- ehe Kind gebären -- 
  Winter Verdienst bitter Armut versinken -- Mangel erkranken -- schwach elend Gernsbach gehen -- Mitleid Vater anzuflehen -- 
  Kind Verwünschung stoßen hierher zurückkomm Arbeit suchen -- Weg zusammenbrechen -- finden -- 
  -- Vater anderer Kind -- -- sorgen -- 
  hoffen -- Gelde reichen Schwiegersohn Gewerbe vergrößern reich Mann -- Hoffnung betrügen -- vergessen verzeihen -- -- 
  -- sorgen -- -- meinen Frau Meining -- 
  -- verlangen -- -- Pflege Kraft erwerben -- arbeiten -- -- Jenny -- 
  -- erzählen -- Vater -- Kind -- nehmen -- hoffen -- Bürger heiraten -- Kind trennen -- 
  meinen Vater -- müssen nächster benutzen -- Gernsbach fahren versuchen -- Jahrgeld -- Leben Kind knüpfen -- Vater vermögen können -- Tochter Enkel aufnehmen -- unterbringen -- -- 
  Walter stimmt Ansicht verabredet Fahrt -- Herr 40 jung Frau arm Platz nähern -- Gesellschaft Haus sitzen -- 
  Diener tragen -- trotz schön Wetter -- Männerüberrock Teppich -- 
  -- Steinheim -- -- rufen Jenny -- erkennen -- stehen -- Begleiterin begrüßen -- 
  -- Vielmals willkommen -- -- 
  -- erneut Huldigung gestatten -- -- Steinheim -- steif Galanterie Hand küssend -- -- vergönnen -- Frau vorzustell Freundschaft empfehlen -- -- 
  Madame Steinheim hübsch -- siebzehnjährig -- höchst schüchtern Wesen -- Manne Gottheit emporsah Ehre wert fühlen scheinen -- anzugehören -- 
  Steinheim bedeutend Embonpoint gewinnen pflegen Äußere Gesundheit alt übertrieben Vorsicht -- worin jung Frau -- Schwäche kennen scheinen -- ängstlich Sorgfalt Beistand -- 
  Jenny Angekommen Freund -- fragen Steinheim -- -- abgesagt Feind Reisen -- Entschluß bringen -- dennoch Weg Häuslichkeit verlassen -- wahr Reiz müssen -- 
  -- Rätsel -- -- antworten -- -- scheinen -- Liebesfrühling -- urplötzlich Brust erwachen -- neu -- jung Leben beginnen -- 
  unbegreiflich holder sehnen treiben Wald Wiese hingehen -- 
  wünscht Frau zeigen -- schön Welt Gefahr -- Reise Gesundheit -- leicht aussetz -- Hannchen -- heißen Madame Steinheim -- dankenswert Sorgfalt wachen -- 
  Findest -- -- -- unterbrechend -- -- Fußboden feucht -- lieb Hannchen -- -- 
  hannch bejaht Entschuldigung Dame -- lassen Steinheim Teppich Fuß brein ziehen Überrock -- wobei Diener Frau behilflich -- 
  fragt William Clara -- Anwesenheit Baden Eduard gehören -- Abreise fremd -- lang Reise Haus entfernen -- 
  erkundigen -- Kind gehören -- seitwärts Obhut Wärterinne sichtbar -- 
  rufen Richard herbei -- lassen Lucy bringen hübsch -- sauber gehalten Kind arm Frau -- wobei Verhältnis nochmals flüchtig besprechen -- 
  -- sehen -- -- Steinheim -- -- tief Gefühl standesunterschied Mensch begründen -- leer Wahn schilen -- 
  Wahn Herz legen -- befreien -- -- ankommen -- Ehe schließen -- vollkommen Gleichheit Verhältnis Bedingung Glücke -- -- 
  Steinheim absichtlich Äußerung -- Anwesende verletzend -- gut finden -- 
  Frau Frau Meining jüng Mann welcher unangenehm Eindruck Jenny Walter Behauptung empfingen -- bedürfen Erwähnung -- 
  Steinheim fühlen -- Verhältnis einzeln Person kennen fahren -- beschäftigen -- fort -- -- geben -- Verschmelz Stände -- gleichmäßig Verteilung Gut denken -- Eduard's Überspanntheit anstecken -- Reform Weltverbesserung träumen -- 
  Traum kindisch -- göttlich schön -- gestehen -- obgleich freu -- erwachen -- -- 
  -- plötzlich Sinnesänderung bewirken -- Herr Steinheim -- -- fragt Walter -- 
  -- Herr Graf -- heran -- Ruhe schmausen -- -- antworten Gefragte -- Beifall lächelnd -- 
  -- reformieren -- Politisieren dergleichen schicken Jugend -- verlieren gewinnen -- 
  zudem ewig Ärger -- solch Parteienkampf halten -- treiben Galle Blut -- rauben Schlaf zuletzt Gesundheit Leben bringen -- Erkenntnis kommen -- -- Liberalismus überlassen fortan -- Literatur -- Anspruch -- Frau leben -- Arrangement zufrieden -- 
  gestehen -- Herr Graf -- vernünftigst -- -- 
  -- Edelmann alt Haus -- begreiflich finden -- -- unbemittelt Bürger Haupt Familie -- Grundsatz äußersn halten entschieden eifre -- Bestehend laufen -- 
  Unterschied Stände heilig aufrecht erhalten -- Besitz Glauben -- geschehen -- kehren -- 
  golden -- womit Dichter schmeicheln pflegen -- -- 
  Steinheim glauben -- schweig Gesellschaft -- entzücken aufhorchend Gesichtchen Frau bemerken -- Beifall sicher werfen Bravour Sängerin -- Arie glücklich beenden Bravo's harren -- Stuhl -- 
  Umsonst -- 
  rufen Beifall -- Dame sprechen Walter -- 
  -- teil Meinung -- -- Mühe wert halten -- Erörterung einlassen -- 
  schnell Ding -- fragen Steinheim Reise neu Steckenpferd bringen -- 
  sprechen Theater -- besuchen -- Art -- gewiß Schauspieler -- kennen -- Nathan darstellen vollendetst Schöpfung Schauspielkunst erklären -- 
  -- Kunst -- -- bemerken Walter -- -- insofern Natur entgegenstehen -- fehlen Schöpfung -- -- fast -- -- 
  -- fehlen irgendwo Welt -- -- -- -- rezitieren Steinheim -- -- eingestehen -- Lessing's Nathan Meisterwerk Schauspieler Absicht Dichter vollkommen begreifen versinnlichen -- -- 
  -- Fall bestimmen -- -- Graf -- 
  -- scheinen -- Dichtung anbetriffen -- Nathan Weise großartig Allegorie -- didaktisch Gedicht -- darstellbarer Schauspiel -- 
  Bestrebe -- positiv Religionsunterschied unwesentlich darstellen -- sobald innerer -- wahr Religion vorhanden -- Lessing einzeln Repräsentant verschieden Konfession national Glaube bedingt Typus nehmen -- Saladin -- Templer Nathan -- abweichend Charakter -- Art protestantisch Familienähnlichkeit bekommen -- 
  tun Interesse Abbruch -- nehmen -- Gegensatz scharf zeichnen sein -- 
  -- Ruhe -- Templer -- strenggläubig Christ -- Abkömmling Muselmannes -- Bruder Jüdin erblicken -- Unwahres -- Schluß -- befriedigen -- Bühne -- 
  Schauspiel unterhalten Zuschauer -- herrlich Gedicht -- Darsteller langweilig -- -- 
  -- Vergnügen gewähren -- -- Madame Steinheim schüchtern -- fast Wort sprechen -- Kind beschäftigen -- 
  -- lang -- feierlich Rede Nathan's finden ermüdend -- -- 
  -- Brutus -- -- -- rufen Mann -- drohen Finger -- Weise -- schalkhaft halten scheinen -- 
  -- Madame Steinheim -- -- bekräftigen Walter -- 
  -- liegen Schauspieler Fehler Rolle -- 
  schlicht -- klar Mann -- Anschauung Gott -- Welt Mensch begreifen -- anspruchlos Weise -- hoch Weisheit bewußt natürlichste Erkenntnis halten -- selbstbewußt gelehrter -- sentenz Kathedertone vortragen -- wichtig Bedeutung fühlen -- 
  stellen jedesmal Position -- ehe moralisch Behauptung sprechen Schein Demut -- Schlichtheit -- umgiben -- täuscht Augenblick -- 
  Lessing dachen Abraham heilig -- erhaben Einfalt stellen Professor neunzehnten Jahrhundert -- fühlen -- tausendmal geschickt Auditorium -- hüten -- zeigen -- weltklagen -- beleidigen -- 
  erscheinen Feig arrogant -- -- 
  Frau Meining lächelen stimmt Grafe -- Jenny scheinen Ansicht teilen -- 
  -- dergleicher Rede hören -- allerlei Bedenklich -- -- Steinheim -- 
  -- vergessen -- Nathan -- Unterdrückt -- verachten Jude -- Herr Unterdrück sprechen -- 
  bescheiden -- fast furchtsam Weise Auftreten Selbstschätzung entschuldigen -- -- 
  -- Gegenteil -- -- rufen Jenny -- 
  -- fühlen -- frei Mensch Auge Schöpfer -- Qual empfinden -- unterdrücken -- verachten -- stolz Unterdrücker -- 
  Mann Nathan fürchten -- 
  -- Kette Gefängnis -- 
  erheben Selbstgefühl -- -- Tod -- 
  weib Sohn sterben sehen Gott trauen -- Tod fürchten -- 
  Feigheit Schwäche Seele -- Nathan frei empfinden -- fürchten fühlen -- verachtet Jude -- -- -- 
  -- Jenny Steinheim's früh Behauptung notwendig Gleichheit Ehe verstimmen -- Ausdruck -- verachtet Jude -- -- brauchen -- Walter's Anwesenheit unangenehm -- -- fühlen Unmut -- fast Träne erpressten -- 
  ungewohnt Heftigkeit letzter Wort sprechen stehen schnell -- Vater entgegenzugehen -- fallen Hals küssen Hand -- 
  -- weis Mann -- arm verachtet Jude -- -- leise -- Vater Wort vernehmen -- begrüßend Steinheim wenden -- Nachricht Heimat fragt Unterhaltung verwickeln -- 
  Jenny tief nachdenken versunken -- 
  Walter bemerken versuchen vergebens -- Seele lesen -- leicht Windstoß Luft fahren Madame Steinheim unruhig Gatte blicken -- 
  schlagen Kragen Überzieher Höhe rufen -- -- rasen Windsbraut Luft -- 
  Schlägen treffen Nacken -- 
  weißen -- Hannchen -- 
  fühlen Schnupfenfieber Anzug Baden -- baden verlassen -- stehen -- 
  Indes -- fällen .... -- 
  -- Gott Wille -- -- -- Frau ängstlich Dame wenden -- 
  -- wunderprächtig baden hoffen -- Badelebe kennen lernen -- erzählen -- Mann erstaunlich reizbar Nerv meinen -- Luft eng Tal zusagen -- 
  -- sein heraus Ems -- Steinheim Kur brauchen denken -- -- 
  Rede Steinheim aufbrechen -- fest Rock knöpfen -- Frau Arm nehmen empfehlen -- Goethe Wort parodierend -- -- 
  -- -- fremd Augenblick weiln -- kehren freudig entzücken -- Vaterstadt begrüßen -- 
  zählen euer fühlen -- welcher Vorzug gewähren -- -- 
  ungleich Paar Blick entschwinden -- 
  Diener zusammengerollt Teppich folgt Entfernung -- 
  groß Gesellschaft Abend Frau Meining versammeln -- 
  mal -- Baden leben -- Herr Meier Jenny Pflicht -- Partie -- Person wünschen -- fremd -- 
  Gesellschaft ziemlich beleben -- plaudern -- musizieren Geheimrätin fordern Jenny -- singen -- 
  bereitwillig Salon Wohnzimmer -- Hoffnung -- befindlich Note mehrstimmig Sache finden -- glauben -- dergleichen unterhaltend -- 
  Etager -- Note liegen -- stehen Türe -- geöffnet Flügel Jenny verbergen -- sodaß Person -- Türe stehen -- sehen -- obgleich Wort -- sprechen -- Jenny verlieren -- 
  -- singen -- -- fragt alt Dame -- Brust Stiftskreuz ziern -- jung Attache -- 
  Gesandtschaft Bundestage -- 
  -- glaub Fräulein Meier proponieren mehrstimmig Piece -- -- antwortet jung Mann -- 
  -- sagen -- Baron -- Meier scheinen Jude -- Frau Meining namentlich Graf Walter -- 
  -- unablässig Begleiter Familie halten extravagant -- Vermutung -- Rücksicht hören -- -- -- Stiftsdame -- 
  -- wiederholen -- Gnädigst -- 
  Graf Walter fällen -- rotür liberale spielen -- indes Torheit -- zutrauen -- Jüdin heiraten -- sicher fern -- 
  Meier hübsch pikant -- 
  Galanterie Grafe Eitelkeit schmeicheln wissen -- Freiheit sogenannter Badeleben entschuldigen -- -- schließen lachend Baron -- 
  Atemlos gelähmt stehen Jenny -- Kopf Säule Etagere lehnen -- Frau Meining treten -- lang ausbleiben auffallen -- 
  Erschreckt fahren empor -- fassen anscheinend ruhig -- 
  -- find Note singen -- freisprech Wolltest -- -- 
  Frau Meining hören -- freundlichst Bitte nötigen Jenny Flügel Platz nehmen Lied singen -- Gesellschaft Tribut zahlen -- 
  Augenblick scheinen Jenny nachdenken -- Wahl Liedes verlegen -- -- plötzlich Gedanke kommen -- greifen sicher Hand paar Akkorde beginnen Byron's -- 
  -- Mädchen Juda -- singen -- Kücken meisterhaft komponieren -- 
  stark -- metallreich Stimme scheinen Schmerz Brust Zauber gewinnen -- tief Trauer klingen Tön Strophe Wort enden -- -- O Vaterland süß -- o Vaterland -- Jehova Rachegott -- -- wagen atmen stehen festgebannt beherrschen Gewalt Schmerzes -- Tönen Gott rufen Rache erflehen -- 
  Gesang wehmütig Klage -- Jenny' Stimme weich -- nochmals mächtig erklang Wort -- -- Knechtschaft feind Jude verlachen -- -- matt Wunsch erstarb -- -- O Vaterland süß -- o Vaterland -- Tod vereinen -- -- 
  Röte Begeisterung -- Singens Jenny's Wang färben -- Lied gewichen -- 
  Ruhig angreifen stehen Instrument -- 
  laut Zeichen Beifall hören -- Vieler Auge stehen Träne -- sehen befremdet -- 
  scheinen dunkel ahnen -- -- flüchtig Unterhaltung finden hoffen -- Wahrheit entgegengetreen -- erschraken -- Gespenste -- plötzlich hell Reihe lebenden treten -- 
  Walter Frau Meining überraschen -- 
  Graf Jenny niemals singen hören -- -- Seele kennen -- hinsinken beschwören -- Ursache Schmerz vertrauen -- erschüttern -- 
  müssen sprechen -- vermied Annäherung verlassen -- singen -- Gesellschaft -- 
  Walter begleiten Saale hinaus benutzt Augenblick -- Vater Nebenzimmer bekannte angereden -- Bitte -- Jenny mögen kurz Unterredung gestatten -- Glück Hoffnung hängen -- 
  -- Glück -- Herr Graf -- -- antworten Jenny -- -- liegen außerhalb Sphäre täuschen -- Nähe suchen -- 
  Glaube -- dringen -- -- 
  reichen bewegen Hand Abschied arm Vater -- 
  Jenny Gesang Persönlichkeit -- Nebenzimmer geschehen -- saal Gegenstand Unterhaltung -- 
  priesen Schönheit Anmut -- finden auftreten abstoßend stolz -- ernsthaft selbstbewußt Frauenzimmer -- Meinungsverschiedenheit herrschen Gesang -- 
  -- Stimme vortrefflich -- -- bemerken Stiftsdame -- -- zeigen Erziehung -- Gefühl preisgeben -- 
  gestehen -- unangenehm -- jüdisch Volke anzugehören -- indes Schuld -- Fräulein Meier Jüdin schämt -- begreifen -- Gesellschaft Weise lassen -- Nerv stark -- 
  ell m'a Fait Mal -- vous Assure -- -- -- stimmen -- Schwiege -- Frau Meining Kreis nähern -- leicht Unterhaltung Eindruck verwischen -- Jenny's Lied Gesellschaft hervorbringen -- 
  Frau Meining dachen ängstlich Besorgnis -- Entging -- Graf Jenny's Entfernung Haus verlassen -- 
  Abend schwül dunkel -- Walter glänzend erleuchtet Zimmer Geheimrätin nächtlich Dämmerung hinausschriten -- 
  Lauf Tage Antwort Onkel erhalten -- verbergen -- Verbindung Jenny entscheiden Ansicht Wunsch -- 
  -- hindern -- -- schreiben -- -- tadeln -- 
  unwiderruflich entschließen wünsch Herz -- Persönlichkeit künftig Gattin -- lieb Ersatz finden mögest -- unerhört Opfer -- bringen -- 
  sobald Verlobung erklären Braut Gegend kommst -- denken treffen -- Mädchen kennen lernen -- würdig scheinen -- Name Gräfin Walter tragen -- Ehre -- hochgeboren Jungfrau beneiden -- 
  Fräulein Meier wagen -- Höhe stellen -- Mut Energie brauchen -- halten -- 
  zeigen -- 
  -- geschehen -- geschehen sehen -- Angelegenheit gut Wendung -- -- 
  Brief Versprechen Herr Meier befreien -- Jenny Liebe verschweigen -- freudig Bewegung Gelegenheit suchen -- sprechen -- 
  Steinheim's Besuch -- folgend Verstimmung unmöglich -- nähern nötigen -- Frau Meining Unterredung bitten -- verweigern -- 
  persönlich Eitelkeit besitzen Walter -- indes Vorzug bewußt -- Geburt Verhältnis Mann geben -- 
  Jugend wiederholen -- jeder Mädchen Bewerbung ehren überall Frau Weise entgegengekommen -- Bestätigung Behauptung bieten -- 
  lieben Hingebung Seele -- 
  Jenny früher Betragen Hoffnung erwecken -- Gefühl teilen -- bereit -- Vorurteil Welt schützen -- Ansicht -- verweigern -- obgleich Liebe kennen -- 
  Voll quälend Ungewißheit kehrt Wohnung -- Jenny's Zimmer brennen Licht Schatten bewegen Vorhäng -- 
  müssen wach -- 
  -- -- -- Walter -- 
  -- -- teuer -- weder Liebe betteln -- unwert halten -- Frieden stören -- 
  -- sehen -- -- 
  trotz männlich Entschlus seufzen tief blicken nochmals Jenny' Fenster -- 
  Tran verdunkelt Blick -- 
  Gedanke -- Jenny verlieren -- Gefühl gekränkt Stolz -- erpreßen -- 
  Walter zerdrücken schnell -- schämt Haus -- Lager -- Schlummer fliehen -- geliebter kommend Tag denken -- 
  Jenny Ruhe finden -- 
  Empörung Seele -- heimkehren -- Vater Arm werfen -- Erlebt mitteilen beschwör -- folgend Bade verlassen -- 
  Gedanke -- tief Überzeugung Vater schmerzen -- Fluch Vorurteil Kind Ruhe -- alt Verhältnis schützen -- nötigt schweigen scheucht Zimmer -- einsam tief Verzweiflung überlassen -- 
  verhehlen -- lieben Walter -- stürmisch Glut Leidenschaft -- Reinhard fühlen -- ruhig Zuversicht -- Brust geliebter Himmel jugendlich Hoffnung -- sicher Zuflucht Stürme Leben erwarten -- 
  wissen -- teuer -- lieblichsen Farbe Zukunft Seite denken Hoffnung -- wissen -- Zukunft knüpfen -- fühlen Schmerz -- Idee -- Walter trennen -- hervorrufen -- 
  Trennung stehen Notwendigkeit -- 
  Äußerung Steinheim's Unterhaltung -- Zuhörerin Abend -- zeigen -- ohnehin fühlen -- Walter -- Hand Annehme -- Kampf verwicklen -- Jüdin Meinung Menge bestehen -- 
  -- stark -- -- -- -- Kind -- Liebe entsagen -- Frieden -- Kraft besitzen -- Walter Gleiches -- -- Opfer bringen -- 
  nimmermehr -- 
  Leidenskelch -- Schicksal bestimmen -- leeren -- 
  Walter wiedersehen -- sagen -- -- lieb -- Trost erhalten -- Leben verbittern -- 
  verabreden -- nächster Fahrt Gernsbach -- Vater Maries -- heißen Jenny's Schützling -- unterhandeln leicht Wagen fahren -- Ungleichheit Weg Equipage Schwierigkeit bieten -- 
  Abend Herr Meier Frau Meining auffordern -- Platz Coupe annehmen Jenny wissen -- Walter fahren -- 
  Arrangement benutzen -- rechtfertigen -- begreiflich -- scheiden müssen -- 
  Walter Hoffnung Fahrt setzen unangenehm überraschen -- -- Equipage vorfahren -- Richard Jenny beschwören -- nehmen -- 
  Anfangs schlagen Jenny -- Schmeichler schlingen Arm Hals rufen weinend -- 
  -- Jenny -- 
  gestern versprechen Mama versprechen -- Mitnimmst -- sagen -- Wort halten -- 
  bitte -- Tant -- nimm -- artig -- artig -- -- 
  Absicht -- Walter -- verraten -- -- Knabe Bitte abzuschlagen -- vorig gewähren -- 
  denken -- Wagen Vater placieren -- Unruhe lebhaft Kind Partien lästig -- 
  müssen -- -- entschließen -- Richard Walter's Wagen nehmen -- -- ungemein leicht Briczka Walter's mutig Pferd bespannen -- schnell bedeutend Vorsprung gewinnen -- Wagen Vater erblickten -- 
  prächtig schnell Fahrt wunderschön Gegend erheitert Jenny' Seele -- 
  Unterredung -- Nacht hindurch Kraft Mut waffnen -- lassen Anwesenheit Richard's -- Deutsch Englisch Entzück aussprechen -- Name jeder Dorf fragen -- vorüber fahren Wagen aufspringend Schmetterlingsscher Schmetterlinge haschen -- fröhlich gaukelnd Lüfte fliegen -- 
  -- ruhig halten -- fallen Jenny Hals -- fragen -- artig -- versprechen -- betragen Augenblick ausgelassenst Fröhlichkeit Unruhe zurückkehren -- 
  -- fröhlich Kind heiteren Natur harmonieren -- umgiben -- -- Walter -- Vergnügen schönen -- kräftig Knabe betrachten -- 
  -- bestimmt erschaffen -- glücklich -- einst jenseits Rechenschaft fordern -- sicher Stunde -- Schuld Glück verlieren -- sünd auslegen -- -- 
  -- -- -- erwidern Jenny -- Schuld nennen -- -- -- 
  -- Jenny -- Fluß -- -- fragt Knabe -- unterbrechend -- frei Stelle erreichen Murg sichtbar -- hoch Felsenufer Weg Gernsbach hinführen -- 
  näh Städtchen -- steil Abhang Wege -- 
  Gegend ernst Anstrich -- Höh Schwarzwald -- tief Land hinein Vorbach -- bekannt Holzschwellung statthaben -- fast schauerlich Charakter gewinnen -- 
  fahren linker Ufer Murg Jenny leicht Schwindel erwehren -- Höhe -- Straße bahnen -- hinab dunkel Wasser Bergstromes -- hart Fuß steil Felswand hinfließen -- 
  ununterbrochen Steige Falle Wege bringen Abwechslung Schnelle Fahren hervor -- Pferd langsam Höhe hinaufstiegen -- Eile hinunterliefen -- woran Richard unsäglich Freude finden scheinen -- 
  hoch Punkt Straße erreichen -- Tiefe senken -- Anlegung Hemmschuhen -- leichtest Fuhrwerk stärksn Pferd nötig -- 
  Kutscher steigen -- Vorkehrung treffen Richard erbat Erlaubnis -- Jenny Walter Sitz steigen -- zuzusehen -- Kette losmachen -- Räd Gleise heben Pferd zurückkehrend -- Diener Zügel abnehmen vorwärts fahren -- 
  -- Laß stehen bleiben -- Jenny -- -- Knabe -- -- zusehen -- Faul Räd -- 
  -- -- rufen -- Schmetterlingsscher Hand hinüberbogn -- antreiben -- 
  -- laufen lehren -- -- 
  Augenblick hören leis Klirren Richard rufen fröhlich -- 
  -- Hei -- Dinger fortfliegen -- -- 
  Kette Hemmschuh gerissen -- Rad -- plötzlich Bewegung Wagens gleis gesprung fürchterlich Schnelle fliegen Briczka Tiefe -- Anstrengung Kutscher Vehemenz vermochn -- Wagen Pferd eindrang -- verdoppelt Eile antreiben -- 
  Sturz Pferd -- Fehltritt -- Wagen -- Richtung kommen -- liegen zerschmettern Fuße Felsen Welle Murg -- 
  -- jubelnden Knabe -- verbergen -- drohend Gefahr -- 
  -- Kind -- Kind -- -- schreien Jenny -- Unheil bemerken -- ziehen Walter's Beistand Knabe herunter -- Todesangst preßen -- 
  Walter unverwandt Pferd -- 
  Arm schützend Jenny legen -- 
  -- laut -- Schrei -- beschwören -- -- 
  Kutscher wenden -- 
  -- Mut -- Mut -- halt Zügel -- sieh Seite -- halt Pferd Augenblick fest retten -- 
  ruhig scheinen Zwang -- Stimme bebt Leichenblässe bedeckt Gesicht -- Wagen Tiefe stillstand erschöpft Kutscher keuchend Pferd Erholung gönnen -- 
  Walter's Gedanke -- Blick gelten Jenny -- 
  leblos -- Stirnwunde blutend -- zurückgesunk Arm Knabe losgelassen -- weinend umfassen halten -- 
  -- Jenny Kind drücken -- eisern Griff Schmetterlingsschere Jenny's Stirn heftig Schlage treffen -- Haut zerreißen -- Jenny entsetzlich Aufregung Moment Verwundung herabtröpfelnd Blut bemerken -- 
  Gedankens -- Kind retten -- anvertrauen -- bewußt -- Stillsteh Pferd furchtbar Angst gewichen -- -- Seelenleid durchwacht Nacht ohnehin angreifen -- ohnmächtig zusammenbrechen -- 
  augenblicklich Hilfe denken -- Haus Nähe -- zurückgeblieben Wagen entfernen -- lassen berechnen -- 
  zitternd Hand legen Walter Tuch Jenny's Stirn -- Bewußtlose Arm befehlen Kutscher -- schnell vorwärts fahren -- Gernsbach erreichen -- nötig Jenny herbeischaffen -- 
  wünschen -- Geliebte Arm schließen -- Brust halten -- 
  sehnen erfüllen hoffen -- 
  unaussprechlich Liebe hing Auge Jenny' bleich Züge -- versuchen Reiben Hand erwärmen schildern Entzück -- leise Schimmer Röte -- schwach Atemzug Wiederkehr Leben anzeign -- Jenny langsam dunkel Auge aufschlagen -- Richard selig lächeln anblicken -- ängstlich schweigend sitzen -- still weinend Walter's Brust sinken -- 
  mächtig drückt Herz erwärmt glühend Küsse kalt Lippe -- 
  -- Weinst -- 
  küssen Graf Walter -- Jenny -- -- fragt Knabe -- ungeduldig peinlich schweigen brechend -- 
  -- Jenny Braut -- freuen -- Tod entgehen -- -- antworten Walter -- strahlend Liebe Wonne -- -- glücklich -- selig Leben liegen -- 
  Komme -- Richard -- kommen -- 
  Mußt Freude teilen -- -- geliebt Kind -- Hand Todes schweben -- kommen -- küssen Jenny -- schön -- süß Braut -- -- 
  Jenny -- 
  Knabe Frage Walter's Brust emporgerichten -- beschämt Geständnis -- Schwäche -- Ruhe suchend -- -- anerkannt Beschützer lehnen -- 
  steigen Gedanke Trennung Grafe düster Schatten Geist -- wenden geliebter barg tief Seufzer Gesicht Hand -- 
  Walter's Stimme -- Freude Liebe -- Wort klingen -- innerst Herz erbeben -- zärtlich -- 
  -- wendest fort -- Jenny -- -- vermögen widersteh -- reicht Hand -- 
  -- -- meiden -- Glück teuer -- -- 
  Gott -- leben -- 
  leben -- Walter -- -- 
  Jenny Hand -- Richard Knien haltend -- langen Walter Gasthause Gernsbach -- kennen -- mehrmals Streifereie eingesprochen -- 
  Diener helfen Jenny Wagen -- wohl fühlt Grafe -- Arzt verlangen -- versichern -- weder Arzt -- Beistand bedürfen -- 
  -- Kopf schwer -- -- -- Binde Stirn -- -- -- tief schlafen -- wissen -- erwachen -- schön Traum umfängen -- -- 
  -- Frau Gräfin Doktor lassen -- -- geschäftig Wirtin rufen flüchtig Röte freundlich lächeln Jenny's Wang hervor -- Walter unendlich glücklich -- 
  Arm Arm harrt Ankunft Vater -- Überraschung Stellung -- -- Vorgang erfahren -- Walter Versprechen erinnern Erfüllung verlangen -- tief bewegen Kind segnen -- Gefahr erhalten glücklich Zukunft entgegenging -- 
  Herr Meier Frau Meining genoss Reiz -- Gernsbach zauberisch schön ebersteinsch Schloß schmücken -- 
  Walter Jenny sehen -- köstlich Aussicht erfreuen -- Fenster Schlosses Tal genießen -- sitzen Brautpaar Fuße Berge Schatten Laube Jenny erzählen geliebter -- gestern beschwören -- verlassen -- schwer Entschluß -- leiben -- herzlich lieb -- 
  Besorgnisse sprechen frei -- Gespräch Stiftsdame teilen -- tief verletzen -- fragen -- 
  -- Walter -- Schmerz -- Ähnliches hören müßtesen -- -- 
  -- niemals -- -- Walter entscheiden -- 
  Glaube -- Glück empfinden -- Höhe Leben gebären -- -- Höhe -- Vorurteil -- Sinn Menge verwirren -- stets klein töricht erscheinen -- Standpunkt handeln sichtbar Richtschnur -- 
  stolz -- -- Geliebte -- Grafenkron schmücken -- zeigen -- Besitz gelten Welt Tadel verletzen -- wissen -- herrlich Weib unser alt Name tragen -- -- -- 
  -- Onkel -- 
  angehörige -- 
  willkommen heißen -- denken -- -- wenden Jenny -- 
  -- Onkel edl Mann Leben ringen -- finden unser Platz bereiten -- 
  würdigen -- -- Stellung -- Verdienst Voreltern erwerben -- ehren Desjenigen -- Welt erschaffen -- 
  Vergiß -- frei -- stolz England -- Sklave befreien -- 
  frei edl Mensch empfinden -- Herz -- lebhaft empört Fessel -- anlegen -- Unterdrückung Unrecht -- 
  Onkel billigen Wahl -- gestehen -- alt Sitt unser Haus -- unwiderruflich Glück begründen -- lieben -- sehen -- treust Beistand finden -- kennen -- -- 
  Gespräch fröhlich Entwürf Zukunft fliegen Stunde vorüber -- Herr Meier müssen Jenny erinnern -- Absicht eigentlich hierher führen -- 
  Glückliche unterhandeln -- empfand Vater krank Marie -- 
  verlangen -- schnell gewähren -- 
  überein -- Summe Erweiterung Gewerbe anvertrauen -- Marie Kind Kapital festsetzen -- hinreichend -- unabhängig Vater unterhalten -- Verhältnis anstand -- Tochter Enkel Haus öffnen -- einziehen -- 
  spät fahren Glücklich Bade -- Freude harrt Brief -- Heimat ankommen -- 
  Herr Meier voraussehen -- Eduard Verbindung Jenny's Walter freuen -- Wahrscheinlichkeit Vater benachrichtigen -- 
  unwiderleglich Triumph Vernunft Vorurteil -- Bekämpfung Lebenszweck -- Heirat Jenny's Glück begründen -- gewinnen Bundesgenosse -- Rücksicht Interesse Ehre -- künftig Jude vertreten müssen -- angefochten -- 
  Eduard melden -- Ferdinand herstellen Kreis Familie zurückkehren -- Brief William Clara wiederholen -- wärmst Ausdrücken Danke sprechen -- Eduard verpflichten sein -- 
  nannt Gründer Glückes -- Glückes -- Anwesenheit Kind fehlen -- vollkommen -- Clara bitten Jenny Herr Meier -- Abreise baden beschleunigen -- falls Opfer kosten -- sowohl William lebhaft Kind sehnten -- 
  ohnehin -- Frau Meining gewöhnlich Baden zuzubringen pflegen -- nahen -- entscheiden -- Clara's Bitte nachkommen Bade verlassen -- beabsichtigen -- 
  kehren Gernsbach -- Marie Haus Vater besuchen -- Stelle wiederzusehen -- brautpaar Todesangst hoch Glück erwachsen -- 
  diesmal Frau Meining vergönnen -- Jenny Walter bewundernd Gegend betrachten sehen -- alljährlich wiederholt Aufenthalt wert -- -- Graf versprechen -- nächster Frau Baden besuchen -- schied Gegend -- Jenny' Schicksal freundlich Wendung nehmen -- 
  Meiersch Familie -- wechselnd Erlebnis begleiten -- scheinen günstig Gestirn ruhig Klarheit leuchten -- 
  Vereinen Frau Meining Walter Baden verlassen -- Erstere fast Heimat begleiten Kind wohlbehalten Clara's Arm führen -- Jenny selig Walter's Seite väterlich Haus betreten -- 
  innig Eintracht verbinden Familie Hornschen -- 
  Eduard scheinen Glücke Jenny -- Freundschaft William's Clara's fröhlich Sinn frühest Jugend wiederzufind Seele Vertrauen -- Walter brüderlich entgegenkommen -- 
  Mann Eduard Graf müssen verständigen -- Gesinnung -- verschieden Punkt ausgehend -- Ziel Enthusiasmus begegnen -- Idee Freiheit Fortschritt umfingen -- 
  Ankunft Walter's Onkel -- Jenny bisweilen Scheu denken -- tragen -- Glück erhöhen -- 
  gewiß vornehm Zurückhaltung -- alt Graf Begegnung Jenny Familie beobachten -- Jenny' Liebenswürdigkeit ruhig angehörige gewichen -- 
  weniger -- Jenny vollst Liebe alt Grafe gewinnen -- -- Abends Walter befinden -- 
  -- ändern -- bekennen -- Hättest schlecht wählen -- Mädchen -- -- Geburt abrechnen -- wahr Perle Frau -- 
  Folge -- Heirate -- 
  klingen angenehm -- dein Name immerfort wacker Bankier Meier vereinigen hören -- 
  Jenny Frau -- hören Gräfin Walter leicht soutenieren Einwendung Mademoiselle Meier -- 
  sage lieben Kind -- Beschleunigung Eurer Ehe wünschen -- 
  denken Vater schnell überzeugen -- gute -- Mann Frau Gut verweileen -- Residenz zurückkehren -- erwarten -- Jenny' Auftret erleichtern -- -- 
  obgleich Wichtigkeit -- alt Graf Ausführung Planes legen -- Walter übertrieben scheinen -- stimmt wünschen -- bereitwillig eingehen erlangt Herr Meier Versprechen -- Jenny's Hochzeit Walter Novembers feiern -- 
  Onkel -- alt Grafe Walter nennen -- Onkel Walter fast überall Begleiter Beschützer glücklich Jenny -- Gesellschaft lebhaftest Vergnügen gewähren -- 
  bisweilen fallen -- gewohnt Kreis -- Mitte jüdisch Familie leben behaglich fühlen -- beruhigt Gedanke -- vernünftig -- bonnen Mine -- Mauvais jeu Pflicht gebiet -- Schritt -- Neff tun -- gleichsam Anerkennung rechtfertigen heiligen -- künftig Gräfin Walter beweisen -- 
  erklären -- Hochzeit neff Stadt bleiben -- unbeschäftigen -- -- betreiben angelegentlichst Besorgung Equipag -- Silbergerät -- vollständig Einrichtung künftig Haushalt gehören -- besucht -- Jagdzeit beginnen -- Edelleute Bekanntschaft -- Nähe Besitzung -- 
  letzter Oktober kommen -- Onkel -- Meiersch Haus Mittag aßen -- Neffe aufforderen -- Mühe -- Besorgung Einrichtung verursachen -- seinerseits gefällig Freund begleiten -- nächster Jagdpartie veranstalten -- Grafe einladen -- 
  Walter antworten anfangs ausweichend -- alt Herr Entschuldigung annehmen Jenny -- 
  -- bitte -- Töchterch -- leg Wort alt Onkel -- Bräutigam einst Flinte Hand Künste Schüler erfreuen -- -- 
  Walter -- 
  müssen Einladung Greise annehmen -- bittend Ton sonderbar befehlend Haltung abstach -- stehen Tafel -- Graf Dämmerung Land fahren wünschen -- Nacht Freund einzutreffen -- 
  lebhaft Diskussion Maßregel Regierung vertiefen -- sitzen Mittagsesse alt Herr Kaffee trinkend Flamm Kamin -- Walter Braut Brüstung Fenster stehen Eduard Joseph neu Zeitung durchflogen -- 
  -- Fahre ungern hinaus -- -- Walter -- Jagd lieben -- Gesellschaft -- paar trennen -- -- 
  -- -- -- fragen Jenny -- -- Onkel bät -- Vater lassen -- Woche bleiben -- -- 
  -- -- laß -- Liebchen -- -- antwortet Graf -- -- Trennung -- unangenehm -- Opfer betrachten -- Götter bringen -- beneiden -- 
  glücklich Zukunft -- -- 
  -- Sage -- Walter -- -- 
  bitten Jenny -- klingen sicher nächster Tag gewiß -- -- 
  -- Abergläubisch Kind -- -- schalt Graf -- ziehen -- 
  -- Schicksal -- Jugend begünstigt -- Huld entziehen -- teilen denken -- 
  bange -- Jenny -- vertrau alt -- wohlbekannt Glück -- -- 
  indessen Eduard Zeitung aufgeseh blickt innigst Wohlwollen Brautpaar -- 
  -- Schade -- Mutter sehen -- -- leise Joseph -- -- sehen -- welcher Zukunft Jenny's harren -- froh Vater Jenny's Glück fühlen -- 
  nehmen Hoffnung -- fest jemals hegen -- schön Wahrheit -- -- 
  -- Weißt -- geschehen -- entgegnet Joseph gewohnt Art -- 
  -- tote wohlsn -- Laß Ruhn -- -- 
  Unangenehm Wort heiteren Stimmung berühren -- stehen Eduard treten alt Grafe -- Fortgehen anschickt Walter auffordern -- -- 
  Herzlich Abschied Braut -- tagelang Trennung Verlobung -- Jenny begleiten Vorzimmer hinaus -- 
  -- -- Walter -- -- Jenny -- lang bleibst -- -- 
  hören -- Onkel -- 
  Stunde lang borge Walter bringen -- -- 
  -- rufen Scheidenden -- 
  -- Wort -- -- antwortet alt Graf -- Walter davonging -- 
  Hell Walter bitten Onkel -- -- Laden Juwelier treten -- Brautschmuck Jenny bestellen -- Abänderung bedürfen -- 
  finden Baron Werner -- Walter Regimente dienen jahrelang Aufenthalt verschieden Höfe Europa Deutschland zurückkehren -- 
  Verwundert -- Grafen Walter sehen -- weder angehörig Besitzung -- fragen Werner -- alt Graf Juwelier Nebenzimmer -- Jenny's künftig Silbergerät aufstellen -- 
  -- welch Zufall führen Stadt -- Graf -- -- 
  -- Braut Baden-Baden hierher folgen -- bleiben Hochzeit -- -- 
  -- Bräutigam -- -- fragen Werner -- -- Feldheim -- erstn vermutlich -- -- 
  -- -- keiner -- 
  Braut Fräulein Jenny Meier -- Tochter Bankier Meier -- -- 
  -- Ah -- fidonc -- 
  Scherze -- -- Judenmädche -- -- rufen Baron lachend -- 
  -- fallen sonderbar -- fragt Walter verletzen ernsthaft -- 
  -- kann_es glauben -- 
  Verhältnis arrangieren -- -- antworten Werner lachend -- -- nötig -- Mädchen heiraen Pour Fumer vos terres -- -- 
  -- Äußerung Mann Ehre -- erklären -- Fräulein Meier Braut -- -- Walter -- heftig auffahrend -- 
  Werner Tone antworten -- alt Graf Juwelier Zimmer -- Veranlassung Streite kennen -- treten -- 
  -- Szene -- Herr -- -- 
  -- gebietend -- leise -- 
  -- wissen -- finden -- brauchen -- -- 
  -- Goldarbeiter ruhig Befehl -- schreiten grüßend arm Neffe hinaus -- 
  -- -- Walter -- -- fragen -- berichten aufgeregt -- geschehen -- 
  alt Herr schüttelt Haupt -- -- -- fürchten -- 
  Dergleiche ausbleiben -- -- -- -- 
  Walter wendend -- -- -- -- 
  -- fragen -- -- antworten -- 
  -- unverschämt Genugtuung geben Beleidigung -- 
  eil -- Freund aufsuchen -- 
  hinausbegleiten -- Onkel -- -- 
  -- Ruhig -- ruhig -- Walter -- -- alt Graf -- 
  -- hinausfahren -- 
  Angelegenheit Werner fatal -- 
  Indes ernst rasch beseitigen -- Stimme -- 
  gute -- Weisest Vermittlung -- zeigst -- Beziehung Scherze liebst -- sehen -- Achtung Braut hegen -- dein Sekundant -- 
  Handwerk fremd -- indes finden Zurecht sehen -- Unterricht schießen Frucht tragen -- -- 
  Walter drücken väterlich Freund Hand -- Unruhe scherzend verbergen dankbar Erbiet -- 
  Werner's Herausforderung lassen warten Walter bitten Onkel -- einrichten -- nächster treffen können -- 
  wollen Angelegenheit ordnen Abend Jenny zubringen -- 
  Onkel raten -- 
  stellen -- Jenny erwarten -- 
  -- -- -- -- -- unnötig Rührung -- beunruhigt aufregen -- 
  jung Herr jetzigen nehmen Ding schwer -- 
  Jugend -- 
  hindern -- Angelegenheit -- nennst -- ordnen -- 
  Jenny gehen -- 
  siehsen -- -- Aderlaß zugedenken -- Kommst -- gehst ruhig Sache -- Braut unbesorgt weißen -- -- 
  Einwendung überzeugen Walter fügen willig -- 
  Jenny schliefen ruhig anmutig Träum wiegen -- Gewohnheit aufzuwecken -- 
  Verwundert fragen -- verlangen -- 
  Eintritt Vater Eduard's unerwartet Ereignis ahnen lassen -- 
  -- Jenny -- -- Vater -- -- kleide schnell -- sollst zeigen -- Seelenstärk -- zutrauen -- 
  Walter erkranken verlangen -- -- 
  -- tot -- -- -- rufen Jenny überwältigen jäh Schreck -- 
  -- -- leben -- -- antwortet Eduard -- -- schwer verwunden Jagd -- Wunsch hierher bringen -- -- 
  Augenblick knien Jenny Lager geliebter -- 
  kennen -- beweisen Blick voll Liebe Trauer -- begrüßen -- matt Bewegung -- Hand Haupt legen -- Niedersank -- 
  Jammer Gesicht anwesend -- Ruhe Untätigkeit -- Zimmer herrschten -- sagen deutlich -- Hoffnung -- Sterbebette stehen -- 
  Walter's müd Haupt ruht Brust -- unverwandt hing Blick Zügen geliebter -- Tran Auge -- Klage entschlüpft Lippe -- 
  stumm Schmerz beunruhigt anwesenden -- Wort -- -- Jenny -- müssen Wort lösen -- -- 
  -- versuchen alt Graf -- tief beugen -- Unglückliche furchtbar Ruhe reißen -- 
  umsonst -- 
  Onkel Bräutigam bemitleidend -- reichen Hand versenkt Seele regungslos Anschauen geliebter -- 
  Stunde gräßlich Stille entschwinden -- Eduard's Bestrebung -- verwundeter Erleichterung schaffen -- unterbrachen herrschend Ruhe -- 
  hören plötzlich laut Atemzug -- Walter's Kopf sinken vorwärts -- enden -- 
  Schrei furchtbarst Schmerz fahren Jenny Herzen fallen Leiche Bräutigam nieder -- 
  folgend verkündet Zeitung -- 
  -- gestern finden Schuß-Duell Grafe -- -- Baron -- -- -- Folge Grafe tödlich -- 
  stehen Punkt -- vermähl Schmerz Verlust unglücklich Braut Leben kosten -- 
  Familienverhältnisse Veranlassung Streite geben -- -- 
  unten lesen -- 
  -- plötzlich erfolgt Tod einzig Tochter Jenny melden tief betrübt Verbittung Beileid Freund bekannte -- R. Meier -- -- 
  Fackelschein Graf Walter Leiche neff Stadt führen lassen -- Gruft Ahn Stammschlos begleiten -- 
  stehen Mann frisch aufgeworfen Grabe -- 
  Herr Meier -- Eduard Joseph -- 
  Freund Gunst verlangen -- Bestattung teuer Liebling überlasse -- gewagt -- Trauer stören -- 
  Hell Sonne heiter Himmel -- freundlich Herbstmorge beleuchten Jenny's Grab -- 
  Einsam stehen fremd christlich Kirchhof -- Jenny fern Mutter -- fern Blutsverwandt ruhen -- 
  starr schweigend unglücklich Vater Erde nieder -- Kind bedecken -- Joseph's Brust Ausruf -- 
  -- wozu leben -- -- herzzerreißend Himmel tönt Träne Auge Vater locken -- 
  richten Eduard mächtig empor -- 
  leben -- -- -- Begeisterung Seher -- -- erblicken -- Opfer Altare Vorurteil bluten -- 
  leben -- frei Zukunft -- Emanzipation unser Volk sehen -- -- 
  Druck F. A. Brockhaus Leipzig -- 
  Druckfehler -- 
  Seite 7 Zeile 20 lies -- 232 -- 4 -- Vergangenheit l. Zukunft -- 264 -- 15 -- loben L. lebt_es -- -- -- 17 Minute fehlen -- 269 -- 13 Savon l. Saron -- 369 -- 4 -- Band l. Land -- 
  Druckfehler -- 
  Seite 16 Zeile 19 L. 
  -- 201 -- 16 -- L. -- 
  F. Angeles Brockhaus Leipzig erscheinen Buchhandlung -- Stadt -- 
  Erzählen Frau W. Gr -- 12. Geh -- 1 Tlr -- 24 Ngr -- sämtlich Schrift Johanna Schopenhauer -- 
  vierundzwanzig Band -- 
  Bildnis Verfasserin -- 
  16 1834 -- 8 Thlr -- 