Marie Anton Renard mehrere musikalisch Instrument selten Fertigkeit bringen -- verschieden Gegende Deutschland Ruhm erwerben -- 
  ansprüch Welt treten -- Talent scheinen berechtigen -- feindselig Geschick lasten -- weisen Anspruch -- zerknicken schön Hoffnung -- 
  Jugend schwehen Mut -- Kampf Schicksal Sieger stehen -- einzig Ziel Ruhe -- Trümmer Vermögen -- flüchten Dunkelheit Dörfchens -- Maierhof Unterhalt Beschäftigung -- 
  dünkt Lage -- kennen Sorge -- Beschäftigung Tags -- Wechsel -- Jahreszeit -- Natur empfinden -- Freude -- -- Frucht Arbeit enden -- 
  Instrument öd Winkel Haus verweisen -- zuweilen -- mitleidig lächeln -- Monument ehemalig Traum Erwartung betrachten -- 
  Brief -- -- weniger bekannte erhalten -- unbeantwortet gelassen -- weniger Lieblingsbücher Lektüre Leben verbannen -- 
  -- helfen Lesen -- -- Nachbar Freund -- Prediger Dorf -- einzig hoch Ständen -- umgehen pflegen -- -- einzig gemacht Erfahrung wiegen Band gedruckt -- beschrieben Empfindung gemalt Feuer -- 
  sonderbar Eigenheit unser Zeitalter -- Empfindung Verstand übergeben -- -- aufschreiben -- gleichsam unser Wesen trennen -- Papier fremdartig Erzeugnis genießen -- 
  gewiß -- Wärme -- wirklich tätig Leben beseeln -- beseel -- leiden -- unser Herz Nahrung entziehen -- fremd Form unser Verstand Eitelkeit beköstigen -- -- 
  -- übrig Welt scheiden -- leben bloß Gegenwart -- Sorge einzig Kind entlockt zuweilen ängstlich flüchtig Gedanke Welt Zukunft -- 
  Marie -- Tochter -- entfalten lieblich Schatten Einsamkeit -- 
  einzig Bestreben Vater -- Körper Geistes-Kräft Gleichgewicht erhalten -- Fall Leben kühlen schnell Besonnenheit verschaffen -- Gemüt tätig -- einfach Leben stimmen -- Blendwerk Phantasie Gefühl ewig entfernen -- 
  verbergen -- alt -- Instrument -- -- verlassen Liebhaber Bild geliebter -- aufbewahren -- Zustande erhalten -- groß Sorgfalt -- -- schlummernd Trieb Herzen wecken -- 
  -- Talent -- -- -- -- geben Anspruch Welt -- fast unglücklich -- -- 
  indessen bemerken -- allzu lebhafte -- Gefühl misstrauisch fremd Empfindung -- Erfahrung anderer achtet -- seinigen allzu teuer erkaufen -- Anton bemerken -- Marie denken lehren -- beweisen -- denken schädlich -- fühlen lernen -- gefühlvoll Gefahr fühlbaren Herzen warnen -- 
  günstig Umstand übernehmen -- schwerlich ausführen -- 
  Gesund Luft -- frei Bewegung -- schön Natur -- inner äußer Friede -- bilden Marie -- erzog heiter harmonisch Geschöpf -- 
  Leben klar Bach -- säuselnd -- blühend Zweig -- sanft Ahnung Jugend herüber bogen -- darinn Spiegelt -- 
  Baum -- Blume -- Vogel Lüfte Gespiel Freude -- vertrat Stelle Lektüre -- Unterricht -- gesellig Umgang -- 
  Phantasie -- Einsamkeit Natur wecken -- umflattert leise Schwing Wirklichkeit -- jugendlich froh -- -- streben -- verschönern -- -- Bestreben Gleichgültigst -- heiter idyllisch ansehen gewinnen -- 
  kommen Stunde -- glücklich -- 
  Marie Natur Zartheit Gefühl empfangen -- hoch Bildung empor heben -- günstig Hauch Umstand Blüte entfalten -- einzig Schmerz -- -- Grund kennen -- gewiß Moment empfinden -- 
  einsamen Spaziergang Ferne hinsehen -- blau Gewölk Welt verschließen -- -- rufen geheim Zug -- 
  Spiel Leben Herzens rauscht fern Musik Seele vorüber -- dunkel Ahnung Entwicklung Äußerung Gefühl -- ungeübt unzerteilt verschließen -- ergriff innerst Wesen -- 
  Marie siebzehn alt -- Einwohner Dorf bekennen einmütig -- Krone schön Mädchen Ort -- Welt -- 
  lauen Abend Vater wogend Kornfelder -- vollbracht Arbeit Lohn Fleiß froh Ansicht reifend Segen nossen -- heit nächtlich Ruhe entgegen träumt -- ängstlich Rufen Aufmerksamkeit erregen -- paar scheu geworden Pferd -- Vorderteil Wagens quer Feld laufen sehen -- 
  eilt Stelle -- woher sehen -- finden Trümmer Wagen jung Mann Frauenzimmer ängstlich beschäftigen -- 
  mitleidig treten nah boten teilnehmend Hilfe -- Freude annehmen -- 
  Dame Umwerfen Arm stark beschädigen -- leicht Wunde Kopf -- scheinen leiden -- 
  bringen sanft -- Anton Haus -- heilsamen Umschlag -- anordnen -- Maries sorgsam Pflege Schmerz linderten -- 
  Antonie Lauben -- nennen Fremde -- reist Stadt ziemlich fern gelegen Landgute -- bekannt Familie bewohnen -- 
  reisen -- Wagen geschwind herstellen -- Bedienter stark beschädigen -- nötigen -- freundlich Wirt verweilen -- 
  Antonie zeigen ansehen -- Kleidung Betrag Reiz hoch Stände -- schön hoch Gestalt -- lieblich Kolorit leicht gebildet Wesen machen hoch Grade liebenswürdig -- 
  -- Erscheinung versetzt Marie -- Antonien sehen -- Gestalt -- Ton -- Betrag erweckten Bild -- gebildet Wesen -- Weg finden -- zweifeln -- vollkommen -- denken lassen -- 
  Antonie begegnen bezaubernd Huld -- Maries Unerfahrenheit -- Offenheit -- Wunsch verbreitet freundlich Licht Vorzug -- angenehm Gefühl Überlegenheit tragen -- herzlich Marie einnehmen -- 
  Marie hing Blick -- Kenntnis -- Antonie Gespräch zeigen -- Gemälde Welt -- womit unterhieln -- Sicherheit -- sprechen -- Verworren denken wagen -- scheinen unerreichbar -- -- 
  Eindruck -- Rührung bewegen indes Herz alt Renard -- 
  läng Beisammensein Verhältnis jung Mann nah enthüllen -- stellen jung Virtuose dar -- alt Bekannt Fräulein -- teils Bedeckung mitgereisen -- teils Kunst adlig Familie -- wohin reisen -- unterhalten -- 
  Branden -- nennen -- bedeutend -- scharfgezeichnet Gesicht -- interessant -- liebenswürdig -- Herz Phantasie -- zeigen Künstlerwärm -- Künstlerstolz düsterem Blick -- Begeisterung drückend Kälte Gespräch -- verwanden Sait Brust -- allzu flach liegen -- berühren -- 
  Mensch Art wirken Eindruck Menschenkenner -- jung beweglich Herz -- schön Schein -- -- Spiel würdig Beschäftigung weihen -- 
  Marie Aufmerksamkeit geringsen erregen -- seinig gespannt -- 
  Jugend -- Anmut -- gänzlich Unbefangenheit erquicken -- Anblick schön -- rein gestimmt Instrument -- worauf Künstler süßest Harmonie Seele verschönert vernehmen hoffen -- 
  Anton fühlen Herz -- lang fremd Eindruck verschließen bleiben -- wunderbar Weise -- eröffnen erwärmen -- 
  Bild Jugend fröhlich Hoffnung Ansicht -- treten Rosengewölk Seele -- ziehen süß Gewalt Brust jung Künstler -- 
  Berührungspunkt finden -- verwanden Idee begegnen -- Strom Sympathie wallen frei geöffnet Herz -- 
  Anton -- -- Mangel Gelegenheit -- mißtrauen hartnäckig behaupten -- glauben bestimmt -- düstern Blick -- ernst -- gesetzt Wesen jung Geist hinlänglich Rechtfertigung Offenheit finden -- gehabten Unfall beklagen -- Verlust schön Viol de Amour -- Umwerfen Wagen zerbroch -- Freude Herzen enthalten -- Bedenklichkeit -- geheimnisvoll Kist -- versteckt Schatze ähnlich Instrument hervor holen -- 
  Brandem entzücken -- spielen schön -- -- beinahe Beifall erringen -- seltenste lieb -- begegnen -- 
  endigen -- fragt Antoni -- Duett singen -- 
  willigen -- sang schön biegsam Stimme rein -- gefällig Ausdrucke mehrere Duett Mozart vortrefflich Meister -- -- 
  Marie Welt versetzen -- 
  harmonievoll Ton durchschaudert Seele wunderbaren -- gefühlt Ankläng -- Strahl Kunst wecken süß Gewalt schlummernd Bildungstrieb -- 
  unruhig -- glücklich -- -- Antonien Gestalt bewundert Liebreiz allmächtig Taumel -- Gefühl Ahnung -- 
  indessen Antonien Hindernis Reise fortsetzen -- heben -- Marie müssen Bekanntschaft -- Strom Träne verlassen sehen -- 
  Antonie glauben -- erwiesen Gefälligkeit belohnen -- Anmut -- alt Renard ersuchen -- -- Stadt zurückkehren -- Tochter überlassen -- 
  Anton versprechen -- unnötig Erklärung haßten -- fallen -- halten -- 
  jung Künstler bedeutend zärtlich Lebewohl -- begnügen Marie paar ausdrucksvoll Blick -- Sinn verstehen -- Gefühl gestehen -- 
  -- Marie fühlt Trennung sonderbarst Zustand versetzen -- 
  beschäftigen -- leer -- 
  Gesang Melodie -- schwermütig Ton -- Stimmung Herzens angeben -- atmet Natur -- 
  Bild Welt Phantasie gehört Musik wunderbar verschmolzen verknüpfen -- 
  einsamen Spaziergang buchenwäldchen Saatfeld schweben bildend Sinn zahmem Flug einförmig Szene Gegenwart -- käfig entflohen Vogel unaufhaltbar Ferne fliegen -- suchen unermüdet Emsigkeit Nahrung -- Instinkt anzuweisen scheinen -- 
  gewohnt Beschäftigung befriedigten -- Unmut hingeben -- künftig Leben trübe Kolorit hauchen -- Hoffnung -- Jugend hold Begleiterin -- annehmen -- Nebel künftig fröhlich Gestalt hingezeichnen -- 
  lieb Aussicht freilich -- Vater Antonien verlangen nachgeben erwünscht Reise bewilligen -- näh -- günstig Augenblick benutzen gedachten -- 
  Anton -- jung Freund Instrument holen -- freudig Verwirrung Herzen denken -- verborgen Schatz Auge Tochter sorgfältig -- verbergen -- 
  Marie sehen -- genau merken -- Vater nachher befriedigend Auskunft geben -- beschließen -- eigenmächtig Besitz Geheimnisse setzen -- 
  -- Anton Geschäft Haus entfernt halten -- benutzen -- 
  glücken -- Marie flüchten gefunden Laute dicht fern gelegen Gehölz -- ahnungsvoll unbekannt selig Genüß finden hoffen -- 
  suchen romantischster -- einsam Stelle Gegend -- 
  hoch steil Ufer lebendig -- klar Gewässer strecken Sanft bemoost Hügel -- Gruppe dunkel Baum umgeben -- neugierig Blick Sonnenstrahl verbergen -- 
  dicht Gebüsch -- begrenzt Seite schnell gewandt Fluß -- weit Aussicht verstattet Einbildungskraft freiste Spiel -- 
  Fluß strömn heit -- eilt Umarmung geliebter entgegen -- Ufer -- spröd -- gefühllos Klippe stoßen -- zürnend sanft Geräusch wallen seitwärts -- 
  -- -- Marie verbergen -- Finger erstenmal Sait durchirrt -- ungewiß Versuch geliebten -- stets gegenwärtig Ton nachzubild Strebt -- 
  Bemühung gelingen -- unvollkommen Ähnlichkeit hervorzubringen -- vermählt ungewiß Akzent biegsam Stimme Tönen Laute -- 
  Wollust -- beschrieben Genuß liegen Moment -- -- erwacht -- erstenmal übend Talent ahnden süß Schauer -- kindlich Unerfahrenheit verbergen Grenze Kunst -- betreten kühn Schritt Weg Unendliche -- -- 
  Marie glücklich -- obgleich zufrieden -- vormals -- 
  Welt blüht -- Welt voll Erinnerung -- Sehnsucht -- verlangen Wehmut -- 
  einsamen Stunde widmen Versuch -- Feenland Harmonie Gefühl hinein zauberten -- -- Fortschritt merklich -- glücklich Gefühl genießen vermögen -- 
  beschließen Vater Schuld Freude mitteilen -- stellen -- schön Herbstabend -- Arbeit ruhend -- dicht belaubt Buchenlaube Gärtchen sitzen -- Entfernung -- bebend Hand -- lieblich -- bewegt Stimme gelungenster Melodie vorzutragen beginnen -- 
  -- Anton Überraschung übersteigen Ausdruck -- eilt -- Auge belehren -- Gehör täusch -- -- Marie schüchtern sanft berauscht Blick mild Errötung -- Arm Laute -- -- überfliegen seltsam Regung -- 
  zürnen -- Anblick einzig -- geliebt Kind -- süß Lippe -- Ton Brust strömen -- schön Bild lösen -- besänftig -- entzücken -- -- 
  -- vergebens -- -- unwiderstehlich Zauber Harmonie Erinnerung zerbrach Rinde -- Herz umschließen -- Talent unverkennbar -- Göttlichen -- Schutz begeben -- frei Aufwuchs verstatn -- -- 
  lehrt Marie harmonisch Stimme reineren Akzentus ergießen -- Melodien Forderung Kunst befriedigen -- 
  Leichtigkeit -- Lust betreten Marie angewiesen Bahn -- 
  süß kürzt Vater arbeitslosen -- Ruhe geweiht Stunde -- lieblich Gestalt Jugend Ahnung geliebt Kind erscheinen -- 
  freundlich Sonne trüb Gewölk Leben hervorgebrochen -- bestreut himmlisch Farbe Abendhimmel -- 
  sorgfältig gefloh -- Quell schön Genüs -- 
  Winter beinahe vorüber -- Marie glauben -- geliebt Hoffnung Antoni reisen -- Herz verweisen -- -- Unterweisung Vater wiederholen -- Brandem Hereintrat -- 
  Gedanke -- Nachricht Anblick verkündigen -- fliegen pfeilschnell Herz -- durchglühen freudig erschrecken -- 
  Branden reizend sehen -- bemerken erstaunen Laute Arm -- bitten kurz Erläuterung -- Probe Geschicklichkeit hören lassen -- 
  anspruchlos Gefälligkeit -- Brandem fühlen -- Entschluß -- kommen -- Augenblick Lebhaftigkeit Stärke zunehmen -- 
  -- Anton herbei kommen -- freut willkommen Besuch -- Endzweck Marie betrügen -- 
  jung Künstler Antonien -- Marie Andenken mancherlei Art lebendig erhalten wissen -- Auftrag -- Marie Stadt begleiten -- artig Brief erinnern Anton gegeben Einwilligung -- 
  Anton lächelen -- lesen -- tragen Bedenken -- Marie häuslich Geschäft entfernt halten -- Brandem vollkommen Abneigung Vorschlag erklären -- entschlossen -- Tochter -- fern Geräusch Welt still Sphär einfach -- unbekannt Leben gewöhnen -- fest halten -- Brandem Blick erheitern -- schön Rührung -- 
  -- -- teuer Mann -- Wort Beglaubigung Nachdruck geben -- Glauben vertrauen Menschenkenntnis -- 
  beide stark -- fest hoffen -- betrachten Mensch -- vierjährig Umgang bleiben -- Augenblick -- 
  Tochter unauslöschlich tief Eindruck -- 
  Maries natürlich Güte -- hoch Unverdorbenheit Anmut Reiz Erscheinung -- Wirklichkeit finden -- hoffen wagen -- gewiß finden -- 
  -- Marie ewig Einsamkeit -- Bekanntschaft Welt entfernen bleiben -- tätig Gemüt Talent dennoch Wirksamkeit Ausbildung erhalten können -- fordern -- Plan untadelhaft -- -- Seite stehen -- ungünstig äußerer Umstand Kind einst unvorbereitet Welt werfen -- -- 
  Gelegenheit -- Marie Mensch mancherlei Art Verhältnis bringen -- Gebrauch -- vertrauen Sorge Schicksal -- 
  schützend Genius umgeben -- sorgsam Liebe wachen -- -- 
  Eitelkeit -- glauben -- günstig fühlen -- wag -- schön Hoffnung Liebe -- glücklich -- nähren -- 
  Ungerecht grausam -- frei Entwicklung schön Gemüt gering beschränken -- 
  Gefühl voll Freiheit entfalten -- schön Blüte heiteren -- phantasievoll Geist Bedrückung fremd Vernunft untergehen -- -- 
  zart Sinn Bahn wahr Schicklich festhalten -- Herz entscheiden -- Sorge innerer äußerer Frieden Leben ewig lieb Sorge bleiben -- 
  -- Moment -- innigst -- uneigennützigste Liebe hold Geschöpf losreißen -- -- 
  -- schön röte Wahrheit überflog Wort Brandem ernst Zug -- indes Feuer Gefühl steigend Rührung sympathetisch vaterherzen mitteilen -- 
  -- -- -- Anton herzlich Ausdruck -- sanft bewegt Blick -- -- vertrau Kind -- Bedenken -- einzig Glück zärtlich Vater -- letzter Freude verlassen Herzen -- -- 
  mancherlei Bedenklichkeit kommen Sprache -- Resultat Gespräch bleiben -- Marie Reise Antonien unternehmen -- 
  erfahren -- beschließen -- Schauer anderer Art -- Brandem Eintritt -- Innerstes durchrann -- 
  sehnlichst Wunsch erfüllen -- verlangend Phantasie nah Befriedigung schweigen bringen fühlen -- -- Vorstellung Vater Dörfchen verlassen lebhaft Beunruhigender Hervortrat -- 
  drängen Einbildungskraft -- worüber leichtsinnig hinweggesehen -- 
  heimlich -- romantisch Plätzche -- still -- zufrieden Stunde -- einfach ruhig Genuß erhalten Gewicht Waage Gefühl -- ahnen -- 
  Gefahr -- Ruhe drohen -- Kränkung -- Eigenlieb widerfahren -- Eindrücke -- Herz verletzen können -- deutlich Vorstellung -- Erinnerung -- Antonien Vater Leben Welt erfahren -- dunkel Ahnung geben -- dünken leichtes -- vermeiden -- Kaltsinn begegnen -- 
  Abreise bestimmen erscheinen -- 
  Anton geliebt Kind -- bedeutungsvoll Wort -- Bild scheidend Vater ewig still Glorie Seele feststellten -- 
  fordern -- desto versprechen Herz -- halten -- 
  bang -- beklommen Gefühl -- fest vertrauen Brandem -- gefaßt Entschluß zerstreuen -- liegen dunkl Gewölk Anton Seele -- umzog Maries heiter Gemüt -- 
  ängstlich stumm hing Hals Vater -- zögernd steigen Wagen -- flüchtig rolln -- 
  bekannt Dörfchen Düstern Kirchturm ruhig Hütte blicken verschwand -- Welt allenthalben hervorspringen -- zerteilen Wolke -- Tran versiegen erheitert Wange -- freundlich Gedanke Wiedersehen erheitert Blick scheidend Vater -- Vorstellung -- liegen -- durchschaueren Herz freudig Erwartung -- 
  kommen -- erheitert Sinn -- 
  hell -- freundlich Wintertag -- 
  sanft Silberglanz schweben Gegend -- reinsten Kristall übergießen -- schimmeren Baum Pflanze zart Nebelduft hervor -- 
  Marie Welt schön -- schön Welt sehen -- -- 
  heiter Licht goß Herz Gegenstand -- liebenswürdigsen Zuversicht -- Unerfahrenheit glücklich Naturell verleihen -- Welt entgegen -- Rücksicht neu -- 
  Begleiter bieten -- Unterhaltung angenehm nützlich -- 
  unterhielt Schilderung verschieden Person -- kennen lernen -- fing -- Ansicht Begriff entwickeln -- 
  Marie schenken ungeteilt Aufmerksamkeit -- 
  sichtbar selten Zutraue Vater -- Art -- äußern -- längst tief Achtung Meinung Wert entstehen -- begründen schön Gefühl kindlich fest Vertrauen Brandem -- 
  Stimmung rührendst Unbefangenheit fröhlich Wahrheit darstelln -- durchwalln selig Gefühl Brust -- schweben glühend Bekenntnis Empfindung Lippe -- 
  -- Grundsatz getreu -- halten -- gespannen -- -- 
  -- Betrachte -- wärmst Freund -- teuer Marie -- 
  Gewähren süß Genugtuung -- Herz Fall schön Offenheit erhalten -- Umgang Welt verleugnen -- -- 
  einzig Versprechen -- glücklich -- -- -- 
  Marie freundlich Hand -- heftet hell -- sicher -- wohlwollend Blick -- fest überzeugen -- Seele können Verstellung wohnen -- 
  küssen geliebt Hand -- haucht sanft glücklich -- glühend Seufzer -- 
  ziemlich spät -- * * * * ankamen -- 
  erleuchtet -- hoch Haus -- Getümmel Strassen -- setzen Marie Erstaunen -- 
  munter Musik Tambourins ziehen strassen -- halten -- Haus still -- 
  Ton hüpft Herz -- 
  -- täte Blick bunt Gewühl Welt hinein -- golden -- begehrungswern -- -- 
  voll Unruhe -- wissen -- 
  gelangt Antonien Haus -- vieler Huld empfangen -- erleuchtet -- zierlich Zimmer hineinführn -- 
  freundlich Gespräch scherze erfüllen Moment Wiedersehen -- 
  -- Maries Bild längst Antonien Andenken erloschen -- unauslöschlich Zügen Brandem Seele gestehen -- 
  Gelegenheit -- Fräulein -- Unterricht singen -- wichtig Dienst leisten -- Besitz unmittelbar angehend Geheimniß -- Antonie bemerken Neigung Marie -- Freude Gelegenheit ergreifen -- fein Art verbinden -- 
  Seite sehnen längst gefällig Wesen -- erheitern -- Wert fühlbar verstünd -- fehlgeschlagen Hoffnung gekränkt Eigenliebe verstimmen -- beide glauben Marie Sicherheit erwarten -- 
  Empfang müssen zärtlich -- Rücksichte bewirken -- -- 
  Marie ausruhen -- Antonie vorschlagen -- Abend Maskenball besuchen -- versprechen Eindruck -- glänzend -- abenteuerlich Spiel Marie -- Vergnügen -- andermal aufschieben -- 
  gefällig Zudringlichkeit nötigt verwirrt Freundin -- Anzug wählen -- Bescheidenheit leiten Wahl -- 
  -- schwarz Schleier bedeckt stark blond Locke -- hell -- freundlich Stirn glänzen -- Vollmond dunkel Gewölk hervor -- 
  einfach Gewand Farbe -- umfloß leicht Falte schlank Gestalt -- erheben rein -- zart Kolorit -- 
  reizend -- auffallend -- 
  dunkel Auge -- Wang glüht Erwartung unbekannt Sehnsucht -- 
  scheinen Traum -- Traum süß -- wünschen -- -- enden -- -- 
  Antonie diesmal einfach Anzug wählen -- unerkannt bleiben -- 
  band Maske -- fahren -- 
  Branden -- bedauern -- Maskenball besuchen können -- folgen -- unkenntlich Tracht -- 
  seltsam -- unbeschreiblich Verwirrung geraten jung Herz Eintritt gefüllt Saal -- -- 
  Phantasie umgaukelt bunt Gewühl wunderlichsen Spiele -- unfähig -- Trug Wahrheit unterscheiden -- legen Bedeutung hinein -- Unerfahrenheit verzeihen -- 
  -- bemerken bloß -- bemerken -- fallen Gedanke -- 
  Kleidung einfach -- glänzend schön Gestalt auffallen -- 
  Eitelkeit bleiben ungeweckt -- Gefühl desto stark erwachen -- 
  Antonie Stunde Arm Arm Saal herumgestrichen -- fing allmählich -- Inkognito -- anfänglich lustig vorkommen -- herzlich langweilig finden -- 
  bekannte erkennen -- Lust bekommen -- Reihe mittanzen -- empfehlen Marie indes Sorgfalt jung Mann -- Nähe befinden -- 
  flüstern paar Wort Ohr -- nennen Marie Name Seeberg -- verlassen schnell -- Einfäll folgen pflegen -- 
  jung Mann vollziehen Auftrag leicht angenehm Wesen -- setzen Marie Ecke Saal -- bunen -- lebendig Maß frei ungestört beobachten -- 
  schwer -- Marie leicht -- munter Gespräch anzuknüpfen -- Verwirrung -- worin anfangs befinden -- zerstreuen -- 
  wissen Gelegenheit geben -- gut Einfall reizend Naivetät vorzutrag -- angenehmst Schüchternheit -- hell geübt Verstand begleiten -- treffend Urteil fällen -- 
  Seeberg hören kunstlos wohltönenden Sprache Gefühl -- sanft Rührung ähnlich -- womit Jugend erstenmal gelesen Idylle Gesn erfüllen -- 
  Jugend -- Freude Musik spannen -- gewinnen Maries lieblich Gestalt Auge still Glorie schmückt Reiz -- -- vereinen -- Ideal weiblich Liebenswürdigkeit geträumen -- 
  tief Herzlichkeit Empfindung -- jugendlich Regsamkeit Phantasie -- Scharfsinn kindlichst Zutrau reizend Mund -- paar ungewöhnlich schön geistvoll Auge -- minde Anmassung ausdrücken sehen -- Erscheinung befremden anziehen -- -- 
  Seite Marie größeres Vergnügen empfinden -- Augenblick -- 
  feinen -- gebildet Ton Gesellschafter -- schön einnehmend Äußere -- romantisch Duft -- womit Empfindung -- empfinden -- überhauchen wissen -- erweckt Herz gefühlt unendlich süß Rührung -- Wesen sichtbarward -- denken -- zeigen verbergen -- 
  Unvermerkt Gespräch interessant Gegenstand -- Liebe lenken -- Marie unruhig -- 
  -- -- Liebe -- -- schüchtern -- unendlich süß Blick Ton -- -- wissen -- erschreck -- Wort Lippe hören -- -- Seeberg -- schmeichelnd Äußerung fühlen -- küssen Zärtlichkeit Hand -- Marie Neuheit -- Lust Gewalt jung Neigung ergreifen berauscht -- trunken Moment -- Herz eingeben -- drücken jung liebenswürdig Schwärmer -- aufrichtet -- leicht ätherisch Kuß Lippe -- 
  Seeberg befremden -- Weltkenntnis rufen Moment Zweifel Herz -- 
  Unschuld -- Auge finden -- hold Verwirrung -- tun -- bereuen vermögen -- Planlosigkeit Wesens -- widerlegen -- erfüllen Herz Entzück -- 
  früh Jugendtraum -- geliebtest -- gespanntest Bild kehren Flügel Einbildungskraft -- 
  -- -- -- rufen verklärt Blick unbeschreiblich Innigkeit -- -- führen Liebe Ideal entgegen -- wonach Herz längst unendlich Sehnsucht verlangen -- -- -- 
  Marie glauben lieblicheres gehören -- süß Bewegung locken zärtlich Träne Auge -- erstaunen -- wein -- unendlich Entzück erfüllen -- 
  fühlten Moment schön -- beschrieben Regung jung -- wechselseitig Neigung -- Antonie stehen -- leicht Entschuldigung lang Wegbleiben Wirklichkeit herabziehen -- 
  dankt jung Manne vertraulich Wesen Sorgfalt -- bitten Marie -- herzlich müde -- sogleich wegzufahren -- 
  tun -- Antonie übellaunig -- schlummeren Fahren -- Zimmer -- sobald ausgestiegen -- 
  Marie bleiben -- überlassen lieblich Träumen Liebe -- erwacht Herzens -- Zustand -- Eins -- nachdenken -- 
  erwacht geliebt Bild -- kennen größeres Glück -- Wunsch -- wiederzusehen -- 
  indes Erfüllung beitragen -- ziehen Gegenstand Aufmerksamkeit -- 
  Schaute verwundrungsvoll lang Straße hinab -- Schauspiel städtisch Tätigkeit unterhieln -- vermissen gewohnt rein Winterluft -- dumpf Nebel ersticken -- 
  -- Unterhaltung müde -- Gesang Spiel Stunde kürzen beginnen -- öffnet Türe Zimmer -- hold Erscheinung gestern treten Antonien Hand jugendlich schön herein -- 
  seltsam mischen Lage -- Antonie heiter -- scherzend Ton -- Herr Seeberg künftig Gemahl vorstellen -- 
  -- werfen unruhigen -- fragenden Blick Seeberg -- angenehm Leichtigkeit nähern -- Bekanntschaft Glück wünschen -- 
  gleichmütig Fassung Unbefangenheit -- dennoch bleiben Brust unerklärlich -- Mißverhältni innerer äußerer Verhältnis hinzudeuten scheinen -- 
  sehnlich Wunsch Brandem hierüber sprechen -- groß Ungeduld Stunde -- versprechen -- entgegen -- 
  bestimmt -- Marie bleiben -- Seele ergießen vertraut Gespräch -- 
  groß Genauigkeit schildern -- gestern vorgehen -- gehören -- sehen -- tun -- 
  Brander -- Verhüllung Augenblick verlassen -- auf schärf beobachten -- Beweis unbegrenzt Vertrauen -- schmerzlich anderer Hinsicht -- angenehm rühren -- 
  Natur Empfindung täuschen -- Welt kennen -- glauben -- übrig Erfahrung gemäß -- schnell gefaßen -- flüchtig Neigung endigen -- Seelenstärk -- Geliebte -- frei Spiel Empfindung großmütig gönnen -- Glück Ruhe -- Gegenwart aufzuopfern -- 
  begnügen -- Seeberg Charakter -- Wahrheit gemäß Bemerkung -- bestätigen -- Antoni verloben -- beide Familie Heirat billigen wünschen -- überließ Vernunft Entscheidung -- hierbei benehmen -- 
  Seeberg schön gebildet jung Mann -- leicht gefällig Äußeren Reizbarkeit Gefühl -- Kenntnis mancherlei Art -- fein gebildet Geschmack vereinen -- 
  verschieden Eindruck -- früh Leben empfangen -- Idee Liebe -- Glück Verhältnis romantisch Anstrich geben -- nachherig Erfahrung -- Sphär Welt -- worin leben -- seltsam Kontrast bilden -- 
  Alter -- unmöglich scheinen -- süßen Jugendtraum Erfüllung sehen -- stimmen -- Bedeutung suchen -- tragen gespannt Empfindungsweis selten kalt Kreis Gesellschaft -- unbedeutend seltsam Wichtigkeit erhalten -- 
  glücklich -- 
  teilen Schwärmerei Wirklichkeit -- Plan -- Leben ungewöhnlich Art genießen -- lassen Kleinigkeit bestimmen -- gewohnt Lebensweise bleiben -- 
  wünscht entscheidend Schritt -- scheuen gleichwohl Aufsehen -- bekannte -- 
  -- gesellschaftlich Verhältnis umstrickt bestimmen -- rauschend Leben ergreifen -- Geschmack -- leben Sehnsucht gefühlvoll -- interessant Unterhaltung immerwährenden leer Zerstreuung -- 
  ewig Sklave fremd Meinung eigen Gefühl ergreifen jeder Luftbild Phantasie Hoffnung -- Glück Freiheit finden -- 
  indessen unruhig -- unbestimmt Gemüt -- verbund schön Anlage -- Bildung schön Gestalt zärtlich unbefangen Herz bezaubernden unwiderstehlich Reiz -- 
  Antonien Schönheit Talent Seeberg Aufmerksamkeit erregen -- Feinheit -- Feinheit scheinen -- Lieblingsidee schmeicheln wissen -- vollenden Eindruck -- anfangen -- 
  Antonie einzig Kind glänzend reich Haus -- groß Hoffnung -- 
  fein -- weiblich Wesen -- ewig leicht -- angenehm Eindrück hasch -- entschiedenste Selbstsucht gefälligen -- liebenswürdig Aussenseit verbergen wissen -- 
  Plan -- gemein Sinn -- Glück -- Wahl Seeberg fallen -- glänzendst Partien gelten -- beherrschen scheinen -- 
  gelingen -- Familie Heirat entzücken -- Seeberg verwandte glauben Glück Besitz vortrefflich Gattin sichern -- -- 
  welcher gänzlich Mangel Harmonie -- Klugheit -- jugendlich Leichtsinn gemeinschaftlich Hang Vergnügen bedecken -- -- -- 
  lieben munter Freude Leben -- Seeberg überall Gefühl Bedeutung hinein legen streben -- suchen Antonie hinweg drängen -- 
  Antonie Leben bequem sicher Weg bahnen suchen -- voll ewig Sonnenschein -- Vertiefung -- Krümmung ruhig Sinnengenuß stören -- Weg stehend Verwunderung sehen -- Blume zuwarfen -- lieben Seeberg romantisch Pfad -- voll -- idealisch Aussicht still -- heimlich Stelle -- Schatten Licht wechseln -- Seele ergreifen rühren -- Fehler ungewöhnlich -- romantisch ansehen geben wissen -- Antonien Fehler Art -- Geschmack schmerzlichsen beleidigten -- 
  Seeberg Art Bekanntschaft Marie lebhafteste rühren -- -- schwärmerisch Eindruck verlieren Stärke -- freundlich Tageslicht -- sanft Morgenanzug unendlich reizender finden -- 
  Umgang Mensch erlangt Gewalt -- meister Fall Ausbruch Gefühl gebieten -- helfen -- Verhältnis finden -- leicht -- zwanglosen Ton festzusetzen -- 
  bedeutend Abend erwähnen -- scheinen lieblich Traum halb verworren -- vorzuschweben -- 
  Antoni -- Marie näh Verhältnis erfahren -- wissen -- täglich sehen -- täglich ungezwung umgeh -- nah reizend Aussicht verbannt Gedanke Folge -- näh Umgang Marie -- 
  schön Natur geliebter -- still Notwendigkeit Wert erfüllen schwärmerisch Achtung -- frisch -- unentkräftet Sinn Freude Leben fesselten jugendlich Neigung unwiderstehlich -- 
  Gegenständen -- angenehm Genuß gewähren -- Genoß hoch Glück Erde -- -- lieben -- glücklich -- 
  Unterredung Brandem Marie -- Mitteilung viele erleichtern -- viele Zufriedener fühlen -- 
  Unbefangenheit scheinen sicherst -- Antoni wenden -- fragen -- Seeberg dürfen -- -- Antonie -- gegenseitig Geschmack besonderer Grund vollkommen Ort finden -- -- 
  fühlen -- gerecht Wohlwollen -- stehen -- unser Empfindung gebieten -- 
  Marie beruhigen -- 
  -- Auge Gefühl göttlich Eindrücke schöne Vorzüglichen verschließen -- -- denken -- 
  -- wünschen -- sehen -- uneigennützig lieben -- Antonien Verhältnis leiden -- -- 
  -- Regt hierüber Zweifel -- wissen Liebe -- -- wissen -- Philosophie -- befriedigend auflösen -- -- überlassen sorgenlos Neigung -- glücklich -- 
  -- betragen Seeberg lieblich Wahrheit -- Innigkeit Gefühl -- stets freundlich Begleiterinn Liebe -- 
  still Vergnügen bemerken feingebildet Freund hoch Kultur -- Mangel allzu fühlen -- Umgang gewinnen Verschiedenheit Reiz -- 
  Marie lernt Welt Alter kennen -- goldensten erscheinen -- Entfernung Phantasie schmerzhaft spannen -- Sehnsucht reizen -- hold Jugend trüben -- 
  Schatten Freude festhielen -- tausend Rücksichte vergnügen betrügen -- Genoß Herzlichkeit -- entzücken -- 
  Spazierfahrt -- Schauspiel -- Gesellschaft -- wunderbaren -- süß Reiz -- überall finden Geliebten -- überall Genoß -- 
  Liebe -- Neuheit -- Jugend Sorglosigkeit vereint -- Himmel umzuschaffen -- 
  harmonisch Licht umfloß Auge Welt -- Gegenstand kleidet Farbe Liebe -- Gemeinste -- Gleichgültigst erhalten geheim süß Bedeutung -- 
  treu Brandem indessen dauernd Neigung bitter Resignation schmerzlich -- täglich wachsend Besorgnis -- Seite -- Maries Gemüt -- mitten gefährlich Verhältnis fein Verführung Beispiel ursprünglich Reinheit Wahrheit festhieln -- -- Seeberg Glück beneiden -- trösten Gedanke -- vertraute unverdorbenen Seele -- 
  zuweilen -- Vater gegeben Versprechen gedachten -- überfiel Grauen -- Marie gleich Herzlichkeit Freude empfangen -- Glück -- Erfahrung -- Zweifel niederlegen -- überall Natur getreu bleiben -- fassen Hoffnung -- Mut -- 
  indessen wenden -- Gewinn verschaffen -- 
  Talent Gesang Spiel bildet Leitung selten Vortrefflichkeit -- Verstand gewinnen täglich reife -- Anlage entwickelt Sorgfalt schön -- 
  zwingen Reise -- Familie müssen -- Entfernung -- mehrere Woche dauern -- 
  Gedanke -- Marie Verhältnissen lassen -- dünken unerträglich -- gleichwohl halten Regung zuweilen Wirkung Eifersucht -- unterliegen -- 
  schwanken -- beschließen -- alt Anton schreiben -- Tochter holen -- 
  indessen verflossen -- Antwort bleiben -- Brand zwingen -- erwart -- düstern Ahnung abzureisen -- 
  Abreise erhalten Marie gewünscht Brief -- 
  Nachricht Vater -- innig Freude empfangen -- beantwortet -- vergeblich entgegen sehen -- 
  Brief alt Freund -- Prediger -- enthalten Wunsch -- schnell zurückkommen -- Vater gefährlich krank -- 
  Marie erwacht lang süß Traum -- erstenmal golden Schimmer Leben verbleichen -- 
  Gegenwart Zukunft liegen schwer -- 
  möglichst Eile bereitet Reise -- Seeberg Antonien beklommen -- innig Lebewohl -- verlassen tief Betäubung Ort -- Freude nossen -- 
  Welch Reise Marie -- 
  Menge verworren -- düster Bild umgaben -- peinigten -- unmöglich -- klar Vorstellung Zustand gelangen -- 
  näh Dörfchen -- desto lebhaft Bild Vater -- -- -- sterbend Vater -- 
  Wohnung -- still tot -- 
  herbstlich Abendwind säuselten schauerlich Buchenlaube Gärtchen -- 
  Eingang empfangen Prediger stumm Trauer -- 
  Brief liegen bleiben -- Anton -- Lebensmüden decken mütterlich Erde -- 
  Marie zerstören -- Boden drücken -- 
  Prediger unterhielt Nacht sanft Tröstung mild Teilnahme -- Lehre -- letzter Wille abgeschieden Vater -- 
  besucht Grab -- 
  Hell -- Heiter -- 
  kalt -- bestimmt Beleuchtung -- Licht Vernunft -- hold Zauber Jugend verwehen -- lieblich Wahn Wirklichkeit vergolden -- bezeichnen fernst Gegenstand deutlich -- klar -- 
  schwarz Trauer stehen dunkel Wald -- 
  wankend Strahl bekränzt Haupt -- lieblich Duft wallt Berg empor -- 
  schweigen -- einsam ertönt zuweilen Lied herbstlich Vogel Feld -- 
  Anton Grabhügel strecken einsam -- einzeln melancholisch Tanne streuen sparsam Schatten Boden -- einsam schwarz Vogel flog schüchtern -- 
  Maries Herz kalt -- schlagen -- 
  Schauer Tode gehen Seele vorüber -- 
  aufgerollt Gemälde liegen Leben Vater -- öd Rückseite stehen schwarz Zügen Grab -- 
  Herz verlassen -- entsagen -- 
  -- O -- -- -- rufen schmerzhaft -- -- unendlich Sehnsucht unser lieb Leben nachblicken -- -- 
  -- vergingen mehrere -- Natur finden Herz erstenmal Freude verschloßen -- schwermütig Sehnsucht verlängert Stunde -- ehemals jugendlich Hoffnung verworren Phantasie schnell verschwinden -- 
  -- indessen frischen Bild letzen -- treten Lebhafter hervor -- stark Einsame Traurige gegenwärtig abstachen -- 
  Auge -- nahe liegen -- undeutlich ungewiß wahrnehmen -- fassen Herz glücklich Gegenwart -- 
  Entfernung treten süß Bild deutlich hervor -- Zauberduft Vergangenheit werfen idealisch Schein hold Szene -- Gegenwart verworren drängen -- 
  bestimmen Entfernung Stärke empfangen Eindruck -- 
  -- Gegenwart beschäftigen scheinen -- verweh Hauch Entfernung -- nass Farbe weggewischen -- tief Seele eingewurzeln -- denken denken -- leise Ähnlichkeit malen auf lebendiger -- stehen -- verflechn Traum -- -- 
  Begriff Marie -- teuer Seeberg -- 
  Einsamkeit Entfernung erheben Andenken Schwärmerei -- Neigung Leidenschaft -- Bild Gotte -- 
  Einst Träumerei romantischst Stelle Gegend aussuchen -- 
  Plätzche -- einst Seele -- voll schnell Entfaltung Versuch Tonkunst wagen -- 
  Erinnerung Stunde drang süß Gewalt Herz -- schnell -- unentwickelt Gefühl scheinen Einfluß Beziehung Leben dunkel -- freudig anzudeun -- 
  Bild nachsinnend -- Flut -- ewig fliehend ewig bleibend Spiel Welle still Vergessenheit wiegen -- Zweig rauschen -- schnell Wendung Kommend süß Schrecken Seeberg erkennen -- 
  feurig wiedersehen -- 
  -- voll -- ungestört Freiheit -- romantisch Gegend -- rührend Reiz Ländlichen -- Feierlich Einsamkeit -- Empfindung erhöht spannt -- denken -- Gefühl verhehlen -- 
  kindlich Genauigkeit schildert Nuance -- gestehen -- Liebe -- Wort scheinen Schranke Verhältnis niederzufallen -- heilig Notwendigkeit Neigung rechtfertigen -- 
  Seeberg Trennung Marie unerträglich finden -- Antonie -- vernachlässigen -- anderer Plan beschäftigen -- tausendfach Stoff Klagen -- gleichwohl fühlen -- sagen lassen -- Herz fremd -- lassen Mangel Einklang merklich fühlen -- 
  indessen Verbindung gedeihen -- Haus -- Kreis Bekanntschaft halten entscheiden -- glauben -- erwarten -- Entschluß -- Antonien brechen -- günstig Umstand erleichtern -- 
  Ersann unterdessen milderes -- lieb Traum -- Marie leben -- Erfüllung setzen -- eilen -- Plan mitteilen -- 
  schlagen -- fern gelegen unbewohnt Gut reisen -- Freiheit Liebe Glück leben -- 
  Marie überraschen -- 
  -- sonderbaren Bewegung fühlen erstenmal Notwendigkeit -- entscheidend Entschluß fassen -- Bühne Leben Rolle übernehmen -- wahr erdichtet Darstellung angenehm Teilnahme spielen sehen -- 
  drängen Einbildungskraft -- worüber hinweg sehen -- 
  welch Beruhigung -- Brand Viertelstund sprechen -- 
  treu Freund fern -- wissen jetzig Aufenthalt -- 
  Tod Vater Band -- menschlich Gesellschaft banden -- zerrissen -- Handlung Bezug -- Welt nah Geliebte -- schön Existenz Hand bieten -- -- 
  dennoch zweifelhaft -- Seeberg zärtlich Vorwurf Bedenklichkeit -- 
  -- verwandte -- fühlend Seele finden -- -- -- -- bunt Gewühl Leben -- Tausend gleichgültig vorübergehen -- lieben -- Glück -- hoch -- Natur gewähren -- leer Spiel Umstand -- kalt Verhältnis Zeitalter aufopfern -- -- 
  -- bestimmen -- Seite Waage neigen -- 
  Gewalt jung erstenmal empfunden Neigung -- Lust rasch tätig Genuß Leben unterstützen Seeberg Grund lebhaft Marie Herzen -- widerstehen -- 
  Entschluß fassen -- 
  -- -- -- lieblichsen Ausdruck -- vollkommen innerer Harmonie Gesicht ausgießen -- -- einzig Glück -- Geliebte -- 
  -- -- zufrieden -- -- 
  reisen -- 
  Marie fühlen glücklich -- fühlen -- schön Leben vorüber -- 
  lachend Gestalt Neuheit finden früh Jugendempfindung -- 
  -- geliebter froh Ungebundenheit frei Welt genießen -- Kleinigkeit Nähe hoch Interesse gewinnen sehen -- Unannehmlichkeit halb -- Freude doppelt empfinden -- Glück fehlen -- -- 
  kommen Dörfche -- Einsam -- düstern Gegend liegen -- 
  alt -- unbewohnt geblieben Wohnhaus -- lachend Mute Bequemlichkeit finden -- vermißten -- -- 
  sparsam gaukelten bunt Freude Leben Maries Stunde -- Sorge erfüllt leer Stelle -- geliebte Sorge -- hoch Freude harmonisch Seele schien Stärke gewinnen -- 
  gewöhnt Lust still -- tätig Leben -- 
  kürzen Musik Stunde -- süß Trunkenheit Liebe drang zart Schwing Gesang mächtig liebend Herz -- 
  -- Seeberg Genoß -- selten Leben fühlen -- heiter -- ruhig Glück -- 
  still -- einfach Freude kontrastiert Vorteil ehemalig Genüsse -- Selbstgefällige frei -- Wahl erhalten froh -- gespannt Stimmung -- 
  Nachmittag sehen wohlgebildet -- jung Mann -- bedienter begleiten -- Tor herein reiten -- 
  Neugierd -- unbekannt Gast -- stillen -- eilen rasch Treppe herauf -- treten Zimmer -- Antonie -- -- 
  reizend Erscheinung -- treten Herein -- Freiem -- gebildet Anstand -- kurz Unterhaltung erklären Grund Besuch -- 
  -- Seeberg -- -- bedeutend -- sicher Akzent -- -- lieben -- Mann lieben -- 
  Schium einst kält -- Gewalt -- geschehen einzig Absicht -- Liebe frei ungestört genießen lassen -- 
  schmeichelt Hoffnung -- Herz einst zurückkehren -- 
  entsag Betrügerin -- einzig Wunsch -- zufrieden sehen -- einzig Schmerz -- Hindernis dein Glück -- 
  Klage -- Schuld -- Liebe erhalten wissen -- -- einzig Grund -- hierher führen -- -- verabred -- Verbindung leichtesten trennen -- versichern -- -- Welt -- Hand bieten -- Zufriedenheit erfordern -- -- 
  -- Seeberg befinden sonderbaren Verwirrung -- 
  treulos Hang Sonderbar legen -- Eigenliebe schmeichelhaft Erklärung geheim Zauber -- Antonien Bild gewinnen Herz vorigen -- 
  erklären -- Antonie -- Zweck erreichen -- verlassen Versicherung -- eigenmächtig handeln -- 
  Antonie Seeberg freilich -- Ehrgeiz befriedigen -- Bequeme -- angenehm Lage versichern -- gelieben -- folglich Verlust Herzen Ruhe ertragen -- 
  geheim Seligkeit Quale zartfühlend Seele -- hoch streben -- Irrtümer bilden -- ewig fremd -- besitzen bequem Klugheit -- Welt vortrefflich Dienst leisten -- verstehen schnell Besonnenheit -- -- geschehen -- Vorteil wahrnehmen -- 
  Seebergs Neigung Marie bemerken -- jung Prinz Zirkel treten -- -- neu aufgegangen Stern -- Aufmerksamkeit ziehen -- -- Antoni -- Bewunderer finden -- Sphär Wunsch eröffnen -- höchst willkommen -- Art gewinnen -- Plan jung feurig Fürstensohne still verfolgen -- Seeberg aufgeben -- 
  indessen verschwinden Abreise Prinz schön Hoffnung gänzlich -- Erinnerung Seeberg vorig Idee kehren lebhaft -- Liebe -- Bild Zurückrief -- leicht -- Gewohnheit -- Neigung entstanden Interesse Spiel -- Entfernung Hindernis groß Reiz erhalten -- 
  Scharfsinnig Seeberg Charakter durchschauen -- Aufführung entwerfen -- Erfolg beweisen -- fein Menschenkennerin -- 
  Glück Liebenden vorigen -- 
  gewaltig Zauber Romantisch verwischen Seeberg Auge -- Betrübnis glauben schwärmerisch Glück ruhig Genuß gewöhnlich Leben herabsinken sehen -- 
  Empfindung -- Grundsatz erhalten -- befestiget -- ermatten zuletzt angenehmst Bild -- 
  fühlen -- Zirkel -- verlassen -- keineswegs trennen -- Meinung -- Urteil machen tief Eindruck -- 
  viele fliegen innere verworren -- scheinen unentschieden -- Saitenspiel innerer Leben -- schön Ton enthalten -- reizend Harmonie öd Missklang hervorgehen -- 
  Verfeinerung Schwärmerei -- Gefühl Klugheit wechselsweise Charakter bilden -- müssen viele ordnen -- müssen Mancherlei erfahren -- viele abwägen -- scheiden lernen -- ehe ruhig -- bestimmt Handlungsweise verstehend -- harmonisch Mensch erhalten hoffen -- -- 
  Marie entgehen -- Besuch Gemüt Freund zerstören -- 
  begegnet Feinheit -- Gewalt -- -- glücklich machen -- -- schön -- zweifeln Anfing -- 
  verschieden -- zuweilen Törichterweise wünschen -- sagen -- lieben -- wissen -- lieben -- 
  rührend Verrätereium Herzens -- wägend Verstand darein mischen -- -- 
  trüb einsam Stunde wacht Herz Andenken vorig Lage -- schwermütig Erinnerung haucht lieblich Kolorit Szene still Jugendzeit -- 
  glauben dunkel Ahnung verstehen -- ergriffen -- einsam Spaziergänge unruhig Wort blau -- verschwindend Ferne sehen -- 
  Heiterer -- tätig Geist verlieren -- schwer -- bedrücken -- geliebter Kaltsinn -- lastet -- Lebenskraft -- Betrachtung harmlosen -- ruhig -- reizend Schleier Vergangenheit zeigen wissen -- innerer Zufriedenheit -- ewig untätig Zustande bleiben -- letzter Empfindung -- 
  -- Freund kühl Besonnenheit scharf beobachten -- -- stehen -- Hebung Übel -- Quelle kennen -- beitragen -- 
  neu Freute -- Geist Szene wirklich Leben üben -- neu Beschloß -- selbstgewählen frei Genügsamkeit ertragen -- 
  -- erhalten gewünscht Aufschluß -- 
  offen unbewacht Augenblick lassen tief Seeberg Seele schauen -- säumen -- Entschluß fassen -- 
  -- -- -- -- einig Schmerz -- 
  viele Geist vorüber -- Verwunderung -- Unwille -- Stolz zärtlich Schwärmerei -- ordnet -- lebhaft Spannung -- worin befinden -- erleichtert Ausführung -- 
  neu glücklich -- denken -- 
  folgen -- lieben -- lieben -- Verlaß -- 
  Abwesenheit Seeberg begünstigt Plan -- 
  still bescheiden -- sorgen dringend Bedürfnis -- Haus gewissenhaft Genauigkeit nötig Anordnung -- verlassen Unruhe -- Selbstvertrauen -- Seeberg Haus -- einzigen anvertrauen -- 
  Brief Lebewohl -- 
  -- Glaube -- -- schreiben -- -- lieben -- verlaßen -- 
  wissen -- weh -- Stelle Herzen verlieren -- äußere Leben verlieren -- innerer Leben -- verlieren -- scheiden -- 
  -- Freund -- -- warten -- Andenken Liebe Lied Nachtigall Sturm -- zerstreut Szene Leben herüber hallen -- -- -- lebendig Spiel Empfindung erwachen -- danken schön Stunde -- 
  erscheinst liebenswürdig -- trüben Schleier -- liebenswürdig Schwäche Vorzug werfen -- verbergen -- 
  Stunde Scheiden beschwören -- lern Wahn entsagen -- dein Handlung fremd Meinung unterwürfig -- lerne vertrauen -- 
  -- gefühlvoll Herz -- gebildet Verstand -- zart Sinn schön Kunst Natur -- geben Vorrecht unbedeutend Mensch -- Urteil gelten -- -- 
  Freude verließesen einst glänzend Welt -- leer unbefriedigend nanntest meinetwill -- vielmehr lieb Wille -- 
  Liebe -- -- -- treulos Phantasie verlassen -- -- 
  ruf Stimmung -- Saitenspiel Liebe Herz zerbrochen -- o -- 
  Tön Welt -- Gefühl entzückend Einklang überströmen -- -- 
  Suche -- Seeberg -- 
  lieben -- wissen -- -- 
  Entfernung verlieren -- Gegenwart drücken -- Illusion lieblich geben -- Wirklichkeit gewichen -- 
  Gedanke froh begegnen -- Blick -- 
  lieben -- Wunsch erfüllen -- -- 
  Seeberg lesen Brief -- Beendigung Reise erhalten -- innigst Bewegung -- 
  zart Schonung -- Marie Trennung darstelln -- Wohlwollen -- Brief durchatmen -- Feinheit -- Antoni unerwähnt lassen -- obwohl wissen -- Einfluß -- Erscheinung schwankend Sinn -- entgehen -- -- lehrt Verlust tausendfach fühlen -- 
  Versuch -- Marie Aufenthalt entdecken -- schlagen fehl -- drohen völlig Leben verschwinden -- 
  öde Haus -- Garten -- Gegend -- kalt -- leer -- abgestorben Herz -- -- vermissen Marie innig Teilnahme -- lernen fühlen -- Gewohnheit stark Band Neuheit -- selten Herz Leben Befriedigung Bedürfnis hoffen -- 
  meister -- wünschen -- geschehen -- fast -- wünschen -- 
  jung Schwärmer -- -- glücklich -- sehnlich wünschen -- Brief Antonien -- worin melden -- gelingen -- Aufhebung Bund Familie völlig annehmlich begreiflich -- freu -- Hindernis Glück ansehen -- erscheinen -- -- niederschlagend Hinsicht -- -- 
  Antonien Lage kurz Ansicht bekommen -- 
  Vergnügen geliebter suchen -- Neigung -- Eigennutz Ehrgeiz stark -- Seeberg hinziehen -- führen -- wovon Schein erkünsteln -- 
  -- Seeberg erfahren vorig Freund wahr Zusammenhäng -- vergleichen Antonien Feinheit zart Empfindung schön Seele -- 
  Sehnsucht Marie kehren quälend -- wünsche flog Vergangenheit -- hing Wehmut lieblich Szene -- still Marie verleben -- 
  erwacht Bedürfnis -- gut Natur gründen -- lebhaft bestimmt -- 
  Trieb -- nützlich -- Bildung edler Selbst arbeiten -- sprechen deutlich -- mahnen unabweislich -- Wirklichkeit Tribut entrichten -- 
  kehren -- suchen Eindruck herrschen -- herrschen -- 
  reisen -- beobachtet -- bilden Sinn Geschmack Kunst -- knüpfte Band -- zerreißen -- Marie Andenken unvermerken schwach -- 
  bewundert -- Welt leben -- Scharfsinn -- womit -- Erfahrung -- hoch Eingebung -- Verhältnis Leben urteilen -- voraus -- -- 
  viele Hell -- -- verlieren glänzend Schimmer -- Ferne umgeben -- 
  Betrügereien Schein deutlich -- Meinung Mensch -- veränderlich -- seltsam gleichgültig -- Phantasie müssen dienen -- Gegenwart verschönern -- 
  wählen beständig Aufenthalt Landgut -- mittelmässig Stadt liegen -- suchen -- Rang Titel Mensch nützen -- -- 
  günstig Schicksal indessen Marie walten -- 
  Dörfchen Seeberg Nähe verlassen -- Plan sogleich Stadt hinrichten -- -- wissen -- wohleingerichtet Theater empfehlen -- 
  Unfall -- mancherlei traurig Bild beunruhigt -- Seite tröstend Selbstgefühl erheiteren -- gelangen -- Sorge -- Schauspielerin aufnehmen -- 
  gelingen -- Talent Gesang erwerben Beifall -- Schauspielerin bildet Anlage schön -- unabhängig sicher Lage -- 
  selbsterworben frei Existenz fühlen -- beglückt -- ruhig -- -- -- 
  fast Mensch träumen Jugend Lage -- worin lieb leben -- 
  Gönnt freundlich Schicksal -- Wunsch -- trübe Stunde -- geheim Zufriedenheit zeigen Erfüllung Lieblingswunsch -- 
  Marie befinden Zustande -- 
  einfach Gang früh Leben lassen -- nachdenken -- Wunsch Bestimmt fesseln -- 
  hell Verstand Umgang Welt erleuchten -- blenden -- Phantasie beschäftigen -- verwirrn -- Gefühl verfeinern -- vernichten -- 
  erfolgt Einsamkeit viele reiflich nachdenken -- viele vergleichen -- unabhängig erhalten lernen -- -- Alter selten Grad Tätigkeit praktisch Weisheit erwerben -- 
  -- -- 
  -- Leben angenehm -- freundlich Geschenk -- liebsn Wort -- Gesinnung ewig unfruchtbar bleiben -- Kraft Gedanken verschwinden -- genießen -- 
  Erinnerung Seeberg Liebe schweben süß Traum Seele -- lebhaft kehrt Bild treu Brandem Herz -- 
  fühlen bestimmen -- tun -- wesentlich Glück sorgen -- Sehnsucht Schicksal erfahren -- regen täglich bestimmt -- stark -- 
  -- -- edeln -- still -- stark fühlend Seele unterdessen gelitten -- 
  Familienangelegenheit -- gewissenhaft Besorgnis -- lang -- glauben -- Marie entfernt halten -- Gegenwart mehrere Ort notwendig -- 
  Zurückkehre Maries Abreise Vater Tod erfahren -- eilt -- mancherlei Ahnung betrügen -- Dörfche -- 
  fühlen -- Marie finden -- Prediger -- Nachricht erfahren -- jung -- vornehm Herr -- Vater Tod weggereisen -- wahrscheinlich vornehm Fräulein Stadt -- beschreiben -- 
  Branden -- wissen -- -- Seeberg Abwesenheit erfahren -- begreifen -- Hoffnung Boden schlagen -- 
  Unmut bitter Schmerz Unwille -- 
  -- O -- Tor -- rasend Tor -- -- rufen -- -- Allwissenheit zutrauen -- Kurzsicht -- -- gestehen anfänglich Liebe -- handeln planmäßig -- verdecken -- -- -- 
  Ruhe schön Seele verlieren -- zärtlich Vater Versprechen halten -- Unruhe Trauer Welt verlassen -- -- 
  quälen Vorwurf -- klagen -- Schuld Erfolgs -- stehen -- -- 
  natürlich Hang Schwermut vermehrn -- haßt Mensch -- aufhören -- -- beziehen schmerzlich süß Gefühl Maierhof -- Marie sehen -- 
  leben abgeschieden düster Leben -- hören Dorf nachts -- geheim Schauer -- klagend Musik Anton Hügel -- 
  indessen richten Geist -- Einsamkeit stärken -- Hand rein -- selbsterworben Grundsatz -- unvermerkt -- 
  Schaute frei Leben -- finden -- Empfand -- handeln -- 
  fühlen Drang Wirksamkeit -- Dörfchen -- Haus bestehen -- zufrieden Bewohner Kenntnisse neu Genuß glücklich Gleichmütigkeit verlieren -- genügen -- 
  beschließen -- Marie Aufenthalt erforschen -- 
  Gedank unverdorben -- rein Seele erquickt neu -- golden -- Genuß uneingeschränkt Vertrauen verleben -- ragten Licht Dunkel Leben hervor -- verstreut erfreulich Schimmer umh Vergangenheit -- Gegenwart Zukunft -- 
  entfernt -- traurig -- ohnehin Leben -- glücklich Misse -- bereuen -- einst selig -- 
  Verhältnis Marie Freund -- äußerer Veränderung leiden -- nötig -- -- 
  neu Sphäre Leben Hoffnung zurücktreten -- reist Antoni -- -- -- näher Marie Schicksal erfahren -- abwesend -- hierüber befriedigend Auskunft geben -- 
  Stadt -- leben -- mancherlei Verhältnis zuwider -- verfolgt Freude Aussicht -- Hofe benachbart Fürst zeigen -- reisen -- erhalten Rufe gemäß -- 
  Abend Ankunft Schauspiel -- hören -- Sturm geben -- eilen -- 
  Miranda treten -- Herz stocken -- 
  Unerfahrenheit -- lieblich Verwirrung Liebe -- erinnern -- ergreifen süß Gewalt -- 
  leben reißend schnell Verzückung schön Stunde -- Marie hold Unschuld sehen -- gehören -- beobachten -- -- 
  Künstlerin -- gedacht schön Spiel Verstand Genüge leisten -- lebend -- entzückend Geschöpf göttlich Einbildungskraft -- Miranda -- Gefühl Flamme setzen -- 
  Verschwand -- Marie treten Stelle -- 
  Augenblick lebendig -- Bewegung -- -- 
  süß Betäubung erwartet Spiel -- -- 
  Zauber Kunst überraschend Wiedersehen heben Gefühl schwärmerisch Höhe empor -- 
  sobald Spiel enden -- eilen -- 
  Marie -- Ankunft vorher erfahren -- Edles -- fein fühlend Gemüt -- Welt leben -- selten -- schön Erscheinung gewinnen -- rührendst Bande Achtung Zutrauen binden fühlen -- empfangen lieblichst Wahrheit kindlich Entzück -- -- 
  Welcher Wollust -- welcher Genuß -- Herz -- innigst Offenheit -- Trennung vorgegangen Szene auf lebendig darstellen -- Empfindung treu unbefang entwerfen -- neu aufgefaßt Bild Erfahrung teilen berichtigen -- 
  -- leben Ort -- brandem beobachtet Marie -- Geist vollkommen erwachen -- sanft Selbstständigkeit hell Vorstellung folgen -- -- 
  Fällen Leben -- heiter -- rein -- offen Gemüt zeigen -- mild Stetigkeit gewiß Grundsätze festhieln -- Gefühl bleiben -- Billigung Herz Beifall glänzend Zirkel -- Jugend Liebenswürdigkeit versammeln -- überwiegen -- 
  mild -- harmonisch Geist berühren zart Hand süßest Akkorde Seele -- dauernd Band Achtung -- vertrauen Freundschaft halten himmlisch Einklang fest -- 