Anton Reiser -- 
  psychologisch Roman -- 
  Herausgegebe Karl Philipp Moritz -- 
  -- 
  Berlin -- 1790 -- 
  Friedrich Maurer -- 
  Anton Reiser Lebensgeschichte handeln -- vorig -- eigentlich wichtig Frage -- fern jung Mensch selber Beruf wählen Stande -- 
  enthalten getreu Darstellung mancherlei Art Selbsttäuschung -- wozu mißverstanden Trieb Poesie Schauspielkunst Unerfahren verleiten -- 
  enthalten unnützen unbedeutend Winke -- Lehrer Erzieher sowohl -- jung Leute -- ernsthaft -- prüfen -- Merkzeiche vorzüglich falsch Kunsttrieb wahren unterscheiden -- 
  sehen Geschichte -- mißverstanden Kunsttrieb -- bloß Neigung Beruf voraussetzen -- mächtig Erscheinung hervorbring -- wirklich Kunstgenie äußeren -- Äußerste erdulden -- aufopferen -- Endzweck erreichen -- 
  vorig Teil Geschichte erhellet deutlich -- Reiser unwiderstehlich Leidenschaft Theater eigentlich Resultat Leben Schicksal -- wodurch Kindheit -- wirklich Welt verdrängen -- bitter verleiden -- Phantasie -- Wirklichkeit leben -- Theater eigentlich Phantasienwelt Zufluchtsort Widerwärtigkeiten Bedrückung -- -- 
  glauben Freier atmen -- gleichsam Element befinden -- 
  hierbei gewiß Gefühl reell Ding Welt -- umgaben -- worauf ungern Verzicht -- -- Mensch -- Leben fühlen -- 
  -- immerwährend Kampfe -- 
  denken leichtsinnig -- Eingebung Phantasie folgen -- selber zufrieden -- wiederum Festigkeit -- reellen Plan -- schwärmerisch Vorstellungsart durchkreuzen -- standhaft verfolgen -- 
  eigentlich kämpfen -- tausend Seele -- Wahrheit Blendwerk -- Traum Wirklichkeit -- bleiben unentschieden -- obsiegen -- woraus sonderbaren seelenzuständ -- geraten -- Genug erklären lassen -- 
  Widerspruch außen innen Leben -- -- 
  -- Widerspruch lösen -- 
  Reiser Türme H. -- -- Gesicht verlieren -- schnell Schritt vorwärts -- atmen frei -- Brust erweitern -- Welt liegen -- tausend Aussicht eröffnen Seele -- 
  dachen Fade bisherig Leben gleichsam abschneiden -- Verwicklung befreaten -- 
  Universität G. -- -- bezog -- Schicksal verfolgen -- Zeitgenossenschaft Jugend drücken -- Mut erliegen -- 
  Kreis hingebannen -- zutrauen selber fassen --- Mut erholen -- müssen sobald Mensch sehen -- unvorsätzlich Jugend verbittern -- 
  Kreis scheiden -- 
  -- Schauplatz leiden -- Welt -- worin Schicksal Jugend durchleben -- liegen -- entfernt Schritt -- -- einrichten -- wandern -- Mensch vermissen -- 
  finden unbeschreiblich Süßigkeit Gedanke -- Philipp Reiser Schicksal -- Ort Aufenthalts wissen -- einzig Freund Abschiede bekümmern -- Verhältnissen -- Mensch -- völlig gleichgültig -- 
  gänzlich hinscheid Leben Zustand vorgebilden -- -- -- 
  Hitze Tag legen -- Sonne neigen -- Schatten Baum lang -- verdoppeln Schritt -- Nachmittag Meile Hildesheim ununterbrochen -- Spaziergang -- betrachten völlig -- Spaziergang -- Hildesheim -- -- H. -- -- Haus -- 
  Stadttor -- schlagen vorher Staub Schuhe -- bringen Haar Ordnung -- Gerte Hand -- spielen -- schlendert Weise langsam Brücke -- zuweilen stehen bleiben -- erwarten -- umsehen -- 
  -- überd seiden Strumpf -- halten Aufzug reisend -- vierzig Meile Fuß wandern Begriff -- 
  schildwache fragen -- wandert Einwohner Stadt -- Spaziergängen zurückkehren -- Tore Hildesheim -- 
  -- Gedanke wiederum äußerst beruhigend angenehm -- Leute fremd auffiel -- umsehen -- gleichsam mitrechnen -- gehören -- 
  -- Mensch kennen -- bekümmeren -- vergleichen -- -- scheiden -- Individualität -- quälen drücken -- hören -- lästig -- Leben Weise ungekannt ungeseh Mensch herumwandeln -- 
  Tor Gasthof suchen -- Straße -- erinnern -- Rektor wohnen -- Fronleichnamsfest -- ängstlich peinlich Lage befinden -- Gesellschaft weder ausschließen -- eigentlich gehören -- -- 
  wälzt Stein Herzen weg -- gänzlich vergehen denken -- 
  Gasthofe -- worin einkehrn -- empfangen bewirtet Kleidung -- Mut ablehnen -- lassen gefallen -- Abendessen zubereiten -- bett schlafen anweisen -- Kaffee bringen -- 
  -- trank Ruhe las Homer -- -- Art Betäubung erwachen -- lebhaft vorstellt -- Barschaft -- einzig Dukat bestehen -- vierzig Meile reisen -- notwendig Ort Stelle übrig müssen -- 
  bezahlen schnell Zeche -- Vermögen arm -- erkundigt Straße -- Seese führen -- wanderen sorgenvoll Gedanke -- schwer Herzen Tore Hildesheim -- 
  früh -- Weg führen angenehm Gegend -- Wald Flur miteinander abwechseln -- Gesang Vögel entgegen tönt -- indes Morgensonne grün Wipfel Baum scheinen -- -- 
  schnell vorwärts -- fühlt Gemüt erleichtern -- heit Gedanke -- reizend Aussicht -- kühn Hoffnung steigen allmählich Seele -- entstehen Vorsatz -- Sorge hinwegsetzen -- Wanderung reich unabhängig -- 
  Nahrung Brot Bier einschränken -- Streue schlafen -- niemals Stadt übernachten -- Unterhalt Reise Groschen täglich bestreiten -- 
  Weise lang Monat unterwegs -- Reise entblößen -- 
  sobald Vorsatz -- standhaft ausführt -- fassen -- fühlen frei glücklich König -- freiwillig Entsagung bequemlichkeiter -- Einschränkung nötigsten Bedürfnis -- Empfindung Gleichen -- fühlen beinahe Wesen -- irdisch Sorge hinweggerücken -- leben Ungestört Idee Phantasienwelt -- Zeitpunkt -- anscheinend Ungemach -- glücklichst Traum Leben -- 
  unmerklich schlich Gedanke mitunter -- gegenwärtig -- Traum -- vorig Knüpft -- 
  stellen -- schön -- Andenken Mensch -- worin gleichsam sterben -- aufleben -- edler Gestalt erscheinen -- düster Zeitraum Jugend alsdann morgenröte gut Tag verschwinden -- 
  Vorstellung bleiben fest -- liegen Grund Seele -- Welt aufgeben -- übrig Traum Phantasie halten -- bekommen hoch Reiz -- -- 
  einzig Gedanke -- Mensch -- -- niemals wiedersehen -- Interesse Leben hinweggenommen -- süßest Hoffnung rauben -- 
  Mittag herannahn -- kehrt Dorfe gering Wirtshause -- ohned Bier Brot Geld -- Fall eintreten -- gut Bewirtung anbieten -- ablehnen -- 
  unbeschreiblich Vergnügen -- Pfennig Stück schwarz Brot erhalten -- Hunger sicher stellen -- 
  brockt Bier -- halten Weise Mittagsmahl streng Gesetz -- -- Reise -- abgehen -- 
  eilt -- schnell dumpfig Gaststube frei -- schattig Baum niedersetzen -- Mittagserholung Homer Odyssee lesen -- 
  --- Lesen Homer zurückgebliebeen Idee Werther leiden -- -- Reiser gewiß Affektation -- wirklich rein Vergnügen -- Buch passen Zustand -- -- Zeile vielgewandert Mann schildern -- -- Mensch -- Stadt Sitte sehen -- lang Heimat anlangen -- Mensch -- verlassen -- nimmer sehen glauben -- finden -- 
  Weg Berg -- Berg -- 
  -- Hitze ziemlich -- Reiser löschen Durst -- klar Bach antreffen -- umsonst schöpfen frei stehen -- 
  Dorfe -- Nacht bleiben -- Gaststube voll Bauer -- Lärm machen -- -- lesen -- beschäftigt Gedanke -- steinalt Frau -- Lehnstuhle sitzen -- Kopf beben -- ziehen Aufmerksamkeit -- -- 
  Frau erzog -- gebären -- alt -- Wand Stube -- Ofen -- Tisch -- Bank sehen -- dacht Vorstellung Gedanke alt Frau hinein -- vergessen -- Art wachend Traum geraten -- bleiben müsster -- Stelle können -- 
  -- Traum plötzlich Veränderung -- Zustand gelitt -- -- Gedanke sammeln -- fühlen Vergnügen Abwechslung -- Ausdehnung -- unbegrenzt Freiheit doppelt -- Fessel entbund -- alt Frau -- bebend Haupt -- gleichgültig Gegenstand -- 
  Art Vorstellung anderer Mensch hineinzudenken -- vergessen -- klebt Kindheit -- kindisch Wunsch -- Augenblick Auge Mensch -- -- heraussehen -- wissen -- umstehend Sache vorkämen -- 
  erstenmal legt weitaussehend Gedanke Streue nieder -- Degen legen -- decken Kleid -- 
  -- Gedanke lassen Ruhe -- Zukunft glänzend schimmernd Blick -- lampen anzünden -- Vorhang aufgezog -- voll Erwartung -- entscheidend Moment -- -- 
  Mitternacht Schlaf Auge -- erwacht -- Schauplatz verändern -- öde Gaststube -- Bierkrug -- schwarz Brot -- erschlaffend Müdigkeit -- rächt reizend Phantasie schrecklich Unmut Lebensüberdruß -- Stunde währen -- 
  legen Kopf Tisch -- suchen vergeblich einzuschlummern -- ermunternden Strahl Sonne -- Fenster scheinen -- Leben wecken -- sobald Weg -- dumpfig Gaststube -- verschwinden schnell Unmut -- reizend Ideenspiel beginnen neu -- 
  leben Weise gleichsam doppelt Leben -- einer Einbildung eins Wirklichkeit -- 
  Wirklich bleiben schön harmoniert Eingebildet -- Gaststube -- Gelärm Bauer -- Streue -- Reime -- 
  unbegrenzt Freiheit -- Beschränkung Abend -- Umgebung -- -- 
  freilich äußerer Gegenstand immerwährend Einfluß innerer Gedankenreihe -- Horizonte erweitern gemeiniglich Vorstellung -- Aussicht Gegend knüpfen Aussicht Leben -- 
  mühsam Bergan steigen -- weit Ebene liegen -- Ferne Städtchen -- See erblicken -- Anblick frischt Gedanke Hoffnung -- -- 
  Auge Gewässer Ferne verwenden -- neu Mut beseeln -- Ferne aufsuchen -- 
  --- Reiseroute Hildesheim nämlich Salzdethfurth -- Bockenem -- Seese -- Duderstadt -- Mühlhausen geradezu Erfurt -- Weimar -- Ziel Wunsch -- 
  glauben nämlich Eckhoffsche Schauspielergesellschaft vorzufinden -- Schauspielerlaufbahn beginnen -- -- 
  spielen unterwegs Wanderung Rolle Gedanke -- dereinst Ruhm Beifall krönen -- mannigfaltig Kummer belohnen -- -- 
  glauben können fehlschlagen -- Rolle tief empfinden -- Seele vollkommen darzustell ausführen wissen -- unterscheiden -- vorging -- äußer Darstellungskraft fehlen -- 
  -- dünken -- Stärke womit Rolle empfinden -- müssen fortreißen -- vergessen -- -- 
  geschehen -- Einbildungskraft erhitzt -- Feld -- glauben -- Beaumarchais laut toben -- Guelfo rasen anfehen -- 
  Guelfo Klavigo's Zwillingen Abreise H -- Lieblingsrolle -- finden Hohngelächter selber -- Selbsthaß -- Selbstverachtung Selbstvernichtungssucht -- dennoch Kraft vereinen -- Guelfo -- 
  Akt -- Guelfo Brudermord -- Spiegel sehen -- zerschmettern -- Reiser wahr Fest -- 
  -- überspannt Schreckliche gleichsam berauscht -- taumelt Trunkenheit Berg Tal -- -- Schauplatz unbegrenzen -- 
  -- Klavigo -- Träne kosten -- kalt -- Beaumarchais treten Stelle -- 
  -- kommen Hamlet -- Lear -- Othello -- Reihe -- deutsch Bühne vorstellen -- Philipp Reiser schauervollen Nächt vorgelesen -- Rolle durchgespieln -- durchempfunden -- 
  gesellen hierzu Dichtkunst -- sanft melodisch fließen Ver -- bescheiden voll edel Stolz Muse -- Zuneigung Herzen sicher gewinnen müssen -- -- 
  wissen eigentlich -- Gedicht -- schön harmonisch -- denken -- getreu Abdruck voll Empfindung -- 
  mitten lyrisch Schwunge Gedanke -- dicht Seese -- Fußpfad -- Straße -- Wiese führen -- Scheibenschieße -- schimmernd Aussicht Zukunft beinahe plötzlich -- 
  Flintenkugel sausen dicht kopfe vorbei -- Zuschrie -- sollen weggeh -- eilt schnell Seese -- wanderen ruhig -- Dorfe übernachten -- 
  Wanderung Reiser Harzgebürg -- früh -- Heerstraße -- Maur zerstören Burg Anhöhe liegen -- enthalten hinauf steigen -- -- verzehrt Stück schwarz Brot -- Frühstück mitnehmen -- Ruine alt Rittersitz -- Heerstraße Wald hinunter -- 
  --- Wanderer alt zerstört Gemäuer Morgenbrot verzehren -- Zeit denken -- Mensch wohnen -- Heerstraße Wald hinunt sehen -- glücklichst Moment -- schallt Prophezeiung Zeit -- Maur einst öde stehen -- Wanderer ausruhen -- Vorzeit erinnern -- 
  Stück schwarz Brot -- festlich Mahlzeit -- steigen stärken Hinunter -- wandert froh Mut Straße fort -- hoch Harzgebürge linker Hand liegen lassen -- 
  wandern -- Boden Welle scheinen -- heben -- sinken -- Horizont fortgetragen fühlen -- verhieln bloß leidend -- steigen Szene Blick empor -- 
  Mittagseinkehr unangenehm Gaststube vorüber -- befinden frei offen Natur -- 
  --- Einkehr beschwerlich -- denken -- befreien -- Kornfeld -- Jünger Christi einfielen -- Sonntage Ähren aßen -- 
  sogleich Versuch Handvoll Korn Ähren herauszustreif -- Körner Mehl sog -- Hülsen ausspucken -- 
  Indes bleiben Nahrungsmittel immer_mehr Zeitvertreib -- eigentlich Einkehr ersparen -- 
  Angenehme Nahrungsmittel liegen vorzüglich Idee -- Begriff Freiheit Unabhängigkeit vermehrn -- 
  Tagereis vollenden -- kehren unweit Duderstadt klein Dorfe -- Wirtshause Haus -- 
  Dämmerung -- Torweg Hofe Wirtshause stehen -- Hof Laube -- Tisch weder Stuhl Bank stehen -- 
  -- Reiser -- auszuruhen -- legen Tisch -- lesen sehen -- laß Odyssee Stelle Menschenfresser -- ruhig Hafen -- Schiff Ulysses zerschmettern -- Gefährt ergreifen verzehren -- -- 
  Wirt Haus kommen -- -- Anfing Dunkel -- Mensch Hofe Laube Tisch liegen -- Buch lesen -- 
  redet Reiser ziemlich unsanft -- aufrichtet -- Wirt wohlgekleidet Mensch -- fragen sogleich -- Jurist -- Gegenden gewöhnlich Benennung Student -- Theologe größtenteils Kloster studieren -- geistliche betrachten -- 
  Wirt Frau sterben -- Haus -- 
  Mann gesprächig -- Reiser halten Abendmahlzeit -- gewöhnlich Bier Brot bestehen -- Gesellschaft -- 
  Mann erzählt sogenannter Jurist -- logieren -- Reiser lassen -- Begriff Erfurt -- studieren -- 
  dergleichen Unterredung -- unbedeutend sein -- erhalten Reiser Idee poetischen Anstrich -- Bild homerisch Wanderer -- Seele schweben -- Unwahrheite Rede Übereinstimmend poetisch Vorbilde -- Minerva Seite stehen überdacht Lüge Beifall zulächeln -- 
  Reiser dachen Wirt bloß Wirt Dorfschenk -- Mensch -- -- sehen -- Stunde zusammentreffen -- Tisch sitzen -- Wort wechseln -- 
  Dasjenige -- menschlich Einrichtung Verbindung gleichsam Gebiet Aufmerksamkeit herausgedrängen -- gemein unbedeutend -- treten -- Poesie -- -- menschlich -- erhalten ursprünglich Erhabenheit -- 
  Mann einrichten -- Streue -- selten übernachten -- Reiser schliefr Heubode -- angenehm Lager gewähren -- 
  früh setzt Reise fort -- Aufenthalt Haus Wirt -- bleiben angenehmst Erinnerung -- 
  innerer Gedankenwelt lebhaft - merklich Ziel nähern -- Besorgnis treten -- Fall -- Aussicht unmittelbar Ruhm Beifall mißlingen -- Entwurf theatralisch Laufbahn gänzlich scheitern -- 
  treten extrem -- Bauer Soldat -- poetisch theatralisch -- Idee Bauer Soldat theatralisch Rolle -- Gedanke spielen -- 
  Bauer entwickelt hoch Begriff -- gleichsam erkennen -- Bauer horchen aufmerksam -- Sitte verfeinern allmählich -- Mensch bilden -- 
  Soldat fesselen Gemüt Schicksalsgenosse allmählich reizend Erzählung -- roh Soldat fangen -- Lehre horchen -- Gefühl hoch Menschheit entwickeln -- Wachtstube Hörsaale Weisheit -- 
  glauben -- Entgegengesetzt Theater fassen -- vollkommen theatralisch Aussicht Traum hineingeraten -- 
  liegen unbeschreiblich Süßigkeit Gedanke -- Bauer Soldat müssen -- Zustande scheinen glauben -- -- 
  Gedanke beschäftigen -- Stadt Worbes -- franziskanermönch dasig Kloster begegnen -- freundlich grüßen -- 
  Kloster vorbeigehen -- hören inwendig Gesang Mönche -- Welt abgeschieden -- Sorge -- Plan Aussicht leben -- -- -- -- 
  Eindruck Gemüt -- stark -- nachher Anblick Kartäuserkloster -- Einwohner Mauer gänzlich Welt scheiden -- Fuß Schauplatz betreten -- verlassen -- 
  wandernd franziskanermönch Idee Abgeschiedenheit kleinlich abschmacken -- -- 
  schnell Gang vertragen Ordenskleide -- poetischen -- 
  tönt hochdeutsch Sprache Leute gegender angenehm Reiser Ohr -- Idee nunmehrig Entfernung plattdeutsch Land lebhaft erwecken -- 
  schön Wetter -- Reiser kehren Abend Dorfe -- Namens Orschla -- Reichsstadt Mühlhausen Weg fortsetzen -- 
  Dorf katholisch -- Gasthof -- stehen Menge Leute Türe -- Schulmeister Orts befinden -- Wort anreden -- eschen Litteratus -- 
  -- Gelehrter -- -- Reiser bejahen lateinisch Sprache -- befragen wohin gehen -- -- 
  gehen Erfurt -- Theologie studieren -- scheinen sicher -- 
  stehen Bauer umher -- horcht -- Schulmeister fremd Student lateinisch sprechen -- 
  Sohn Schulmeister -- Hildesheim studieren -- Vater adjungieren -- 
  Reiser Stube -- legen mehrer Beweis -- Literat -- Homer Tisch -- Schulmeister kennen -- Bauer deutsch -- Homer -- 
  Reiser fahren fort Latein sprechen -- -- wobei komisch laufen -- gelehrt Unterricht sprechen -- fragt Reiser -- Schüler Kirchenväter läse -- worüber Verlegenheit geraten -- fassen -- -- Alternatim -- 
  Abschied Reiser -- früh -- warnen -- Kaiserlich preußisch Werber gegender nehmen -- Drohung schrecken lassen -- äußern -- Gewalt nehmen -- 
  Reiser legen Streue ruhig schlafen -- erwacht -- regnen stark -- Kleidung Schuhe seiden Strümpfe -- Haus -- Reise fortsetzen -- überd leimigt Bogen -- Näs Landstraße außerordentlich beschwerlich -- 
  freilich Unvermutetes Reiser --- Wetter Jahrszeit zuviel zugetraueen -- Fall vorbereiten -- weder Stiefel -- Kleidung Regenwetter versehen -- beständig Anzug Kleidervorrat ausmachen -- 
  -- auszuharren -- Himmel aufklären -- Erdreich trockenen -- 
  -- hört folgend -- regnen -- -- 
  früh Kaiserlicher Unteroffizier Gaststube -- Ort Werbung liegen -- Krug Bier vertraulich Reiser Tisch setzen -- Soldatenlebe weit sprechen Anfing -- zudringlich -- geradezu versichern -- Preußische Kaiserlichen Werber Mühlhause -- Gulden Handgeld anwerben lassen -- Anschein -- Soldat Reiser Phantasie -- eher denken -- realisieren -- 
  Soldat hinausgegangen -- treten Schulmeister herein -- Reiser gut bieten -- heimlich warnen -- Werber nehmen -- Soldatenlebe schlimm halten -- Sohn Mainzischen Dienst -- Paß -- können schwerlich durchkommen -- 
  Reiser versichern -- nötige legitimieren -- 
  nämlich lateinisch Anschlagboge -- Schulaktus Hannover -- Geburtstage Königin England Rede halten -- worauf Nahme Reiser Reiseruss drucken stehen -- 
  gedruckt Prolog Deserteur Kindesliebe -- worauf Nahme Verfertiger stehen -- nebst Gedicht Einführung Lehrer -- Nahme übrig Primaner gedruckt aufführen -- 
  sonderbaren Dokument gerne vorzeig -- äußerst nahe legen -- undeutlich merken lassen -- Landstreicher halten -- 
  bringen gedruckt Zeugnis Vorschein -- gut Wirkung tun -- anfänglich glauben -- vorlegen -- 
  legen lateinisch Anschlagbog auseinander -- zeigen Name Reiseruss -- 
  -- Schulmeister Gelegenheit -- Stärke Latinität zeigen -- Anschlagbog deutsche übersetzen -- Reiser gewinnen -- 
  ziehen Prolog hervor -- weisen anwesend deutsch gedruckt Name -- stimmen überein -- Schulmeister erzählt Gelegenheit -- Jesuitenschule Komödie spielen -- Nahme drucken -- 
  zuletzt legen Reiser Gedicht -- Nahme auf Liste Mitschüler drucken erscheinen -- vollends Zweifel verschwinden -- -- Name -- verschieden Weise drucken aufzeigen -- 
  Werber stillen -- scheinen Reiser Respekt bekommen -- 
  verschaffen Ruhe -- 
  lassen Feder Papier geben -- fing -- Hymn Homer deutsch Hexameter übersetzen -- 
  Abend Schulmeister -- unterhalten -- 
  vorüber -- Reiser legen ruhig schlafen -- 
  erwacht -- Himmel trübe gestern -- Regen an Fenster schlagen hören -- fing Mut sinken -- stehen Streue -- setzen traurig Tisch -- homerisch Hymn vorwärts -- stellen an Fenster -- -- Himmel aufklären -- Soldat Hereintrat -- Morgenvisite -- 
  Reiser ankleiden -- Haar Zopf flochen -- fing Kriegesmann -- Größe -- Länge Haar Komplimente -- Schade -- Kriegsstand treten wollen -- 
  Schulmeister -- gestern überlegen -- vorgezeigen Dokument Siegel -- bringen Umstand Reiser vorzüglich Anregung -- Werber durchkommen -- gönnen -- Anspruch -- 
  dauern -- Reiser -- fort -- traurigsen -- Abend aufklären -- Mut erwachen -- 
  Überredungskraft -- Leute nachdrücklichst Vorstellung überzeugen -- Vorsatz -- Erfurt studieren -- wovon Welt abbringen können -- glauben scheinen -- 
  Schulmeister lateinisch -- Morgenfrüh Mühlhause zureisen -- Wirt Gasthofe begegnen -- lateinisch spräch -- verreißt -- seinigen -- Fuß -- hohlen -- 
  Soldat versprechen Reiser -- Schrecken -- begleiten -- Gehölz Weg bringen -- 
  Frühe Soldat -- begleiten -- Gasthofe Reiser Zeche bezahlen -- Gewalt zugeben -- 
  gehen Dorfe Orschla Hähnichen Anhöhe herauf -- Soldat sprechen Wort -- Gehölz kommen -- erwartet Reiser Augenblick Entscheidung Schicksal -- dent entgehen -- 
  stehen Soldat still -- halten Reiser ordentlich pathetisch Anrede -- prüfen -- getraut -- Hand anderer Werber fallen -- einzig ärgern -- hören -- Reiser Soldat -- gleichsam betrügen -- 
  wirklich Vorsatz studieren -- Soldat -- wünsch Glück Vorhaben -- glücklich Reise -- 
  hiermit fort -- Reiser traut -- Strecke gehen -- auffallend begegnen -- bucklig Mann -- Schwein hertreiben -- lateinisch anreden -- Student halten -- 
  Gastwirt Orschla -- wovon Schulmeister -- -- Fuß -- seinigen holen -- -- fues -- Schwein holen -- Schulmeister Orschla Deklination dekliniern -- Seinig erheben -- 
  sobald Reiser Freie -- gewahr -- aufgelauert -- unerwartet Glück - Gefahr -- entronn -- -- ernsthaft künftig Leben nachdachen -- 
  erwog -- Leute ehrlich ansehen -- -- Universität studieren wollen -- 
  Idee selber zuwider -- dauern -- Kulisse Lichter Einbildungskraft hervortraten -- Aussicht weichen müssen -- 
  wandert Mittag ziemlich unbequem Weise -- Boden trocken -- wobei Schrecken Schuh leiden anfingen -- Umstand gewissermaßen unersetzlichen ausmachen -- 
  fühlt drohend Verlust Schritt -- Mittagsstunde Himmel Wolke umziehen -- Regenguß prophezeien -- einstellen -- Reiser Wanderschaft zweitenmal unterbrach -- 
  Glück erreichen Jägerhaus -- mitten umh Wald umgeben Feld liegen -- voll Zutraun einkehrn -- höflich aufnehmen bewirten -- 
  -- Empfang vorbereiten -- freundschaftlich nehmen Leute einsamen Wohnung -- 
  -- Leute verständ -- Wetter Wanderer aufnehmen müssen -- 
  hören regnen -- Leute nötigen selber -- Nacht bleiben -- 
  Abendessen nötigen -- verbat Reiser -- hinlänglich Gelde versehen -- Bewirtung bezahlen -- weit Reise -- außerordentlich einschränken müssen -- worauf Jäger Art Unwillen Tisch ziehen -- 
  Reiser Gefühl gleich -- unbekannt Mensch aufnehmen sehen -- 
  finden -- Haus -- weisen Nacht Bette -- erstenmal Wanderung bieten -- 
  weckt Frühstück -- nötigen -- bleiben -- Immerfort regnen -- 
  Mann Holz -- verweisen Reiser Bibliothek -- unterhalten -- 
  Bibliothek bestehen Sammlung alt Kalender -- Totengespräch -- Geschichte göttingschen Student -- erfurtisch Wochenblatt -- Bürger Bauer -- Bauer Thüringische Dialekt sprechen -- Bürger hochdeutsch Sprache antworten -- 
  Reiser amüsiert herrlich Sache -- Gedanke Raum -- gütig Wirt Wirtin weniger Wort -- Geringst neugierig -- fragen -- wohin gehen -- woher kommen -- Gedanke stören -- 
  gastfreundlich Stube Fenster -- wodurch über Feld Holze -- indes Regen draußen stromweise ergoß -- bleiben einer angenehmst Bild Reiser Gedächtnis -- 
  Himmel aufgeklären -- Reiser Wohltätern Abschied -- suchen sogar ersparen -- nennenswert Kleinigkeit Gelde -- Bezahlung dreitägig Bewirtung annehmen -- wegging Name fragen -- 
  Andenken Leute Reiser froh Stunde -- Mut zutrauen Mensch -- -- Ozean -- verlieren -- 
  Weg gestrig Regen ziemlich beschwerlich -- Sonne heiß scheinen -- trocknet Boden -- Reiser erreichen Mittag Reichsstadt Mühlhausen -- neu ungewohnt Anblick -- Türmen liegen -- 
  stehen -- warnen -- meister Gefahr Werber bevor -- -- 
  diesmal möglich Mühe -- ehe Tor -- sorgfältig Toilette -- versucht Rolle unbefangen Spaziergänger gelingen diesmal -- Hildesheim -- -- Schildwach befragen -- glücklich durch Tor Stadt -- 
  Stadt eilen schnell -- erkundigen Tore Weg Erfurt -- verdoppeln Schritt -- Soldatenkleidung Ähnlich fern erblicken -- 
  froh schüttelt Staub Füßen Stadt -- letzter Schlagbaum zurücklegen -- preußisch Werber -- 
  grün Turmspitz bleiben einzig Bild -- Häuserhaufen -- übrig verlosch -- schnell Einbildungskraft Gegenstand hinweggleiten -- 
  nähert Ziel Reise -- betrachtet Zurückgelegt still Vergnügen -- wobei Sparsamkeit hart Lebensart süß Triumph gewähren -- Beschwerlichkeiter beinahe überstehen -- 
  Demungeachtet fühlen wiederum Art Ängstlichkeit -- Zwischenraum ungewissen Aussicht -- 
  -- Einbildungskraft Anstoß gelitt -- Wirklichkeit -- hindernissen kämpfen -- Voraus darstellen -- 
  dünken Reiser leicht -- schön angenehm Aussicht weit Welt wandern -- Ort Stelle -- Aussicht -- 
  Reiser gerne Ziel weggewünscht -- Stande -- Wanderung fortsetzen -- 
  traurig Bemerkung -- Schuhe -- Verlust -- Umstand -- worin befinden -- unersetzlich -- hemmen weit Aussicht -- -- ernsthaft Zustand nachdachen -- 
  merkwürdig -- verächtlichst wirklich Ding -- Weise glänzendst Gebäude Phantasie eingreifen zerstören -- verächtlich Ding Mensch Schicksal beruhen -- 
  Reiser Glück -- Welt -- hing eigentlich Sinn Schuhe -- übrig Kleidungsstück veräußern -- Anstande erscheinen -- machen zerrissen Schuh -- ersetzen -- übrig Anzug unscheinbar verächtlich -- 
  versetzen -- Weg Langensalze begreifen -- traurig schwermütig Gedanke -- Bauer Handwerksbursch -- Wege gehen -- gesellt -- Gespräch unterhalten -- 
  Handwerksbursch erzählt Reise Kursachsen -- Bauer Klagesache -- Dresden Kurfürste anbringen -- 
  Mittag drückend Hitze -- 
  handwerksburschen drückt Stiefel -- Reiser Tritt Schuh verschlimmern -- Bauer klagen entsetzlich Durst -- Feld Arbeitsleute antrafen -- Eimer Wasser stehen -- ermüdet Wanderer trinken geben -- 
  Szene -- unbekannt -- voneinander entfernt Mensch nahe zusammenfind -- gemeinschaftlich Bedürfnis -- gemeinschaftlich Trost Zuspruch aneinander -- Unbekannt entfernt voneinander sein -- halten Reiser Unangenehme Wanderung schadlos -- innig Vergnügen zurückerinnern -- 
  Gefährt verlassen Stadt Langensalze -- aufhieln -- nächster Ort erreichen suchen -- übernachten -- 
  spät Gasthofe -- letzter Nacht Ankunft Erfurt zubrachen -- 
  -- erwachen -- Gedanke Schuster -- Freude -- Ort finden -- Groschen -- warten -- Schuh dauerhaft Stand setzen -- groß Verlegenheit befreien -- 
  rasch Erfurt -- -- 
  kleiden -- erscheinen -- Mut Zutrauen selber -- 
  letzter Dorfe Erfurt lassen Trunk Bier geben -- -- 
  Gasthofe lebhaft -- 
  bemerken Nähe Stadt -- Einwohner befinden -- Gelehrter -- Werk sprechen -- 
  Dorfe bekommen Reiser Stadt Erfurt Gesichte -- alt Dom -- Türm -- hoch Wälle -- Betersberge -- 
  -- Vaterstadt Freund Philipp Reiser -- wovon erzählen -- -- 
  Weg Stadt Kirschbaum pflanzen -- 
  --- Hitze Mittagssonne legen -- Leute gehen Tor spazieren -- Reiser Weg Hannover zurückdachen -- -- hierher leicht Spaziergang -- klein dünkt Zwischenraum -- zurücklegen -- 
  Stadt sehen -- Anblick neu ungewohnen -- breit schön Straße -- Anger -- enthalten -- Stadt umherzugehen -- ehe Stab setzen -- nächster Dorfe -- Weg Weimar liegen -- 
  Wanderung Straße Erfurt vorstädter -- kehren -- spät -- Gasthofe -- 
  sitzen Wirt -- dick Mann -- Fenster -- Reiser fragen -- Eckhoffsche Schauspielergesellschaft Weimar -- 
  -- antworten -- Gotha -- 
  Reiser fragen -- Wieland Erfurt -- 
  -- antworten -- Weimar -- 
  -- sprechen jedesmal Art Unwille -- verdrössen -- -- sagen -- 
  hart Antwort dick Wirt -- verrücken Reiser Plan -- -- 
  Weimar eigentlich Sinn richten -- glauben -- unerwartet Kombination finden -- angebetet Verfasser Werther leiden sehen -- klingen Gotha Weimar Ohren -- 
  lassen irren -- stehen eilig -- Abend Weg Gotha begeben -- -- streng Regel abweichen -- nächster Dorfe übernachten -- 
  Ehe Sonne untergehen -- Erfurt Rücken -- ehe Nacht -- erreichen Dorf Weg Gotha -- -- 
  Dom alt Turm Erfurt machen neu Bild Seele -- heraustragen -- Wiederkehr Ort einladen scheinen -- 
  Dorfe -- einkehren -- Letzt Streue unruhig Nachbaren -- 
  nämlich Fuhr Leute -- zn aufstand -- grob Dialekt miteinander unterhieln -- worin Wort vorkommen -- höchst widrig Reiser Ohr tönen -- Menge häßlich Nebenidee begleiten -- Bauer sagen nämlich -- 
  quam anstatt -- 
  quam scheinen Reiser Wesen ausdrücken -- Grobheit quam -- voll Backe aussprechen -- gleichsam zusammengedrängen -- 
  Reiser eingeschlummeren -- wecken verhaßt Wort -- Nacht traurigsen -- Streue zubringen -- 
  anbrach -- schwammig aufgedunsen Gesicht Schlafkamerad -- vollkommen quam übereinstimmen -- Ohr gellen -- Gasthof verlassen -- früh stark Schritt Gotha zuwanderen -- 
  Nacht schlafen -- Gedanke Weg Gotha heit -- wozu -- Schritt Aussicht eng -- Phantasie Spielraum -- 
  Sonntage -- Schuster -- Woche auf Land gehen -- Schuld einfordern -- kehren Gotha -- -- teuer leben -- 
  Nachricht Reiser bedenklich -- ungefähr Gulden Vermögen -- Schicksal Gotha entscheiden müssen -- 
  -- Gespräch Schuster -- Einwohner Gotha Not klagen -- unterhaltend -- stimmt Idee herab -- wirklich Leben Stadt denken -- Mensch kennen -- zweifelhaft -- Schicksal nehmen -- Wunsch merken -- 
  unangenehm Reflexion machen -- Weg beschwerlich -- Schritt müd -- Türmch Gotha zeigen -- wovon Schuster -- Kirche -- Komödienhause ständen -- 
  angenehm Kontrast lebhafen sinnlich Eindruck -- Gemüt allmählich erheitert -- verdoppelt Schritt Gefährt Atem setzen -- 
  Türmch bezeichnen deutlich Fleck -- unmittelbar laut Beifall eingeernten -- Wunsch ruhmbegierig Jüngling krönen -- 
  Platz behauptet geweiht Tempel -- Tempel -- Kunst Muse weihen -- Talent entwickeln -- Empfindung Herzen geheimst Falte lauschend Publikum enthüllen -- 
  -- Ort -- erhaben Tran Mitleid Fall Edlen geweinen -- lauter Beifall Genius zugejauchzen -- Seele täuschen -- Herz schmelzen wissen -- 
  Mitleid tote Ehre lebend schön Lösung -- Reiser leben weben Element -- -- Vorwelt empfinden -- nachempfinden -- Szene Leben Raume durchleben -- 
  -- Menschenleben -- Abwechselung mannigfaltig Schicksale -- Anblick Türmchen gothasch Komödienhause -- Reiser Seele Bilde darstelln -- worin Klage Schuster -- begleiten -- Sorge -- Meer verlieren -- 
  -- einzig Gulden Tasche fühlt Reiser beglücken König -- Reichtum Bild vorschweben -- Spitze Türmchen Gotha umgaukelten -- Reiser schön Traum Zukunft auf vorspiegelten -- 
  Stadt -- lassen Reiser Gefährte voran -- setzen gemächlich Baum -- -- Kleidung Ordnung bringen -- stattlich Weise Gotha Einzug halten -- 
  gelingen -- Handwerksleute -- Tore Gotha spazieren gehen -- vornehmen Manne Hut abzog -- Reiser Verwunderung setzen -- Reise Fuhrleuten Streue schlafen -- glänzend Figur spielen -- 
  alt Tor Gotha dunkel Straße -- hinaufgieng -- Seite Gasthof golden Kreuze ansichtig -- einkehren -- Gasthof glänzendsten scheinen -- 
  Hereintrat -- finden vorn Gaststube Schwarm Handwerksburschen -- Schri lärmn -- umkehren -- alt Wirt -- freundlich anredet fragt -- logieren wollen -- 
  Reiser erwidern -- Herberge Handwerksburschen -- 
  täen -- Wirt -- sollen Logis zufrieden -- hierauf nötigt Reiser wohleingerichtet Stube -- alt Hauptmann -- Hoflaquai -- wohlgekleidet Leute -- Gesellschaft Reis Wirt introduzieret -- höflichster behandeln -- 
  einzig unbescheiden neugierig Frage -- beweisen schmeichelnd Aufmerksamkeit -- 
  Zimmer stehen Flügel -- jung Mann Namens Liebetraut hören lassen -- 
  Liebetraut kurz zufällig Weise Gasthof eingekehren -- alt Wirtsleut -- zureden -- gerne Ruhe setzen -- Gasthof Pacht übernehmen -- eigentlich Wirt -- obgleich alt Anweisung geben -- Wirtschaft bekümmern müssen -- 
  jung Liebetraut lassen Reiser Gespräch schön Wissenschaft Dichtkunst -- zeigen Mann fein Geschmack Bildung -- sonderbar -- scheinen undeutlich anzuspielen -- Reiser hierher kommen -- Theater widmen -- 
  lassen -- Stube anweisen -- -- 
  sammeln Gedanke -- Plan -- Besuch schauspiel Eckhof -- Anliegen vortragen -- 
  Stube Gedanke beschäftigen -- Fenster stehen -- kommen Chorschüler Haus singen Motett -- Reiser Schuljahre Wind Regen mitgesungen -- 
  erinnern trüb Zeitraum Leben -- Mißmut -- Selbstverachtung äußer Druck Schimmer Freude rauben -- Wunsch fehlschlugen -- schwach Strahl Hoffnung übrig bleiben -- 
  -- denken -- Morgenröte Dunkel hervorbrechen -- -- 
  trügerisch täuschend Hoffnung scheinen sagen -- -- selber Qual -- Freude selber -- glücklich Wendung Schicksals entfernen -- 
  höchst Glück Schauplatz -- einzig Ort ungenügsam Wunsch -- Szene Menschenlebens durchleben -- befriedigen -- 
  Kindheit Existenz -- ziehen jeder Schicksal -- -- desto stark -- schreiben Schuljahr -- Wut -- Komödie lesen sehen -- 
  -- jeder fremd Schicksal fühlen gleichsam entreißen -- finden Lebensflamm -- selber Druck außen beinahe erloschen -- 
  echt Beruf -- rein Darstellungstrieb -- anziehen -- 
  liegen -- Szene Leben -- darstellen -- 
  -- Kunst Opfer fordern -- 
  seinetwill Lebensszen spielen -- ziehen -- gefiel -- treu Darstellung liegen -- -- 
  täuscht -- echt Kunsttrieb -- bloß zufällig Umstand Leben gründen -- -- 
  Täuschung -- leiden verursachen -- Freude rauben -- 
  sicher Kennzeichen empfinden gewußt -- Kunst vergessen -- Künstler gebären -- vergeben Anstrengung -- verloren Kummer ersparen -- 
  Schicksal Kindheit -- leiden Einbildungskraft dulden -- wirklich Zustande immerwährend Mißlaut herrschen -- schön Traum nachher bitter Qual rächen -- 
  lang Wanderschaft bringen Reiser Nacht Gotha sanft Schlummer -- früh erwacht -- Lisuart Dariolette Schluß Arie -- verwünscht alt singen -- entgegen Tönt -- -- Sorge Erwünscht bringen -- 
  zeilen Gedanke schweben -- ziehen -- erkundigt jung Wirt -- Eckhof wohnen -- Vormittag Besuch -- 
  halten gedruckt Prolog Bereitschaft -- Hannover verfertigen Island sprechen -- vorzüglich Eingang finden hoffen -- 
  jung Gastwirt Liebetraut nötigen vorher Frühstücke -- scheinen Umgang besonderer Vergnügen finden -- anfing -- vertraute Herzensgeschicht -- bestehen -- Gasthof pachten -- jung Frauenzimmer -- lieben -- eher heiraten -- 
  Reiser Eckhof -- Weg drängen Entwurf -- Anfang Wanderung -- Seele -- nah Ziel Reise -- Melodie Vers Lisuart Dariolette tönt Ohr -- diesmal täuscht Hoffnung -- -- 
  Eckhof empfangen Erwartung -- unterhalten beinahe Stunde -- 
  Reiser jugendlich Enthusiasmus Schauspielkunst scheinen Greise mißfallen -- lassen Gegenstand Kunst -- mißbilligen -- Theater widmen -- wobei hinzufügen -- freilich Mensch fehlen -- eigen Trieb Kunst -- äußerer Umstand bewogen -- Schaubühn widmen -- 
  aufmunternd Reiser -- Bemerkung -- denken Geist Schüler vortrefflich Meister -- 
  ziehen gedruckt Prolog hervor -- Eckhof vollkommen Beifall erhalten -- sogar Ausbat -- bemerken -- nahe Talent Schauspieler Dichter miteinander verwanden -- eins gewissermaßen voraussetze -- 
  Reiser fühlen Augenblick glücklich -- jung Mensch fühlen -- vierzig Meile trocken Brot Fuß reisen -- Eckhof sehen sprechen -- Anführung Schauspieler -- 
  Engagement anbeträfe -- Eckhof -- müssen vorzüglich Bibliothekarie Reichardt melden -- Reiser sprechen wollen -- 
  Reiser versäumen Augenblick Anweisung folgen -- Eckhof -- Bäckerhause wohnen -- Haus Bibliothekarie Reichardt -- höflich empfangen -- Eckhof einlassen -- 
  Indes debütroll Hoffnung -- Reiser hoch Wunsch -- kommen -- zweifeln -- Endzweck erreichen -- 
  Heiterkeit Gesicht kehrt Haus -- Anfang Unternehmung höchst glücklich halten -- günstig Umstand zutrauen -- Wunsch fehlschlagen können -- 
  Wirt entdecken -- scheinen zweifeln -- Gotha bleiben -- theatralisch Laufbahn antreten -- 
  voll zutrauen Schicksal -- bringen Reiser Gesellschaft alt Hauptmann -- Hoflaquaien Wirt Mittag höchst angenehm -- voll schimmernd Aussicht -- worin bestärken -- überschriten Mittagsessen erstenmal Tanmel Freude -- Bestand Kasse -- dünken desto fest Ort hartnäckigste Verfolgung Plan binden -- 
  fast täglich Eckhof Besuch -- raten -- für Probe Schauspielhause fleißig besuchen -- Reiser -- alt Eckhof Element -- Kleinigkeit aufmerksam -- Schauspieler Erinnerung -- 
  Reiser erlauben -- Komödie unentgeltlich besuch -- erstemal gewiß Bindrim Vater Zaire debütieren -- 
  besonderer Beifall finden -- Reiser fühlen -- meister Stelle Ausdruck -- Spornte -- selber debütroll Schauplatz betreten -- liegen Eckhof dringend -- nächstaufzuführend Stück Rolle zuteilen -- 
  nächstemal Poet Mode aufführen -- Reiser Vorschlag Rolle Dunkel übernehmen -- Eckhof Grund widerraten -- Rolle spielen -- angehend Schauspieler ratsam -- Rolle zeigen -- alt geübt Schauspieler sehen wohnen -- 
  verschieben Debüt Spieltage -- Hoffnung nähren -- Entscheidung Schicksal beruhen -- 
  Eckhof holen Reiser Trost Hoffnung -- Anfing verzagen -- gerne unterhalten -- flößt Selbstzutraue Mut -- 
  Demungeachtet paar Äußerung Eckhof äußerst niederschlagend -- Engagement Rede -- Reiser jung Mensch berufen -- Poet Mode Rolle Reimreich spielen -- Eckhof -- vorzüglich Jugend annehmen -- scheinen verstehen geben -- Beweggrund Reiser finden -- neunzehn alt -- scheinen -- alt halten -- Verlust Freude Jugend -- Anschein Jugend bleiben -- 
  andermal -- Got sprechen -- Eckhof -- ungefähr Reiser Statur -- physionomirt -- Schauspieler Reiser vernichten -- Eckhof zufällig Weise Aufmunternde -- fragt -- Prolog dichten -- Reiser bejahen -- sobald Haus -- Vers -- auswendig wissen -- niederschrieb -- Eckhof überbringen -- 
  bringen paar Arbeit -- Wirt geraten Gedanke -- Reiser dramatisch Werk Schaubühne verfertigen -- -- 
  lassen Weise ausreden -- wünschen Reiser voraus Glück glänzend Laufbahn -- betreten -- 
  Eckhof Gedicht lesen -- bezeigen Reiser Beifall -- -- wollen Bibliothekarie Reichardt lesen geben -- 
  Reiser Aufmunterung Gleichen -- Eckhof Ausspruch erinnern -- nahe Schauspieler Dichter aneinander grenzen -- 
  zweifeln -- Gedicht Weg Theater bahnen -- Ziel nah bringen -- 
  -- Schauspieler Großmann -- Gotha aufhieln -- Reiser -- Straße begegnen -- Mut zusprach -- Grund anführt -- gewiß solange aufgehalt -- gesonn -- -- Debüt -- Theater engagieren -- Woche -- Reiser aufhieln -- 
  tröstend Wort freundlich Anrede Großmann wahr Balsam Reiser -- Schlos -- bauen -- einsam nieder -- finster Unmut ungewiss Schicksal nachdachen -- 
  Reiser Hoffnung Haus -- bringen Wirt vergnügen -- 
  Probe -- führen Operette -- Deserteur -- -- worin fremd Schauspieler -- Namens Neuhaus -- Deserteur -- Frau Lilla spielen -- 
  Eckhof beweisen Probe geschäftig -- Reiser stehen Kulisse -- Vergnügen -- Anstrengung Aufmerksamkeit einzeln schön Werk entstehen -- Abend Zuschauer vergnügen -- 
  denken lebhaft Nähe reizend Beschäftigung finden -- schauplatz Spiele Schicksal entscheiden -- Existenz Fleck entwickeln -- 
  -- engumschränkt Schauplatz weit Reise Wunsch beschränken -- -- finden -- schließen Zukunft reichen Schatz golden Phantasie -- lassen schön schönere Ferne blicken -- -- 
  Kulisse Gedanke vertiefen gestehen -- stehen diesmal -- Bibliothekarie Reichardt zukommen -- entscheidend Antwort erwarten -- 
  Mien verkündigen -- redet Reiser trocken Wort -- täte leid -- sagen -- Engagement Theater -- Debütrolle können -- Wort Reiser geschrieben Gedicht -- gleichsam Trost hinzufügen -- herrsch leicht Versifikation -- sollen Talent vernachlässigen -- 
  Reiser Leib Seele lähmen -- Wort hierauf antworten -- -- Theater letzter Vorhange kahl Mauer grenzen -- stützen verzweiflungsvoll kopf Wand -- 
  unglücklich -- doppelt unglücklich -- eingebildet wirklich Mangel treten fürchterlich Eintracht -- Gemüt Schreck grau Zukunft erfüllen -- 
  Ausweg Labyrinth -- Torheit leiten -- kahlen öde Mauer -- täuschend Schauspiel -- 
  eilen vor Tor hinaus -- Allee -- angenehmst Vorstellung beschäftiget -- verzweiflungsvoll nieder -- Mensch gehen kalt vorbei -- wissen -- Augenblick einzig Hoffnung Leben verlieren -- verlassensen Mensch -- 
  sonderbar -- verlassensen Zustande -- unbekannt Gefühl Liebebedürfnis regen -- Verzweiflung Mitleid Zustande verwandeln -- Wesen fehlen -- Mitleid -- 
  getraut Mittag -- Haus -- aß -- kehren Nachmittag -- Abend Komödie -- Operette -- Deserteur aufführen -- Tod Hoffnung bezeichnen -- 
  Leben Teilnahme fremd Schicksal stark -- Abend Schicksal liebend -- drohend Todesstreich trennen -- 
  treffen -- Homer Mädchen -- erschlagen Patroklius weinen -- beweint Schicksal -- 
  Musik rühren Träne -- Ausdruck erschüttert Innerst -- 
  stark fühlt Szene bewegen -- Deserteur -- Todesurteil wissen -- Gefängnis Geliebte schreiben -- betrunken Kamerad Ruhe lassen -- Wort Buchstabiere lehren -- 
  Reiser fühlen tief -- Mensch Mensch -- Schicksal liegen -- Freund Hutkokarde stehen Seele -- 
  weswegen putzt Hutkokarde -- Mädchen -- Einzige fallen -- Göttin -- wiederfinden -- gelieben -- 
  Schauspiel endigen froh -- Unglücklichen trösten -- Wein verwandelt lachen -- Trauer Fröhlichkeit -- betrüben schwer Herz Reis Wohnung -- dunkel -- Strahl Hoffnung -- 
  Haus -- legen sogleich Bette -- Sinn Stumpf -- Gedanke wissen Ausweg finden -- Schlaf einzigen -- übrig bleiben -- 
  -- Schlafe erwach -- Lebensaussicht abschneiden -- Hoffnung -- wozu erwach -- Gedanke Auflösung -- gänzlich vergessen -- Aufhör Erinnerung Bewußtsein süß -- Nacht Wohltat Schlafe reichsen Maß Genoß -- 
  leise Wunsch hemmen gänzlich Abspannung Seelenkräft -- Traum täuschend Hoffnung schweben -- vorbei -- endigen ewigstill Nacht Grabe -- 
  wohltätig reichen Natur Hoffnungslose Schale dar -- Vergessenheit leiden trinken -- Erinnerung -- wünschen -- wonach strebt -- Seele verwischen -- 
  Reiser spät tiefem Schlafe erwachen -- fühlen wunderbar Leib Seele stärken -- fühlt Kraft -- unternehmen -- Umstand Ziel Wunsch gelangen -- 
  steigen Gedanke -- Unterrichtsstunde bewerben -- fleiß nähren -- Theater umsonst dienen -- 
  --- Entschluß lebhaft -- traut Kräfte -- sobald Schimmer Hoffnung -- Ziel erreichen -- 
  Gedanke ziehen -- Eckhof -- Entschluß entdecken -- Rat ausbat -- versichern -- leben können -- Art -- leben dächen -- merken lassen -- 
  Eckhof loben billigt Standhaftigkeit -- -- zweifle -- Anerbiet annehmen -- 
  Bibliothekarie Reichardt -- Reiser Entschluß -- versprechen -- Bescheid geben -- 
  kehrt Reiser voll neu Hoffnung Haus -- Beginn selber ehrenvoll -- Kunst Fleiß nützlich Geschäft nährendem Erwerb verbinden - übrig Stunde Kunst Opfer bringen -- 
  aß Mittag voll zutrauen Wirt -- fühlt unwiderstehlich Mut -- Kunst Liebe -- Härteste Leben ertragen -- notwendigsten Bedürfnis einschränken -- Nacht ruhen -- Kunst üben -- Unterrichtsstunde gehörig abwarten -- 
  Entschlüssen -- heroisch Mut einflößten -- Reichardt -- hören Endurteil -- Anerbiet -- umsonst Theater dienen -- einlassen können -- schlechterding neu Engagement Theater finden sollen -- 
  -- Reiser Woche eher kommen -- lassen -- vergeblich -- 
  -- unerwartet abschläglich Antwort versetzt Reiser Art inner Erbitterung - fing Augenblick -- hassen -- verachten -- fragen -- Souffleur -- Rollenschreiber -- Lichtputzer Theater können -- 
  -- Reichardt antworten -- 
  täte Leid -- Reiser Feuer für Theater verrien -- Unternehmen mißlungn -- indes anderwärts gelingen -- 
  Reiser tief Gedanke Reichard weg -- Bau Schloß nieder -- Schiebkarren Stein zuführten -- ordneten -- -- 
  stehen Stunde -- Arbeit -- entstehen sonderbar Begierde -- Kleid auszuzieh -- übrig Tagelöhn stein Bau Schiebkarren herbei führen -- 
  Mittag -- Sonne scheinen Heißer -- 
  -- Hand Arbeiter laß -- ruht -- verzehrt Erde Mittagsmahl -- 
  -- Reiser Wort -- fragen -- Tagelohn betrügen -- 
  Anzahl Groschen -- Reiser Vermögen -- Geld verdienen -- 
  Entschluß -- Tagelohn arbeiten -- Augenblick Reiser gewiß -- innerlich lachen müssen -- Arbeiter -- sprechen -- Mütz abnehmen -- wissen -- Kamerad -- 
  einzig -- Erbitterung -- Selbsthaß Selbstverachtung milderen -- Entschluß -- worin ehren -- 
  wahr Zustand Wirt entdecken -- Deg -- Kleid Bezahlung lassen -- Schloßbau Stein zuführen -- 
  Gedanke vorging -- glauben -- wahrer Ernst -- wissen -- Einbildungskraft täuscht -- Gedanke Rolle spielen -- 
  Handlanger Schloßbau Niedrigste -- -- gewählt freiwillig Niedrigkeit außerordentlichen Reiz -- leben übrig Stande -- Sonntag fleißig Kirche -- still religiös Mensch -- einsamen Stunde ergötzt Shakespeare Homer -- dasjenig reell Leben -- -- 
  rührend dergleich Vorstellung Gedanke -- Sonntage fleißig Kirche -- Prediger aufmerksam zuhören -- 
  -- hierdurch vernichten gleichsam -- -- schlecht Prediger sagen -- lehrreich halten -- klüg einfältigst Mensch -- 
  denken Zustande -- worin Hutmacherbursch -- Prediger -- gefiel -- Wesen hoch Art -- Chorschüler Straße Ehrfurcht betrachten -- 
  Theater Zustande Begriff -- -- Zustand wunderbar Weise Wunsch nah bringen -- 
  Ehe Stelle Tagelöhner Bau Schloß bewerben -- unterlassen -- Eckhof -- Lebewohl sagen -- erzählen -- letzter Hoffnung scheitern -- 
  Erzählung Beklemmung Rührung vorbringen -- nunmehrig Zustand -- denken -- -- 
  -- Eckhof reden -- 
  sollen Mut sinken lassen -- Meile eisenach Barzantische Truppe -- fehlen -- Truppe annehmen -- sollen Weile üben suchen -- Gotha -- günstig Umstand ereignen -- Aufnahme desto leicht -- Zeitlang Truppe stehen -- -- können versuchen -- Weg Gotha Eisenach Chaussee Spaziergang -- 
  Anrede Eckhof Projekt Stein zuführen -- Arbeit um Tagelohn Reiser Gedanke verschwinden -- 
  - Ziel -- wohin -- nahe -- Bedenklichkeit hören -- Weg Gotha Eisenach Spaziergang denken -- wodurch Untreue Wirt begehen -- Eisenach Schauspieler -- eher leicht -- Tagelöhnerarbeit bezahlen -- 
  -- Mittag -- Eckhof Haus -- -- umzuseh -- Eisenach -- 
  Weg -- Spaziergang -- 
  erstorben Hoffnung Seele erneuern -- machen lebhaft angenehm Kontrast melancholisch Idee -- womit Vormittage Tagelöhner verdingen -- 
  denken nah Gotha -- zurückkehren -- Wirt angenehm Nachricht bringen -- 
  -- Schönheit Natur ergötzn -- wandeln innig vergnügen romantisch Täler Berg -- Turm alt Wartenburg -- Kindheit gehören -- erblicken -- umfaßt Gemüt Gegenstand umh Wärme Anschließung -- doppelt schön -- -- süßen Traume schweben -- worin -- ehemals denken -- einer darstellen -- 
  -- allenthalben -- -- weniger Stunde Gotha Eisenach versetzen -- woran desselbig Tag denken -- 
  Überrock Sache -- tragen -- Haus lassen -- wanderen -- Anzug -- Degen Seite -- Reichardt Eckhof Besuch -- Eisenach -- 
  Zufälliger Weise stecken geschrieben Gedicht -- lateinisch Anschlagboge -- worauf Nahme stehen -- Rocktasch -- Homer -- Wäsche -- tragen -- samt Überrock zurückbleiben -- 
  Stadt -- scheinen froh heiter ansehen -- Mensch scheinen gleichsam Freude stimmen -- lauter froh Ahnung Gasthof treten -- Nacht bleiben -- -- niedergesetzen -- erkundigen -- Abend Komödie spielen -- 
  Welch Donnerschlag -- antworten -- 
  Barzantische Schauspielergesellschaft Mühlhause abgereistn -- -- 
  -- feindselig Schicksal Fuße nachfolgen -- ordentlich Absicht Hoffnung vereiteln -- 
  -- Einbildung -- doppelt unglücklich -- einzig Hoffnung -- Unterhalt finden -- Schuld Gotha tilg -- Annahme barzantisch Truppe Eisenach beruhen -- Weg nehmen -- hergekommen -- 
  Zustand bringen Verzweiflung nahe -- -- erstenmal Schicksal wegsetzen -- Art Vergessenheit geraten -- Anschein froh aufräumen -- -- unerwartet hämisch Streich Schicksal Verbindung losgesprochen -- vernachlässigt verworfen Wesen ansehen dürfen -- Betracht -- 
  genießen -- lassen Abend Bier Brot -- Nacht Bette geben -- sanftest Schlaf Genoß -- Zukunft rechnen -- einzig Gedanke Zukunft Schicksal stören -- Aussicht -- 
  fühlen -- wohltätig Schlaf auf schlummernd Kraft erwecken -- fühlt Lähmung gewiß trotz Erbitterung Schicksal -- wodurch Mut bekommen -- dulden -- wagen -- Endzweck dennoch erreichen -- 
  entschließen -- barzantisch Schauspielergesellschaft nachzureisen -- Eisenach Mühlhausen Weg -- kommen -- zurückgehn -- 
  Gasthofe Zeche bezahlen -- bleiben Vermögen Dreier übrig -- womit Wartenburg steigen -- weit schön Gegend übersehen -- 
  Unteroffizier Wartenburg redet Reiser höflich -- fragt -- Merkwürdigkeit besehen -- worauf Reiser erwidern -- 
  Nachmittag Gesellschaft -- wollen Gegend umsehen -- 
  fühlen -- blicken -- Standpunkt -- Schicksal erhaben -- 
  Widerwärtigkeite ungeachtet Fleck kommen -- schön Moment reizend Aussicht umgebend Natur rauben -- 
  sammeln gleichsam Stärke Mühe sorgenvollen Wanderschaft -- auf antreten -- 
  Plan -- hierzu entwerfen -- bestehen Geringerem -- weniger Dreier -- übrig -- bloß Schlafgeld anwenden -- Wurzel Feld nähren -- Herweg Gotha versuchen -- paar Wurzel Feld auszuziehen -- -- genießen -- angenehm Erquickung gewähren -- 
  Hieran Erwachen erinnern -- vorzüglich -- Trotz Schicksal einflössen -- beinahe unabhängig denken -- 
  fing -- Entschluß Selbstgefühl durchsetzen -- womit Wanderung bloß Genuß Bier Brot beschränken -- fühlen doppelt unabhängig -- -- Unteroffizier Wartenburg Gesellschaft zurückerwaren -- Merkwürdigkeit Schlosses zeigen -- verzehrt Reiser Feld mal roh Wurzel -- alt Einlegemesser -- Freund Philipp Reiser besitzen -- Scheibe schneiden -- groß Wohlgeschmack verzehren -- 
  -- Wartenburg aufhalten -- Meile Eisenach -- überfiel -- Wurzel verzehren -- unwiderstehlich Trägheit -- mitten Feld einschlaufen -- Abend Sonnenuntergang erwachen -- 
  nächster Dorfe zugehen -- Weg -- erreichen spät Gasthof -- verzehren -- bloß Streue bezahlen -- 
  Dorfen verirrt Feld -- Wurzel suchen -- gestrig Trägheit überfiel -- Hitze drückend -- Schatten Baume finden -- legen nieder -- sogleich überfiel Schlaf -- Weg Eisenach Gotha -- Hinreise weniger Stunde zurücklegen -- beinahe zubrachen -- 
  labyrinthisch Schicksal -- Wanderung -- wissen herausfinden -- Gotha scheinen Straße zurückzubiegen -- müssen -- Weg Mühlhause fortsetzen -- Straße scheuen -- gewissermaßen leiben -- verirren -- 
  lateinisch Anschlagbog helfen Weg zweimal -- -- verdächtig Person halten -- Paß vorzeigen -- andermal -- Paß verlangen -- Gegend kommen -- Viehseuche herrschen -- zeigter lateinisch Anschlagbog -- fügen hinzu -- Student -- lateinisch Paß führen -- 
  -- Dorfrichter Schulze Orts -- Frau -- Bauer -- ansehen geben -- Latein verständ -- laß wichtig Miene Anschlagbog -- -- -- 
  Reiser Art Betäubung -- gleichsam Irre umhergieng -- herrschen bloß Imagination -- Feld leben -- scheinen binden -- lassen Einbildungskraft Zügel schießen -- 
  Schicksal romanhaft -- 
  Schauspieler -- Wunsch mißlungn -- abgeschmackt Rolle -- spielen -- müssen Verbrechen begehen -- Irre umhertreiben -- Verbrechen denken -- 
  stellen -- jung Edelmann -- H. -- unterrichtet -- Universität Göttingen beziehen -- Trunk Zweikampf nötigen -- bloß verteidigen -- wütend Deg rannen -- worauf Flucht nehmen -- wissen -- tot lebend -- 
  gemacht Erdichtung drängen Herumirr Feld -- fast Wahrheit -- träumen -- einschlief -- Gegner Blut liegen -- deklamieren laut -- erwacht -- spielt Weise Phantasie mitten Feld Gotha Eisenach Rolle -- Theater verweigern -- 
  -- Verzweiflung retten -- Zustand völlig leer abschmacken denken -- -- weggeworfen -- Schmach versinken -- 
  Bitterste erträglich -- -- Rückkehr Eisenach Gotha -- Sonntag -- drückend Hitze -- 
  Reiser Felde Dorf suchen Schatten -- finden -- grün Baum bepflanzten Platz Kirche -- 
  lassen Bauernhause Glas Wasser geben -- legte Bäume nieder -- Kirche singen -- singen schlief -- wachten eher -- Prediger Kirche -- Sohn -- Universität zurückgekommen -- 
  gehen Reiser -- fragen -- woher kommen -- wohin gehen -- verwirrt Antwort -- gestehen -- Duell -- Göttingen -- flüchtig -- 
  selber -- Geständnis äußerst schwer -- Gedanke Unwahrheit Sache fallen fast -- 
  bloß Ideenwelt leben -- -- fest Einbildungskraft eingepragen -- Verhältnissen wirklich Welt hinausgedrängen -- drohen Scheidewand Traum Wahrheit Einsturz -- 
  Prediger nötigt Haus -- bewirn -- 
  -- Reiser -- gleichsam Angst treiben -- entfernen sobald -- 
  -- müssen imaginiert Zustande Gesellschaft Mensch fliehen -- 
  --- Nahe Gotha nötigen wiederum Prediger Haus -- halb unterhalten -- erzählen -- paar Fuß -- wohlgekleiden -- reisend Gelehrter durchgekommen -- unterhalten -- Kalend bemerken -- zweifeler fast -- Doktor Barth -- 
  erzählt Prediger Reiser Geschichte -- Hofmeister herumgetrieben -- alt Pfarre Ruhestätte finden -- -- Welt vorging -- fern Zusähe -- 
  Reiser erzählt Prediger imaginiert unglücklich Geschichte -- wobei Prediger Kaffeeschälch Erfrischung eingemacht Obst vorsetzen -- Mut zusprach -- Verbrechen können -- weiß Scheide Degen -- Reiser tragen -- fragen -- Degenscheide Zeichen Freimaurer -- Reiser Orden -- -- 
  Jemehr verneinen -- desto fest glauben Prediger -- demungeachten Freimaurer sehen -- Punkt entdecken -- 
  Prediger betrachtet Reiser manchmal Kopf Fuß -- scheinen sonderbar Vorstellung -- 
  -- halten Mensch -- verschweigen -- -- wissen -- dran -- -- 
  Demungeachtet unterlassen -- Frage -- Reiser -- Sonne Untergange neigen -- Abschied -- Prediger Ermahnung Weg -- vorzüglich Verbrechen Reue büßen -- 
  Unterhaltung Prediger Ermahnung Reiser Imagination erhitzen -- -- 
  Abenddämmerung Gotha -- Art hartnäckig Betäubung Fühllosigkeit -- dicht golden Kreuze vorbei -- logiern -- Tor heraus -- erstemal Gotha kommen -- Weg Erfurt -- Mühlhause -- Barzantische Schauspielergesellschaft erreichen -- 
  Gotha -- Verschwand allmählich imaginiert Geschichte -- Gotha Irre herumgetrieben -- Aussicht öffnen -- Gotha liegen -- Mittelpunkt Bestrebung -- eisenach -- hoffen Mühlhause -- besser Glück -- dorthin zurückkehren -- 
  dunkel -- ehe Dorf erreichen -- verirrt -- beinahe Meile -- indes zuletzt Straße -- langt Gasthofe -- Hinreise Erfurt Gotha -- widerwärtigsen Nacht -- Gesellschaft grob Fuhrleut zubringen -- Quam frisch Andenken -- 
  Gasthofe finden lebhaft -- Handwerksburschen Bauer Flur sitzend -- Reise Kursachse erzählen -- 
  Reiser Gasthof -- treten Wirt herzu -- gebot Erzähler Stillschweig -- spät Nacht -- -- schlafen legen -- 
  Handwerksbursch Bauer legen Streue -- zubereiten -- worauf Reiser Platz -- -- 
  Handwerksbursch Grobheit Wirts zufrieden geben -- einschlafen -- unzähligemal versichern -- Kursachsen Grobheit Wirt widerfahren -- 
  Reiser Dreier Schlafgeld bezahlen -- Vermögen Pfennig geschmolzen -- fing -- erschöpfen fühlen -- roh Wurzel mehrere einzig Kost -- Gedanke Meile -- -- Schrecken erfüllen -- fühlen gelähmt -- Raum Mühlhause furchtbar Wüste -- Labetrunk Stärkung reisen -- 
  Handwerksbursch -- Abend vorher Reise Kursachsen spät Nacht erzählen -- Weg Erfurt -- fragen Reiser Wege gehen -- bejaht -- wandern übereilt Schritt fort -- 
  Handwerksbursch -- Buchbindergeselle ziemlich betagen -- fragt Reiser Profession -- antworten -- 
  Schuhknecht -- finden ordentlich Art -- Schuhknecht nennen -- -- bloß Blendwerk Phantasie verfolgen -- -- 
  Buchbindergeselle scheinen Erzählung -- Reise Geschäft -- Gefährte Erfahrung zurückhaltend -- unterrichten -- -- Sommer Obstzeit -- halb Gulden weit Tour können -- Not leiden -- 
  obst -- meinen -- nirgends versagen -- Brot -- Weise brauchen Tag Pfennig verzehren -- 
  -- mehrmals Kursachse durchgereisen -- befinden -- halten Reiser würdig -- Orden initiieren -- Vorzug Annehmlichkeit reizendste Art beschreiben -- Leben voll immerwährend Veränderung Unabhängigkeit -- 
  -- Reiser fühlt Knie wanken -- Müdigkeit Schritt -- Augenblick -- einförmig abhängig Leben gerne gefallen lassen -- ruhig Aufenthalt dargeboten -- 
  Gefährt scheinen Kummer merken -- suchen Mut Trost einzusprechen -- nahe Erfurt kühl klar Quell kommen -- Buchbindergeselle -- drückend Hitze Durst löschn -- 
  wohltätig Quelle -- Einwohnern Erfurt -- Wanderer erquickend -- Reiser -- erschöpfen niederwarf -- Labetrunk -- Mensch fordern wagen -- unmittelbar -- Schatz Natur empfangen -- 
  -- erhalten Reiser doppelt Wert -- Poetische hinzutrugn -- -- wovon sagen -- einzig Schadloshaltung notwendig Folge Torheit -- -- natürlich Gesetz Schicksal Kindheit notwendig einflechten müssen -- 
  -- alt Türme Erfurt Tale emporstiegen -- Reiser hoffnungslos zurückwanderen -- kurz jugendlich Schimmer Hoffnung ausgereist -- fallen sonderbar -- Gefährt Buchbindergeselle -- 
  glauben -- Reiser Schuhknecht -- hielen Student -- Universität Erfurt studieren wollen -- 
  Reiser Hinsinken ermatten -- fühlen zufällig Wort Buchbindergesellen Leben zurückrufen -- 
  sobald Stadt -- nahe liegen -- studieren bleiben -- mühselig Wanderung -- Endzweck -- Ziel Reise -- nahe -- ehrenvoll Weise -- Plan umwechseln -- 
  Jemehr Müdigkeit zunehmen -- reizend wünschenswert Gedanke Aufenthalt weit Stadt -- worin -- denken -- Plätzchen finden -- 
  hoffnungslos traurig Zustand Umherirren -- worin mehrere befinden -- Reiz angespannten erhitzt Einbildungskraft übertragen -- Gedanke gänzlich Hilflosigkeit ermüdet Schritt -- Müdigkeit vermehrt Gedanke Hilflosigkeit -- vorzüglich sinken Mut Erschöpfung Kraft entstehen -- 
  kommen Stadt -- Bäckerhause vorbei -- Laden Menge Brot aufgetürmt liegen -- 
  Reiser einer aussuchen -- Berühret -- schoß beinahe Haufen brot Straße herunter -- 
  --- Leute Haus fangen Lärm -- Reiser müssen Gefährt schnell Ecke wenden -- Schmähung entgehen -- 
  verfolgt Reiser widrig Geschick auf äußerer -- 
  kehren Gasthofe -- Reiser durst widersteh letzter Pfennig -- übrig -- Bier geben lassen -- 
  Trunk Schlafgeld künftig Nacht ausgeben -- bleiben übrig -- frei Himmel wohnen -- 
  Gedanke -- Trunk Bier Vergessenheit Künftig trinken -- Kummer befreaten -- 
  Schicksal -- betrachten fremd Wesen -- denken -- unwiederbringlich verlieren -- schlummern -- Schlief Stundelang -- 
  erwacht -- Stunde Mittage -- Gefährte weggehen -- sitzen -- Kopf Hand stützen -- stumm Verzweiflung -- Mann -- sitzen -- anreden -- erkundigen -- fremd Student -- 
  Bejahet -- erzählt Mann -- gleichsam -- Reiser Zustand wissen -- jetzig Prorektor Universität -- Abt Benediktinerkloster Betersberge äußerst menschenfreundlich Mann -- Kurzem -- jung Manne -- hierhergekommen -- sogleich Unterstützung verschaffen -- menschenfreundlichster annehmen -- 
  Reiser Prälat besuchen -- sollen dreist -- gewiß gütig Aufnahme finden -- 
  hierauf kommen Leute -- Mann Gespräch -- 
  Reiser -- gänzlich Erschlaffung Seel Körperkraft -- wohltätig Schlummer -- hiervon Folge -- stärken -- fühlen neu Hoffnung neu Mut beseeln -- Prälat Benediktinerkloster Betersberge denken -- 
  sogleich Weg -- erkundigt Betersberge -- jung Student begegnen -- höflich Bescheid -- begleiten sogar Strecke -- gehörig zurechtzuweisen -- 
  Om -- 
  steigen befestigten Petersberg hinauf -- Wachen lassen ungehindert -- -- 
  Wohnung Prälat -- Bedienter freundlich Gesicht empfangen -- sobald -- Student -- sogleich Prälat melden versprechen -- 
  -- Treppe Saal führen -- Gemälde hingen -- Petrus vorstellen -- Hohepriester Haus Feuer wärmen -- -- 
  Reiser Blick Gemälde heften -- treten Prälat schwarz Ordenskleidung Brevier Hand heraus -- Reiser richten kurz lateinisch Anrede -- Hinaufsteigen Petersberg ausgedachen -- Inhalt -- widrig Glück umhergetrieben -- Erfurt kommen -- Unterstützung finden hoffen -- Weise angefangen Studium fortsetzen -- 
  Prälat fragt Leutseligkeit lateinisch Sprache -- katholisch Augsburgisch Konfession bekennen -- Reiser letzterer bejaht -- antworten Prälat fast Wort -- 
  täte leid -- Reiser widrig Glück umhergetrieben -- sehen -- Universität Unterstützung finden -- 
  Indes wollen Hoffnung benehmen -- 
  hierauf fragen Reiser Geburtsort -- Hannover nennen -- fahren Prälat fort -- 
  geben Rat Doktor Froriep wenden -- gewissermaßen Landsmann -- 
  melden -- -- 
  Wort drücken Reiser Stück Silbergeld Hand -- fügen hinzu -- 
  Mittagsmahl vorleiben nehmen -- 
  Mut Zerschlagenen aufrichten -- völlig Gesunken Verzweiflung retten -- Min Ton -- womit Prälat Günther Reiser Bitte beantwortet -- Rat erteilen -- 
  Behandlung beinahe Träne rühren -- eilt Reiser fort -- glauben träumen -- draußen Türe stehen -- Stück Geld besehen Besitz halb Gulden -- vorher Dreier Nachtlager fehlen -- 
  -- halb Gulden dünken unschätzbar Reichtum -- -- Mut einflößen -- woran Schicksal hing -- 
  Speisehause -- Genoß erstenmal warm essen -- 
  Tisch erkundigt Kaufmannskirch -- Doktor Froriep wohnen -- 
  treffen -- Nachmittag Kollegium lesen -- redet ähnlich Weise -- Abt Günther -- lateinisch -- 
  Doktor Froriep Reiser hören -- Hannover -- außerordentlich freundlich -- führen Hörsaal -- Student Hüten Kopf sitzen -- Reiser ungewohnt Anblick -- vielmehr -- merken -- aufhieln -- bedeckt bleiben -- 
  Erfurt -- Hörsaale Professor -- mitten Student sitzen -- Tag offen Feld -- durchwanderen -- Aufenthalt -- 
  Doktor Froriep las Kirchengeschicht -- wobei lustig Anekdot unterlaufen -- Auditorium aufmunteren -- Musensöhn schallenden Gelächter begleiten -- 
  Reiser Traum -- 
  erinnern Kindheit -- Hörsaal Schule heilig -- finden akademisch Hörsaal -- Höher -- 
  Kollegium -- Doktor Froriep Reiser Stube -- fragt Geschichte -- Wendung -- Hannover Schrift -- übel ausgedeuten -- Haß vornehm Mann zugezogen -- weggehen -- 
  -- Aussicht -- Gedanke kommen Theater widmen -- reiflich Überlegung Entschluß fahren lassen -- einsehen -- Zukunft Schritt schaden -- denken -- Erfurt auf studieren widmen -- 
  merkwürdig -- Reiser Lüge -- Kollegium Doktor Frorieps ausgedachen -- -- ehe -- Wahrheit verwandeln suchen -- jesuitisch selber täuschen -- 
  suchen nämlich Gedanke überzeugen -- Torheit Unternehmen vollkommen einsehen -- freiwillig Entschluß ändern -- fest Vorsatz bleiben -- gut Gelegenheit -- Schauplatz betreten darböen -- 
  Hälfte Lüge anbetreffen -- suchen einzubild -- Rede -- Königin Geburtstage halten -- verfänglich Stelle sein -- Nachteil ausgedeuten -- 
  geschehen -- berühren -- beruhigen diesmal Möglichkeit -- helfen wissen -- 
  sagen -- Neigung Theater Hannover gehen -- Trieb Studieren wahrscheinlich bleiben -- Duellgeschicht passen -- 
  Doktor Froriep scheinen glauben -- fassen hoch Idee Reiser -- erwarten -- lnd Sohn angesehen Eltern halten -- entzweiet -- Name verschwiegen -- 
  Reiser finden schmeichelhaft -- Meinung hegen -- desto -- gefällig Art Lüge zudecken -- Doktor Froriep Unwahrheit -- glauben -- entschuldigen -- 
  -- Erwartung -- 
  -- Doktor Froriep reden -- Mut -- wollen für Tisch Wohnung besorgen -- 
  Reiser Tag Welt verlassen -- traut tröstend Wort -- vernehmen -- glauben Doktor Froriep Augenblick Schutzengel sehen -- 
  -- schreiben paar Zeile -- womit Abt Günther -- Frorieps Bitte -- umsonst Student immatrikulieren -- 
  glücklich Wechsel Schicksals versetzen Reiser Zustand -- Widerwärtigkeite vergessen -- Wanderung Ungewisse gereute -- Zeitpunkt erleben lassen -- vollkommen Vorstellung -- Leben Hilfe entblößen -- Körper Seele gelähmt Aussicht Hoffnung -- 
  Freude Herzen eilt Gasthof -- Nacht bleiben -- lassen Papier holen -- fing -- Gedicht -- auswendig wissen -- nacheinander aufschreiben -- Doktor Froriep bringen -- einigermaßen Aufmerksamkeit wert zeigen -- 
  schreiben Nacht -- Heft fertig -- 
  früh steigen voll anderer Gedanke -- gestern -- Petersberg hinauf -- gutmütig Abt Günther freuen -- sehen -- gewährt Bitte -- fertigen sogleich Matrikel -- wobei akademisch Gesetz drucken übergeben -- Befolgung Handschlag angeloben lassen -- 
  Matrikel -- worauf stehen -- Universitas Perantiqua -- Gesetz -- Handschlag -- Reiser lauter heilig Ding -- dachen Zeitlang -- wollen sagen -- Schauspieler -- 
  stehen Reihe Glied -- Mitbürger Menschenklasse -- hoch Grad Bildung übrig Auszuzeichn streben -- 
  Matrikel Existenz bestimmen -- betrachtet -- Betersberge hinunterstieg -- anderer Wesen -- 
  Mittag zeigen Doktor Froriep erhalten Matrikel -- bringen Gedicht -- diesmal Glück machen -- erwarten -- 
  Erfurt nämlich Studium schön Wissenschaft Student selten -- Doktor Froriep leiben -- -- Fache einigermaßen dienen -- 
  Gedicht bewirken -- Reiser neu Gönner interessieren -- Nacht Gasthofe lassen -- sogleich Universitätsquartiermeister -- Fechtmeister -- Auftrag -- Logis verschaffen -- 
  quartierte für alt Studiosus Medicinä -- Haus wohnen -- Besorgung Freitisch Student -- ziehen für Tisch -- 
  glücklich Umstand Reis Stunde -- unglücklich Mensch Welt -- Erziehung -- Kummer Schuljahr drücken -- 
  Idee Freitischen -- Schüler genießen -- liegen Last -- fühlen Grund unglücklich -- Tisch Fechtmeister -- Feld Gotha eisenach roh Wurzel aß -- 
  -- Student -- Fechtmeister aßen -- timid blöd Mensch halten -- Wirt -- Student Art umging -- Umstand -- Zustand unerträglich -- scheinen unbegrenzt Freiheit niederträchtigste Abhängigkeit versunken -- 
  ungeachtet scheu Wesen schonend -- wiederum aufgeschrieben Gedicht danken -- wovon Doktor Froriep verschieden Leute sprechen -- -- wissen -- Student Erfurt gewiß Name -- sonderbar Wesen Rechnung Dichtergabe schreiben -- 
  fehlen gänzlich Wäsche -- zutrauen Mensch -- Mangel ersetzen -- 
  unmöglich Mangel gestehen -- drückendsen -- Grund meister Traurigkeit verursachen -- schieben -- worüber trauern affektieren -- Mangel Wäsche unpoetisch Gegenstand scheinen -- 
  Fechtmeister weisen bleibend Quartier Student Namens R. -- -- -- Stube wohnen müssen -- sogleich Wochenschrift gemeinschaftlich herausgeben -- Reiser Dichter Schriftstellertalent Vorstellung -- 
  Reiser dachen Plan Wochenschrift -- Satire Art Schrift anheben -- letzter Wochenschrift heißen -- neu Stubengenosse merkt Geld führen -- bestimmt Aussicht -- erhalten -- fing ziemlich kalt -- raten für Degen versetzen -- Reiser -- freundlicher Blick erhalten -- 
  Hr. N. -- -- -- ordentlich Mann -- beiderseitig literarisch Unternehmung gerne auslagen -- 
  gehen Buchdrucker Erfurt -- Namens G. -- -- bringen Plan Wochenschrift Vorschein -- 
  stellen nachdrücklich -- mißlich Unternehmen -- sicher -- Aufsatz Blatt geben -- Publikum beliebt -- z. E. Wochenschrift Bürger Bauer -- herausgeben -- Betteljung Bierhäuser Erfurt herumgetragen -- 
  Bürger Bauer -- Reiser Wanderung Jäger Mühlhause vorgefunden -- Mitarbeiter nebst Stubengenossen Verleger Herausgeber erwählt -- 
  müssen Abend Buchdrucker speisen -- Rettich Art hart länglich Käse -- Erfurt gewöhnlich -- aufgetrag -- wovon Mitarbeiter unaufhörlich aßen -- Frau Buchdrucker manchmal sauer -- 
  Aufsatz -- Student R. -- -- Wochenschrift Bürger Bauer liefern -- prosaisch Nachahmung Beatus ille Horaz -- 
  Aufsatz Reiser -- steif Gedicht Welt -- Hannover Schule -- 
  Aufsatz Honorar erfolgen -- Plan Student R -- Wochenschrift -- Reiser herausgeben -- Ansehnliches gewinnen -- Weise Stecken geraten -- Reiser Interesse -- verdenken -- Reiser Melancholie -- vorzüglich Mangel Wäsche -- schlecht Zustande Schuh entstehen -- traurig Gesellschafter -- 
  Student R -- suchen Reiser Verlauf -- gewohnen -- Logis unterzubringen -- 
  -- Kirschlache -- Wohnung Brauer -- Student logieren -- Sohn Haus ebenfalls Schule besuchen -- 
  bekommen Reiser wiederum Zimmer -- müssen -- Student Familie zusammenwohnen -- 
  -- Haus angenehm Lage -- stehen Reihe Haus -- schmal Gewässer vorbeifließen -- diesseitig Ufer Bäumen bepflanzen -- 
  eingeengt Straße -- vorüberfließend Wasser -- Kleinheit Haus tragen -- Gegend alt Stadt frei ländlich ansehen geben -- 
  Haus alt Stadtmauer -- Aussicht Kartäuserkloster -- 
  Mauer Gras bewachsen -- verschieden Ort halb eingefallen -- bequem hinaufsteig -- alsdann Plan Garten -- womit Erfurt innerhalb Maur umgeben -- übersehen -- 
  erhalten Reiser ordentlich Freitisch Universität -- Idee ruhig Bleiben behalten Oberhand -- -- neunzehn alt -- Freund H. -- -- -- schreiben -- hoff wünsche nunmehr Rest Erfurt beschließen -- 
  lernend Laufbahn nämlich unmittelbar lehrend übergehn -- Ziel wünsch Hoffnung erreichen -- -- 
  übrig Glänzende glauben Verzicht tun -- schimmernd Theaterphantasi scheinen Zeitlang Kopf verschwinden -- 
  Welt versetzen -- Aufenthalt H. -- -- -- erstaunlich gewinnen -- 
  Wällen Erfurt Stadt spazieren -- fühlen lebhaft -- Anstrengung unehretäglich Zustande gerissen -- Standpunkt Welt Kraft verändern -- 
  Glocke Erfurt läuten hören -- allmählich Erinnerung rege -- gegenwärtig Moment beschränken -- fassen -- entschwinden -- 
  glücklichst Moment Leben -- Anfing interessieren -- gewiß Zusammenhang -- Einzel zerstücken betrachten -- 
  Einzeln -- abgerissen Zerstückt -- -- Verdruß Ekel erwecken -- 
  entstehen -- Druck Umstand Gedanke gegenwärtig Moment erheben -- 
  -- unbedeutend -- leer trocken -- Mühe denken wert -- -- 
  Zustand lassen Ankunft Nacht -- tief Schlummer -- gänzlich vergessen wünschen -- kroch Schneckenschritt -- fort -- erklären -- Augenblick leben -- 
  Anfang Aufenthalts Erfurt Augenblick -- übersah Leben -- Ortsveränderung neu -- Einbildungskraft Emmerwiederkehrende fesseln -- -- 
  Emmerwiederkehrende sinnlich Eindrücke scheinen vorzüglich -- Mensch Zaum halten -- Fleck beschränken -- -- 
  fühlen Einförmigkeit Kreises -- umdrehen -- unwiderstehlich anziehen -- gewinnen alt leiben -- fliehen -- scheinen Art Frevel -- Umgebung hinauszutren -- gleichsam Körper -- ersteren fügen -- 
  Reiser Wohnung Kirschlache scheinen -- Einbildungskraft auf fesseln -- 
  Aussicht Garten Kartäuserkloster nämlich Romantische -- Reiser unwiderstehlich anziehen -- Blick still Sitz Einsamkeit heften -- heimlich Sehnsucht empfinden -- 
  -- Gebäude Phantasie scheitern -- geräuschvoll Weltscene weder wirklich Leben -- Theater durchspielen -- fallen -- gemeiniglich geschehen pflegen -- Empfindung Extrem -- 
  Welt vergessen -- Mensch abgeschieden -- still Einsamkeit verleben -- unaussprechlich Reiz - Abgeschiedenheit erhalten Gedanke desto hoch Wert -- größ Opfer -- bringen -- 
  -- worauf Verzicht -- lieb Wunsch -- Wesen eingeweben scheinen -- 
  -- Lampen Kulisse -- glänzend Amphitheater verschwinden -- einsam Zelle -- -- 
  hoch Mauer Kartäuserkloster umschließen -- Türmchen Kirche -- einzeln Häuschen -- innerhalb Mauer Reihe nacheinander stehen -- wovon jeder Mauer abgesondern -- Fleckchen Garten -- interessant Anblick -- Höhe Mauer -- einzeln Haus -- Gärtche -- bezeichnen auffallend bedeutend Einsamkeit Abgeschiedenheit Bewohner Ort -- 
  glock Türmch anziehen -- tönt Reiser Ohr -- Sterbeglock irdisch Wunsch Aussicht -- Zukunft Leben -- 
  - Ziel -- Fuß Eingeweiht Bezirk Maur treten -- finden immerwährend Wohnung -- Grab -- -- 
  Geläute Kartäuser Art geschehen -- Langsamkeit traurig melancholisch -- -- 
  nämlich Kartaus Chor versammeln -- tun Reihe Zug Glocke -- nehmen Platz -- -- Ältest Jüngsten hereingetreten -- 
  horchen Reiser Schall Glocke zuweilen still Mittagsstund -- zuweilen Mitternacht -- früh -- jedesmal erneuert Eindruck lebhaft Gemüte -- Bild Einsamkeit Stille Grabe erwachen -- -- 
  -- abgeschieden Mensch Tod überleben -- Gräber umherwandelt -- Hand reichen -- 
  -- Idee vertraut -- leiben -- manchmal angenehmst Aussicht Leben vertauschen -- 
  Brief Philipp Reiser Hannover erhalten -- -- ehemals Gespräch -- besonderer Teilnehmung Freund Schicksal -- weitläufig Schilderung damalig Liebe enthalten -- Liebe kommen -- Hindernis Weg stehen -- 
  Demungeachtet tragen Reis Brief beständig -- lesen öfteren -- Philipp Reiser einzig Freund -- 
  unweit Kirschlache angenehm Spaziergang -- grün Gebüsch Tale klar Bach ergießen -- 
  -- Aussicht umher hemmen -- befinden reizend Einsamkeit -- 
  -- bringen Reiser Stunde grün Rasen Ufer Bach -- denken Schicksal -- denken müde -- lesen Brief Freund -- -- Inhalt interessieren -- fast auswendig lernen -- 
  lesen -- näh -- Brief -- 
  Umstand -- Philipp Reiser Erfurt gebürtig -- Vaterstadt vertauschen -- Anton Reiser befinden demselbig Fleck -- Freund Jugend verleben -- Eindruck umgebend Welt erhalten -- 
  durchleben Gedanke Philipp Reiser Kinderjahre -- verdoppeln -- Tal Bache sitzen -- Brief lesen -- Wesen Erinnerung bringen -- 
  Student O. -- -- -- leiben -- Philipp Reiser Erfurt -- öftesen unterreden -- 
  O. -- -- -- jung liebenswürdig Schwärmer -- Phantasie schweben jugendlich Lebensreiz -- beseelten hoch Freundschaftsgefuhl -- zuweilen laufen klein Affektation -- Grund gefühlvoll Herz -- 
  finden Reis Mann -- ruhen eher -- Sonntage Kartäuserkirche -- -- auffallend scheinen -- trauen -- hereinzugehen -- 
  unterwegs Nichtigkeit Kürze Leben unterhalten -- wobei bemerken -- Reiser neunzehn O. -- -- -- alt -- wussen -- Rest anfangen -- Kloster anlangen -- Kirche treten -- leer weiß Wand -- einsamen Chor Stille Grabe predigen -- 
  Kirche nämlich Kartäuser selber fast besuchen -- Gemeinde gehören -- weder Kanzel stühl Bank -- leer Wand flach Boden -- Kirche -- dämmernd Licht -- Fenster fallen -- ernst melancholisch ansehen -- 
  O. -- -- -- Reiser knieten Pult Chore -- weißgekleideten Mönch hereintraen -- bückend Zug Glocke -- 
  setzen Pulte Chor stimmen Bußegesang tiefen -- traurig Tönen -- stehen sang Hymn -- traurig erschallen -- fallen Angesicht -- fleht tief klagend Tön Erbarmung -- 
  -- halb Zirkel stehen Jüngling blass Wang ausnehmend schön Bildung -- 
  -- Reiser Auge seinigen wenden -- andachtsvoll gen Himmel schlagen -- -- 
  O. -- -- -- kannt Unglücklichen -- Orden Kartäus treten -- Blitz Jugendfreund Seite erschlagen -- Reiser schweben Bild Jüngling beständig Seele -- -- 
  Halbe bringen alt Mauer Wohnung -- sehnt Bezirk still Maur -- Meinung Welt Täuschunge Blendwerke ausschlossen -- -- 
  Jüngling verblühen -- Grab zuwelken -- selber einsam Gärtche bauen -- --- sanft Strahl Abendsonne Zelle begrüßen -- irdisch Wunsch Hoffnung entnehmen Ruhe Heiterkeit Tod entgegen sehen -- 
  Stimmung alt eingefallen Mauer Wohnung -- folgend Gedicht -- still geweiht Behausung -- Grab rührend Vorbild -- Welch geheim Empfindung heften Auge voll Träne -- einsam Hütte -- 
  ehrwürdig Greis -- Bewohner Ort still Andacht -- Heil -- leer Gewimmel gaukelnd Eitelkeit fern -- fern Geräusch Stolz -- Hand einsam Gärtche bauen -- Seele -- -- edl Unwille Strebet -- Kerker fliehen -- kommend -- Himmel würdiger -- Heil -- genieß Segen göttlich Einsamkeit -- Erdegedank entwöhnt Geist -- engelgefühlen zerfließ ewig Ursprung jauchzend emporschwingen -- herrlich -- O Greis -- -- 
  -- -- Voll Kummer Leben durchleben -- sinkend Scheitel Bereist -- rüstig Mann -- stark -- blühend Jüngling -- -- Freude Leben -- einsam Zelle wählen -- O warst Ziel Verachtung höhnend Stolz -- 
  Betrog falsch Freund -- 
  Fühltest lebhaft -- Wunsch Mensch Hoffnung nichtig stolz -- 
  verbitternd Ekel schal unschmackhaft Freude Leben -- einst blumig Schauplatz Welt traurigen Einöde -- -- sicher Freistadt listigen Ränk Bosheit fandst -- Geräusch Tor -- Verführung schön gleißend Laster -- Leben betrüglich Freude fandst -- -- 
  sehen -- 
  Auge -- stumm Zähr -- zittern langsam Wange Jüngling herab -- abgehärmen bleich gebrochen -- Hinsterbend Leben verweinen -- lechzend Blume schwülen dahinwelkt .-- geheiligt Kerker -- Strahl erquicken -- Zwang oderUnbedacht schmachtest -- O Wein -- Jüngling -- weinen -- 
  Gott vergeben Zähr -- unschuldig Wunsch Natur Auster Seele preßen -- 
  O Träne deinenThränen vermischen -- sanft lindernd Trost Seele hinweinen -- 
  Sanftlächelnd Sonne Frühlingsabend -- röten letzter Strahl mitleidig einsam Fenster -- legst Lager -- träumsen künftigen -- Voll glänzend Aussicht -- schwimmsen Wonnegefühle -- verlierst Labyrinth Freude -- erwachst glücklich Schlummer -- siehst -- -- traurig Zelle öde Wand -- -- Strahl Hoffnung lächeln hinein -- o säuseln Zephire Jüngling Haus -- liebkoset trocknen mitleidig Auge Zähr -- -- 
  Blühet Blume -- Garten -- Fenster erschall -- tröstend Lied -- Philomele -- 
  allliebend einst -- Leben quälend Bande leidend Seele befreien -- voll zärtlich Wehmut -- durchtauter Nächte Grabstätt klagen -- 
  Reiser Seele Kartäuser -- anfehen Ernst denken -- abgeschied Welt zubringen -- drücken -- Wunsch Begierden -- quälen -- befreien -- 
  -- Gedanke vertiefen -- O. -- .. -- -- Student Erfurt Willens sein Komödie spielen -- Rolle unbesetzt sein -- -- -- 
  Anrede wirken mächtig Reiser Phantasie -- Kartäuserkloster hoch Maur tief Hintergrund stehen -- Kulisse Lichter plötzlich vordrängten -- O. -- -- -- überdem hinzufügen -- umgehen -- Stück -- aufzuführ Wille -- Reiser Rolle antragen -- vollends ernsen melancholisch Gedanke -- verschwinden -- 
  Stück nämlich -- Student Erfurt aufführen -- heißen Medon Rache weise -- sagen -- Moral enthalten -- erstaunlich Tugend Person predigen -- 
  Stück Reiser Rolle Clelie -- Geliebten Medon -- übernehmen -- Kinne wenig Spur Bart zeigen -- Länge Frauenzimmer auffiel -- -- Medon spielen -- fast riesenmäßig Größe -- 
  ungeachtet auffallend Sonderbarkeit Rolle -- Reiser dennoch Hange -- Theater Weise betreten widerstehen -- -- Gelegenheit -- Ungesucht Darbot -- 
  Doktor Froriep Hannover schreiben -- Reiser Aufführung ehemalig Lehrer Rektor S. -- -- -- Haus gewohnen -- erkundigen -- wider Reiser Vermut -- Zeugnis geben -- Doktor Froriep Gunst bringen -- 
  Rektor S. -- -- nämlich schreiben -- Anlage jung Mensch versprechen -- 
  Doktor Froriep -- nachteilig -- Zeugnis enthalten -- Schonung Nachsicht betrachten -- Reiser verdoppelt Eifer annehmen -- -- -- Gnade Prinz verschaffen -- 
  Zeugnis schonend nachsichtsvoll abfassen -- ausnehmen Punkt -- Reiser -- nächtlich Spaziergäng -- Verdacht Liederlichkeit -- Sache beschuldigen -- wovon weitesen entfernt -- Drückend Zustandes -- Selbstverachtung -- Schwärmereie abhalten -- 
  Hang Theater -- dasjenig -- worauf Grund -- übrig Unregelmäßigkeit schieben -- wodurch jung Leute Schule H. -- -- -- hingerissen -- 
  -- Brief ankommen -- Reiser Begriff Student Erfurt Komödie spielen -- 
  -- Doktor Froriep widerriet -- -- Herz hing -- Torheit -- entziehen Gunst -- 
  Vorbereitung Komödie -- Reiser lernen Rolle Klelie auswendig -- häufig Probe halten -- wodurch Reiser groß Student Erfurt -- höflich betragen -- vorteilhaft Meinung hegen -- wodurch Welt versetzen finden -- verschieden -- worin Kindheit leben -- 
  Komödienprobe versäumt Reiser -- Doktor Frorieps Prediger Kollegium fleißig besuchen -- 
  bestehen Anzahl Student -- Kaufmannskirch -- Gegenwart Doktor Froriep übrig Student -- verschloßen Tür -- Predige üben -- 
  wünschen Reiser ebenfalls auftreten -- Deklamation hören lassen -- reizendst Aussicht -- Doktor Froriep verstatt -- Kanzel besteigen -- 
  Thema ausgedachen -- worin Schönheit Natur -- Wechsel Jahreszeit poetischen Farbe schildern -- glänzend schimmernd Aussicht Ewigkeit pathetisch Weise Predigt beschließen -- 
  kommen Hindernis -- Wunsch Erfurt gewähren -- 
  zweifeln -- heftig wünschen -- zweifeln -- wirklich Aufführung Komödie Stande -- Rolle behalten -- 
  Wunsch gewähren -- 
  Sorgfalt Klelie schmücken -- 
  Licht anzünden -- Vorhang rauschen empor -- stehen zahlreich Auditorium -- spielen unbefang Rolle -- einzigesmal Unnatürlich einfallen -- Gedanke vertiefen -- theatralisch Darstellung begreifen -- Mitwirkung Augenblick notwendig -- -- 
  vertiefen Gegenstand -- vergessen -- Zuschauer Unnatürlich Rolle bemerkten -- Spiel sogar Beifall erhalten -- 
  Schauplatz betreten -- Student bleiben -- doppelt Vergnügen -- fühlen Wiedererinnerung Abend paar glücklich -- -- weniger Woche -- Erfurt zubrachen -- begegnen -- halb Traume vorkommen -- 
  rücken Wochenschrift Bürger Bauer Gedicht -- wodurch Nahme Schriftsteller erfurtisch Bürger -- 
  besorgt Korrektur Buchdrucker G. -- -- Gelehrt -- -- groß Vorzüg Geist Herzen Tod -- widrig Schicksal verfolgt -- langwierig ununterbrochen Druck Umstand -- verlernen -- Wert geltend -- Kraft -- wodurch Welt fest Fuß fassen -- Platz behaupten müssen -- lähmen -- 
  Doktor Sauer Buchdrucker G. -- Wochenschrift schreiben -- Titel Medon Freund -- wovon Jahrgang herauskommen -- 
  hieran -- Druck Umstand kämpfen -- schwer müssen -- Anzahl trivial Aufsatz niederzuschreiben -- wobei Funke unterdrückt Genie hervorsprühten -- 
  müssen schreiben -- wöchentlich Bogen liefern -- wiederum Jahrlang mühselig Leben atmen -- 
  -- Wochenschrift aufhören -- nötigen -- Korrektur erhalten -- 
  selber dramatisch Ausarbeitunge Wert Pulte liegen -- wagen -- Vorschein bringen -- müssen vornehm Herr Erfurt -- Sorgfalt Korrektheit Kopisten Trauerspiel Geld abschreiben -- Abschreiberlohn wiederum Leben frisn -- 
  Arzt verdienen -- 
  fühlt besonderer Hang -- Leute helfen -- Hilfe meister bedürfen -- wenigster leisten -- 
  -- Hilfe bezahlen vermögen -- geraten Arzt selber Gefahr verhungern -- Wochenschrifte herausgeben -- Korrektur besorgt -- Trauerspiele abschreiben -- 
  -- lassen Kur bezahlen -- bringen arm Leute Arznei Haus -- verfertigen -- übrig übrig bleiben -- verwandte -- 
  gleichsam weggeworfen -- Leute vornehmen Welt Zutraue -- ziehen Rate -- meister sogar Nahme -- Arzt gering Erfahrung Geschicklichkeit erwerben -- 
  Fache vortrefflich Ausarbeitunge liefern -- Unglück -- Menge verlieren -- Verfasser -- Zeitgenosse bemerken -- 
  -- übrig medizinisch Ausarbeitunge Pulte verschließen halten -- müssen Schrift französisch Arzt -- Erfurt -- -- Doktor Sauer -- wissen bemerken -- Lateinische übersetzen -- Übersetzerlohne leben -- hülflosen arm kranke Arzneimittel zubereiten -- 
  müssen abstumpfen -- Unwürdigkeit Demütigung Schicksal fühlen -- 
  Doktor Sauer lächelnd Min -- Innerst Seele untergraben demütigung Herabwürdigungen Tatkraft -- lähmen Mut -- 
  innerer Wert trauen -- Welt verkannen -- 
  Konnexion Buchdrucker G. -- -- -- Korrektur besorgt -- zuweilen Aufsatz berühmt Erfurtisch Wochenschrift Bürger Bauer -- Las Reiser Gedicht -- freigeworden Amerikaner -- verdienen -- Sammlung vorzüglichst Poesie deutsche stehen -- Blatt verlieren -- Bierhäuser Erfurt feil bieten -- 
  Gedicht unterdrückt Geist Freiheitsgefühl ausgehauchen -- Schwung feurig Teilnehmung herrschen -- Gedanke -- 
  entzücken Gedicht Reiser ruhen -- Bekanntschaft vorzüglich Mitarbeiter Wochenschrift Bürger Bauer -- 
  halten schwer -- Wunsch erreichen -- Doktor Sauer Hang fühlen -- fern Klasse Wesen anschließen -- gleichsam ausgestoßen -- 
  Indes finden Weg -- Reiser Studium englisch Sprache Erfurt fortsetzen -- Erbot -- Doktor Sauer Englisch lehren -- einigemal Wunsch äußern -- Sprache -- 
  Anerbiet annehmen -- erhalten Reiser Gelegenheit wöchentlich paarmal Mann zusammenzukommen -- nah anzuschließen wünschen -- 
  Gelegenheit offen Reiser -- erzählt mannigfaltig Unterdrückung -- Kindheit -- Anverwandt Lehrer aussetzen -- nachh Streiche Schicksal nacheinander -- Staub darrniedergebeugen -- Reiser auffahrend Unwille enthalten -- Verkettung hämisch nennen -- worin denkender empfindend Wesen gleichsam absichtlich eingeengt quälen -- 
  Reiser Art Unwille äußern -- verzog Saures Mund sanft Lächel -- wodurch freilich Unwille erhaben -- irdisch Bande lösen -- baldig vollkommen Befreiung ahnungsvoll entgegen -- 
  -- Kampf beinahe durchgekämpfen -- braucht widerstehend Kraft -- Trotz Schicksal -- 
  Demungeachtet lodert Lebensflamm manchmal -- 
  hoffen zuweilen glücklich sehen -- Eifer Erlernung Englischen -- Studium versprechen -- vorzüglich englisch Sprache geschrieben medizinisch Werk nutzen -- Übersetzung englisch Geld erwerben -- 
  bieten sogar Aussicht Art Versorgung Erfurt dar --- glücklich Wendung -- ausharren zuschreiben -- 
  Erfurt wollen -- pflegen Reiser sagen -- müssen ausharren -- Geduld verlieren -- 
  bescheiden mäßig wünschen -- Schimmer gut Glück aufmunternd -- 
  wissen -- äußerer Glück helfen -- Quell Glück selber versiegen -- Blume Leben zerknickt -- Blatt notwendig welken müssen -- 
  Reiser fühlt Teilnehmung anziehen -- Schicksal Mannes -- seinigen unzertrennlich verknüpfen -- 
  müssen Mann glücklich -- Ding Gleis bleiben -- 
  Reiser trog diesmal -- nachh Ahnung -- Glaube Entschädigung erlittenen Kummer -- notwendig Erde finden müssen -- 
  -- Sauer entschlummeren weniger -- gut sehen -- 
  außen Glück anlächeln -- innerer Kraft zerstören -- bleiben unbemerkt unbekannt Tod -- Gas -- wohnen -- nächster Nachbaren -- Sarg hinaustragen -- fragen -- begraben -- 
  Grad Nichtbemerktwerden -- unbevölkert Stadt -- Erfurt -- höchst auffallend -- 
  weniger -- Reiser Doktor Sauer Erfurt verleben -- höchst wichtig -- Seele gewiß Anstoß geben -- 
  raffen Unterdrückung -- Geist lähmen -- 
  Unwille -- Empfand -- flößen gewiß trotz -- Schwerst unterliegen -- gewissermaßen Widerstand rächen -- gelitten -- 
  Tag Dorfe Erfurt spazieren gehen -- O. -- Gesellschaft -- -- 
  Abend zurückkehren -- kommen Gewässer -- dickem Gebüsch umgeben -- schwarz Ufer hinkroch -- 
  bleiben Sauer stehen -- suchen Stock Tiefe messen -- abreichen -- 
  bleiben stehen -- untergeschlagen arm Wasser -- bemerken schwarz Fläche -- langsam fließend kröch -- -- 
  Bild Sauer blass Wang -- untergeschlagen arme -- bedeutungsvoll Stygischen Fluß herunter blicken -- Reiser lebhaft Seele -- nachh Nachricht Tod vernehmen -- 
  --- bedeutend Bild formen -- Zeichen Sache -- -- 
  Reiser eröffnen fröhlich Aussicht -- 
  Student kommen Einfall Komödie aufführen -- Vergnügen Geschmack bekommen -- 
  Stück wählen -- argwöhnisch Schatz Lessing -- erhalten Reiser wiederum Frauenzimmerrolle -- Umkleidung spielen müssen -- Rolle Maskaril -- Schauspielerkredit Student befestiget -- Gefälligkeit ansehen -- Rolle übernehmen -- Weise drängen -- 
  Veranstaltung theatralisch Vorstellung -- fing Reiser gleich Ausarbeitung Empfindsamkeit -- womit Schriftsteller auftreten -- 
  Schrift affektiert Empfindsamkeit lächerlich -- wahr Empfindsamkeit gehörig Licht stellen -- 
  seinsollend Satire Empfindsamkeit geraten freilich ziemlich grob -- Seuche vergleichen -- hüt -- jedwed Gegend kommen -- Empfindsamkeit herrschen -- Eingang Stadt Dorf versperren müssen -- 
  Unwille vorzüglich empfindsam Reise -- Deutschland erscheinen -- affektiert Nachahmung Werther leiden -- Reiser erwecken -- selber heimlich Sünd anklagen müssen -- desto heftig sucht Besserung -- eifern -- 
  -- Abends Abhandlung schreiben -- treten Buchdrucker P. -- -- -- Hannover Stube -- bringen Brief Philipp Reiser -- 
  Buchdrucker -- Hannover Anzahl Neujahrwünsche verfertigen -- erstenmal gedruckt sehen -- 
  Reiser Buchdrucker Türe hinausbegleiten -- drücken Goldstück Hand -- hinlänglich -- Mensch -- Woche Gelde entblößen -- Mangel merken lassen -- Staube heben -- 
  unvermutet Geschenk erhalten groß Wert Art -- womit geben -- Buchdrucker P. -- -- -- Wort hinzufügen -- Kleinigkeit alt Schuld -- abtrug -- nämlich Reiser Neujahrwünsch -- Gedicht u. S. W. bloß Ehre Hannover verfertigen -- 
  Reiser Umstand Goldgulde -- woraus Geschenk bestehen -- unschätzbar Wert -- reißen Menge verlegenheiten -- Mensch sagen -- 
  -- Erfurt glücklich erleben -- weder innen außen drücken -- Zukunft trübe Aussicht -- 
  Brief Philipp Reiser interessant vorhergehend -- enthielt Nachricht verschieden Reiser Mitschüler -- Hannover Komödie spielen -- Beispiel folgen -- heimlich fortgangen sein -- Theater widmen -- 
  vorzüglich I. -- -- Klavigo Beaumarchais spielen -- Sohn Kantor -- -- -- -- -- --- Präfektus Chore -- Namens O . -- -- gewisser T. -- -- -- Prediger Sohn -- Reiser Abschiede -- romantisch Spaziergäng Hannover -- 
  finden Reiser sonderbar Art Stolz -- nachahmen -- Mut -- Schritt -- 
  schreiben Reiser überspannt Stiele -- Dichter Hölty Hannover sterben -- schließen Wort -- freu Dichter -- wein Mensch -- -- 
  Fortgang Liebesroman enthalten Brief -- 
  Reiser rollen Komödie beschäftigen -- finden Freund Erfurt -- Student Namens N. -- -- Hamburg gebürtig -- Doktor Froriep Haus wohnen -- Abschrift Reiser Gedicht -- Kartäuserkloster zeigen -- Verfasser Freund verschaffen -- 
  Freundschaft empfindsam Art -- wogeg Reiser Abhandlung schreiben Begriff -- 
  jung N. -- -- gefühlvoll Herz -- lassen Strom hinreißen -- spielen Gelegenheit empfindsamen -- wissen -- eifert Reiser lächerliche affektiert Empfindsamkeit -- bloß empfindsam scheinen -- selber suchen -- dünkt Affektation -- treiben ernsthaft Sache -- Spott leiden -- ziehen Reiser allmählich Wirbel hinüber -- Seele hinaufschrauben -- abgeschmacktest Zustand geraten -- denken -- 
  Reiser aufmunternd -- ungeachtet dürftig Umstand schließen -- äußerer Glücksgütern fehlen -- 
  -- bildet ordentlich Liebe Anhänglichkeit jung N. -- -- -- -- wahr Freundschaft Reiser vermehren -- -- Torheit -- nähern -- Melancholie Empfindsamkeit wechselsweise mitteilen -- 
  geschehen vorzüglich einsam Spaziergang -- Natur Szene veranstalten -- Sonnenuntergang Jünger Emaus Klopstock lesen -- trüben -- Zachariäs Schöpfung Hölle -- u. S. W. vorzüglich lagert Abhange Steigerwalde -- Stadt Erfurt -- alt Türm Umfange Garten -- liegen sehen -- 
  hinauf Einwohner Erfurt häufig spazieren -- Feuer -- kochen Kaffee -- patriarchalisch Idee erneuern -- 
  sitzen N. -- -- -- Reiser Stunde -- lesen Dichter wechselsweise -- meister wahr Mühe Arbeit -- peinlich Zustand -- gestehen -- Idee nehmen -- 
  -- Steigerwalde freundschaftlich beieinand sitzen -- anmutsvoll Tal hinuntergeblicken -- unser Geist schön Werk Dichtkunst nähren -- -- 
  erwägen -- Umstand ereignen -- Stillsitz Lesen frei Himmel angenehm -- denken -- unannehmlichkeite N. -- -- -- Reiser empfindsam Szene kämpfen müssen -- Boden feucht -- ameis Bein krochen -- Wind Blatt verschlagen -- u. S. W. N. -- -- -- finden vorzüglich Gefallen -- Klopstock Messiade Reiser vorzulesen -- entsetzlich Langenweil -- Lektüre verursachen -- -- selber gestehen wagen -- N. -- -- -- Vorteil lauten Lesen -- womit verging -- Reiser verdammen hören -- Gehörte entzücken -- traurigsen Stunde Leben -- erinnern wissen -- meister zurückschrecken -- Lebenslauf vorn durchgehen -- 
  groß Qual geben -- gänzlich Leerheit Seele -- vergebens streben -- Zustande herauszuarbeiten -- unschuldigerweise selber Augenblick Schuld beimißen -- selber Stumpfsinn anklagt -- erhaben Tönen -- unaufhörlich Ohr klingen -- rühren erschüttern -- 
  N. -- -- Reiser fast unzertrennlich beisammen -- sehnt Letzter einsam Spaziergänge -- reinst vergnügen gewähret -- verleiden -- gemeiniglich versprechen Spaziergang -- kehren verdrießlich Haus -- finden -- suchen -- sobald -- Reiz verlieren -- Quell Freude versiegen -- 
  -- Verdruß -- Stelle gereizt Hoffnung treten -- groben -- gemein -- niedrig Art -- mind Grad sanft Melancholie dergleichen bestehen -- 
  ungefähr Empfindung Mensch -- Regen durchnassen -- Frost schaudernd Haus kehren -- kalt Stube finden -- 
  Leben führen Reiser -- schreiben Abhandlung falsch Empfindsamkeit fort -- wobei einsamen Spaziergang sonderbar Äußerung Empfindsamkeit gemein Mensch bemerken -- wenigster erwarten -- 
  nämlich Garten Erfurt spazieren -- Pflaumenzeit -- enthalten -- überhangend Ast -- schön reif Pflaume abzupflücken -- Eigentümer Garten bemerken -- Unsanft Wort Anfuhr -- wissen -- Pflaume -- abgepflücken -- Dukat kosten -- 
  Reiser suchen abdingen -- müssen gestehen -- Heller Geld -- 
  Eigentümer Garten geraubt Pflaume einigermaßen befriedigen -- müssen einzig Schnupftuch Tasche geben -- Verlust leid -- 
  traurig weggieng -- -- Schritt tun -- schön Einlegemesser Erde liegen -- heben geschwind -- rufen Gärtner -- Tausche antrug -- gefunden Messer -- Schnupftuch geben wollen -- 
  erstaunt Reiser -- Gärtner -- vorher grob -- Hals fallen küssen -- Freundschaft ausbat -- Reiser notwendig Günstling Vorsehung müssen -- Messer finden lassen -- Gärtner verlieren -- Reiser Schnupftuch Freude -- versichern -- Garten ständ -- Pflaume -- -- pflücken -- Sache dienen -- -- außerordentlich Fall vorkommen -- 
  Reiser weggehen sonderbaren Zufall nachdachen -- fallen -- erstemal Leben -- eigentlich glücklich Ereignis begegnen -- wobei mehrere Umstand vereinigen müssen -- selten vereinigen pflegen -- 
  Glück scheinen Kleinigkeit gleichsam erschöpfen -- desto_mehr büßen lassen -- Weise -- verschulden -- 
  -- Landprediger Wakefield -- ungewöhnlich glücklich Wurf Würfel -- Freund Pfennig spielen -- vorher -- ehe Nachricht Banquerot Kaufmann erhalten -- Vermögen verlieren -- 
  Weile halten Schicksal Demütigungen -- Reiser zugedenken -- lassen ungestört Vergnügen -- Komödien-Aufführung gewähren -- worin Rolle -- 
  sehnlichst Wunsch einigermaßen erfüllen -- tragisch Rolle glänzen -- 
  -- Art zutrauen theatralisch Einsicht -- fragt Rat -- Teilnehmung Komödie sowohl -- geschrieben Gedicht -- Student -- Höflichkeit begegnen -- Lage Schule H. -- -- -- -- -- angenehm Ersatz -- 
  besuchen fleißig Universitätsbibliothek -- besonderer Gefallen finden -- Halde Beschreibung China studieren -- verschwenden -- 
  Grade erscheinen -- Siegwart Klostergeschicht -- lesen Freund R. -- .s Buch Mehrehrenmal -- tun entsetzlichst Langenweil Zwang -- angefangen Rührung -- Band hindurch bleiben -- 
  Reiser Sinn -- Geschichte historisch Trauerspiel bringen -- wozu allerlei Entwurf -- schön verschwenden -- 
  -- wünschen -- geraten -- vergeben Anstrengung Art -- trübselig widrig Stunde -- denken -- 
  Natur Gedanke Reiz verlieren -- Moment drückend -- Leben eigentlich Verstande Qual -- 
  leiden Poesie Betracht Rubrik Reiser Leidensgeschichte ausmachen -- innerer äußerer Zustand Verhältnis darstellen -- wodurch dasjenig gewiß -- Mensch Leben hindurch -- unbewußt -- Dunklen verbergen bleiben -- Scheu tragen -- Grund Quelle unangenehm Empfindung zurückzugehen -- 
  geheim leiden -- womit Reiser beinahe Kindheit -- kämpfen -- 
  Reiz dichtkunst unwillkürlich anwandelen -- entstehen wehmütig Empfindung Seele -- denken -- worin verlieren -- wogeg -- gehören -- lesen denken -- verlieren -- -- darstellen -- ungefühlt -- unnennbar Vergnügen verursachen -- 
  ausgemacht -- Trauerspiel -- Romanze -- elegisch Gedicht -- -- müssen -- Empfindung erwecken -- wovon Dichter gewissermaßen Vorgefühl -- 
  Moment selig Vorgefühl Zunge stammelnd einzeln Laute hervor bringen -- 
  Klopstocksch Oden -- Lücke Ausdruck Punkt ausgefüllt -- 
  einzeln Laute bezeichnet allgemein -- erhaben -- Wonneträne -- dergleichen -- 
  -- dauern -- Empfindung zurücksank -- paar vernünftig Zeile -- Anfang Bestimmte -- ausgeboren -- 
  Krisis Schöne entstehen -- woran Seele nachher festhalten -- -- -- kein Blick würdigen -- 
  -- Seele dunkel Vorstellung -- -- wodurch verächtlich -- 
  untrüglich Zeichen -- Beruf Dichter -- bloß Empfindung Dicht veranlassen -- bestimmt Szene -- dicht -- eher Empfindung -- Empfindung -- 
  -- Empfindung Blick Detaille Szene werfen -- Empfindung -- Dichtungsvermög -- 
  gewiß gefährlich -- täuschend Hange überlassen -- warnend Stimme früh Jüngling zurufen -- Innerstes prüfen -- Wunsch Stelle Kraft treten -- Stelle ausfüllen -- ewig Unbehagen Strafe verboten Genuß bleiben -- 
  Fall Reiser -- Stunde Leben mißlungen Versuch trüben -- unnütz Streben -- täuschend Blendwerk -- Seele schweben -- umfassen glauben -- plötzlich Rauch Nebel verschwinden -- 
  Reiz Poetischen Mensch Leben Schicksale kontrastieren -- Reiser -- Kindheit Sphäre -- Staube niederdrücken -- Poetische gelangen -- Stufe Menschenbildung überspringen müssen -- folgend erhalten -- 
  äußerlich Lage -- eigentlich Stube -- müssen -- Anfing Kälter -- gemeinschaftlich Stube wohnen -- Einwohner -- ausgefegen -- herausgehen müssen -- 
  Stube wohnt Familie -- nebst Reiser Student -- besuch fremde -- erzählen -- Kind gelärmen -- singen -- zanken geschrien -- nächster Umgebung -- worin Reiser philosophisch Abhandlung Empfindsamkeit schreiben -- poetischen Ideal darstellen -- 
  Trauerspiel Siegwart schreiben -- Einkehr Einsiedler anheben -- Reiser Lieblingsidee -- Lieblingsidee fast jung Leute pflegen -- einbild -- Beruf Dichtkunst -- 
  -- Zustand Einsiedler gewissermaßen selber Poesie -- Dichter Stoff beinahe vorgearbeiten finden -- 
  Gegenstand fallen -- fast Zeichen -- echt poetisch Ader finden -- Poesie Gegenständen suchen -- selber liegen müssen -- Gegenstand -- Einbildungskraft darbieten -- verschönern -- 
  Wahl schreckliche ebenfalls schlimm Zeichen -- vermeint poetisch Genie verfallen -- freilich Poetische selber -- innerer Leerheit Unfruchtbarkeit äußerer Stoff ersetzen -- 
  Fall Reiser H. -- -- -- Schule -- Meineid -- Blutschander Vatermord -- Trauerspiele zusammenzuhäufen suchen -- Meineid heißen -- wobei wirklich Aufführung Stück -- Effekt denken -- Zuschauer -- 
  Zeichen ebenfalls -- poetisch Beruf sorgfältig prüfen -- abschreckend -- 
  wahr Dichter Künstler finden hoffen Belohnung Effekt -- Werk -- finden Arbeit Vergnügen -- verlieren halten -- Gesicht -- 
  Werk ziehen unwillkürlich -- selber liegen Kraft Fortschritt -- Ehre Sporn -- antreiben -- 
  bloß Ruhmbegier Begier einhauchen -- Werk beginnen -- Kraft gewähren -- besitzen -- ehe Ruhmbegier kennen -- 
  schlimm Zeichen -- jung Dichter Stoff gerne Entfernt unbekannte nehmen -- morgenländisch Vorstellungsart -- dergleiche bearbeiten -- Szene gewöhnlich nächster Leben Mensch verschieden -- Stoff selber poetisch -- 
  Fall Reiser -- Gedicht Schöpfung schwang -- Stoff freilich entferntest -- Einbildungskraft denken -- Detail -- scheut -- lauter Masse finden -- Darstellung eigentlich erhaben Poesie halten -- wozu unberufen jung Dichter Lust -- -- Mensch nahe liegen -- letzterer freilich Genie Erhabenheit hereintragen -- finden glauben -- 
  Reiser äußerer Lage hierbei drückender -- gehofft Unterstützung H. .... erfolgen -- Hausleut scheel Blick ansahen -- inne -- weder Geld besitzen -- hoffen -- 
  Frühstück Abendbrot -- Genoß -- Stande bezahlen -- lassen deutlich merken -- lang Wille -- borgen -- Nutzen ziehen -- überd traurig Gesellschafter -- -- wünschen -- Wohnung aufkündigen -- 
  auffallend -- tragisch Reiser -- 
  Gedanke Lästigseins -- Leute -- leben -- gleichsam dulden -- wiederum Existenz verhassen -- 
  Erinnerung Jugend Kindheit drängen -- 
  häufen selber Schmach -- verzweiflungsvoll blind Schicksal auf überlassen -- 
  Erfurt -- tausenderlei romanhaft Idee durchkreuzt kopfe -- worunter reizend scheinen -- Weimar Verfasser Werther leiden Bedienter suchen -- Bedingung wollen -- Art gleichsam unerkannt Weise -- nah Person desjenigen -- Mensch Erde stärksen Eindruck Gemüt -- vor Tor blickt Ettersberge hinüber -- Scheidewand wünschen liegen -- 
  Froriep -- Abschied nehmen -- eigentlich Ursache sagen -- weswegen Erfurt verlassen wollen -- 
  Doktor Froriep schieben Entschluß Melancholie -- reden -- bleiben sollen -- entlassen eher -- Reiser versprechen -- abzureisen -- 
  Teilnehmung schicksal Reiser schmeichelhaft -- sobald finden -- verfolgt Gedanke Lästigsein nächster Umgebung quälend Geist -- nirgends Ruhe Rast -- streift einsamst gegender Erfurt umher -- Gegend Kartäuserkloster -- wohin Ernst -- sicher Zufluchtsorte sehnt -- wehmütig still Mauer hinüberblicken -- 
  irren umh -- Abend -- Himmel Wolke überziehen -- stark Regen fallen -- Haut durchnetzen -- 
  Fieberfrost -- innerer Unruhe Gemüt gesellt -- treiben Sturm Regen umh -- alt Gemäuer einsam öde Straße -- bisherig Wohnung zurückkehren -- Gedanke ertragen -- 
  steigen hoch Treppe alt Dom hinauf -- behen Tuch Kopf -- suchen alt Gemäuer Weile Regen schützen -- 
  Müdigkeit fallen Art betäubend Schlummer -- Regenguß -- Getöse Wind erwecken -- auf Straße irren -- 
  Regen Gesicht schlagen -- fallen Stelle Lear -- to Shut -- out -- Such night As This -- 
  -- Tür verschließen -- Nacht -- -- -- spielt Rolle Lear Verzweiflung -- vergessen Schicksal Lear -- Töchter verbannen -- stürmisch Nacht umherirren -- Element aufforderen -- entsetzlich Beleidigung rächen -- 
  Szene halten -- Zeitlang Zustand -- worin -- Art Wollust denken -- Gefühl abstumpfen -- leer Wirklichkeit übrig bleiben -- laut Hohngelächter ausbrechen lassen -- 
  Stimmung kehrt alt Dom -- eröffnen -- Chorherre Frühmette Licht versammeln -- 
  alt gotisch Gebäude -- weniger Licht -- Widerschein hoch Fenster -- machen Reiser -- Nacht umh irren -- Bank niedersetzen -- wunderbar Eindruck -- 
  -- Behausung -- Regen schützen -- Wohnung Lebenden -- 
  Leben selber Freistatt suchen -- scheinen dunkel Gewölbe einladen -- Nacht -- Reiser -- durchleben -- neigen -- Rufe folgen -- 
  Reiser fühlen Bank Dom Art Abgeschiedenheit Stille versetzen -- unbeschreiblich angenehme -- Sorge Gram entrücken -- vergessen -- 
  Lethe trinken -- fühlen Land Frieden sanft hinüber schlummern -- 
  heftet Blick blass Widerschein hoch Fenster -- vorzüglich -- Welt versetzen scheinen -- 
  majestätisch Schlafkammer -- Auge aufschlagen -- wild Nacht durchträumt -- 
  Traum Fieberkrank -- freilich Zeitpunkt Reiser Leben -- -- Grund schicksale Kindheit -- 
  Selbstverachtung -- zurückgedrängt Selbstgefühl -- wodurch Zustand versetzen -- 
  Selbstverachtung immerwährenden Druck außen bewirken -- woran freilich Zufall schuld -- Mensch -- 
  angebrochen -- kehrt Reiser ruhigerem Gemüte Dom -- begegnet Straße Freund N. -- -- -- früh Kollegium besuchen -- erschrak -- Reiser Gesicht -- Nacht abgemattet entstellen -- N. -- -- ruhen eher -- Reiser Zustand entdecken -- 
  freundschaftlich Vorwurf -- Reiser zutrauen -- bringen alt Wohnung -- suchen Leute Licht darstellen -- tilgen gering Schuld Freund -- 
  aufrichtig Teilnehmung Freunde stärkt Reiser erkrankt Selbstgefühl -- gewissermaßen stolz Freund -- ehren -- 
  Bedung -- -- Verschlag Boden Haus beziehen -- wohin Bette -- -- lassen -- paar unangenehm Woche zubrachten -- 
  Laß studiert -- Abgezogenheit völlig glücklich -- Gedicht Schöpfung quälen -- -- Art Verzweiflung geraten -- Ding ausdrücken -- fühlen glauben -- Ausdruck -- 
  meister Qual -- Beschreibung Chaos -- beinahe Gesang Gedicht einnehmen -- worauf krank Einbildungskraft lieb verweil -- ungeheur grotesk Vorstellung Ausdruck finden -- 
  denken Art falsch täuschend Bildung Chaos hinein -- Traum Blendwerk -- Bildung schön -- wirklich -- Bestand -- Dauer -- 
  falsch Sonne steigen Horizont herauf kündigen Glänzend -- 
  --- bodenlos Morast überziehen trügerisch Einfluß Kruste Blume sproßten -- Quelle rauschen -- plötzlich arbeiten entgegenstrebend Kraft Tiefe empor -- Sturm heuln Abgrunde -- Finsternis brechen Schrecknissen verborgen Hinterhalt hervor -- verschlingen neugeborenen furchtbar Grab -- 
  zurückgedrängt Kraft bearbeitet Grimm Seite ausdehnen -- seufzt lastend Widerstand -- 
  Wasserwog krümmen klagt heulend Windstoß -- 
  Tiefe brüllten eingeschlossen Flamme -- Erdreich heben -- Fels gründen -- versanken donnernder Getöse verschlingend Abgrund -- 
  -- dergleich ungeheuer Bild -- zerarbeiten Reiser Phantasie Stunde -- Innere selber Chaos -- Strahl ruhig denken leuchten -- Kraft Seele Gleichgewicht verlieren -- Gemüt verfinsteren -- Reiz Wirkliche verschwinden -- Traum Wahn -- Ordnung -- Licht Wahrheit -- 
  Erscheinung gründen gewissermaßen Idealismus -- wozu neigen -- worin philosophisch System -- H -- studiert bestärken finden -- 
  bodenlos Ufer finden Platz Fuß ruhen -- 
  Angstvolle Streben Unruhe verfolgt Schritt -- 
  -- Gesellschaft Mensch Böd Dachkammer treiben -- phantastisch Träum vergnügtest Stunde zubracht -- Romantisch -- Theatralisch -- unwiderstehlich Trieb einflößen -- 
  gegenwärtig innerer äußerer Zustand -- wiederum idealisch Welt verlieren -- Wunder -- Veranlassung alt Leidenschaft Feuer fing -- wiederum Gedanke Theater heften -- sowohl Kunstbedürfnis -- Lebensbedürfnis -- 
  Veranlassung ereignen -- Sp -- sch Schauspielertruppe Erfurt -- Erlaubnis erhalten -- Ballhause spielen -- Student Komödie aufführen -- 
  Reiser -- sogar gewiß Ruf Schauspielertalent erhalten -- wodurch Prinzipal Truppe sogleich -- engagieren -- Lust Schauspieler -- 
  Versuchung -- -- wonach Mühseligkeite Leben kämpfend vergeblich streben -- anbieten -- Reiser stark -- 
  setzen Rücksicht Auge -- leben weben Theaterwelt -- H. -- -- Komödienzettel enthusiastisch Verehrung hegen -- Mitglied Souffleur Rollenschreiber Art Neid betrachten -- 
  namens B. -- -- Truppe befinden -- nachher berühmt Schauspieler -- ziehen meister Neugier -- 
  zeichnen Mitglied Truppe vorzüglichsn -- Reiser wünschen sehnlich Bekanntschaft -- schwer -- entdeckt B -- Wunsch -- Entschluß -- Theater widmen -- bestärken -- Reiser Freund finden hoffen -- 
  setzen Rücksicht Seite -- suchen Gedanke D. Froriep Freund N -- -- selber verbergen -- engagiert -- sagen -- Prinzipal Truppe -- Mut Hoffnung Rolle zeigen -- Entschluß billigen -- 
  Rolle -- worin auftreten -- zufällig Weise treffen -- Poet Mode spielen -- worin Rolle antrug -- 
  wünschen -- Dunkel spielen -- Rolle auswendig lernen -- neu Freund -- Schauspieler B -- abriet -- Rolle spielen -- vorzüglich gelingen -- Reiser Reimreich übernehmen -- bedeutend Schauspieler Rolle besitzen -- 
  Reiser lassen gefallen -- Maskaril Magister Blasius -- Rolle Beifall spielen -- Stärke Komischen zutrauen -- 
  schreiben Rolle -- lernen auswendig -- 
  Aussicht theatralisch Laufbahn vollkommen glücklich -- Bemerkung -- Hoffnung fürchterlichst -- Angst Schrecken erfüllen -- 
  -- -- Satan Engel Fäusten schlügen -- 
  bemerken -- Verlust Haar drohen -- 
  -- Körper Fehl notwendigsten brauchen -- betreffen Zufall -- Voraus selber Abscheu erfüllen -- 
  eilt Not treu Freund -- Doktor Sauer -- Erhaltung Haar Hoffnung -- finden Abend -- Poet Mode aufführen -- Garderobe Kulisse -- kleiden komisch -- Reimreich -- Lächerlichste Licht darstellen -- Name stehen Komödienzettel Ecke angeschlagen -- 
  Schauspiel angehen -- Freund N. -- -- Theater -- bittersen Vorwurf -- Reiser lassen Taumel Leidenschaft stören -- Rolle vertiefen -- woran sogar Freund N -- zuletzt -- komisch Anzug lachen -- Bote erscheinen -- Prinzipal ankündigen -- Doktor Froriep sogleich Statthalter fahren -- Beschwerde führen -- sofern wagen -- Student -- Nahme Komödienzettel drucken ständ -- Theater betreten lassen -- Verlust Konzession spielen -- unausbleiblich Folge -- 
  Reiser stehen versteinern -- Prinzipal wissen Angst -- wozu greifen -- Schauspieler erbot -- Rolle Reimreich -- -- Souffleur spielen -- pocht Parterre -- Vorhang aufziehen -- 
  Wütend Reiser Kulisse -- zernagt Rolle -- Hand halten -- 
  eilt -- schnell -- Schauspielhause -- durchirrt Straße stürmisch regnerisch Wetter -- Mitternacht bedeckt Brücke -- Regen schützen -- Mattigkeit niederwarf -- Weile ausruhen -- worauf umherirrt -- Anbrach -- 
  äußerer Anstrengung Natur -- einzig -- verloren bitterst Schmerz einigermaßen ersetzen -- 
  fortdauernd Leidenschaftliche Zustand -- unbefriedigt Sehnsucht Nahrung -- 
  mißlungen theatralisch Leben drängen gleichsam Nacht -- leidenschaftlich Zustand durchgieng -- darstellen -- 
  lassen Doktor Froriep -- reden -- Vater -- 
  bedienen schmeichelhaft Ausdruck -- Reiser Anlage Besserem Schauspieler bestimmen -- verkennt -- Wert fühlen -- 
  -- Reiser Unmöglichkeit einsehen -- Wunsch Erfurt befriedigen -- täuschen wiederum -- überreden selber -- freiwillig Idee Theater widmen entsag -- gleichsam vereinigt -- Entschluß hintertreiben -- Art -- Doktor Froriep abmahnen -- Schmeichelhaft -- 
  -- rächt Selbsttäuschung erneuerten bitter Unmut -- Unentschlossenheit -- Kampf selber -- -- härteste Schlag treffen -- vermeiden hoffen -- müssen Haar verlieren -- 
  Gedanke nunmehr perück -- Erfurter Student Ungewöhnliches -- erscheinen -- unerträglich -- 
  weniger Gelde -- übrig -- äußerste Stadt -- Gasthof einquartieren -- Schlief -- Abends Bier Brot geben lassen -- desto lang gelbe reichen -- 
  größtenteils öd Gegende umher -- suchen -- regnet -- Kirche Schutz -- bringen Weise beinahe vierzehn -- wissen -- bleiben -- Freund ausspähen -- N. -- -- O. -- -- W. -- -- -- interessieren -- Gasthofe unvermutet überraschen -- Entfernung freundschaftlich Vorwurf -- 
  Haar Stirn Perücke überkämmen -- stark puderen -- einigermaßen Anschein -- Haar trügen -- 
  Entschloß Freund -- abholt -- menschlich Gesellschaft -- -- -- wünschen Weise entfernt einsam wohnen -- 
  Wunsch suchen gewähren -- 
  gutmütig -- -- sprechen Onkel -- damalig Regierungsrat Professor Springer Erfurt -- stellen Reiser Zustand -- Bedürfnis einsamen Wohnung lebhaft -- 
  Regierungsrat Springer lassen Reiser -- jemals aufmunternd angereden -- wahr Teilnehmung aufnehmen -- Manne -- Reiser innigst Zuneigung Verehrung fassen -- 
  Las statistisch Kollegium -- Reiser paarmal anhören -- Sache interessieren -- R. Springer auffordern -- Fache widmen -- wobei möglich Weise unterstützen wollen -- 
  Anfang Unterstützung R. Springer sogleich -- Reiser -- Wunsch gemäß -- einsam Wohnung -- Gartenhaus einräumen -- wozu Reiser Schlüssel bekommen -- Fenster schön Aussicht aneinandergrenzend Garten -- Erfurt umgaben -- 
  Reiser Genoß Freitisch -- Doktor Froriep tätig -- suchen Weise Unterstützung verschaffen -- fing sogar mathematisch Kollegia hören -- gut Freund ziehen literarisch Zusammenkünft -- lesen Ausarbeitunge -- Sache nunmehr Gang -- neu unglücklich Anfall Poesie verdorben -- 
  neu Aufenthalt einsam romantisch Wohnung beitragen -- Einbildungskraft auf erhitzen -- 
  Brief -- Philipp Reiser Hannover schreiben -- Rückfall beschleunigen -- 
  Schreiben Tone wertärschen Brief abfassen -- 
  patriarchalisch Idee müssen Weise erwecken -- Schade -- Affektation geschehen -- 
  Brief schreiben -- schaffen Reiser Teetopf -- lieh Tasse -- Holz Haus -- kaufen Stroh -- Erfurt Brennen brauchen -- selber Stübchen -- Öfchen Tee kochen -- womit -- Rauch beinahe ersticken -- Stande -- 
  geschehen -- schreiben gleichsam triumphierend Philipp Reiser -- 
  -- -- Lage -- reizender wünschen -- 
  blick Fenster weit Flur hinaus -- sehen Ferne Reihe Bäumchen Hügel hervorragen -- denken -- u. S. W. Schlüssel einsamen Wohnung -- Herr Haus Garten -- u. S. W. manchmal sitzen -- Öfchen -- Tee koch -- u. S. W. Tone fort -- stattlich lang Brief -- Reiser Herz bringen -- schön Brief kritisch Freund -- Doktor Sauer zeigen -- 
  verdarb vollends Sache -- gutmütig Höflichkeit Kompliment -- Reiser Gegenwart leiben -- wünschen -- entfernt -- Brief Reiser erhalten -- 
  -- beinahe Ruhe gebracht Dichtungstrieb Reiser angefacht -- 
  suchen Gedicht Schöpfung vollends Chaos durchführen -- heben neu Qual -- Darstellung gräßlich Widersprüch ungeheuer labyrinthisch Verwicklung Gedanke verlieren -- folgend Hexameter -- Bibel -- Hölle Begriff erlösten -- 
  still Gewässer rauscht Stimme Ewig Sanft -- sprechen -- 
  Licht -- Licht -- 
  merkwürdig -- Lust verging -- Gedicht fortführen -- sobald Stoff fürchterlich -- 
  suchen Stoff -- fürchterlich bleiben müssen -- mehrere Gesang bearbeiten -- -- Tod selber -- 
  schmeichelhaft Idee -- -- Jüngling -- ernst Gegenstand besingen wählen -- heben Gedicht -- 
  Jüngling -- früh Kelch leiden trank -- u. S. W. Werk schreiten -- Gesang Gedichts -- wovon Titel schön hingeschrieben -- bearbeiten -- finden Hoffnung Reichtum fürchterlich Bild finden -- Bitterste täuschen -- 
  Flügel sinken -- fühlen Seele lähmen -- -- weit Leere -- schwarz Öde erblicken -- vergeblich aufarbeitend Leben -- Schilderung Chaos anbringen lassen -- ewig Nacht Gestalt verdecken -- ewig Schlaf Bewegung fesselten -- 
  strengt Art Wut Einbildungskraft -- Dunkelheit Bild hineintragen -- schwärzten -- Herkules Haupt grün Blatt Pappelkranzes -- -- Cerberus fangen -- Haus Pluto nahen -- 
  niederschreiben -- lösen Rauch Nebel -- weiß Papier bleiben unbeschrieben -- 
  wiederholt vergeblich Anstrengung falsch Dichtungstriebe -- erliegen -- verfiel Art Lethargie völlig Lebensüberdruß -- 
  werfen Abends Kleider auf Bette -- bleiben Nacht folgend Art Schlafsucht liegen -- Abend folgend Tag -- Weihnachten -- Bote Gönner Regierungsrat Springer wecken -- Frau Reiser Weihnachtsbrot Geschenk übersandn -- 
  -- unwiderstehlich Schlafsucht bestärken -- 
  schließen Brot -- leben vierzehn -- Genoß -- Nacht -- immerwährend Schlafe -- -- letzter ausnehmen -- beständig Schlummer -- Bette zubrachten -- 
  hierzu freilich Umstand -- Holz -- einzuheizen -- 
  Wort sagen -- Bedürfnis befriedigen -- gewissermaßen leiben -- Mangel Holze Beweggrund sonderbaren Lebensart vorschützen -- 
  Reiser Zustande Freund stören -- Wunsch äußern -- paar Woche einsam wünschen -- 
  Zustand sonderbar Wirkung Reiser -- bringen Art gänzlich Abspannung Gleichgültigkeit -- wodurch Zustand -- vergeblich besingen streben -- gewissermaßen selber darstellen -- 
  scheinen Lethe trinken -- Fünkchen Lebenslust übrig -- 
  letzteren -- Zustande -- -- isolieren betrachten -- glücklichst Leben zählen -- 
  fortdauernd Abspannung allmählich schlafend Kraft erholen -- 
  Schlummer sanft -- Ader scheinen neu Leben verbreiten -- jugendlich Hoffnung erwachten -- Ruhm Beifall krönten -- schön Traum lassen golden Zukunft blicken -- 
  lang Schlafe berauscht -- fühlen angenehm Taumel -- süßen Schlummer aufdämmeren -- 
  Wachen selber fortgesetzt Traum -- geben Zustande ewig bleiben -- 
  gefroren Fenster ansehen -- angenehmsen Anblick -- nötigen -- lang Bett bleiben -- 
  Brot Tisch betrachtet Heiligtum -- schonen müssen -- Dauer Brot Dauer glücklich Zustand abhehen -- 
  fühlen -- sobald gelten -- schwach -- 
  Theater stehen glänzend jemals -- theatralisch Leidenschaft durchstürmt Seele -- Gemüt Zuschauer Spiel erschüttern -- 
  Brot verzehren -- stehen Abend -- ordnen Anzug -- Gang Theater -- Winkel setzen -- erstlich Stück Namens Inkle Yariko -- alsdann leiden jung Werther aufführen -- 
  Verfasser letzteren fast tun -- wertesch Brief Dialog Monologe verwandeln -- freilich -- Publikum sowohl Schauspieler rührend Gegenstand -- außerordentlich interessieren -- 
  ereignet tragisch Katastrophe letzter Stück komisch Zufall -- 
  nämlich irgendwo paar alt verrostet Pistole geliehen -- nachlässig -- vorher probieren -- 
  Akteur -- Werther spielt Tisch -- -- Werther stehen -- buchstäblich -- -- Hand berühren -- selber Staub abputzen -- u. S. W. -- genau vollständig darstellen -- Schoppen Wein Brot bringen lassen -- wozu Aufwärter ermangelen Brotmess Tisch legen -- 
  Stück einrichten -- Werther Freund Wilhelm -- Schuß fallen hören -- hereinstürzen -- ausrufen müssen -- 
  Gott -- 
  hört Schuß fallen -- 
  schön -- Werther unglücklich Pistole ergreifen -- Stirn halten -- losdrücken -- versagt Hand -- 
  widrig Zufall Fassung bringen -- schleudern entschlossen Schauspieler Pistole weg -- rufen pathetisch -- traurig Dienst versagen -- 
  Ergriff plötzlich -- drücken -- o Unglück -- versagen -- 
  ersterben Wort Mund -- zitternd Hand ergreifen Brotmess zufällig Weise Tisch liegen -- durchstichen Schrecken Zuschauer Rock Weste -- -- 
  fallen -- stürzen Freund Wilhelm herein -- rufen -- -- Gott -- hört Schuß fallen -- -- 
  Schwerlich Tragödie komisch schließen -- 
  -- bringen Reiser hochschwebend Phantasie -- vielmehr bestärkt -- Unvollkommene -- Vollkommen ersetzen müssen -- 
  hören -- Schauspieler Erfurt abreisen -- Leipzig -- hören ferner geschickte Schauspieler Truppe Namens B. -- -- Ruf Gotha erhalten -- Nebenbuhler fürchten -- Leipzig Ort glänzen -- Perücke schicken wiedergewachsen Haar verbergen -- 
  Grund nm Leidenschaft -- vorher -- Weile schlummern -- auf Vernunft Sieg geben -- 
  Freund sogleich Entschluß -- gesonn -- Sp -- -- .schen Truppe Leipzig -- unwiderstehlich Trieb fühlen -- unglücklich -- überwind -- Unternehmung immerfort hindern -- 
  stellen Grund leidenschaftlich stark -- Freund N. -- -- sagen -- reizendst Schilderung -- künftig Frühling Steigerwalde Klopstock lesen u. s W. Reiser halten Schauspieler -- bringen Regierungsrat spring Schlüssel Gartenhause -- Lebhafteste unglücklich Zustand schildern -- Trieb Theater unterdrücken -- 
  R. Springer behandelt Reiser tolerante Art -- 
  raten selber -- Trieb unwiderstehlich -- folgen -- Trieb -- wiedergekehren -- wahr Beruf Kunst enthielen -- Alsdann entziehen sollen -- 
  Gegenteil -- Reiser selber täuschen -- Unternehmung glücklich -- Umstand Lage -- dreist wenden -- Hilfe versichern -- 
  Reiser gerührt Herz Abschied -- Wort vorbringen -- Großmut Nachsicht Mann Gemüt bewegen -- 
  selber Weggehe bittersen Vorwurf -- lieb Freundschaft würdiger zeigen -- 
  Reiser Abschied nehmen -- Doktor Froriep -- Entschluß N. -- -- wissen -- nachsichtsvoll -- Gönner behandeln -- Doktor Froriep erklären -- Entschluß widerran -- vielmehr bestärken -- Schaubühne Maß Schule Sitte -- eigentlich -- -- 
  Ironie fügen Grund hinzu -- Tochter -- Arm tragen -- -- -- berühmt Schauspieler Reiser hören -- Nahme Deutschland berühmt -- 
  wohlgemeint Ironie bleiben Reiser fruchtlos -- demungeachten innig Rührung bitter Vorwurf selber erinnern -- Doktor Froriep tun -- wovon Endzweck vereiteln -- 
  scheinen nunmehr Pflicht Selbsterhaltung -- innerer Vorwurf Gehör geben -- fest überzeugt glauben -- unglücklich Mensch -- Neigung folgen -- 
  Sp -- -- -- sch Truppe letzter Woche -- Mangel Einnahme äußerer Armut geraten -- 
  Direktor Sp -- -- -- reiste Garderobe Leipzig voraus -- übrig Schauspieler müssen zusehen -- Ort Bestimmung erreichen -- reist Pferd -- Wagen -- Fuß -- Umstand jedeu erlauben -- gemeinschaftlich Kasse längst erschöpfen -- Leipzig hoffen -- erholen -- 
  Reiser Nachmittag -- Abschied nehmen -- Fuß Weg -- Freund N. -- -- begleitet Pferd nächster Dorfe Weg Leipzig -- N. -- -- künftig Sonntage predigen -- 
  Gasthofe eingekehren -- selig Szene erinnern -- genießen -- Abhange Steiger Klopstock Messiade lesen -- Reiser Weg -- N -- begleitet Strecke -- dunkel -- 
  umarmt -- nehmen rührendst Weise Abschied -- Abschied erstenmal Bruder nennen -- 
  Reiser reißen -- eilen schnell fort -- Freund Zurief -- reit -- 
  Entfernung -- -- rufen -- Nacht -- 
  sobald Wort -- fatal -- ärgeren -- Einfiel -- 
  empfindsam Szene Erinnerung Stoß erleiden -- komisch klingen -- -- leben -- ordentlich Nacht wünschen -- gleichsam Besuch ablegen -- 
  --- schneidend Kälte -- 
  Reiser wanderen -- Bürde tragen -- reizend Aussicht Ruhm Beifall Straße fort -- 
  -- Anhöhe -- stehen still -- übersehen beschneit Flur -- Augenblick sonderbar Gedanke Seele schoß -- fremde wandeln -- Schicksal dunkel Ferne sehen -- Täuschung verschwinden -- entstehen -- denken -- Leipzig aussehen -- Rolle auftreten u. S. W. Weise legen Weg Erfurt Leipzig vergnügen -- sprechen häufig Name N. -- -- -- lieben -- weinen heftig komisch Nacht einfiel -- Zusammenhäng rührend Erinnerung bringen wissen -- 
  Erfurt -- Leipzig Gasthofe golden Herz einkehren müssen -- Schauspieler logieren -- gleichsam Niederlage -- 
  Stube treten -- finden ziemlich Anzahl Mitglied Sp -- -- sch Truppe -- künftig Kollege begrüßen -- außerordentlich Niedergeschlagenheit bemerken -- erklären -- tröstlich Nachricht -- würdig Prinzipal Truppe Ankunft Leipzig -- Theatergarderobe verkaufen -- Gelde gehen -- -- 
  Sp -- -- -- sch Truppe zerstreut Herde -- 