Gemälde weiblich Erziehung -- Caroline Rudolphi -- 
  -- 
  Kupfer -- 
  Heidelberg Mohr Zimmer -- 
  1807. Vorrede -- 
  Gegenwärtige Brief weiblich Erziehung dürfen Vorrede weiblich lesend Welt wagen -- beschämend Frage -- 
  -- wozu erscheinen -- befürchten -- 
  dennoch Rechtfertigung Dasein Paar Wort vorausgehen -- 
  Verfasserin wenden Publikum -- Schreiben einzig Auge -- 
  denken jung Mütter bestehend -- Naturberuf ernst Blick Auge fassen -- würdig erfüllen -- -- Herzensgrund -- fremd Rat wichtig Angelegenheit verschmähen -- 
  nehmen weiblich Praktik desto willig -- Theorie Stiche lassen -- Moment -- Beistand meister bedürften -- Geist Leben gebrechen -- Leben anzufachen vermögen -- lebendig Handlung Theorie hervorgehen -- 
  praktisch Anweisung vorhanden -- dennoch Verfasserin überflüssig achten -- kurz Auszug Beobachtung Erfahrung pädagogisch Leben Mitwelt Opfer darzubringen -- 
  jung Mütter -- be- Fall Rat suchet -- Brief vorzüglich widmen -- 
  Nehmet freundlich -- Mutter -- 
  -- Verfasserin gedingen -- wissen -- Zeile lesen -- Name sehen -- 
  Anleitung gewiß achtbar Mittelstand unbrauchbar -- bürgerlich Stufe Familie -- Gemälde erscheinen -- -- Vermögenszustand gewöhnlich Wohlhabenheit annehmen -- 
  hoffen -- 
  Stand müssen annehmen -- 
  indessen lassen Erziehungsgemälde anderer Standpunkt nehmen -- zeigen -- minder begütert Familie Kind zweckmäßigsen würdig glücklich zufrieden Leben ausbilden mögen -- 
  Schrift Mütter zueignen -- hoch Lebensweise Wohlhabenheit handelnd Person gegenwärtig Brief Hindernis Anwendbarkeit scheinen -- 
  obwohl Geist Büchlein betrachten -- zufällig Ding unabhängig -- einzig Wesen Sache -- 
  lassen sagen -- Leben bürgerlich Verhältnis Ansicht -- Früh Erziehung lassen -- Individuum innerer Trefflichkeit Unkunde äußerer Verhältnis -- unglücklich mißkennen seinigen -- dennoch elend -- 
  dennoch bleiben Satz unbestreitbar Wahrheit stehen -- Hauptsumma Erziehungslehre -- Lasst eure Kind Mensch -- hindern -- liebreich förderlich Erhaltung Anlage -- 
  Ziehet ungebührlich hervor -- bringen weder Geist Körperkraft Treibhausluft -- rein Lebensluft gedeihe -- frisch kräftig entfalen -- 
  gelten Zeit -- Stände -- jeder Geschlecht -- 
  möge Verfasserin Brief gelingen -- zeigen -- allgemein Wahrheit auf Individuum anwenden können -- 
  bedürfen Wort Rechenschaft Einkleidung Romanähnliches Gewand -- 
  lieb Freundinne -- bedürften -- verzeihet -- Zeitalter Buch fordern -- hoffen -- Frau lesen -- lesen -- 
  Nehmet Erziehungs-Gemälde Schwesterhand freundlich -- 
  lassen nahe -- betrachten einsam abendstunde -- Wiege eur schlafend Kindlein -- 
  Ergötzet traurig Nächte -- krank Liebling bewachen -- 
  lesen harmlos Zeitkürzung -- 
  Verfasserin Ernst fragen -- 
  Erziehung -- aufstellen -- 
  Kühnlich -- 
  -- 
  wesentlich Mutter -- ernstlich -- -- abhängen -- 
  Leben Gemälde entwerfen -- Licht hell aufgetragen -- Umrisse schärf -- Wirklichkeit erscheinen -- Trapperiee malerisch ordnen -- Alltagsleben werfen pflegen -- 
  Sache lieben treiben können -- Selma -- stellen Verfasserin sicher Bürge -- 
  wohnen tief Heiligtum weiblich Herzens -- Mutterliebe -- 
  Gemälde weiblich Erziehung -- 
  -- 
  Brief -- 
  forderst -- lieb Emma -- Wegweiserin schön Beruf -- Mutter kürzlich auferlegen -- wodurch ehren -- menschlich Wesen ehren -- 
  Mutter -- fühlst hoch still Demut -- fast allzu scheuem mißtrauen Einsicht Geisteskraft -- 
  Weißt -- still forschen Sinn Einsicht -- Geistesruh Kraft -- getreu bleibst -- 
  bitte nachgeben -- 
  teuer Adoptivtochter bitten -- fähig versagen -- 
  -- -- 
  Jda gestern alt -- 
  scheinen demnach früh -- Erziehung reden -- 
  dennoch -- -- 
  Jda Amme unnachlässig fordern müßtesen -- brauchen sagen -- -- glücklich Mutter -- Ernährerin Deines Liebling -- 
  Diät -- wodurch Nahrung -- Jda reichsen -- gesünde bleiben -- laß dein verständig Arzt vorschreiben -- Befolge fie Gewissenhaft -- 
  -- fremd Amme vergeblich fordern -- moralisch Diät -- folgend Winke -- 
  Bewahr weich Gemüt tief Schmerz -- stark Bewegung -- 
  Suche heit Ruhe erhalten -- eigentümlich -- Kraft Gleichgewicht körperlich Funktion ungehemmt Tätigkeit bleiben -- süß Nahrung Kind ungehindert bereiten mögen -- 
  Unfall plötzlich kommen -- Eindruck erwehren könntest -- weich Gemüt schwach physisch Konstitution -- fühlst Innerst Dein wesen angreifen -- erschüttern -- versag Freude Selbstnähren -- 
  Opfer -- Kind Erhaltung notwendig bringen -- 
  Suche Preis gut Amme erhalten -- der heißen Geist Gemüt gesündeste -- 
  -- wähl schön -- gutmütig Gesicht -- 
  hart -- finster -- bösleidenschaftlich Zug Amme dein Kind Fall -- 
  äußerste Phlegma -- 
  -- jung -- gesund -- gutmütig unglücklich Weib finden -- dein Kind Amme -- ziehen liebreich -- Kind Herz zugetan -- 
  Laß arbeiten -- wenden behutsam -- schaden -- Sorgsamer betrüben -- -- -- -- Fall -- Erinnerung nötig -- eintreten -- 
  Müßtest Selbstnähr aufgeben -- fändest Amm -- Forderung entspräch -- bleiben Auffüttern übrig -- Fall moralisch unschädlich -- körperlich gedeihlich -- 
  Nahrungsmittel -- jung Kind zuträglich -- Milch krank Mutter -- schlecht Amme -- 
  schön Mutterlieb -- Schwäche -- Folge Härte verschieden -- kränkelnd Mutter entschließen -- Freude Selbstnähren aufzuopfern -- zart Menschensprößling zumuten -- früh Plag Leben teilen -- -- -- 
  -- hoffen -- Schicksal süß Mutterfreude rein voll Züg schmecken lassen -- 
  Heiterkeit Kind Frohsinn anglimmen -- 
  Deines angesichts Freude Lächel bilden -- melodisch Stimme -- heit -- horchen -- Wohllaut Wesen gebären -- 
  Schreie -- jeder Kind -- Schmerz -- Unbequemlichkeit -- Notwehr bitte Hilfe abdringen -- 
  Sprache Schmerz deuten lernen -- Kind anderer Wesen -- 
  Abhelfe schnell klein leiden -- entdecksen -- Jda früh Person erkennen -- süßest lächeln sagen -- kennen -- 
  früh Vermögen Sinnesorgan eigentlich Wahrnehmung Kind erwach -- lassen bestimmen -- Entwicklung verschieden Natur anfangen -- 
  jung Geschöpf zeitig einfach angenehm Gegenstand Wahrnehmung umgeben -- sicherlich heilsam -- gering Bedeutung -- scheinen -- 
  -- hoffen -- -- Freundin -- besuchen -- laß Ausschmückung Stübchens sorgen -- Schauplatz Lebensjahres Jda -- 
  -- bitte -- Laß einfach schmücken -- 
  sauber -- höchst reinlich halten -- wissen ohnedies -- 
  dünken -- sehen Jda Bettchen -- -- warm mild Jahrszeit -- nett sauber decken -- zart Äuglein schon -- Fenster für grün Vorhäng behängen -- 
  sobald Jda Licht ertragen -- erhellet heilig Dunkel Kämmerlein -- stellen Freundin appenzellisch Taube freundlich Kind -- lieblich Kindergruppe Gips Bettchen -- wechseln -- -- 
  -- Blick anmutig Bild fallen jung Seele zuführen -- schnell Wechsel verwirren -- 
  mäßigen Wärme -- erfrischt -- gereinigt Luft Zimmer -- brauchen -- lieb Emma -- reden -- Notwendigkeit öfteren Waschen -- 
  Sinn Ordnung hoch Reinlichkeit Wink Art überflüssig -- 
  wissen -- Forderung Wärterin Punkt streng -- -- 
  Jda wiegen -- 
  Frage Wieg Nichtwieg -- Art -- beantworten -- verraten kleinlich pädagogisch Pedanterie -- letzter Jahrzehnt Vorschein -- 
  Jda Wiege gut Großmutter Läufen versehen -- laß Läufe -- stellen fest -- gewöhn schaukelnd Bewegung Bedürfnis -- 
  gesund -- gewiß ungewiegt schlafen -- frühest Lebenszeit -- Existenz fast leicht -- unterbrochen Schlummer -- Woche Schlaf wiegen -- späterhin nötig -- 
  Laß dennoch Läufe Wiege -- 
  Zeit -- -- physisch Unruhe peinigen -- weinen gewohnt Beruhigungsmittel -- Brust -- beruhigen -- versuchen -- Bewegung -- Arm Wiege -- Schmerz besänftigen Schlaf herbeiführen -- 
  Jda gesund -- laß schlafen -- Lust -- laß künstlich Art schlafen nötigen -- 
  verstehen -- allzulebhaft Beschäftigung -- Vorhalt vieler Gegenstand -- laut Vorsingen Vorsprechen -- natürlich heilsam Antrieb Schlaf verscheuchen müssen -- -- 
  dein Schlaf lang Brief verscheuch -- langweilig herbeirufen -- leiben -- leben -- 
  Brief -- 
  Kinderstube schriftlich besuchen -- mehrere Woche verflossen -- Jda schön Keim Entwicklung nah drängen -- 
  physisch Wohlsein Kind sagen -- inniglich erfreuen -- 
  -- Wohl übelbefinden unser entscheiden gewiß Leben -- anschlagen lassen -- 
  Jda früh Person unterscheiden -- vermuten -- früh -- scheinen fast unglaublich -- 
  Wunder Liebe unmöglich -- 
  -- Mut -- Kind fast ausschließend leben -- äußerer Umstand stark entgegen stemmen -- 
  -- müßtesen Jda früh gewöhnen -- Gertrud -- -- abwesend müßtesen -- Sehnsucht mißmutigweinerlich Stimmung gewöhnt -- Weine herbei kämest -- Keim Eigensinn Idee Ertrotzenkönnen Aufbrächtest -- 
  Gesellschaft denkbar -- wohltätig -- -- -- 
  -- Deines Mann dringend Geschäft nachlassen -- Anspruch Gesellschaft -- Erholung bedürfen -- 
  -- Jda -- -- 
  Gertrud -- verständig -- Ausbildung Einsicht fehlen -- ersetzen Gehorsam fast vergötternd Liebe -- 
  Gewöhne Jda Zeit -- -- 
  nutz Gertruden ehrerbietig Liebe Ausbildung -- 
  Suche seelengun Geschöpf -- wert -- hergebracht Meinung Vorurteil dienend Stand befreien -- Stelle verständig Ansicht Ding gut Überzeugung pflanzen -- 
  Punkt sicher Stand erheben -- 
  heilsam -- 
  Bild -- Hand -- maschinenmäßig dein Wille tun -- laß verständig Stellvertreterin -- dein Geist geben -- Mutterherz -- Lehre Geist handeln -- 
  -- echt weiblich Herz übrigen -- 
  gelingen -- ich_es wünschen hoffen -- 
  Laß unterstütz Mutterpflicht -- -- wichtig Obliegenheit versäumen müssesen -- 
  Geschenk -- womit gewöhnlich Dienstbot gewinnen suchen -- bewerkstelligen -- ehrendem vertrauen -- 
  -- Gewöhne Gertruden -- -- Zeit Sprache -- Kind sprechen -- 
  erinneren -- Deutsch verdorben -- 
  Korrigiere freundlich -- Fehler -- sprechen -- sagen -- deiner Kind willen Provinzial-Ausdrück entwöhnen müssen -- 
  wichtig -- sprich -- sprech Kind vermeiden -- machen gut verstand anschaulich -- nachteilig gewöhnlich Art Wärterinne Kind schäkern -- schädlich gewaltsam Anreizung lachen -- 
  Sage -- Jda lachen lernen -- sobald herzlich freuen können -- Schäker Kitzel verkehrt Weise -- 
  Gertrud ähnlich Belehrung Zeit vorbereiten -- brauchbar Gehilfin -- Geschäft erleichtern Abwesenheit verderben -- 
  Halt -- reinlich ordentlich kleid -- fest Gewohnheit -- ehe Jda Gegenteil bemerken -- Ordnung Reinlichkeit Notwendigkeit -- Gegenteil ahnen -- 
  Jahrszeit nahet heran -- Lüfte mild -- 
  Laß wärmst Stunde Tag Fenster fleißig öffnen -- Jda frisch Luft befreunde -- 
  freuen verlangen -- 
  tragen hinaus Gärtche -- verweile lang freie -- 
  Kleide wärm -- Hülle -- unser Zahnschmerz -- Ohrenzwang -- furchtbar Heer Erkältungsübeln -- Rheumatismen nennen -- Erfahrung kennen -- 
  halten -- sorgsam Kinderdiät -- fürchterlich Blatternkrankheit Kind abwenden stehen -- 
  fromm Wunsch Glaube bleiben -- liegen sicherlich Reale Grund -- nämlich -- wohlverstanden Diät wohlgeordnet Lebensweise -- Natur nahe halten -- viele ausrichten können -- Lebenstag Kind ununterbrochen Sinn fortsetzen -- 
  Skrofelkrankheit sicherlich vermeiden -- 
  Kind Kindheit verderben -- grausam Plagegeister -- Leben hindurch -- Ferse sitzen -- Rs .. ch Familie sehen -- traurig Lazereth arm Familie erinnerst -- 
  Bewahr lieb Kind warm Bett -- warm Stube -- Speise -- sobald anfangen letzter bedürfen -- auf sorgsam -- 
  -- Leb -- gute -- 
  Brief -- schreiben Vorsatz -- halten -- 
  unterdessen Jda Monat alt -- lächeln -- bewegen -- greifen -- glänzt leuchten -- 
  bedeutend -- jung rege Leben beschäftigen -- -- -- Stoff -- Art fehlen -- 
  nahen -- 
  Vernimm -- 
  Pestalozzisch Buch Mutter befreunden -- 
  glauben -- 
  ehrwürdig P. selber verübeln -- 
  Mutter -- Buch -- Methoden-Bücher schreiben -- 
  roh verwahrlost Landvolk Gegend -- 
  Mutter Auge -- Vorschrift peremtorisch Anweisung Mechanik Unterrichts -- -- 
  -- ästhetisch Sinn hoch Grad Ausbildung erhalten -- Selbstdenkende Vorschrift gesetzlich Verbindlichkeit -- 
  Form ewig Wiederholung unleidlich -- unnötig -- 
  ungeachtet finden gebildetst tiefsten denkend Geist Schrift reichen Stoff Nachsinn Erwägung Sache -- 
  weder z. B. Kursus Benennung menschlich Gliedmaß Wiederholung nachbeten -- 
  bedürfen -- 
  Buchstab töten -- Eist lebendig -- 
  nehmen Gegenstand -- verschieden regelmäßig Teil zusammengesetzt -- Kind Körper freilich nächster -- gewiß brauchbar -- einzig -- Teil kennen Lerne -- 
  lassen -- Ding Anschauung -- -- geschickt -- minder künstlich -- groß Kunstwerk Natur -- menschlich Körper -- -- Entwicklung Begriff Körper tauglich scheinen -- 
  frühling Jda gärtch Haus Landsitze Garten -- groß umliegend Gegend wandelst -- gib -- worauf Blick häufigsten fallen -- worauf lieb verweil -- Gegenstand händch ausstreck -- reißen -- 
  roh Stein -- gehen -- zeig Finger -- sagen -- Stein -- suchen mehrere Stein wiederholen -- merken -- Name -- Stein -- -- merkst -- Stein Körper unterscheiden -- 
  fallen Aufmerksamkeit auf lebendige -- z. B. Sperling -- vorbeifliegend Schwalbe -- nenn Name -- Vogel -- laß Jda fliegen bemerken -- wiederhol Wort -- Vogel -- 
  Bring -- Freude -- Vogel Käfig nah -- Laß betrachten -- Lust -- entlaß Auge Käfig -- sehen fliegen -- wissen -- Vögel -- Ferne fliegen sehen -- gestalten -- Begriff -- Vogel -- 
  unterscheidend Benennung -- Fink -- Schwalbe -- Nachtigall -- Lerche -- Krähe -- hören -- Begriff Vogel festgesetzen -- 
  -- sprechen anfängen -- Haushuhn Vogel nennen -- -- 
  Laß Irre -- 
  fallen anderer Gegenstand Auge -- -- 
  -- verweilen -- 
  Tulpe Nelke -- nenn Name -- Blume -- 
  Fängt -- Farbe unterscheiden -- füg Name Farbe hinzu -- Lehre gelb Blume -- blau Blume -- rot bunt Blume sagen -- eher -- Farbe unterscheiden -- übe -- 
  Witterung rauh Freie -- 
  machen Gegenstand Stübchen aufmerksam -- Lehre kennen -- unterscheiden benennen -- -- wünsch -- Zimmerchen einfach dekoriern -- Gegenstand -- -- reden Könntest -- 
  laß Gegenstand schnell wechseln -- 
  begüterten Haus finden einst Kinderstube alt Haute-Lisse-Tapeten verunziern -- 
  Wieg klein Kind König Saul abbilden -- Spieße David fahren -- 
  Vorjüngste Kind -- plaudern Anfing -- fragen -- Tante -- erklären -- Mann Messer -- 
  verlegen -- Kind hiervon nächster Bild führen -- erzählen -- sehen -- nächster Bild stellen Teufel Zinne Tempels -- Christus versuchen -- 
  -- sagen -- Aff -- schön heilig Mann herunterstürzen -- einfiel -- Furcht Affen Kind hineinfabeln -- 
  nächster Abbildung Not helfen -- finden -- 
  Herkules -- halb verbrennen Scheiterhaufen -- Kentaur Nessus -- Aktus Ferne zusehen -- 
  erspar Beschreibung übrig Vorstellung -- 
  Jupiter Europa -- Diana Aktäon fehlen -- verstehen -- -- 
  Komme -- Lilli -- rufen -- Garten -- Blume pflücken Mutter Kranz flechn -- 
  verlassen Kinderstube -- -- voll albern Schnurpfeiferei finden -- Kind zeitvertreib dienen -- gänzlich Verwirrung Begriff dienen -- -- 
  Zurüstung eigens herbeigeschafft Gegenstand bedürfen allererst Unterricht -- 
  gemeinst Ding dienen -- künstlich zusammengesetzt -- 
  Jda früh Form belehren -- 
  führ rund Tisch -- bezeichn Form nennen -- zeig viereckig nenn Form -- Ecke zeigst -- sehen -- unterscheiden -- 
  -- rund Körper -- bemerken lehrst -- Kugel -- 
  Kind ohnehin Freude -- rollen sehen -- einer unschädlichst Spielzeug -- verletzen -- 
  Laß -- rund Tisch unterscheiden -- rund Fläche aufsuchen -- Teller -- Tasse Art Nähe -- 
  zimmerchen Stoff plaudern -- plaudern Belehrung -- einigermaßen hingeben -- 
  Trittst an Fenster -- regelmäßig Form -- gleich Abteilung geben Stoff -- Pestalozzisch Weise -- plaudern -- 
  Schatze Vernunft reicheren Schatze Mutterliebe täglich Stoff Unterhaltung schöpfen -- -- 
  -- laß Gegenstand schnell flüchtig Jda vorübergehen -- vielmehr haften halten -- -- 
  Brief -- 
  Jda wachsen gedeihet Geist Körper -- Herz Mutterherz einer verschmolzen -- 
  O zweifle -- -- -- 
  Spur aufkeimend Eigensinn bemerken -- 
  freilich früh -- unser Plan früh -- -- 
  Ehe besonderer Unterdrückung vielmehr Ausrottung Fehler sagen -- gewiß -- Sache irrest -- weinerlich Wesen -- überfällen -- Wegwerfen Ding -- leiben -- Eigensinn -- vielmehr Unlust -- schmerz Zahnen herrühren -- 
  hierüber ungewiß -- raten -- heftig weinen -- Spielzeug Boden werfen -- Weggeworfene aufheben -- griffe -- Augenblick anderer reichen -- freundlich schließen -- sehen -- Liebe Schmerz besänftigen lassen -- 
  Fährt fort -- weinen -- ernsthaft -- such Ortsveränderung zerstreuen -- gehen Garten -- -- -- Zimmer -- 
  Schreit weggeworfenen Sache -- sein wiedergeben -- werfen abermals weg -- Zweifel -- Eigensinn -- 
  -- heftig weinen -- liebkosend Ton Eigensinn anreizen -- 
  waffnen allzuweich Gefühl -- eher zärtlich -- böse Stunde vorüber -- 
  Mißlaune Kind Schmerz herrühren -- Kränkiichkeit enthalten gewöhnlich Samen Eigensinne -- 
  dennoch böse Same nähren -- 
  heraus -- frühen ausgejäten -- ehe Kraft gewinnen -- -- 
  Gib Jda niemals -- wonach schreien -- gib Freundlichkeit -- wonach freundlich äugeln -- kommen -- -- bittend Blick gebend entgegen -- 
  Schlage -- -- geben -- Verweigere standhaft -- abschlagen -- schön -- kläglich fordern -- 
  Schreit -- Bedingung -- 
  Begierde -- -- reizen -- laß Ding -- vermeiden -- Nähe -- 
  verboten Baum Eden Erziehungsmittel himmlischen erwachsen Mensch -- wissen -- Mensch Probe bestehen -- 
  unser Kind fordern -- Eltern leisten -- 
  Eltern - bös Lust Kind erwecken -- umgeben allenthalben Ding -- Kind -- pflanz Wald verboten Bäume -- Sorglosigkeit -- -- Gehorsam prüfen -- 
  -- lieb Emma -- 
  Laß Jda Stübchen fern bleiben -- anrühren -- auffällt reizen -- 
  Gabel -- Messer Scher halten fern -- -- 
  Kind freuen Glanz -- erregen Begier -- 
  Entferne zerbrechlich Sache -- laß glänzend Ding Herzensverlang spielen -- Geld Metallsachen -- beschädig Verdorbe -- 
  Nähe zerbrechlich kostbar Hausgerät -- Kind sehen berühren -- nachteilig -- 
  Begierd -- Trotz -- Bitterkeit eurer Kind Seele pflanzen -- zeigen viele -- -- -- 
  verstehen -- gelten gewiß -- 
  Gehorsam -- Ding umgeben sehen -- entfernen -- anrühren -- 
  eins -- Emma -- 
  Umgib süß Jda -- -- schön Gegenstand Art -- dulde geschmacklosesr -- 
  Malest -- malesen schön Blume -- verzi Wand -- 
  sobald -- Stübchen aufhängen -- kennen -- vertausch -- veränder Verzierung Monat -- kennen -- hängen -- fort -- 
  Laß Blume Garten aufsuchen -- Maßstab Aufmerksamkeit Vergleichungs-Vermögen erhalten -- 
  schriebst neulich -- Vögel besonderer Freude machen -- häng Sammlung ausgestopft Vögel Partie -- -- sehen -- Natur bekennen erkennen -- 
  Laß Abbildung Kupferstiche folgen -- 
  bertuchsch Bilderbuch Dienst leisten -- 
  laß Menge Gegenstand flüchtig vorüber -- befestigen Partie Wand -- völlig -- irren -- 
  nimm Bild weg tun Stelle -- 
  Fenster vorbeigehend Pferd -- Schaf -- Kuh -- auffallen -- Freude Name nachgesprochen -- zeigen nachher Abbildung -- Abbildung Ding -- Wirklichkeit kennen -- früh richtig Vorstellung Bild Sache Seele festsetzen -- 
  Nenne einzeln Teil jeder Gerät Zimmer -- -- einzeln Teil unterscheiden -- 
  Fang einfachsen -- gehen künstlich zusammengesetzt fort -- -- 
  Jda Eigensinn bewahren -- Langeweile stet Beschäftigung sichern -- Hauptquellen Übel Erziehung verstopfen -- Mutterherz streng Zukunft ersparen -- strafen -- -- 
  Schädlichkeit unentbehrlichen entfernenden Ding laß Gefühl belehren -- 
  Greift brennend Licht -- Feuer Kamin -- sagen -- 
  Jda -- brennen -- 
  Jda -- tun wehe -- 
  verstehen -- schön hell Flamm greifen -- 
  Laß Fingerchen Licht klein nähern -- -- Verbrenn Muttersorgfalt schützen -- laß fühlen -- Brenn -- 
  stehen -- Licht greifen -- vergessen scheinen -- rufen -- brennt -- Erinnerung Gefühl Wort zurückkehren -- 
  freilich Messer -- Gabel -- Schere -- scharf Instrument verbergen -- 
  Auge fallen -- sagen -- 
  Jda -- schneiden -- 
  Jda -- stechen -- 
  Gefühl kennen -- warnend Stimme kennen -- gewiß Ton Wort merken -- 
  -- bezeigen dennoch ungestüm verlangen -- laß Spitze klein stechen -- Laß -- schmerzen -- sicherlich bös Ding wegwerfen -- Erfahrung Stimme Warnung kennen -- 
  Paar ähnlich Erfahrung -- brauchen -- sicher Warnung merken -- willig gehorch -- 
  -- 
  Ratgebend Freundin auffordern -- sagen -- Brief Freude -- Ratschlag anwendbar findest -- Briefe nachfolgen -- 
  Brief -- 
  laufen Jda -- Monat halb alt -- 
  weder Laufband -- Gängelwag -- Werkzeug -- Kind lehren -- -- der h. Kraft kommen -- 
  besorgt -- Jda krumm Füßch krumm Hand Kriechmethode bekommen -- 
  Laß Sorge an Herz -- bitte -- -- 
  Kind -- natürlichst Weg lernn -- kräftigst -- Glied -- Natur -- 
  lebhaft erinner Knabe Tagelöhner -- Arbeit stehen -- 
  Vater gebrechlich Mensch krumm Fuß -- Hausarbeit verrichten -- 
  Mutter müssen Arbeit ausgehen -- Familie Notdurft erwerben helfen -- 
  alt Kind -- klein -- klein warten -- 
  hüttchen stehen dicht unser damalig Landhause -- 
  hört Hüttche schreien -- 
  jammerter arm Kind -- Krüppel müssen -- 
  alt Beschäftigung -- angemessen -- halbjährig Bube Tags -- Schlief -- Zimmer -- breitet Teppich -- setzen -- Allerlei Spiel -- Kugel -- 
  Weg rollen -- greifen -- gelingen -- fing kriechen -- kroch -- 
  Versuch mißglücken bisweilen -- schreien -- 
  helfen -- Beschäftigung stören -- 
  lernen helfen -- kroch -- trotz Krebs -- rück -- vorwärts -- gefiel ungemein Kraftäußerung -- 
  freundlich ansehen -- lachen -- kroch groß Schnelligkeit -- 
  Monat alt -- Versuch -- Hans Birnen -- aß -- Stuhl Zimmer hinzulegen -- 
  kroch Schnelligkeit Stuhle -- 
  -- 
  Versuch -- stuhlbeine aufrichten -- Versuch mißlingen -- 
  Birn reizen stark -- 
  versuchen -- -- gelingen -- stehen Stuhle -- zittert -- ergriff Beute -- lachen überlauen -- -- 
  lacht Beifall -- 
  Bein halten -- 
  sitzen Boden -- kroch -- zuvor -- Ecke Zimmer Richtung herum -- 
  wiederholt Experiment täglich -- bekommen Kraft Stehen Bein -- 
  fing -- Hans Ziel rücken -- 
  Stuhl aufrichten -- legen Kuchen -- Obst -- -- Paar Stuhl -- 
  fing -- Stühle halten -- hinzugeh -- Preis liegen -- 
  Stütze versagen -- 
  reicht Finger -- ergriff -- Ziel -- 
  Finger -- -- 
  führen -- Hand -- wohin -- 
  -- Monat alt -- laufen -- 
  müde -- kroch -- alt -- fast Bein -- mußt netterer kräftiger Bübchen sehen -- Hans -- 
  Erfahrung -- ehe Erziehung eigentlich beschäftigen -- -- wissen -- Erziehung gehören -- 
  Geschäft Beruf -- wiederholen mehrere Kind natürlichster Methode Gehenlernen -- finden probat -- erstemal -- 
  Erfahrung gründen Zuversicht -- empfehlen -- 
  rechtfertigen -- 
  unzählig Menge Beispiel entgegensetzen -- Kind Laufzaum lernen -- Krüppel -- Kind -- Leitband Brust zusammendrücken -- früh Stehen gezwungen Gängelwag krumm Bein -- 
  setzen groß Menge roh Völkerschaft -- verkrüppelt Gestalt seltener Erscheinung -- Europäer -- gewiß -- Natur vorgreifend Werkzeug -- kindlich Kraft Tätigkeit bringen -- kennen -- 
  Fort Laufzaume -- fort Gängelwag -- Tante -- Jda beschenken -- Methode fürchten -- 
  Beweise Wort -- glücklich Erfolg Gegenteil -- 
  Art -- beweisen -- Mensch einzig überzeugenden -- 
  rufen Geschäft -- 
  -- Brief -- 
  Wörtche Antwort Frage -- 
  früh Musik jung Kind glücklich wirken können -- 
  Beantwortung fast vorweggenommen -- 
  Jda Freude Gesange -- reg Sinn -- schön Empfänglichkeit melodisch -- 
  Harmonie entwickeln gewöhnlich Kind Sinn früh -- 
  lieblich nachlallen Liedchen -- 
  -- Frühling kommen Nachbildung Rhythmus -- scheinen Talent ankündigen -- Pflege wert -- -- 
  Deutung Auspizi günstig -- sicher Weise wohltätig -- sanft Mütterche singen hören -- 
  alt Fuhrmannsfrau -- zeil Morgenliede -- 
  -- Wach -- Herz -- sing heftig apostroph Pferd richten -- Striegeln Anspann schicken -- unmittelbar Gesange zürnen sehen -- 
  schön Gemüte gerechtest Unwille entwaffnen -- dürfen versuchen -- Melodie Kirnberger's -- -- Schwach sündlich Mensch gebären Graun's Arie -- -- weichgeschaffen Seele -- -- schön Choral -- 
  -- Herzlich leiben -- o Herr -- -- anstimmen -- stehen Gelingen -- 
  Instrument -- auflösend Harmonika -- Menschenstimme messen -- rein sanft tragen -- 
  O sing -- sing -- Jda -- 
  Garten -- 
  Frühling -- 
  leben wohn Blume Vogel -- -- singen häufig -- 
  beschäftig Laß beschäftigen Gegenstand -- Freude -- einzig -- der h. Überdruß -- 
  Vorspiele Klavier raten -- 
  wissen -- Kind hinhorchen -- horchen -- klingen -- Schelle fast -- schön Klavierspiel -- gewöhnlich unterbrech -- Hand Fuß drauf schlagen -- 
  -- Kind selten musikalisch Talent zeigen früh empfänglich Sinn Harmonie -- 
  Bemerkst -- Jda still fröhlich horchen -- zufällig spielen hören -- ernstlich hinverlangen -- 
  Zeichen Natur geben -- beschäftigen -- vorspielst -- 
  Gib fleißig -- Füßch früh Laufe bleiben -- einer Einwärt biegen -- laß stehen -- hintereinander laufen -- lieben ausgebreitet Teppich Boden herum spielen -- 
  Gertrud mitunter tragen -- abwechselnd arme -- -- 
  gelehrigen Gertrud fortkommst -- wahres Glück -- 
  Sage meinetwegen -- wert halten -- 
  wissen -- redlich Seele golden Belohnung bedürfen -- schick Brief golden Herz -- Andenken Brust tragen -- wünsch Jda erinnern -- 
  Seite stehen Name -- -- 
  Gedenke -- 
  erklären Freundin -- -- weich Herz verlein -- Jda eigensinnig Laun nachgeben -- gedenken -- widersteh -- 
  Gewalt antun lernen -- holden Engel küssen -- -- 
  -- Hörst -- gute -- golden Herz mahnen -- 
  kenn Mensch -- Sorgfalt stoßen -- pedantisch -- völlig überflüssig erklären -- 
  -- sagen -- Unschuldigste tadeln verwerfen -- Kind zärtlich Liebkosung -- ängstlich berechnen -- schade -- 
  -- Portion Speise Getränk jedesmal zuwägen müssen -- 
  antwortet Mutter verständigen Manne Art -- bitten -- Zuzugeben -- Amme Kind heftig küssen -- Kind sogar unwillig -- heftig Amm abwehren -- 
  eigensinnig -- meinen -- Liebkosung -- -- Mutter -- 
  müssen gewöhnen -- 
  -- Pädagoge schweigen -- Freundin schweigen unzart Gegenstand -- 
  -- -- Lehre Fels fallen -- Freundin -- fühlen -- überflüssig -- -- 
  einer -- bitte -- Kind leiben -- schaffen -- necken -- scherzend entreißen -- woran Freude -- heftig -- wiedergeben -- 
  tausend Art -- Heftigkeit Eigensinn Kind einzuimpfen -- 
  gebildet Mann spielen Mädchen -- toll Frätzche komisch finden -- heftig geworden Kind schneiden -- 
  sagtest neulich -- Jda Mann sehen -- blöde -- 
  schön -- führen Warnung -- 
  Gertrud Jda spaßen -- 
  kennen Jda Furcht Dunklen -- 
  glauben -- 
  sehen gehören -- woran Erinnerung Finster wiederkommen -- bange -- 
  wohltätig Furchtlosigkeit trüben -- erhalten -- 
  hoch negativ Wohltat -- Eigentum unbefangen kindlich Unwissenheit respektieren -- 
  Vorstellung -- unglücklich Kindheit leidenschaftlich Furcht Angst -- Kind golden Morgenröte trüben -- 
  frühest Kindheit trefflich Vater sorgfältig Anwandlung unselig Leidenschaft verwahren -- 
  Arm -- hüllen Schlafrock -- hinaus Dunkel Garten -- zeigen heraufsteigend Mond -- kindlich Herz fühlt Freude ahnt Furcht -- 
  -- dunkel -- Zimmer Gäng Haus umher -- singen -- 
  foderen Mutter -- schlafen legen -- kurz Abendgebet vorgesprochen küßen -- sogleich -- Licht hinweg -- 
  Magd Schlafzimmer -- 
  Rief -- Mutter -- Vater -- küsse -- 
  kommen befriedigt Herz -- 
  hierbei bleiben -- rufen -- Schlief meistens -- erwacht Morgen -- 
  -- -- 
  Kind -- alt Bruder spielen -- jung Vetter -- besonderer Freude -- necken -- 
  erzählen -- Halbdunkel spielen -- allerlei schauerlich Ding -- begleiten Erzählung Tönen Bewegung -- entsetzlich Angst geraten -- 
  jung Mensch -- zwölf dreizehn alt -- komisch vorkommen -- schauerlich -- -- Angst bleiben wissen -- versuchen trösten -- Furcht eingeimpfen -- völlig mächtig -- 
  fürchten -- womit -- 
  graut Riese Kopf -- wovon Vetter erzählen -- v Pferd feurig Auge -- Alp -- Gespenst -- Kobolde -- Drache -- Hexe -- Komet -- Gewitter -- jung -- 
  herrlich Vater früh verlieren -- 
  arbeitet Furcht entgegen -- überhand -- Freude fähig -- 
  wünschen Tod -- Leben voll stet Angst unleidlich scheinen -- 
  Blume Vogel -- vorzüglichsen Freund -- schön Natur sprechen vergebens -- Baum Strauche Untier lauern -- 
  Stern -- früh glücklich machen -- -- wohn Engel -- fürchterlich -- meinen -- Komet verwandeln jung Heranbringe -- 
  -- Freude Kindheit fast -- 
  siegen gut -- heit Natur -- 
  geben Gespräch heiterer -- gebildet Mensch -- zufällig gegenwärtig -- Geist Richtung -- 
  Siebzehnt -- achtzehnt Resten Eindruck kämpfen -- spät völlig verloschen -- 
  Bewahr unser Liebling -- gut Emma -- erspar Kampf Angst -- hart Anstrengung Kraftaufwand fordern -- loszumachen -- 
  Ding -- fürchten -- Periode Furcht Jda eintreten -- 
  Besorg -- Jda Furchtlosigkeit Keck -- dreist -- 
  heilig Furcht -- unzufrieden sehen -- 
  O -- -- Schauer unsichtbaren -- Natur bewegen -- Seele Ehrfurcht durchdringen -- 
  Liebe leben -- Geist -- geheimnisvoll Sprache vernehmen -- wecken göttlich Mensch -- 
  Wächst heran -- -- laß Brausen Wog Gestade -- Nausch hoch Tannenwipfel -- Rolle fern Donner merken -- 
  feierliches -- Horch -- Jda -- donneren -- Horch -- brauset -- aufmerksam -- 
  Schüchter schmiegen -- weißen -- Gefühl unsichtbaren Seele dringen -- 
  früh Name Gott hören -- -- 
  heilig Schauer Unsichtbar -- Innigkeit -- anhängen -- Religion -- 
  Geräusch nah Donner bange -- heiter Blick hinauf -- leise Wort -- 
  Vater Himmel -- unwillkürlich Lippe strömen -- Herz besänftigen -- 
  hören -- 
  Worte Blick fallen Funke jung Gemüt -- zünden spät -- verlieren -- 
  letzter Jahr Jda deutlich Wort -- lieb Mutter -- erfreut -- 
  versuchen -- 
  Bruder Woldemar sagen Onkel Wilhelm -- 
  komisch klingen -- 
  -- Tante Selma sagen lehren -- 
  O Tante Selma plaudern -- 
  -- Erzähle Tante -- 
  Ehe Monat verlaufen -- -- 
  kindisch freu Reise -- 
  Leb -- 
  Stelle häufig Sprechübung unser Liebling -- 
  begierig -- erfahren -- deutlich fünfzehnt Monat sprechen -- 
  ordentlich artikuliert Ton sprächen -- dürfen bange -- 
  Kind -- Ablauf Jahr sprechen -- Sprachwerkzeuge -- entwickeln -- 
  freilich angenehm -- 
  groß Zuversicht erwarten -- Werdest Gertrud anhalten -- -- Jda vorsagen -- langsam -- bestimmen -- deutlich aussprechen -- 
  lallend Kind nachlallt -- fein unvollkommen Kindersprach erhalten -- närrisch lauten -- 
  Leb -- 
  Brief -- 
  menschlich Plan -- 
  Stadt Brief -- 
  diesmal -- -- -- schnell darein finden sprechen -- 
  Übung Sinn verhandeln -- -- bestimmt -- 
  Stellst Jda dergleichen Übung -- 
  Natur freigebig -- freilich -- dergleichen besonderer Übung -- -- 
  reich Kind Feinheit schärf Sinn begabt -- früheste wissen -- Versuch anstellt -- 
  mach Versuch bisweilen sehen -- 
  steck Ziel lang Gartenallee -- befestigen -- Jda vorzüglich sehen -- z. B. Kanarienvogel Käfig -- gehen Ferne -- Anfangs erkennen -- 
  Nähere allmählich -- sehen -- erkennen -- bemerken gewiß -- sobald Auge unterscheiden -- 
  Tritt folgend groß Ferne -- erkennen -- -- vermuten -- 
  Laß anderer Ziel -- -- bunt Blumenkranz -- näh Ziel -- Frage -- 
  hängen -- antworten -- Wechsle Gegenständen -- leiben -- setz Ziel hinaus -- 
  Auge gewiß anstrengen -- Gegenstand Ort erkennen -- Freude sehen -- Blick scharf -- 
  abwesend mußt -- laß Gertrud entgegen -- sagen -- 
  Mutter -- genau merken -- erkennen -- nämlich wissen -- entgegen -- 
  Übung Ungesucht täglich anzustellen -- 
  ähnlich Weise lassen Ohr üben -- 
  Z. B. Bruder Woldemar -- Onkel finden ausgewesen -- Jda sehen -- 
  stübch -- hörst unten sprechen -- undeutlich -- Stimme kenntlich -- 
  Fragst -- 
  Jda -- sprechen unten -- Anstreng -- hören -- Sprechende -- 
  tausendfach Art lassen Versuch -- Wichten -- unterhalten -- besseres sprechen -- 
  übrig Sinn üben Nachhülfe gehörig Feinheit erlangen -- 
  Gefühlssinn -- -- Finger -- Wort -- Tast Getaste stark zuwider -- zuweilen Probe stellen -- 
  Laß Jda Auge zutun -- bloß anfühlen Gertrud Hand unterscheiden -- wächsern Apfel wirklichen -- leinen Hemdchen kattunenen Kleide u. S. W. -- 
  Unterscheidet Gefühl schnell -- übe feinerem Unterscheid -- 
  Übung Gesichts Gehörs fortsetzen -- 
  wesentlich -- 
  bekannt Tor ziehen Vorstellung jung Menschenseel -- 
  öffnen -- -- -- Mensch menschlichst Vorstellung -- 
  sagen -- dast Jda Freude Rausch Wind dein hoch Pappel -- Gesange Vögel -- bunt Farbe Blume -- o Laß -- -- freie -- 
  bilden Sinn schön Natur glücklich -- Leben Natur -- 
  Brief -- 
  Engel -- schreiben -- 
  Abschied hold Kind schwer -- 
  träumen fast Nacht -- vielmehr Gemälde heilig Familie -- euer Bild übertragen -- 
  O Emma -- glücklich Emma -- welcher Kind -- -- 
  gewiß -- wärst hundert Mütter entschuldigen -- Jda allzuweich -- allzuzärtlich Aufmerksamkeit verwöhntestn -- -- Verzögest -- 
  -- bürgen -- Monat Verfahrungsart sehen -- 
  aufhören -- schreiben -- bitte ferner Leitung herzlich -- vertrauen groß Erfahrung Geistesreif alt Freundin innig -- widerstehen vermögen -- 
  Fahre fort -- Idee Jda fernern Bildung mitteilen -- 
  unbeschreiblich Kind fein Sinn Reinlichkeit erfreut -- 
  vergessen -- erzählen -- traurig dasitzen -- Fingerchen beschmutzen -- hinaus rufen wurdest -- ehe Reinig Konntest -- 
  blöde -- merken -- -- fehlen -- still weinen -- 
  fragen -- fehlen -- beschämt Hand -- stammeln -- 
  lieb Tante -- bitte abwischen -- 
  wusch Hand küssen Wange -- Augenblick vertraut -- 
  Sinn weiblich Grazie -- spätest Alter Schimmer Liebenswürdigkeit bewahren -- 
  unser Kind wach erhalt bestreben -- 
  Jda Hof Garten gehen -- sorgfältig Unrein ausweichen -- erinnern Brauchtest -- 
  Abends -- wissen warst -- Woldemar -- Garten arbeiten -- schwarz -- erdig Finger neckend liebkosen -- heftig Kind weinen gehören -- -- 
  Woldemar erschrak -- still hinaus -- wusch -- bringen ros Garten -- lächelen -- schluchzen -- küßen Woldemar Ungestüm Liebe -- 
  lacht Engel -- 
  Jda weinen -- 
  herzig Anblick -- 
  Kleide Jda dunkele Zeuge -- 
  lebhaft Kind trieben achtlos herum -- raten -- gewöhnt -- Flecken sehen -- 
  -- Sicherer -- Reinlichkeitssinn ferner ausbilden -- -- wissen zart Farbe kleiden -- gewahr -- reinlich aussehen -- 
  Garten herumtummeln -- bind schwarz Schürzche -- Flecken bekommen -- 
  Stück wack Gertrud dein Sinn eindringen lernen -- eingeschärft -- Jda Liebe Wohlgefalle sehen -- 
  hierin Stande -- Angehört -- bevor -- 
  scheinen Reinlichkeit hoch Luxus -- Sonntags erlauben -- 
  Frage -- 
  Sonntags Jda lieben -- schweigend beschämt hinaus -- sauber kleiden -- errötend Blick Zimmer -- 
  -- klopfen Sanft Schulter -- blicken nieder -- 
  gut -- 
  O -- halten -- fast einzig -- Fehler gut -- obgleich wehe -- 
  Geschenk machen -- laß saubeer Leinzeug -- eleganter -- 
  nah Messe schick Dutzend leinen Schürze -- 
  verdirb diesmal Freude -- schenksten -- verstehen -- -- 
  allzureinlich können -- fragen neulich verwandte voll Ernst -- 
  -- Antwort -- fehlen -- -- -- 
  -- 
  mißverstanden -- pedantisch Weise -- 
  Frage -- -- -- 
  -- vollkommenste Wesen unvollkommen -- 
  weich Güte -- Ernst -- Strenge hingehören -- Schwäche -- Schwäche Güte -- -- 
  Hausfrau -- Gerät täglich mehrere Mal bestimmt Stunde waschen -- stäubch Sache wahrnehmen -- Stube Kammer Veranlassung täglich waschen lassen -- Winter fast trocken Fußboden dunstrein Luft Zimmer -- sagen -- reinlich -- 
  Bedenken Reinlichkeitspedanterie nennen -- 
  ordentlich -- nämlich Ordnung Charakterzug Weibe -- 
  Mechanik äußerlich Ordnung treiben -- kleinlich Pedanteri -- Stück -- freies -- Gemüt gewaltig ängstigen -- nämlich Ordnung läppisch Art Form vorschreiben -- 
  Laß unser Liebling schön weiblich Tugende lieblichsen Gestalt sehen üben lernen -- 
  fern Ängstliche -- 
  heftig Weinen -- Woldemar beschmutzen -- lassen ahnen -- schön Hang Reinlichkeit stark -- 
  bitte -- Sporn -- 
  bedürfen schwach Trieb Schöne gut Anfeuerung -- 
  stark erheben Befestig -- 
  unterdrücken -- Unterdrückung lähmen -- 
  Brief -- 
  Brief -- Jda Erziehung schreiben -- Worte Gehorsam Rede -- 
  Solltest hieraus schließen -- echt Pädagogik verbannen wissen -- 
  wärest Irrtum -- lieb Emma -- 
  Knabenerziehung halt gewiß Alter unbedingt Gehorsam notwendig -- 
  Mädchen -- Leben bloß Gehorsam Gesetz Wahren -- schöne Schicklich -- früh Natur -- Gefühl verwandeln -- Blitzesschnelle wirken -- 
  Ehe Grund Rede -- weiblich Seele schnell Schicklichst Moment erkennen -- ergriffen -- handeln darstellen -- 
  Gesetz tief Wesen eindrücken -- leises -- mißbilligend kopfschütteln -- Jda abhalten -- -- Verstand reif -- Unzulässigkeit begreifen -- 
  Urteil -- bilden -- Tribunal Schicklichkeit -- appellieren -- 
  fast anbetend Liebe einfallen -- fragen -- 
  -- sagen -- 
  -- zunehmend verstand Gefühl Kraft Wille hervortreen -- Bedürfnis -- Verbot wissen -- Ding ausbleiben -- Richtstuhl Vernunft gehören -- 
  Gib Grund -- sobald -- -- fassen -- 
  Machen innerer Notwendigkeit anschaulich -- erkannt Grund gehorchen -- 
  sprech -- vernunftgründ Rede -- -- 
  zuvoreilen -- schädlich -- verleiten Kind altklug Vernünftel -- 
  Jda z. B. nah Sommer auf Land -- erwarten -- Gärtche -- Blume -- Huhn voliere -- 
  wissen -- Landlebe hängst -- 
  abwesend Vater versprechen -- Wiederkehr Aufsicht Bau Einrichtung Zimmer Stadt -- 
  begreiflich lassen Kind hieran -- auflegen müssen -- süßest Wunsch entsagen -- 
  ähnlich Veranlassung Belehrung täglich Leben -- 
  Gebrauche hervorspringendsten -- angehen -- 
  foderen Grund Anordnung -- wohlan -- laß kindlich gehorch -- 
  jung Gemüte heilsam -- verderblich Geist Widerspruchs -- 
  häufig Räsonier Kind laut -- stark warnen -- Schädlichkeit Erfahrungskreise überzeugen -- 
  kennen verderblichen Mißgriff Erziehung -- ewig moralisierend Räsonnement -- 
  erinn traurig Beispiel Erziehungsmethode -- Kinde -- schlecht Anlage unleidlich -- widerlich -- 
  einzig Kind kränkelnd Eltern -- grenzenlos lieben -- Irrtum früh vermeint Verstandesäußerung anleiteten -- Geistesenergie aufzuhelfen glauben -- 
  Dina gewöhnen -- -- wovon Grund -- treu Glaube -- Widerspruch annehmen -- 
  müssen Fehlgriff bereuen -- 
  Dina tief Seele -- Gewißwerden Wille zweifeln -- Überzeugung Wille fragen -- Geistesbedürfnis eher ruhen -- Ding -- -- Grund -- 
  flach Geschöpf -- Dina gehören -- fragen Antwort Wille -- Frage -- hören -- -- -- Stimme hören -- 
  Dina Frag Einwendungs-Mechanismus -- verständigen Mensch fast unmöglich -- lang Paar Minute auszuhaln -- Geduldigst unwillig wegwend -- Gutmütigkeit Bemerkung enthalten -- Dina's Frage einwürf Sache -- Rede -- fast zusammenhängen -- 
  erwachsen -- Kind widrig -- wahr Strafe -- -- 
  woher erbärmlich Geistesverkrüppelung -- 
  -- arm Eltern naseweis Frage Gesprächigkeit -- hervorbrechend Geistesfunke -- ergötzn laut applaudierten -- 
  -- Widerspruch Zunge bereit halten -- losbricht -- ehe gehören -- eigentlich sagen -- lächerlichsen Auftritt Anlaß -- 
  reifen Geisteskraft -- überall Grund Ursache fragen -- Zuversicht reiferen verstand Glaube Wort gute -- entschiedenste Zug Charakter Kindlichkeit -- 
  Vater sehen Kind Repräsentant Wahren -- Mutter Inbegriff schöne gute -- 
  unbedingt glauben -- Frucht Baum Erkenntnisse brechen -- 
  siehsen -- lieb Emma -- Gehorsam -- Einsicht -- wesentlich Stück Erziehung -- dennoch sicher mißverstehen -- hieraus schlössen -- blinde -- sklavisch Gehorsam Schutz nähmen -- 
  Gehorsam -- Liebe vertrauen entspringen -- heiligen Mensch -- weihet Religion -- -- Religion -- 
  Gehorsam bloß Willkür -- weder lieben -- vertrauen -- feig Sklavenseele heuchlerischen Augendiener -- 
  Erziehung gehören -- 
  Unsrige verbannen -- 
  Angeb lassen Periode kindlich Leben freilich -- Glaube Gehorsam Einsicht Überzeugung verweben allmählich Platz -- 
  früh kindlich Alter -- -- Fall -- Kind Grund Vorschrift fassen -- vorenthalten -- übrig gläubig Gehorsam edl Charakter gewinn -- frei Wesen würdig -- 
  Jda Frage -- einst -- -- Mutter -- arbeiten -- wüsste gut Antwort -- -- Weile -- lang Weile unvernünftig könntest -- strafen müssen -- 
  fragen -- -- lieb Mutter -- -- Catharine ausgehen -- 
  hören -- Leute Straße sprechen -- -- -- 
  einlassen -- Verbot ernstlich wiederholen -- sagen -- Ursache begreifen können -- fest bleiben -- Gertrud ausgehen -- 
  Haupthindernis kindlich Gehorsam gewöhnlich -- unnötig Verbot -- Wunsch Dorn umzäunen -- gewaltsam Durchbrech nötigen -- falls jämmerlich Indolenz versinken -- ergehen lassen -- Freude schlafen -- essen Trinken suchen -- 
  gestatten Wesen -- -- verbieten -- Schädlich -- gestehen auf Wort bescheiden Bitte -- bewilligen -- schlagen -- hernach zugestehen -- lassen verweigernd Wort letzter -- 
  ehrerbietig Resignation gewöhnen -- heilsam -- 
  schädlich -- Kind abbetteln -- abtrotzen lassen -- 
  beharrlich Bettelei Art trotz -- gleichfalls Schwäche Eltern berechnen -- 
  frühe Ungehorsam entstehen gewöhnlich Lüsternheit -- erwachsene Auge Kind genießen versagen -- Bemächtige suchen -- sobald unbemerken -- 
  abhelfen -- 
  jetzig Lebensweise -- 
  Wären Genüs einfach -- fiel Schwierigkeit weg -- 
  lassen -- unser Gaume erfreut -- voll Anteil -- Sache abtun -- Kind Wunsch stillen -- ehe schädlich Begierde -- 
  Lebensweise -- viele täglich Genusse gehören -- wenigster physisch Entwicklung jung Menschenwesen günstig -- schädlich -- -- 
  Kind schlafen -- lassen essen -- Mahlzeit Eltern schlafen -- 
  Kind verdauen schnell -- erneut Magenreiz Tag -- öfter verlangen Speis -- 
  Laß Jda warten -- fordern -- nämlich wirklich Hunger Leckerei -- 
  Gib zeitig Frühstück -- morgens aufstehen -- gewaschen angekleiden -- 
  niemals -- 
  Milch -- Wasser wissen Brot herrlich Frühstück gesund Kind -- 
  Fodert -- gib Stückche leicht Rockenbrot Apfel anderer Obst -- 
  Jda Mittagsmahlzeit zwölf halten -- schlafen -- 
  Fodert Vesperbrot -- laß sogleich -- Hunger mächtig -- Ungeduld reize -- 
  Gib niemals Backwerk -- 
  Stückchen Rockenbrot Weizenbrot Obst Milch -- eins -- bescheiden -- 
  O bitte -- bitten -- halten streng hierauf laß gesund Appetit Lüsternheit -- 
  heiter Freude verzehren -- -- Mal -- 
  bringen Kind viele -- Leckerei gesund Appetit verdirben -- lassen ersetzen -- 
  Jda Alter -- schlafs bedarf -- Tisch -- gewöhn -- -- höchstens Speise Tisch -- -- kindlich Gaume angemessen -- jung Magen verarbeiten -- 
  Laß speis Wohlgefalle sättigen -- 
  gesund -- Leckereie überreizt Kind -- ißt -- gewähren lassen -- 
  starkgewürzen Schüssel Tisch -- Bruder Mann lieben -- laß Jda kosten -- Laß angenehm Milchspeise -- gekocht Frucht u. dergl -- Geschmack bleiben Kind -- Mädchen -- -- Leben getreu -- 
  Natur gedeihlich -- 
  Laß Jda Senf scharf Ding kosten -- 
  Kaffee süß Wein -- 
  O gütig streng -- bitte herzlich -- 
  sehen täglich Wein trinken -- 
  Gieße gut rot Wein Rheinwein Wasser -- fi Tisch trinken -- 
  Lees Essens trinken -- stund Tisch -- durstet -- Wasser -- völlig gesund -- 
  Diät gegedeihen -- sollst Freude sehen -- 
  -- Frau gehen -- 
  Rätin D - allerliebst Kind streng halten -- fragen neulich Frau Z * -- -- hoffen stark -- -- entgegnen -- 
  -- Gott -- -- 
  Jda -- Leute essen -- Speise ungewohnen -- gut Tisch -- -- 
  -- -- wohnen -- 
  Alsdann bekommen -- Appetit -- einfach Schüssel essen -- gut Tafel finden -- herrlich Obstes gedenken -- Dessert fehlen -- wovon Jda besonderer Freundin -- 
  -- -- arm Kind entbehren -- niemals fein Backwerk -- künstlich gemischt Gericht süß Wein bekommen -- 
  erwachsene wissen -- schmecken -- -- 
  Kind gönnen -- -- 
  -- -- O Jda Mahlzeit sehen -- sein gegenwärtig -- Sagosüppch -- Reißbrei -- Fleischsuppe u. dgl. bringen -- Hand klopfen -- anlachen -- -- 
  -- leiben -- Löffel voll -- sobald Begierde stillen -- 
  Suppe Mutter -- Onkel Woldemar Gertrud kosten -- jubeln -- fallen neu -- 
  Apfel kriegen sogar Kanarienvogel -- 
  gewiß -- Frau Z * -- Jda bedauern -- Freundin tadeln -- Fürstenmahlzeit glücklich Kind gegenwärtig -- -- 
  -- Frau R * -- zugehören -- -- drücken leis Hand -- Unterhaltung Frau Z * -- 
  Brief -- 
  nächster Frühling kommst Jda -- 
  Welt auftun -- 
  Ortsveränderung pflegen Verstandesentwickelung beschleunigend Einfluß -- -- Kind Ort verweilen -- Bild jung Seele schnell vorübergleiten -- 
  bekommen richtig Maßstab Gedächtniskraft -- Bemerkungsgeist -- 
  erstaunen wahren -- bemerken -- fast entgehen -- behalten -- längst vergessen -- 
  -- jung Kind Lustreise Meile nehmen -- ängstlicher Blödigkeit verhüten -- Kind bemächtigen -- lang -- Mutter Wärterin sehen -- 
  ungünstig find wahr Ausbildung -- Kind Lebensjahr Reise herumschleppen -- Nutzen Gesehen verlieren -- Bild schnell folgen -- eins Seele verdrängen keiner Idee zuführen -- 
  Laß Vorschlag Art reizen -- lieb Emma -- 
  Freundin Paris -- Jda -- sobald Heranwächst -- französisch Sprache Frankreich locken -- Tante Rom -- anfangen -- Kind Kunstsinn Italien bilden -- laß schimmernd Vorschlag bewegen -- 
  französisch Sprache -- -- Sicherer geben -- -- deutsch Muttersprache -- Geläufiger reden lernen -- früh sprechen hören -- -- jemals Hauptaugenmerk Erziehung deutsch Kind -- 
  französisch Wärterin Kind zugestehen -- 
  deutsch Eltern lassen Schicksal gebären -- 
  deutsch Sprache -- hören -- lallen -- -- Sprachorgan entwickeln -- 
  deutsch Sinn -- Charakter -- Geist -- aufpragen -- Sprache gewiß unbeträchtlich Einfluß -- 
  -- späterhin völlig Geläufigkeit erlangen -- -- 
  -- bekommen -- Sprache Ausland Hauptsache deutsch Erziehung -- 
  -- hoch Stände französisch Sprache notwendig Übel -- 
  Lage Verhältnis Geläufigkeit Sprache fast notwendig -- Jda sprechen lernen -- dein Verhältnis wahrscheinlich fortleben -- -- Mann -- 
  Sorge -- lieb Emma -- -- Fall Bedürfnis -- Kosten Wesentlichere -- 
  Jda alt -- deutsche rein sprechen -- fang -- täglich bestimmt Stunde französisch nennen -- sehen -- 
  Lege Abbildung allerlei Gegenständer französisch deutsch Benennung -- weile tun -- laß deutsch Name -- laß bloß französischen nennen -- -- setzen voraus -- deutsch -- lesen -- 
  -- lernen -- andermal -- -- 
  deutsch lesen -- eher -- mach Lieblingsgeschichtche gewohnt Lesebüch französisch Übersetzung -- wörtlich getreu -- laß Übersetzung bekannt Geschichtchen lesen -- erzähl französisch -- lieser dergleichen -- Laß deutsch erzählen -- übersetz deutsche -- Laß französisch erzählen -- Sprache geläufig -- 
  Setz täglich Stunde fest -- französisch sagen -- erwidern -- halten späterhin -- allenfalls -- Paar -- Französin -- 
  tun -- -- wichtigerer Ding unbeschadet -- fremd Sprache -- 
  Reise Genf -- Lausanne -- Frankreich -- -- Gewinn Sprache -- alsdann Vorteil bringen -- nachteilig -- 
  Reise jung Kind -- genannt Grund -- nämlich Gegenstand schnell flüchtig Geist vorüber eilen -- bleibend Eindruck -- gewiß -- späterhin schwer besiegend Zerstreutheit angewöhnen -- -- -- gewiß unwichtigeren -- 
  häuslich erzogen Frau kennen süß Gefühl -- reg Gemüt einzig Art bewegen -- frühest Kinderjahre schön Erinnerung lebendig hintret Holdselig anlächeln -- 
  innig bewegen -- Anblick Stübchens -- Wieg stehen -- Spielzeugs -- leiben -- Platz väterlich Garten -- lieb spielen -- 
  O -- hängen unzerstreut Herz treu -- warm Freude -- 
  Mensch einzig schön Gefühl ersetzen -- früh Umhertreiben Stadt Stadt -- Land Land -- heilig Vorliebe für's Vaterland -- schön Vorurteil Herzens -- unverdorben Natur eng Vaterhaus knüpfen -- gänzlich verlöschen -- 
  vollend Geschlecht -- 
  schön Häuslichkeit entwickeln -- früh Gasthof-Lebe -- -- folgen -- hoch Ordnungslosigkeit gewöhnen -- 
  -- Emma -- bringst französisch Sprache Opfer -- 
  gehst Jda Frankreich -- 
  -- überall reisen -- 
  O -- lieb Emma -- 
  Charakter hinlänglich ausgebildet gründen -- solide Kenntnis Schatz erwerben -- Vollendung ästhetisch Bildung Reise Rom Paris -- -- Frage -- heilig Boden Schatz Kunst -- -- Kunstschatz fremd Boden besuchen -- -- Vorsatz ausführen -- 
  Freundin -- reisen -- -- nämlich Verhältnis Reise gestatten -- fordern -- 
  laß Jda heimisch Boden wurzeln -- väterlich Haus -- lieb Aufenthalt -- 
  Eilfter Brief -- 
  Jda übermorgen alt -- Angebinde senden -- 
  erhältst hierbei Kästchen voll Sache -- vierjährig Herz erfreuen -- 
  Erstlich erhalten schön Puppe -- schön -- -- -- leinen Chemise kleiden -- Mützchen -- -- häßlich -- elegant putzen -- 
  Laß Jda Name geben -- gib -- nennen -- liebsten -- 
  erhalten komplett Wirtschaft -- Zubehör -- Schachtel Rechenpfennig -- Schiefertafel nebst Schwamm Griffel -- 
  Hand arbeiten -- rot Kleidchen weißes -- 
  -- liebste -- wissen -- 
  -- vorziehen -- laß tragen -- kleide künftig -- 
  -- Kind früh Geschmack -- unschuldig Ding folgen -- loben -- 
  Art Eigensinn bestehen -- brauchen -- 
  Beobacht fleißig -- Wirtschaft Freude -- Trieb zeigen -- Ordnung halten -- 
  besonderer Freude -- bewahren Kram andermal -- schal Überdruß Seele schleichen -- 
  mach Puppe -- leiben -- laß überall -- lieben -- 
  Frage -- raisoni -- Merk -- tun stille Seite -- müde anfangen -- 
  glücklichst organisiert Kind müde -- woran Tätigkeit üben -- 
  Herrlichkeit Rechenpfennige Schiefertafel hinzugetan -- 
  einfach Stunde angenehm beschäftigen -- anfangen -- rechnen -- schreiben lesen lehren -- bloß Mutter spielen glauben -- 
  Rechn angeben -- 
  liegen Natur Sache -- 
  Nimm allenfalls Pestalotzi's Methode Rechnen Grundlage -- 
  strich Quadrate vorbilden -- bild Rechenpfennig -- gehen stufenweise -- Methode fordern -- 
  Freude -- Jda zählen -- zusammentun -- abzieh -- vermehren teilen lernen -- 
  anderer Mal Buchstabe Tafel -- -- getreu Nachmalt -- -- nachzeichnen -- -- Alphabet schreiben -- 
  schreiben Buchstabe nennen lernen -- verstehen -- 
  geläufig -- schreiben einfach Silbe -- Buchstabe zusammengesetzen -- Laß aussprechen -- 
  mehrsilbig Wort -- schreiben kurz Satz -- -- sprechen -- 
  Hernach laß Tafel Brief schreiben -- beantwortest -- schreiben lesen fast gleich -- 
  Anfang lateinisch Buchstabe bedienen -- Gewinn -- Druckschrift schnell lesen -- geschrieben lateinisch Letter Ähnlichkeit -- deutsch -- 
  bitte -- Lesen Druckschrift eilen -- Buch -- Kind verstehen -- geben -- 
  -- Art Kind zusammengekünsteln -- laufen Erbärmlichkeit hinaus -- wodurch Wort Phrase -- Gedanke zuführen -- 
  kenn Produkt -- ungeschrieben bleiben -- 
  scheinen fast unerreichbar Aufgabe -- Buch Kind schreiben -- verständlich -- anziehend kindisch -- 
  Laß Jda Frühling Sommer Garten herum spielen -- Freie bewegen -- Büchern zeitig -- 
  Unterricht -- bitte -- Jda Weise -- durch lesen -- -- richtig klar Verstande Buch verstehen -- Kind schreiben -- 
  Lies -- überschlag -- Alter früh kommen -- 
  sicher Gewinn Lesen -- 
  Schreibe Fabel Lied -- fassen -- Laß auswendig lernen -- 
  vorgesprochen lesen -- verstehen -- Freude finden -- gewiß unrichtig deklamieren -- Ausdruck hineinlegen -- 
  Wenige hersagen -- verstehen -- theatralisch -- bloß Verstand Gedächtnisübung -- Entwicklung Gemütskräfte dienen -- 
  Wahl schwer -- eng Ausschuß Lieblingsdichter wählest -- Geist vertrautesn -- weniger gut Kinderbücher -- 
  O Stunde Leben erbärmlich Kinderbücher kosten -- leer Spreu durchsuchen -- Körner heraus finden -- 
  Leb -- lieb Emma -- 
  Kapitel künftig zurückkommen -- erbärmlich Seichtigkeit Buch warnen -- 
  schaden tief Gemüt still Sinnigkeit -- stet Moralisier Kind -- Popularisierum ernst Ding -- eitel Streben Buch -- kindisch Verstande nahe bringen -- Ordnung Ding fern liegen -- 
  Anzahl Kinderbücher -- Bedenken Jda Hand geben -- 
  Zwölfter Brief -- 
  -- gewähltest Hilfsmittel -- Dein Kind Verstandeskraft üben Tätigkeit erhalten -- Abwechslung -- wodurch Jda Aufmerksamkeit Wach Rege erhalten -- bisweilen Unterhaltung fehlen -- 
  Stunde -- gewohnt Verstandesübung auflegen -- -- -- 
  Tue Stunde Zwang -- geraten -- 
  Suche Kind anscheinend Spiel neu Anstrengung überlisen -- 
  Wort -- laß -- 
  lang Weile Mißmut -- Mißmut Unart verfallen -- strafen Mußt -- 
  verschaffen früh Gegenmittel weiblich Arbeit -- 
  Lehre stricken nähen -- 
  Laß Strumpfbänder -- Strümpfe Woldemar stricken -- laß Tücher nähen -- 
  wissen -- -- erinneren Kindheit -- glücklich -- Strümpfche vollenden -- Tuch säumen -- wovon rühmen -- Mutter helfen -- 
  Beiher -- Bruder arbeiten -- 
  gleichgültig -- 
  für's lassen -- lieb tun -- früh Lehre einprägen -- schön arbeiten -- -- 
  -- Wort Großmut Vergessenheit -- 
  Wort früh verlaut -- leer Schall Ohr vorüberströmen -- redselig Moralsprecher verbilden -- 
  Laß Jda ungehinderen -- kindlich Tätigkeit stark anfeuern -- 
  Zeigt Trieb Bruder arbeiten -- bezeig freundlich Wohlgefalle -- loben -- 
  einfach Strick Nähe hinlänglich begreifen üben -- gehen künstlicher weiblich Arbeit -- -- Erlernung neu Belohnung anhaltend Fleiß Erlernt -- 
  beobachten -- -- Stufenfolge Leichter Schwerer -- 
  laß Belohnung erwarten -- Beschäftigung völlig überdrüssig -- 
  Verschaffen Abwechslung -- schnell -- gewöhnt -- flüchtig Geschäft gaukeln -- einer Lieb gewinnen -- leidlich Grade Vollkommenheit bringen -- 
  Solltest Flattersinn Jda bemerken -- solltest bemerken -- besorgen Ständ -- Charakterzug -- halten ernsthaft Stetigkeit -- verdamm -- wenn_es Not tun -- Paar Nichtstun -- 
  Lebhaftigkeit empfindlicher Strafe geben -- 
  stehen Erfolg -- 
  träg Kind freilich Strafe Schildbürger -- Krebs Rache Wasser werfen -- 
  indolent Natur wissen Rat -- 
  Bedürfnisse fassen -- ausrichten -- 
  versagen -- reich Maß gewähren -- freilich -- Fleiß Ordnung abzurichen -- 
  Wesen veredeln -- 
  Fall -- glücklich Mutter -- -- 
  Kind verschieden arten -- schön Anlage Natur aussteuern -- heftig Woldemar -- fast allzu zart Jda -- 
  Kind mußt ernsthaft regelmäßig Tätigkeit anhalten -- eingewöhnen -- 
  Feuerkopf Knabe schlimm Bürger -- 
  Edelmann Edle Bürger -- Welt Kontingent ernstlich zahlen -- 
  können -- -- früh vorbereiten -- 
  Welt bedeutend Dichter gebären -- künftig amtlos umherschweifen -- Mensch Periode Leben -- eigentlich Dichterperiode allezeit Dichter -- 
  prosaisch Zwischenzeit Beruf -- 
  Virtuos Kunst Schatz Kenntnisse tragen -- begeisteren Phantasie Stoff darreichen -- 
  genialischen Woldemar -- Muse Schützling wählen mögen -- Geisteskräft früh Anstrengung gebrauchen lernen -- 
  Beantwortung Frage Woldemar -- 
  Tief mußen Erziehung hinein verflechn -- 
  Gebiet weiblich Feder verbieten -- -- 
  schreiben lehren Mann weiblich Erziehung -- berechtigen -- Grenze -- 
  Gebiet groß -- eng abstecken -- unsrige -- 
  kehr Liebling -- Jda -- 
  viele Herz -- 
  solltest Unerschöpflichkeit lächeln -- 
  heraus -- 
  Jda stricken Strümpfche säumen Tücher -- 
  -- nähet Röckche -- arbeiten Kleide -- nähet Blume -- zeichnen -- 
  früh Buchstabenschreiben -- voraus -- früh Zeichne vorbereiten -- 
  gewiß hierzu Anblick schön naturgegenständ Abbildung -- Vergleichung Bild Sache -- früh anstellen müssen -- kräftig mitwirken -- 
  wundern -- verschieden Blume getreu zeichnen -- 
  Laß -- künftig Hübsches arbeiten -- Zeichnung verfertigen -- 
  hoch korrigieren -- ehe Arbeit brauchen lässt -- Arbeit mißraten -- Mut -- unternehmen -- verlieren -- Schlecht tröste -- 
  Laß Stufe Stufe -- 
  Lebhaftigkeit Stufe überspringen -- Laß -- heiß Mißlungen -- anderer Kind -- 
  weißen -- -- sagen -- geraten -- sagen -- Laß finden -- woran liegen -- 
  Rat -- laß Arbeit haften -- wünschen -- Lust Freude Beschäftigung völlig erschöpfen -- 
  Gelungen loben sollest -- 
  Anstrengung kosten -- -- 
  schwach Kraft bedürfen Aufhülfe -- 
  Lobe selten mäßig -- Lob neu anziehend bleiben -- sehen -- Lob Bedürfnis -- fähig -- Verhüte -- seinetwillen anstrengen -- 
  Prämie Arbeiten -- Mühe kosten -- nachteilig -- 
  hierüber künftig -- 
  -- 
  Dreizehnter Brief -- 
  diesmal Freude versagen -- -- gelieben Emma -- schreiben -- 
  Schreibtische verlangen -- 
  verlangen -- wissen -- Deinig -- -- voll Seele plaudern -- 
  inhaltreich Brief liegen -- 
  vergebens entschuldigst -- Inhalt dein Briefe Jda -- 
  entschuldigen -- 
  -- Welt Innigkeit lieben -- Kind -- nämlich kindlich Kind -- Kind -- ausnehmen -- kein Heißer lieb -- Jda -- -- fast unwillkürlich -- Geist Kind Stufe Entwicklung folgen -- 
  morgend Geburtstage erhalten Jda Tante Selma -- Rosenkranz -- -- Rose freuen -- -- Körbchen Äpfeln zahmen Hänfling -- Futter heraufziehen -- Hand fressen -- 
  sagen -- verschenken -- fast Leidenschaft freigebig -- 
  Laß Gelegenheit wissen -- Geschenk tun -- Freude -- 
  Beantwortung Brief -- 
  Laß anfangen -- 
  früh Liberalität Kind überbilden Fehler ausarten können -- 
  Jda alt -- täglich geben -- -- geben -- verteilen -- 
  früh -- gewöhnlich Alter -- Freigebigkeit Kind zeigen pflegen -- 
  Den- fürcht richtig Leitung schön Triebe -- 
  weis Sparsamkeit -- verständiger Zurathalt freilich Eigenschaft -- Kranze weiblich Tugende fehlen -- 
  spät hervorkeimen -- entfalten -- 
  Kind Seele schrecklich Unnatur -- 
  schwerlich gehässigeren Anblick Kind -- Eigennutz -- Habsucht Geiz angebilden -- 
  Werk Erziehung allemal -- jung Kind finden -- 
  fünf- -- sechsjährig Kind hell Begriff Eigentum -- Sorge Bedürfnis morgens völlig fremd -- -- Heil kommend Generation -- 
  Begriff beibringen -- lehren -- Sparbüchse freuen -- Tante -- Onkel Base Neujahr Geburtstage Stück Geld hineinwerfen -- wodurch Schatz -- zwanzigsen Zwanzigst gebrauchen -- 
  Kind Geiz -- Geldliebe -- einimpfen -- Blatter -- wissen gut Materie empfehlen -- Sparbüchse voll Dukat u. dergl -- -- -- fünfzehnen bisweilen vorzeigen -- 
  Methode folgenden -- 
  öffnen Schatz -- legen Alsdann golden Münze -- Kind aufmerksam -- schön Kleid -- lecker Schüssel -- Tanzparti -- Lustfahrt u. S. W. können -- -- All -- Geld -- -- bekommsen Gebrauche -- 
  lassen Kind jedesmal vergeblich Dukat Schatze bitten -- Anwandlung schön Gebrauche verspüren -- 
  müssen vorzüglich stark ausgeprägt Seele -- Weg gehofft Respekt Gelde eintreten -- 
  Lehre Eigentumsrecht Kind beizubringen -- wirken -- Zund Kind finden -- -- 
  Höre -- Mutter einzig Kind Werk -- gelingen -- 
  besucht Schwester alt Knabe -- 
  einer unbändigst Kind -- zeigen Charakter -- nennen -- 
  Schwester -- Kind leidenschaftlich lieben -- -- unglücklich Weise kein -- Besuch Pathchens gewaltig freuen -- 
  Knabe -- Zeitlang heit -- froh Lebensgenuß Haus unterbrechen -- 
  Mahlzeit -- Spaziergang -- Ausfahrt bleiben ungestört -- 
  Bube -- gewohnen -- Mutter beherrschen -- Herrschaft Schwester Lebensweise ausüben -- dulden -- Wortwechsel Freundinne -- 
  Desto gelingen Mutter -- 
  Adolf -- Mutter genießen -- Genoß -- 
  -- Mutter Glas Wein Tasse Kaffee -- sagen -- -- Mutter -- trinken -- reichen schwach Mutter -- -- 
  -- -- Adölfch -- nimm -- 
  gönnst fast -- -- 
  -- adölfch Wein -- trinken -- verschütten -- Mutter hintendrein Bedingung -- dein Wille -- mußt artig -- 
  täglich ungezogen -- Adolf -- 
  Abends Schwester Mutter Knabe wein Spaziergang Feld -- 
  herrlich Junius-Abende -- Welt versetzen -- 
  froh -- Haus -- 
  halten -- 
  Mitgehen ertrotzen -- 
  kühl -- 
  Mutter tragen Arm Überrock -- Fall -- kühl -- 
  Arm Schal hängen -- mitnehmen -- 
  fragen -- Adölfch -- Überrock anziehen -- 
  -- -- Mutter -- Überrock anziehen -- -- 
  -- redet -- Überrock umzugeben -- erkälten müssen -- 
  -- 
  -- ziehen -- 
  Mutter Schal umtun -- Bube schreien -- reißen Hals -- 
  empört sanft Schwester -- adölfch arme fassen -- derb durchklopfen -- 
  fing schwach Mutter lamentier -- Unrecht geschehen -- Schal gehören -- Eigentumsrecht geltend machen -- 
  überlassen Schwester ferner Gerechtigkeitspfleg -- Mutter Arm -- voraus fragt -- Eigentum meinen -- 
  antworten -- Schal Tag -- bestehen -- -- schenken -- Kleiderkommode tun -- Sache -- schenken bekommen -- beisammen verwahren -- Bedeute zeigen -- Eigentum -- Wille anrühren dürfen -- 
  glauben -- Werthalten in achtnehm Sache beitragen -- Kind früh wissen -- -- 
  Versuch -- Punkt Idee verhelfen -- merken -- verloren Mühe -- lassen -- 
  fällen Knäblein -- 
  Siehst lieben Adölfch künftigen hartherzig -- eigenwillig -- drückend -- egoistisch Haustyrann -- 
  -- gut Emma -- besorgen -- schön Hang Freigebigkeit Jda Fehler ausschlagen -- 
  Laß getrost wegschenken -- 
  Liberalität Kind ohnehin -- schön Aufwallung -- schön -- herrlich Strahl Krone weiblich Gemüt -- stören -- 
  eigentlich geben heißen -- wissen freilich -- 
  Wohltätigkeit kennen -- 
  Ding legen Wert -- Augenblick -- Freude -- 
  -- Freude geben -- wissen -- Vögel Himmel -- Scheune sammeln -- 
  geben Reflexion finden -- loben -- 
  Jda Apfel Birne -- schmecken -- -- leiben -- Stückche reichen -- schön Blume abgeben -- -- Anblick ergreifen -- Kind liebend anlächeln -- enthalten -- an Herz zn drücken -- 
  holdseligeres -- mild Natur -- 
  Tugend Regung Kind -- Paradiesesblum -- trauernd Mensch -- Glaube Liebe verlieren -- himmlisch erquicken -- 
  Herr Erde wandelt verschmitzt Bosheit heilig göttlich Zorn zürnen -- 
  erquicken Anblick Unschuld -- müssen ziehen -- müssen herz -- verhärtet Art umh aufstellen -- 
  wetten -- Jda Rosenkranz -- aufsetzen -- jubelnd Kreis herumdrehen -- Mütterche schmücken -- 
  Laß geschehen -- bitte -- 
  Gib Nachricht -- Äpfeln tun -- Vogel Freude -- 
  Laß Futter einschütten frisch Wasser Glas gießen -- 
  freundlich -- Ordnung Geschäft einzugewöhnen -- 
  Laß -- sobald frühstücken -- 
  Mahne -- vergessen -- leise freundlich -- Haussorg völlig individuell -- 
  kennen lernen -- tausend Spaß -- 
  Gib -- Liebe -- Geschäft abnehmen -- 
  Merkmal Stetigkeit dienen -- 
  Anfang -- Gast neu -- weder vergessen -- versäumen -- 
  treu besorgt -- einheimisch -- bemerkenswert -- 
  lachen -- denken -- treu Abend schön Puppe einwiegen Einsang -- -- geputzen vornehm Lehnstuhl setzen -- fremd Dame heißen -- bitten -- fremd Dame Kleiderkammer tragen -- Putze müde sehen -- 
  Spielen Lilli -- 
  O -- munter trüb Wintertag -- Lilli Zimmer herum fahren -- sitzen -- 
  -- tanzen Lehrtest -- 
  Laß Nachbarin -- desto sicher -- Tanzmeister -- 
  gewahr -- Gesellschaft Jda gedeihlich -- Sache sogleich einstellen -- 
  tanzen gehören Gesellschaft -- lernen -- 
  -- beständig Gespielin geben -- alt jüng -- -- 
  entfalten -- nötig -- Wesen Alter -- anschließen können -- kindlich Geist Spiegle -- Gemüt Liebe Gleichen -- Bewunderung Nachsicht -- gesellig Tugend übe -- -- täglich Umgange Gleichen lernen -- 
  sehen -- streng prüfend -- Kind -- Jda Gesellschaft geben möchtesen -- 
  -- Kind gleich Stande gleich Glücksumstände gebären -- -- 
  gleich Grundsatz erzog -- verschieden Individualität Jda -- wissen Sache wünschen -- 
  beisammen finden -- Kind -- übergeben -- -- Stand Vermögen Deinig -- passen -- Schwierigkeit überwinden wissen -- 
  Punkt bestehen -- Kind Art -- Natur Geist Gemüt reichlich ausstatten -- 
  immerhin arm -- Jda Gespielin -- unerläßlich Bedingung -- Jda völlig behandeln -- genieße -- Jda -- untergeordnet -- dienend Wesen Jda stellen -- 
  unglaublich nachteilig -- 
  fast unvermeidlich Kind sklavisch Kriecherei Scheelsucht -- Neid Tücke -- Egoismus Anmaßung pflanzen -- 
  Bedingung -- 
  erziehest arm Kind Jda -- künftig äußere Schicksal fest sichern -- Charakter Wesen Erziehung -- 
  besonderer Unglücksfälle jeder menschlich Wesen vorbereiten fassen -- abhängen -- Kind Schicksal sichern -- 
  Suche Manne hierüber völlig einig -- ehe Sache unternimmst -- 
  Sorge Ding -- Kind genau kennen lernen -- der h. -- glücklich Anlage gewiß -- ehe Jda Lebensgefährtin machsen -- 
  Mensch Ding verzagt -- Rolle Schicksal Wesen wissentlich übernehmen -- 
  freilich arbeiten ohnedies Mensch Schicksal -- Werkzeug hoch Mächt -- 
  arm Eltern Kind abnehmen -- Haus Wohlstande hoch Lebensgenüsse erziehen -- Schicksal entschieden Richtung -- 
  Subjekt -- wählen -- genau kennen -- 
  lang Brief -- wichtig Fragepunkt Antwort schuldig -- 
  -- dein Woldemar männlich Gesellschaft lassen mußt -- Bruder verlassen -- freilich abwesend Vater ersetzen -- -- 
  Herzens Meinung Woldemar sagen -- -- 
  lang weich Klima mütterlich Pflege Aufsicht atmen -- 
  Mann zurückkommen -- ungewiß -- 
  Woldemar alt -- 
  kräftig -- feurig Knabe -- lang ausschließend leben -- Herz weich -- Phantasie weiblich -- 
  beständig Umgang zart Schwesterche stimmen Geschlecht weich -- 
  Suche Kreis Bekanntschaft würdigen jung Mann Erzieher -- machen -- finden -- gemeinschaftlich Erziehungsplan herrlichen Knabe -- leg Vater -- sanktionieren -- machen stark -- treu befolgen -- 
  Schenke Manne -- wert halten -- kostbar Schatz übergeben -- vertrauen -- 
  Weißt Kreis -- wert Hältst -- nächster Brief Porträt Mannes zeichnen -- Geschäft Tausend scheinen -- 
  menschlich Schwäche -- verstehen -- Art -- Woldemar bemerken vermöchte -- hindern können -- -- hoh Ideal -- hinauf schauen -- 
  sichtbar -- vermuten -- Schwäche herrlichst Vorzug stark überglänzen -- Achtung Abbruch -- 
  Vierzehnter Brief -- 
  Ungeduld siehst verheißen Bild künftig Mentor Deines Woldemar entgegen -- 
  Wohlan -- 
  jung Mann -- Staatswirtschaft studieren -- verwandter glänzend Laufbahn bestimmen -- fühlen stark Abneigung Bestimmung -- vielmehr gewöhnlich Weg Ziel Ehre -- schwerlich betreten -- 
  Kind fühlen innig hingezog -- mitten -- unser Zirkel Häuflein Kind sehen -- 
  Mann traulich Kind umgehen sehen -- 
  unabhängig Gelehrter leben -- beschließen -- -- jeder Amt drückend Fessel -- 
  dennoch scheinen -- stimmen -- Woldemar Erziehung widme -- sobald Knabe sehen -- 
  Kinderliebe überwiegen Liebe Unabhängigkeit -- 
  Umfang Wissens kenn -- kennen -- 
  Art -- Ding wissen -- weniger -- selten Geister -- 
  Mann Gegenstand Reiche gelehrt wissen sprechen -- Sache Herr Meister -- denken -- klar -- sprechen -- 
  dennoch Herrisches -- Absprechend Tone -- fühlen -- Überlegenheit still rein Kraft Ruhe geiste hervorgehen -- fast bewußt -- 
  vorzüglich hören deutsch Geist Deutschland Geist reden -- fassen -- 
  produktiv Geist -- Fahne geschworen -- gehören Schule ausschließend -- 
  Urteil wert -- 
  rein liberal Ansicht deutsch ausländisch Geistesprodukt erhalten -- 
  völlig Geistesfreiheit zuhören -- 
  allerliebsten sehen Kind jung Volke umringen -- 
  Kleinsten tragen Arm -- erzählen komischst märch Welt -- heranwachsend Knabe umringen -- irgendwo Augenblick sehen -- fassen -- lassen sobald -- 
  spielen Pianofort singen herzergreifend -- rein mild Tenor -- 
  zeichnen -- wissen -- Kunstkenn -- 
  neulich Reise Kassel Begleiter -- bringen mehrere Galerie -- 
  Tischbein führen Gefälligkeit herum -- erklären jung Begleiterinn ungemein bereitwillig -- fragen -- 
  horchen -- Begleiter unmündig Kunstsinne aufhilfen -- 
  Verklärung darstellen -- P -- -- Gesicht erscheinen -- herrlich Meisterwerke stehen -- 
  Moment -- -- Gefühl -- Mensch -- Seligkeit -- Name einzeln Mensch Seele Tempel heilig Stille thronen -- 
  -- Wilhelmshöhe feiern -- unvergeßlichsen bleiben -- 
  Christoph steigen hinein -- verweilt Stunde Höhe Kaskade -- weiden Herz Auge Herrlichkeit Natur -- überschaut -- 
  erstenmal -- Genoß wahrhaft kindlich Seele reizend Lokal -- vorlängst Schafhausen -- Rheinfall -- 
  Seele Genoß -- ungleich kalt Kritiker -- vaterlande schön finden -- rühm -- Auslande -- 
  Reise treten innerer Mensch unverhüllt hervor -- 
  eigentümlich Wesen nah kennen lernen -- 
  Mischung Kraft Milde -- Festigkeit kindlich Hingabe -- Stolz Demut -- -- 
  unerbittlich hart Unwahrheit feil Kriecherei -- 
  galant Weiber -- 
  scheinen Geschlecht Mitleid Achtung -- Bedürfnis -- Besseren heraus heben -- Ehrerbietung behandeln -- 
  Gestalt männlich -- 
  dunkl -- feurig Auge zurückscheuchen -- heit Ruhe sprächen -- 
  Schwäche sagen -- unvermerken fast Auge verlieren -- 
  hassen -- -- konventionell Form Umgang -- billig -- 
  hassen -- verabscheuet Anspruch Standesvorzug -- würdig Mensch wählen -- adelig -- bürgerlich -- lassen sicher sogleich stehen wählen letzter -- 
  Höchst wahrscheinlich Frucht Behandlung -- früh hoch Gönner -- 
  Stand früh Liebe entgegen -- 
  -- Rang fremd Ort geltend -- stolz -- Person -- gelten -- 
  -- Edelmann wohlfeil weg -- 
  flüchtig hingeworfen Bild Mann -- glauben -- Woldemar's Geist seinigen herrlich entfalten müssen -- 
  send Brief Manne -- Urteil Mensch zusammentreffen -- wünschen -- Sache einleiten -- schick dein Woldemar vierzehn Besuch -- 
  schicklich Gelegenheit finden -- -- 
  P. Woldemar sehen -- Divinationsgabe bestellen -- unauflöslich fesseln -- 
  Natur begegnen -- fliegen -- alt Platons's verloren Hälft -- -- lassen -- 
  P. wissen Kind -- Plan -- 
  O ungeduldig Ausgang -- 
  denken -- 
  lassen -- Mann entlassen -- sehen -- 
  Fünfzehnter Brief -- 
  sitzen herrlich Junge -- alt Robinson Hand ergötzen herzlich -- 
  -- Emma -- dachen Ausgang -- 
  arm Mutter -- sollen -- Gott wissen -- -- dein Liebling trennen -- Gemahl rauh Norden folgen -- 
  vermuten -- Regierung Posten anweisen -- Petersburg -- -- denken -- 
  Gemahl unwiderruflich entscheiden -- Kind Deutschland bleiben -- 
  ehrend vertrauen -- -- übereinstimmend -- Jda eurer Rückkehr übergeben -- glauben -- Herr P. einzig Mann unser weit Kreis -- Woldemar schönsen Entwicklung helfen können -- 
  -- arm Mutter -- Opfer bringen -- Schmerz Inneres zernagen -- 
  trösten -- Laß erzählen -- Vermutung völlig erfüllet Hoffnung übertreffen -- 
  Woldemar Sonntag Mittag -- Herr P. speisten -- 
  Art -- zueilten -- unverkennbar kindlich Zärtlichkeit -- Hals fallen -- fast Zimmer bemerken -- fallen P. stark -- 
  Blick fest heften -- 
  Woldemar Anfing erzählen -- Jda -- Schwesterche lassen -- Auge Erinnerung überflossen -- Hr. P. leise -- 
  Kind -- wirken -- 
  edle Natur Wesen sichtbar aufgeprägen -- 
  -- Sohn Freundin fast Bestimmtes sagen -- 
  lächelen Schwieg -- 
  allerlei Ding sprechen -- 
  Woldemar fremd Herr paarmal flüchtig betrachten -- 
  Blick freundlich Mien machen Furcht vertrauen Knabe wechseln -- 
  fast getraut hinzublicken -- lassen -- Freund ergötzen Kampf Gesicht königlich -- 
  Woldemar Sofa ziehen -- vertraut plaudern -- 
  blicken halb verstohl P -- 
  treten nah -- Woldemar's Hand -- liebreich -- zuvor -- fragen -- 
  -- Fürchtest -- Woldemar -- 
  betreffen -- 
  fürchten niemals -- Feuerrot -- hinaus -- 
  Bleibe -- P. sanft bittend -- 
  Knabe wagen Blick hinauf -- P. rührender Liebe -- 
  -- fürcht -- Herr P. -- 
  -- -- kommen nah lieben -- 
  springen hing Mannes Halse -- 
  P. Auge glänzen Freude -- Kinderherz gewinnen -- 
  -- Heiß -- P. -- Herr P. -- -- -- gewiß -- 
  -- -- Fürchtest -- 
  fürcht -- -- Wort fehlen -- sagen -- 
  -- -- -- 
  -- -- -- heißen -- 
  -- -- Herrlicher Junge -- 
  nennst deinen Vater -- -- schreibst -- 
  -- -- 
  -- nennst Mutter -- -- 
  erröten stark -- 
  Mutter -- 
  -- anderer -- 
  Mutter sehen freundlich -- lieben -- ansehen -- sagen -- 
  Vater sehen bisweilen ernst -- 
  -- liebst -- 
  O -- lieben -- -- Mutter lieben -- 
  Glaube -- fürchten -- lieben -- sagen -- 
  -- -- heißen -- -- 
  -- Haus gehen -- -- O nehmen -- 
  leiben -- -- 
  P. fragend -- 
  winken -- -- Knabe Hand fort -- 
  spät Abend bringen -- Bitte -- Gast überlassen -- täglich paar Stunde abtreten -- 
  Vertrag eingehen Woldemar' Auge funkelen Freude -- 
  P. Wort halten täglich hergebrachen -- 
  -- lassen gewähren -- 
  lesen -- lesen -- sprechen -- 
  plaudern -- offen Ohr -- 
  wovon sprechen -- 
  P. P. Unerschöpflich Preis -- 
  P. -- 
  -- Garten Zimmer beschäftigen -- einzig Inhalt Gespräch -- 
  Woldemar Haus Landkarte beschäftigen -- -- 
  -- Selma -- -- fühlen Knabe ungewöhnlich stark hingezogen -- 
  Erziehung einzig Geschäft -- wünschen -- 
  wahrscheinlich -- Eltern -- Wirbel Welt umh treiben -- überlassen -- 
  Erziehungsplan selten begabt Kind entwerfen -- 
  bringen -- 
  Eltern nebst dringend Verlang vorlegen -- 
  wissen -- glücklich -- völlig unabhängig Existenz genießen -- 
  wissen -- Welt teuer -- Unabhängigkeit -- 
  glauben -- entsagen -- 
  Kind willig opfern -- -- fühlen heiß Drang -- 
  sagen Eltern -- -- 
  -- Auge glänzen -- 
  gespannt Erwartung -- Idee billigend auffassen -- 
  O -- stammeln -- Auge fließen -- 
  verzeihen -- heiß Wunsch Sache halten -- 
  nehmen -- Mutter -- Sache nötig -- verabred -- 
  Stadt Verabredung dien Brief -- geschrieben Erziehungsplan Woldemar beifügen -- 
  Plan roh Skizze können -- täglich Leben Kind reife ausmalen -- Fist -- lieb Emma -- -- -- 
  deiner Mann voll Zustimmung fehlen -- Sache entscheiden -- 
  sobald Abreise D. festgesetzen -- kommen -- Jda abzuholen -- 
  O welch schmerzlich sehen -- 
  Jda losbringen -- denken -- 
  kommen unfehlbar -- sobald rufst -- 
  posttäglich schreiben -- Kleinod -- Jda Entwicklung getreuest Bericht erstatt -- rechnen hoch Gewißheit -- 
  müssen Mutterherz kennen -- -- vergeblich umständlichst Bericht dein Kind warten lassen -- 
  Stünde -- Sache Wendung geben -- -- Kind -- Jda -- behieltest -- Freude gehofft Genuß opfern -- Lieblinge lassen -- 
  Sache -- lebhaft denken -- Kind trennen -- 
  P. bleiben Woldemar L. -- ziehen wahrscheinlich Haus -- beköstige -- 
  Kind Mahlzeit -- Spaziergängen beisammen -- 
  Lehrstunde trennen -- -- 
  Herr P. Französischen vollkommen mächtig sprechen schön -- 
  Jda Unterricht -- sobald -- 
  versprechen -- Übung Jda täglich Stunde hinzuzutun -- -- 
  Zeichenmeister Kind gemeinschaftlich -- 
  Woldemar besorgen -- -- Jda weich -- fürcht P. Aufsicht -- 
  wünschen -- Kind täglich sehen -- 
  Jda gewiß -- wünsch -- möchtesen Gefährtin finden -- fast sagen -- notwendig -- Gespielin Alter -- 
  Kind sorgen -- erwählen mögest -- 
  Leb -- teuer Seele -- 
  sechzehnt Brief -- 
  Gefunde Gefährtin Jda -- 
  Mathilde verwaist Kind -- alt -- -- 
  O glücklich treffen -- 
  Laß -- halb alt Mathild Unart -- glücklich Naturell -- Verwahrlost -- fertig -- 
  sagen -- heftig Eigensinne -- Herrschsucht -- allzunachgiebig Eltern verwöhnen -- Verstand -- lebhaft Phantasie tief Gefühl -- Gemüt fast weiblich Zartheit Jda lieblich Freundlichkeit fehlen -- 
  Laß kümmern -- -- Schicksal bestimmen -- Mensch -- -- 
  Einwilligung völlig Adoption hiermit Form -- 
  -- Schauet gnädig -- himmlisch Mächt -- Werk gedeihe -- -- 
  Sonderbar bingen -- wissentlich Schicksal Menschenwesen Richtung -- 
  -- -- -- 
  Woldemar hängen täglich fest Mentor -- 
  sobald schreibst -- -- sehen Jda holen -- bereit -- 
  verstehen -- P. begleiten -- trennen -- grausam -- begierig -- Mann sehen -- gegenwärtig künftig Lebensfreude Hand -- 
  -- Woldemar sitzen -- -- -- Tante Selma -- beschreiben -- Paar frei Stück -- sprechen -- -- beschreiben -- -- Haus denken -- 
  -- müssen bitten -- Augenblick abzureisen -- müssen Engelsmutter Hals fliegen -- fest -- fest halten -- bleiben müssen -- L -- glücklich -- wünsch -- fort Petersburg -- denken müssen -- 
  Herr P. leiben -- -- sprechen -- lesen -- 
  Mutter denken -- denken -- 
  Nacht träum Jda -- 
  Nacht -- 
  aufwachen -- stehen Herr P. Bette Tuche Hand -- Auge trocknen -- 
  fragen -- 
  -- Junge -- 
  geträumen -- -- Mutter Jda -- 
  sehen -- -- Mutter -- marmorn Frau -- dreizehn Kind verlieren -- letzter -- jung sterben sehen -- war_es -- sehen Jda just arme hängen -- 
  versprechen -- Woche Mutter Jda holen -- 
  froh stehen -- 
  anziehen -- spielen seagnn Herr P. -- -- Willkommen -- schön -- Pracht -- -- 
  singen -- Traum vergessen -- 
  schicken -- lassen -- lieb Tante -- bitten -- reisen -- -- 
  lieb Schwätzer sitzen plauderen -- bringen dein Einladungsbrief -- 
  bereit -- 
  Wohlan -- -- reisen -- abhalten -- 
  O -- sammle Kraft -- 
  bedürfen -- 
  hart -- Kind trennen -- 
  Richt -- gleich abreisen -- 
  weichen -- -- 
  Mathilde Aufnahme vorbereiten -- 
  traurig schön Woche sehen -- 
  siebzehnt Brief -- 
  überstehen -- Emma -- gefürchtet Trennung -- 
  glücklich L. ankommen -- arm verwai Mutter Deutschland Grenze erreichen -- Zeile Trost schreiben -- 
  Trost -- -- bedürftig -- 
  helfen -- dein kostbaren Schätz ziehen -- Gefühl -- Herz verarmen -- 
  Mußt -- Freundin trennen -- teuer -- Leben -- 
  Kind ansehen -- Anblick Herz erquicken -- kommen Räuberin Freude -- 
  widerwärtig Gefühl -- ertragen -- 
  Stelle treten -- 
  -- -- -- Ort nah kommst -- D * vereinigen -- 
  laß schweigen -- Stachel Schmerz tief wund Herz drücken -- 
  häufig getreu Bericht Kind -- Jda Mathilde -- verheißen -- 
  Anfang sogleich -- 
  Platov Brief Woldemar beischließen -- 
  schmerzlich Losreißung geschehen -- Wagen entrolln -- Norden -- Südwesten -- versanken tief schweigen -- 
  verharrn sämtlich still Feier -- 
  jeder überlassen eigentümlich Natur -- still Fortwein -- gänzlich Abgeschiedenheit Gegenwärtig sichtbar -- 
  ruhig heit -- Abend unbeschreiblich schön -- 
  Mathilde teilen fremd Schmerz still Ruhe -- 
  Woldemar unterbrechen schweigen -- 
  -- leiben -- Platov -- 
  wissen -- Engelsmutter bleiben -- 
  -- lern -- Schelten -- Tobe -- 
  Vater gestraft -- toll Zeug treiben -- nötig -- 
  Vater schreiben -- machen -- taugen -- 
  Mutter schreiben -- wissen -- trösten -- -- 
  -- Wort tröst -- rollt Träne herunter -- 
  Jda -- brechen ihrig neu -- 
  Schluchzend -- 
  Jda Tante Selma Mutter trösten -- 
  O brav -- Fromm -- -- -- 
  -- -- brav lernen -- -- fallen Mathilde -- Mutter freuen -- -- 
  --- drückt Gesicht Wagenkisse -- Kind tief Rührung weich -- 
  gefaßt wendet Platov -- -- -- heilig Welt -- 
  -- -- Moment Leben heiligen übrigen -- entglühet Menschliche Mensch -- -- 
  -- fahren fort -- -- Woldemar -- nehmen Wort -- wild unbändig -- klagst Vater -- verständig Wacker sanft -- Lernest brav -- schreiben Mutter -- schön Herz erfreuen -- -- 
  -- -- L. -- sagen -- zwölf Monat lernen mußt -- 
  einteilen helfen -- zurecht Könntest -- 
  sehen -- Mann -- 
  Lebensweise ausmachen -- Gesetz -- halten streng -- 
  Stunde Tag arbeiten -- lernen -- lernen -- finden -- 
  finden -- Gesetz -- gegeben Gesetz abweichen -- -- -- 
  -- -- O -- -- 
  Woldemar sagen -- -- -- fallen heftig -- Feuer Ehrgeiz allmählich Platz tief Rührung lieben Junge -- 
  Auge funkelen bloß Gedanke -- Schlaffheit fähig halten -- 
  Zunge lösen -- 
  heitern still Pracht Abends Schmerz leise besänftigen -- 
  Berg fangen -- Verklärung Abendsonne glühen -- Fernst scheinen ablösen Erde rein Äther schweben -- 
  Weg Läng Gebirge -- -- scheinen neu -- 
  -- 
  frisch Lebensbahn -- Aussicht hinein -- 
  Abendglock läuten nah Ortschaft -- Landleute -- Fruchtfelder besuchen -- froh Segenshoffnung heimkehren -- grüßt reinlich Sonntagsgewande freundlich ehrerbietig Wagen -- Jda -- -- -- Tante Selma -- gut Bauer leiben -- 
  leiben -- fürchten -- schmutzig aussehen -- 
  Sonntags -- Woche -- -- 
  -- verständig Woldemar fing -- erklären -- Woche reinlich aussehen können -- Reinlichkeit Gewerb-Leute angemutet dürfen -- -- fein Lebensweise führen -- 
  froh Orientier Kind -- hinzu -- jeh Fehlgriff Erziehung halten -- Einsicht Erkenntnis -- Kind -- stempeln -- 
  Lasse -- -- Bewußtsein -- wahr schön schöpfen -- 
  falsch urteilen -- bringen Zurecht -- Schone behutsam Eigentümlichkeit Geist -- 
  halb Stunde fahren -- kommen Ort -- Kirchweihe -- Kirmes -- -- 
  tanzen -- wild -- 
  Musik elend -- Getobe Gekreisch Tanzend Trinkende fürchterlich -- mild schön Weinlande erwarten -- 
  Jda fast schön Eindruck verdorben -- Leute vorig Ort -- 
  Jda -- Freude Gestalt kennen -- meinen Ernst -- Leute sein bös -- leider -- 
  weinen schmerzlich -- 
  nah kommen -- schließen Angst nah -- 
  Schoß -- streichelen -- küßen -- -- grad Angst Furcht vernünftig Vorstellung verlieren -- 
  Woldemar hernach freundlich -- sprechen -- -- -- Jda -- Leute -- bös -- Leide -- vergnügen -- -- 
  Jda scheinen hören -- schluchzen heftig -- 
  schließen -- Hing Schleier hoffen -- schlafen -- vergebens -- 
  Ort vorüber -- Gekreisch allmählich Ferne verlieren -- erholen -- -- -- O Tante -- Bauer bitten -- sehen -- vergnügen -- garstig vergnügen -- -- 
  müssen herzlich lachen -- 
  Kind Ernst -- 
  -- 
  O Freude fast tierisch Charakter widerlich -- 
  fürcht -- Jda künftig Arbeiter -- ansprechen -- Groschen Trink -- wissen -- Art Lustigkeit trinken herkommen -- -- einzig -- Sache sagen lassen -- 
  Woldemar merken -- Jda sprechen -- Sann Weilchen wenden Platov Frage -- Trunkener -- wissen tieten -- gestraft dürfen -- Unglück anrichten -- 
  Platov Frage -- -- Kind 5 -- 6 -- Zimmer Aufsicht lassen -- brennend Licht nahe Vorhang Feuer fangend brächte Haus anzünden -- 
  Kind -- retten -- besonderer Strafe verdienen -- 
  Woldemar -- -- Pl -- 
  -- -- -- 
  Wald -- 
  Kind wissen -- -- -- 
  Pl -- 
  trunken Bauer Pfeife Wirtshaus anzünden -- worin -- wärst Richter -- würdest Mensch -- Woldemar -- -- 
  Besann Augenblick -- -- 
  einsperren lassen -- 
  Pl -- 
  strafen -- 
  wissen -- -- Kind -- völlig trunken Mensch unmündig -- Mündigkeit frei Gebrauch Vernunft bestehen -- 
  Wald -- 
  Schuld -- wissen -- -- Pl -- 
  -- 
  Wald -- 
  -- Kind -- müssen wissen -- Trinke -- Pl -- 
  -- Woldemar -- 
  Vernunft entäußern -- frei Schuld Strafe -- Wahnsinne verüben -- obwohl straf -- voll Bewußtsein begehen -- 
  mancherlei Gespräch halb Stunde fahren -- Lahmer Invalide hölzern Bein Wagen -- 
  -- Erbarme -- schenken arme -- Krieg Bein abschießen -- -- 
  Jda verstümmelt Mensch sehen -- 
  schauderen heftig -- besah gespanntest Neugier -- 
  -- Tante Selma -- schenk Brot unser Reisekorbe -- -- 
  eins -- Münze -- 
  -- -- arm Mann -- -- reichen Brot Geld -- 
  -- -- bess Bein schenken -- -- -- 
  Kind komisch Freude -- -- -- -- Mamsellche -- tanzen lustig herumhinken -- 
  -- Armer lustig Mann -- fragen -- -- 
  L -- -- Mamsellch -- 
  -- Maß Wagen Auge -- Platz lassen -- 
  -- -- -- 
  -- Tante -- laß Woldemar Fuß hingehen -- Lahme Mann fahren -- -- 
  Lahme Träne Auge -- 
  -- Mamsellche -- fahren -- alt Soldat -- Bein -- Gott bitten -- gesund bleiben -- -- schön Engel Himmel -- 
  -- -- kommen -- 
  Brötchen geben -- Tant Geld schenken -- sollen -- mußt garstig Trank trinken -- wovon Leute toll -- 
  Mensch Auge -- murmelen Paar Wort -- verstehen -- 
  überschüttet Danksagungen -- bestätigt Jda Bestellung -- bezeichnen Haus -- 
  Wagen rolln -- 
  Mensch eingefunden -- Jda Paul -- Paul Name -- 
  legen Brötchen Seite -- 
  lassen geschehen -- 
  hungrig -- halten -- 10 -- Frühstück -- hören -- bisweilen Seufzer -- 
  weiterfahren fragt Jda -- arme Bein abbrechen -- 
  verstehen -- 
  wiederholen -- Krieg abschießen -- 
  Krieg erzählen -- fassen -- brechen -- 
  -- wissen -- -- Leute -- wehe -- totschießen -- gewiß betrunken -- 
  schweigen -- 
  -- trunken -- Kind -- Platov -- Branntweine -- -- 
  Jda -- Ding verstehen -- müssen -- Mensch feindlich auszögen -- 
  herzlich müde matt kommen Abends spät Haus -- Ankunft vorbereiten -- 
  rührend Jda wiedersehen gut vorausgegangen Gertrud -- innig Anhänglichkeit bewillkommen -- 
  Mathilde -- vorging -- weniger nehmen -- 
  bringen Kind Ruhe -- 
  Jda beten -- -- Gott -- laß Vater Mutter Woldemar Nacht sanft ruhen -- hört -- eigen Antrieb hinzusetzen -- Tante Platov -- lahmen Paul -- 
  -- -- 
  Reich Kraft Herrlichkeit -- sprechen -- Jda Gebet fortsetzend -- voll Seele -- küßen -- Licht entfernt -- folgend Ordn -- 
  Leb -- teuer Emma -- 
  Achtzehnter Brief -- 
  fast einrichten -- 
  Schlafkammer gemeinschaftlich Wohnzimmer -- 
  Bettchen stehen dicht Meinig -- 
  Gertrud schläft Nebenkammer -- 
  Kind halb Bett -- 11. Bring schlafen -- -- lassen verständig Gertrud Stelle vertreten -- hindern -- 
  sobald Bette -- -- 
  Jda schlafen fast sogleich -- 
  Mathilde wachen -- 
  Gertrud unterdessen Nebenzimmer -- 
  Gestern Abend beten Jda -- 
  -- Gott -- vergnügen -- unartig -- -- 
  Laß Mutter Nacht süß ruhen -- Jda träumen -- -- 
  Mathild gewöhnen -- beten -- lassen -- kommen -- 
  morgens 6 stehen -- 
  7 Kind -- 
  jeder Eckchen waschen -- 
  jeder nämlich Seite Schlafkammer inne -- -- abkehren -- waschen kleiden -- 
  Jda Schamhaftigkeit Mathild mitteilen -- 
  Mathild -- alt -- -- hernach Jda -- 
  schreiben lese unterdessen dicht stoßend Kabinett -- Türe stehen -- 
  neulich morgens schlich Jda Nachtröckchen leise herein -- Gertrud Mathilde besorgen -- 
  siegelen Brief Trennung -- 
  fertig -- Tisch -- küßen dein Name -- küßte Siegel -- 
  O Siegel Mutter küssen -- sehen -- -- Brief Tante Selma -- drücken Mund fest -- ehe aufmachen -- 
  Kuß -- 
  -- rührt süß Schwärmerin -- 
  Gertrud rufen anziehen -- hüpfte fröhlich -- 
  Schlafkammer jeder Kommode Verwahrung Sache -- 
  einzig Stückche herumliegen -- 
  Ehe hinunt -- jeder Seite -- brauchen -- 
  Gertrud droben -- Kammer kehren -- 
  Kind -- 
  Wohnzimmer -- grün Blumenkörbe -- hattest -- Teil teilen -- mittlerer Wand stehen Sofa -- Arbeitstisch -- Gebiet -- 
  Seite Zimmer stehen gleich Kommode -- Mathild -- Jda -- 
  Arbeitsgerät -- Buch -- Spielsache sorgfältig abgesondert verwahren -- 
  Ehe Abends hinauf schlafen -- -- brauchen -- ordentlich verwahren -- 
  Abendzeit Kommode holen -- Garten Stock -- Licht finden -- 
  herum liegen lassen -- gestraft -- 
  nötig -- Mathilde entsetzlich unordentlich gewöhnen -- vielmehr verwöhnen -- 
  Jda fortgerissen -- Sache ernsthaft Nähme -- 
  womit strafe -- 
  Gelde -- 
  Bekanntschaft lahmen Paul -- Jda Wert Geld legen -- Begriff Inbegriff Ding erhalten -- -- 
  Paul -- letzter Brief erzählen -- Ankunft -- Jda bestellen -- empfangen Milchbrötchen -- 
  fragen Nachmittag -- früh wiederkommen -- 
  Tante Selma -- 
  früh hungern -- 
  erröten Schwieg -- hungern -- lieb Jda -- ansehen -- 
  Paul Brot -- 
  lieb Tante -- Jda versprechen -- 
  Jda -- hören -- 
  Milchbrötchen Paul -- siehst -- groß -- brauchen Sättigung -- 
  Paul ißt schwarz Brot -- 
  -- Tante -- Paul Brote -- 
  mußn Geld geben -- kaufen -- 
  Tante -- Geld -- keiner -- 
  weißen -- -- 
  sollst Woche Strümpfche fertig strick Mathild -- Sonntag fertigen Strümpf bringen -- bekommen jeder Groschen -- Geld -- euer -- -- 
  Jda Auge glänzen Freude -- 
  Paul -- fragen -- Hinunter dürfen -- 
  Hinunter -- 
  Höre -- Paul -- -- Milchbrötch versprechen -- Tant -- klein -- 
  Brot -- wovon -- Sonntag Geld -- fleißig -- fleißig -- 
  kommsen Sonntag Mittag -- 
  -- Tante -- Paul -- 
  winken lahmen Paul -- 
  Samstag anfangen -- 
  Jda -- Tante -- schenk Woche Brot -- 
  rufen Gertrud -- Schlüssel Speisekammer -- lassen Jda mitgeh -- Brot Paul aussuchten -- 
  -- vermuten -- groß fassen -- bringen Mühe schleppen -- 
  unterdessen Paul bestätigen -- Kind versprechen -- scharf eingepragen -- danken -- Schöne sagen dürfen -- 
  schwer -- meinen -- stehen Auge voll Wasser -- wahr engelsmien Brot reichen -- 
  Gott ln -- Fräulein -- schicken Blick Himmel -- Kind Herz treffen -- 
  Jda alte sinnend -- 
  hüpfte hinauf -- 
  -- lieb Tante -- geschwind -- gib Baumwoll Stricken -- 
  erhalten teilen Mathilde -- fangen -- 
  strick Strümpfche -- Aufgabe Anstrengung vollenden -- 
  bedauern Jda -- alt Paul sehen -- 
  -- Woche -- Freude Sache neu bleiben -- 
  Wochengelde Strafgeld erlegen -- einer nachlässig -- 
  denken -- Jda hüten -- 
  Mathilde Gelde anfangen -- wundern -- 
  scheinen entschieden Neigung wozu entwickeln -- 
  sonderbar -- stark Natur Indolenz bestehen -- zeigen -- 
  unkindlich Kind studieren -- 
  tun -- fast lassen -- hervortun -- woran erkennen fassen -- 
  Leb -- Emma -- 
  Jda schreiben -- 
  üben -- 
  gut Schreibmeister -- verlangen -- entfernt Lieber mitteilen -- 
  Neunzehnter Brief -- 
  Samstag -- Kind hatten_es heimlich -- 
  Abend zuvor Strümpfche vollenden -- 
  Frühstück hinunterging -- Fuschelt -- 
  Gang Kommode -- 
  jeder bringen Strümpfche -- 
  ziehen Börse heraus -- 
  jeder erhalten Versprochener -- 
  Genoß Vergnügen sehen -- Freude Gesicht verschieden abspiegeln -- 
  Gelde -- Jda -- 
  O -- Tante wissen -- malen Finger Form Brotes Tisch -- 
  Paul Brote kaufen -- -- 
  -- lieb Tante -- 
  Geld behalten -- 
  Tante Brot Äpfel -- essen -- 
  Geld Blume kaufen -- schön herrlich Blume -- 
  -- bedacht -- Blume -- Tante -- leiben -- 
  Paul Broten essen -- 
  -- 
  lieb Tante -- Blume -- 
  Paul -- 
  an Frühstück -- Hänfling Eichhörnchen -- Frühstück -- 
  bemerken -- vergnügen -- 
  Hänfling setzen Schulter -- achten -- 
  fliegen Hand -- bewegen Hand unsanft -- gehen Hänschen -- -- 
  -- Hänsche tun -- -- O -- spielen -- 
  -- -- Kind -- vergnügen -- -- 
  jammert -- arm Herzens -- schön Anstrengung unbefriedigen bleiben -- 
  anvertrauen -- Idechen -- fehlen -- -- 
  O arm Paul essen -- 
  Mittwoch -- Donnerstag Freitag anfangen -- 
  -- Weißt Rat -- Kind -- 
  Frage Bruder Woldemar -- Mittag -- -- 
  -- Geld -- -- 
  -- Geld -- 
  erheitern -- 
  Mathilde Gespräch Jda Kommode gekramt geschwiegen -- 
  Gelde -- fragen -- 
  wissen -- Tant -- Antwort -- 
  lassen -- 
  Kind -- 
  Jda erwarten -- Woldemar Tische -- 
  Türe treten -- springen entgegen fallen Hals -- 
  Woldemar -- -- lahme Paul Brot -- 
  4 kaufen -- 
  3 hinzutun -- -- 
  O -- lustig -- Tant -- Blume -- 
  Wort Blume Woldemar verlieren -- 
  Tische Platov Nebenzimmer -- erzählen Verlauf Jda -- 
  -- -- 
  früh Jda Blume erwachen -- 
  -- Woldemar Taschengelde vorhatt -- -- Jda Freude -- 
  Entschluß ansehen -- Jda -- -- Blume -- -- 
  quälen ohnedies -- neu aufdecken wissen -- 
  Gedanke geben -- 
  lassen -- allenfalls nachweisen -- schön Blume bekommen -- 
  Platov Nebenzimmer -- klopfen Jda paarmal Türe rufen -- -- Tante -- Becker -- 
  wohnen -- weißen -- -- -- 
  schicken Gertrud -- 
  gravitätisch Miene Geld -- 
  Woldemar ziehen Börse heraus fehlend -- fassen Hand -- Gertrud hinüber -- 
  bringen Brot tragen -- 
  O -- Hättest Kind sehen -- lieb Emma -- 
  pocht Herz gewaltig -- 
  hüten Jda Fenster -- Paul erblicken -- 
  Woldemar tragen Brot hinunt -- -- Jda Paul geben -- 
  eigentlich -- wissen -- fürchten -- alt Mensch weich sehen -- schwesterch Ehre Freude gönnen -- -- bleiben -- 
  -- 
  -- Sieh -- alt Paul -- -- Woche essen -- 
  geben -- 
  Woldemar -- tun -- -- Paul -- Samstag -- -- 
  Paul greifen Hand -- küssen -- 
  -- -- Paul -- sollen -- 
  -- -- 
  -- Fräulein Jda -- -- reich Mann -- 
  Gott alt Paul leiben -- Engel sorgen lassen -- 
  Arbeit -- grob Strümpfe stricken -- 
  -- verdien -- bezahlen Nachtlager -- 
  Brot -- 
  betteln -- 
  Bruder beten -- -- Gnade -- -- 
  -- Tue -- Paul -- -- 
  bekommsen Krug Bier -- -- 
  Freude -- hinken possierlich herum -- 
  -- -- -- 
  -- Gehen -- -- Alter -- -- -- diesmal -- 
  Danke aufhören -- 
  entließen -- 
  Jda glücklich -- 
  Woldemar herzen ungestüm Heftigkeit -- herauf kommen -- Wort -- einzig lobend Wörtchen -- 
  Abend treten leise fragen -- 
  -- Tante -- früh -- -- 
  stehst -- Junge -- 
  -- 6 -- -- 
  -- 
  Schlage 6 klopfen leise Kammertüre -- aufmachen -- stehen Korbe voll Maiblumen -- Aurikeln Tazett -- Platov' Diener folgen blühend Rosenstöck -- herrlich Syring Topf -- 
  -- -- herein -- Jda schlafen -- -- 
  schlich leise herbei -- bestreut Decke Blume -- brechen Rose -- legen Hand -- stellen Töpfe Haupt Ordnung -- unbeschreiblich Liebe schlafen -- schlich leise -- 
  -- Tant sagen -- Jda aufwachen -- -- 
  -- Jung -- sollst wissen -- gehen -- erschricken -- unerwartet hören sehen -- 
  schnell -- 
  -- Jda erwachen -- Sinn Geruchs -- 
  fast schlafend ziehen prüfend Geruch -- 
  halb geschlossen Auge -- 
  -- -- Tant -- Garten -- -- 
  -- Garten -- Woldemar pflanzen -- 
  schaut Munter umher küßen Blume -- nahe liegen -- 
  Gertrud bringen Gefäß frisch Wasser -- sammelt Jda Schatz -- 
  Froher Kind sehen -- 
  -- O -- lieb -- lieb Woldemar -- himmlisch Woldemar -- 
  Mathilde -- Bruder -- Blume bringen -- -- 
  Mathild rot -- verdrießlich -- -- 
  -- kommen -- mußt bringen Glas voll schönsten -- 
  Kind kleiden -- bitten Jda -- zugestand -- Woldemar Frühstück kommen -- 
  -- ernten Freude -- heiß Herz begehren -- 
  glücklich Mutter -- teuer Emma -- 
  Platov holen Woldemar -- 
  fing Brief -- Kind spielen Heiterer Ruhe Seite -- Briefträger schelln -- dein lieben Erstling P -- bringen -- 
  früh wurdest D * vereinen -- 
  tief verwundet Herz eher besänftigen -- unverhoffen Entgegenkommen Deines Mann -- 
  O -- Mußt Heiter -- 
  sehen Schmerz Freude verschmelzen -- Brief erhältst -- 
  Leb -- 
  Mathildes Natur liegen hieroglyphen -- entziffern -- 
  ahnen stark -- gemein Wesen -- 
  Aufgabe -- fremd Herz gewinnen -- 
  Wille -- Jda Wille Innere verschließen bleiben -- 
  Geduld kosten -- 
  Zwanzigster Brief -- 
  -- eingeteilen -- 
  8 Frühstück -- 
  9 dauern Frühstück -- gehören -- nämlich Fütter Haustier -- heiter Morgengespräch -- Begieße Blume u. S. W. 9 eigentlich Geschäft Tag -- 
  Stunde gestricken -- gestern Gelernt repetieren -- 
  halb Stunde schreiben -- bloß Buchstabe -- allerlei Zusammensetzung -- 
  geschrieben ablesen -- 
  folgen Stunde Unterricht Klaviere -- geben -- Kind anfangen -- Trieb zeigen -- sehen -- scheinbar gleich Anlage -- nämlich Weise ausbilden -- 
  an Klavier -- Viertelstund sprechen -- wissen -- 
  lassen Mathild spielen -- -- -- Vorrang lassen -- alt -- brennend Ehrgeiz verwunden -- 
  spielen -- sitzen -- stricken hören -- 
  Aufmerksamkeit Anwendung gesagten zufrieden -- sing Lied -- wählen -- 
  halb 11 -- 
  frühstück Garten -- 
  11 -- jung Mensch -- Pestalozzi's Methode rechnen lehren -- 
  12 Tischzeit -- der heißen -- 1 -- frei spielen -- Wetter mild -- Garten -- Zimmer -- 
  2 Mahlzeit vorbei -- 
  3 -- liebsn -- 
  stricken Stunde -- 
  3 4 zeichnen -- Naturgeschicht vornehmen -- 
  4 Brot Milch Frucht nossen -- hinaus spazieren -- -- 
  Woldemar -- ausrichten -- Zeiteinteilung -- 
  treffen Promenade gewöhnlich -- 
  5 holen -- wissen -- -- 
  Kennst reizend Gegend -- weißen -- Abwechselung darbieten -- 
  Spaziergang Lustfahrt -- 
  nächstens Kind lieben Pfarrer N -- bringen -- 
  Kabinett Naturgeschicht studieren -- wozu Mathild ungewöhnlich Hang -- 
  Solltest glauben -- Vorliebe Mineralreich äußern -- 
  Jda hängen Poetische Natur -- 
  Blume -- 
  Blume -- Blume -- 
  Sache ordentlich verständig treiben -- 
  Jda Schönheitssinn Kind Alter entwickeln -- ungemein zart -- 
  trunken Bauer -- garstig vergnügen -- nennen -- liebenswürdig Mensch -- -- schön vergnügen -- -- -- selig vergnügen -- -- glänzen Gesicht Freude -- Mensch sprechen -- 
  hold Engel fast schön Gestalt umgeben -- 
  Gortrud sehen hübsch -- Reinlichkeit Geschmack abgewonnen -- 
  vorzüglich nett kleiden Herein -- springen Jda hinan -- Wort -- 
  -- schön Gertrud -- leiben -- -- 
  reg Sinn für's schön -- wahr Abscheu Unästhetisch -- dennoch alt häßlich Paul -- begreiflich -- 
  glücklich organisiert Wesen -- Hang schöne Trieb guter früh Eintracht stehen -- einer verschmolzen -- 
  Kind erziehen -- Wohltat Geist -- Herz Seele -- 
  wissen -- Leben schön Bedeutung geben -- Wechselwirkung Kind wesen Kind -- 
  Mathilde -- 
  unholder -- gemein Natur -- 
  wachen -- Wesen Hand Welt allzuzart -- verhärt -- leicht Aufgabe -- 
  Mathild unkindlich Natur erforschen -- nächster -- dauern -- ehe Grund kommen -- 
  arm Kind äußerst verschließen -- 
  z. B. errat -- Gelde -- Woche Seite legen -- Gebrauch -- 
  liefern Kind Samstag Strümpfche -- bekommen Fertigkeit stricken -- reich Vorrat Strümpfen -- nächstens Pfarrer N -- verteilen arm Gemeinde bringen -- 
  Paul Woche holen Gabe -- 
  Jda Blumenliebhaberei kennen -- Blume Topf pflanzen -- bringen Samstag Tribut -- 
  Mal holen Jda Brot Geld -- lassen -- Wohltat froh -- Menge Brot sehen -- bekommen -- bedeuten -- bequem -- Brot Geld Haus tragen -- Brot Nachbarschaft kaufen -- wollen -- 
  heißeste Enthusiasmus Sache verflogen -- müssen -- Eindruck heilig Original -- wiederholt Eindruck Kopie -- schwach -- öfter wiederholen -- -- 
  schön still Freude -- alt -- 
  verderben -- 
  Merk -- trinken Bier bisweilen Branntwein -- 
  jemals betrunken sehen -- sehen -- 
  -- Liebe -- Mathild Familienangelegenheit genau Auskunft verschaffen -- 
  kennen -- eher Charakter -- 
  achtjährig Kind seltsam verschließen -- 
  Gelde besonderer vorhaben -- -- 
  sehen -- überzählen -- Geiz -- entsetzlich -- 
  Anschein -- 
  Gertrud beharren fest Meinung -- 
  gewaltig schaffen -- sonderbaren Kind kalt unfreundlich begegnen -- 
  O Neid finster-einsam Gemüt einschlich -- Neid Jda Liebenswürdigkeit fast vergötternd Liebe -- hold Wesen überall entgegen lachen -- -- 
  verhüten -- lassen angelegen Sorge -- 
  machen Kind -- 
  Alter natürlich Vorzug zulassen -- genießen Mathilde -- 
  ordentlich freuen -- Stück Jda zuvortun -- 
  geschehen -- -- 
  Z. B. Rechn -- voraus -- 
  Zeichn schreiben rücken schnell -- 
  Glühet -- bemerken -- -- 
  neulich -- finst Straße hinausblicken -- Jda Vögel besorgen -- 
  entfernen -- -- -- Stunde Garten -- 
  Jda bleiben Zimmer -- 
  Jda -- -- worüber Mathild traurig -- 
  Leide tun -- 
  -- Tant -- gewiß -- 
  wissen -- fehlen -- bitte -- vergnügen -- versprechen -- ansehen -- traurig -- -- 
  -- 
  fehlen -- glauben wissen -- 
  Sieh -- lieb Kind -- Vögel fütterst -- Eichhörnchen besorgst -- stehen sehen Ferne -- 
  denken -- schlimm -- Eltern -- Wunsch anvertrauen -- Eichhörnch Vogel Blume schenken -- 
  Jda -- 
  Tante -- gewiß -- 
  vertrauen -- wünschen -- 
  leiben -- 
  -- 
  wissen -- Kind -- 
  Mensch -- merken -- 
  Jda -- 
  O süß Tante -- schenk Kanarienvogel -- sehen -- Jda -- -- 
  -- 
  Herzenskind -- gib -- herauf -- -- 
  Freude -- 
  tusen -- -- 
  Jda -- O -- Tante -- tun Jda -- 
  Stelle -- behen Fenster Kommode -- tragen Mathild Platz -- 
  Leb -- vögelchen -- -- werfen Kuß -- Mathilde herein -- 
  -- Mathilde -- -- mußen Vogel -- 
  Kanarienvogel -- 
  behalt grau Hänschen -- -- 
  Mathild verlegen -- Beschämung Freude kämpfen -- 
  -- Liebe Jda -- brav -- leiben -- -- 
  Kind -- leiben -- 
  Komm -- Mathilde -- hängen Vögelchen -- pflegen achtsam -- 
  Laß niemals Not leiden -- 
  versprechen -- Pflegesohn halten -- -- 
  wahr Innigkeit schließen Kind -- -- 
  O Mathilde erweichen -- -- 
  entscheiden Vorfall -- 
  herbeiführen lassen -- absichtslos sein -- böse Falt Argwohn Eifersucht jung Gemüte ausglätten -- 
  veranstalten -- Absicht verraten -- 
  mißtrauisch Herz gewahr -- tun verkehrt Wirkung -- 
  -- Kind leben -- gerecht unparteiisch -- lieben Prädilektion jeder schön Mutterlieb -- durch täglich Leben Kind offenbaren -- lieb Argwohn besiegen -- 
  hieran glauben halten fest -- dauern mögen -- Mathild Herz verstehen lernen -- 
  Mathildes Charakter sprechen -- 
  Jda lieben sanft mild Farbe -- 
  Mathild Farbe grell -- 
  Pferd Wohlgefalle -- keins finden schön -- schecken -- -- 
  Hüte -- Geschmack tadeln -- 
  bleiben -- frei äußeren -- 
  Zartere Weg Schönheitssinne finden -- 
  geduldig erwarten geziemt Erzieher Gärtner -- 
  zwanzigst Brief -- 
  fang Mathilde -- 
  neulich Krämer Haus Kattune -- 
  lassen Kind jeder Kleidchen wählen -- 
  Jda wählen -- erwarten -- himmelblau -- 
  Mathilde Feuerfarbe flammen -- 
  Kleide sanft aussehen -- lieb Mathild -- Woldemar -- Mittag -- Kind Einkauf zeigen -- 
  sanft -- Woldemar -- -- 
  glühen -- aussprechen -- 
  -- Wahrheitsgefühl scheinen stark Gemütsanlag hervorzuragen -- 
  -- fragt Platov -- 
  unsanft Mädchen liebenswürdig -- 
  --- schweigen betreffen -- nieder -- 
  trau Mathilde -- -- -- -- Schutz nehmend -- 
  fühlen -- antworten -- 
  Tisch -- zufällig Zimmer bleiben -- treten schüchtern -- Tante Selma -- -- 
  -- 
  sollst Unrecht -- versprichst -- -- -- 
  -- -- -- -- Ding scheinen -- -- 
  kennen -- wissen -- Kind -- -- 
  -- -- stolz Herz Zutrauen triumphieren -- Demütigung aufrichten -- 
  -- -- glaubst -- -- vertrausen -- betrüben -- Mensch erraten -- -- -- 
  lieb Tante -- Eltern Haus -- -- 
  -- -- -- O -- 
  schämen -- -- 
  Mutter fordern -- müssen -- heftig -- werfen Tür reißen durcheinander -- -- aushalten -- -- -- -- 
  Bruder Casimir -- -- -- fügen -- 
  -- Jda fromm -- schämen -- Fromm -- 
  bös -- -- ansehen -- zerschlagen -- 
  manchmal Jda schlagen -- fürcht Platov Woldemar -- Jda unbändig leiben -- 
  Sieh -- Tante -- stumm -- sagen -- denken -- 
  -- Armes Herz -- 
  dauerst -- 
  bisweilen sagen -- denken -- traurig -- -- 
  böse denken -- mußt böse -- 
  zugehören -- neulich Jda sagtest -- gut Mensch müssen bös Schlecht hassen -- können -- 
  lieb Gott machen -- 
  sagen -- denken -- mußt hassen -- -- leiben Solltest -- 
  -- -- Höre -- Kind -- Sache -- 
  Schlecht leiben -- -- Schlecht verabscheuet -- -- 
  böse -- Könntest -- fielesen -- -- 
  Herz krank -- 
  gesund -- Arzt aufrichtig -- sagen -- fehlen -- 
  Arzt -- anvertrauen -- -- 
  -- Tante Selma -- -- -- -- 
  -- bisweilen -- 
  abends Kabinette schreiben -- Jda schlafen -- Jda Morgens kleiden waschen -- -- anhören -- 
  Auftritt sonderbaren Kind Ursprung Bedürfnis Beichte lebhaft denken -- 
  kommen -- Mensch verpflichten -- Innerst gräueln freiwillig aufzuschließen -- 
  Gemüt Bedürfnis -- Notwendigkeit Beicht empfinden -- -- 
  harmonisch Wesen -- Jda einst -- beichn -- 
  schön Natur reflektieren räsonnieren -- eitel -- 
  bewahren -- 
  Mathilde übrig still vergnügen -- schwer Last wälzen -- 
  Abend -- Nacht -- wispern Ohr -- -- Tant -- 
  drücken innig -- durchbeben Spruch -- 
  Freude Himmel Sünder -- u. S. W. innerer himmlisch Freude -- 
  wahren Anfang Erziehung -- 
  bildungs- besserungsfähig -- 
  -- gelieben Emma -- 
  zwanzigst Brief -- 
  schreiben -- gut Emma -- 
  Kind Zeitlang Land -- 
  Woldemar bleiben Mentor Stadt -- kommen -- holen -- 
  müssen Abwesenheit alt Paul Wochengeld auszahlen -- Jda Mathild Vogel besorgen -- unterdessen Jda Hofgärtner -- 
  Abschied Kind -- trennen -- 
  machen Reise Wasser -- 
  Jda neu -- 
  Mathild öfter Wasser -- vertraut lacht Jda -- Anfangs fürchten -- 
  bringen morgens 5 Wasser -- 
  Jda Bezwang Furcht -- 
  abends 8 kommen N. -- 
  Pfarrer Familie empfangen wahrhaft patriarchalisch Einfalt Liebe -- 
  artig gezogen Tochter zwölf -- 
  Vater Geburtstage Kind Gelde beschenken -- Wohlgefalle verwenden möchten -- 
  Mathilde legen Anteil still Seite -- ausgeben -- 
  Jda kauft Gertrud hübsch Halstuch -- 
  übrig legen -- Pfarrer Tochter Geschenk kaufen -- mitbringen -- 
  wählen -- nämlich allerliebsten Strohhut -- tragen -- Rosa-Band -- Lila -- 
  austeilen -- Wusst vorher -- 
  Schwarzäugig rotbackig Jüngst setzt Rosabande -- 
  Ältesten -- zart sanft Züg -- bringen -- 
  Art -- -- bezaubern -- 
  Pfarrer -- äußerst originell Physiognomie stark Züg -- Anfangs heran -- 
  -- Zurücktrat verbergen -- Mathilde küßen -- 
  schonen -- zart Liebe -- 
  Mathilde scherzen jovialisch -- scheinen -- -- 
  selten -- bemerken vorziehen -- -- 
  Tochter tragen Kind fast Hand -- 
  Abendessen bestehen mancherlei Speise -- Backwerk Früchte -- 
  Kind zuvor -- essen -- anbieten -- gewöhnlich Abenddiät beobachten -- 
  reichen -- 
  Mathilde -- gütlich -- 
  Jda fragen -- wählen -- 
  bejahen -- 
  wählt Früchte -- seltensen geboten -- begnügen -- 
  Mathildes Erzählung Gertrud wissen -- Eltern Haus leckern Tafel -- Kind bekommen -- 
  überlassen Wille -- trefflich -- 
  robust Natur -- 
  Den- merken -- Maß halten -- 
  bleich Träger -- 
  Jda blühen sichtlich -- 
  O Land können -- 
  Pfarrhofe gehören schön Obst Gemüse-Garten -- 
  Nahe Haus rund Rasenplatz -- Seite Akazie mancherlei Gesträuch Baum Halbzirkel malerisch umpflanzen -- 
  rasen Mittags speisen -- 
  Abendessen schön frei Platz köstlichen Aussicht Westen einrichten -- Sonne Gebirge untergehen sehen -- 
  wissen -- nahe Strom -- woh -- westlich Gebirge scheinen Duft Äther schweben -- Sonne Hinunter -- entglühet Abendrot -- Herz Sinn heiligen verklären -- 
  Berg verdicht dunkelblau Maß -- Kontrast Irdische himmlischen stimmen ernst ernst -- 
  sitzen Abendtisch -- Mond Aufstieg -- 
  gut Pfarrersleut tief Feld -- Kind Ruhe bringen -- 
  gewohnt Beschäftigung treiben -- verstehen -- 
  Hingegebe frei Natur lassen -- 
  einer ernsthaft treiben -- 
  Naturgeschicht -- worin trefflich Pfarrer Töchter täglich Stunde unterrichten -- Unterricht methodisch treiben -- 
  unser Aufenthalt gestatten unseren nehmen -- gütig -- Alter jung Kind bequemen -- 
  gewaltig Eifer Studium mitbringen -- 
  Mathild Element -- 
  Pfarrer Mineralienkabinett vortrefflich -- 
  Jda -- 
  hübsch Herbarium -- 
  Betty Klärch -- Tochter -- kennen -- umher wachsen -- Flecht Forstbäume -- 
  ziehen halb Gehölz Wiese umher -- bringen schwer Ladung Kräuter Blume Körbchen -- worüber Pfarrer dozieren -- 
  lassen unsrigen herumschwärmen -- 
  Kletter Mädchen -- Gämse -- 
  Anfangs bange Kind -- 
  Pfarrer beruhigen -- seinigen Weg Steg kennen -- verirren -- 
  wissen Maß halten Anstrengung erhitzten -- 
  kühn -- lassen Jda nah Berg klettern -- 
  Mathilde selten Lust -- bleiben Garten -- 
  Jda Monat gewachsen sichtbarlich stark -- gewöhnlich Grazie Gewandtheit Behendigkeit gewinnen -- Tanzmeister entbehrlich -- 
  fürchten -- zart Wesen Stürme Leben physisch -- Sinn aushalten -- blickt überirdisch Gestalt liebend Schmerz -- 
  Kraft freuen -- 
  Herbst Winter bringen ruhig fleißig Stadt -- 
  Sobald Frühling -- der heißen März April -- zeihen Kind hinaus unser lieb Pfarrer -- Nachsommer verlangen Gartenhaus Pfarrhofe bauen lassen -- Platov Woldemar Raum -- -- weilen -- Platov' Plan dienen -- 
  hausen schön Jahreszeit -- 
  Pfarrhause Aufenthalt Epoche -- 
  gewinnen -- begreifen -- 
  Betty Klärch Französisch lehren -- gut Eltern anschlagen -- Leute reell -- 
  -- Pfarrer Stunde kommen -- vierer französisch Stunde -- 
  sonderbar schließen siebenjährig Jda zwölfjährig Betty -- 
  Mathild klein Clara schaffen -- 
  lieben -- 
  Not -- trennen müssen -- 
  Pfarrer Jda fast Ungebühr leiben -- 
  Familie erzählen -- 
  -- schwärm -- Rechenschaft geben -- eigentlich Magnet Haus liegen -- 
  harmonisch Einheit Liebe -- Geist -- hauchen -- 
  Pfarrerin stark Ausgezeichnetes -- müssen still Ruhe -- schaffen -- gewahr -- ungleich Namensschwester -- Deborah Primrose -- Schüssel Mahlzeit Geschichte -- nächst apfelpasteten Johannisbeerwein Herrlicheres denken -- Meisterstück Erziehung Töchter -- 
  Deborah Willich scheinen -- -- erschrecken -- Haus vorstellen -- 
  scheinen Keim früh Tod tragen -- 
  fein dunkl rote zart Wange -- still wohnen -- Zeichen bange -- 
  Mann -- weiblich Wesen schwärmerisch lieben -- -- 
  Schüchter leise äußern -- 
  gehen Abends spazieren -- erlauben niemals -- 
  sehen Unmöglichkeit -- ansinnen -- 
  abends Mahlzeit lustwandeln -- selten tätig Gespräch -- lenken Frage Gegenstand -- worüber Mann Meinung austauschen -- 
  -- -- lieben Deborah -- Ansicht Ding kennen -- fragen -- 
  -- Fortplauder lassen -- Mann Schuß bringen -- -- 
  -- -- -- Sache durchzufinden wissen -- appellieren unreifen verstand reiferen Mann -- Spruch letzter Instanz völlig zufrieden -- 
  neu -- finden hold -- verwandte -- fast gleich Geist -- wechseltausch Idee sehen -- 
  spräch -- brächt Freude -- -- 
  -- Sprecht -- hören neue -- 
  hineinmisch -- Gespräch Alttäglich herabkommen -- -- 
  freuen -- Geist Eurigen heben -- -- 
  --- geben -- -- -- Vorstellung -- 
  weich -- öfter Nähme -- 
  selten Einigkeit Mensch -- 
  sagen -- bewundern -- 
  bloß trefflich Natur getreu -- 
  dünken -- können -- -- 
  -- Deborah -- Abends -- glücklich -- -- 
  -- -- -- Hermann -- wissen -- verdienen lerne -- 
  -- Kind -- 
  verdienen -- 
  elend Ding -- Glück -- Himmel abverdienen -- 
  fühlen -- heiß Liebe Kind hangen -- denken -- wert -- Hermann's Weib -- inne -- Lieben Seele Leben Glückes wohnen -- verlieren -- bang Sinn -- laufen Garten herum -- bind jung Bohne -- halten -- sehen -- Gurke Melone stehen -- sehen Hünerhof Küche -- Ordnung -- Verdienst -- still Glück wert -- Himmel -- Herz tragen -- -- -- Hals fallen -- holden Seele -- ruh heilig Herz -- 
  O grübel -- fromm Herz -- gib Glück sicher -- Ruhe -- Kind Schoße Mutter -- verderben -- 
  irdisch Himmel himmlischen täglich fähig -- 
  -- gehen bewegen auseinander -- 
  künftig erzähl wert Familie -- Umgang Kind Gewinn dünken -- 
  darstellend Erzählung -- Leben anschaulich -- 
  Anschauung Bild Mensch schön Verhältnis kräftig abdrücken -- 
  Wodurch Glaube Mensch entzünden -- Leben -- 
  Gespräches Pfarrer erwähnen -- Inhalt gehören -- Briefe Interesse -- 
  Abends -- Kind Bett bringen -- heiß -- Fenster Schlafkammer lassen -- 
  sehen Garten hinaus -- 
  Jda beten -- gewohnen -- laut -- 
  Pfarrer stehen zufällig Fenster bleiben stehen -- 
  Jda -- -- danken -- unsichtbar Vater -- glücklich -- 
  danken -- Tant leiben -- leiben -- 
  danken -- erschaffen -- gut Pfarrer -- Pfarrer leiben -- 
  Laß fromm froh -- -- 
  Laß Nacht sanft schlafen -- Herr Pfarrer -- freundlich -- 
  Laß -- -- Mathild -- 
  Vater -- gut Eltern Vater -- gut Mensch Vater -- lieben -- -- -- 
  -- -- Amen -- -- hört leis Stimme unten Garten sagen -- 
  rufen Jda -- Nacht -- gut -- gut Tant -- 
  Mathild ungestüm Liebe -- 
  Nacht -- 
  stehen Augenblick selig Träumen Zukunft versinken -- löschte Licht -- hinunt -- lieb Pfarrersleut Abendspaziergang -- 
  Deborah Kopfweh -- bleiben Töchter Haus -- 
  Pfarrer -- Garten finden -- bieten still Arm -- wandelt heiter Abendrot Saatfeld -- 
  fing leise Stimme Gespräch -- Pfarrer -- 
  Freundin -- Abend Garten köstlich Minute -- bloß verdanke -- gehören schön Leben -- 
  -- 
  wissen -- verstehen -- betreffen Jda -- 
  Pfarrer -- 
  -- Jda Abendgebet Fenster belauschen -- 
  O -- Inneres ergreifen -- rein -- ungetrübt Kindheit -- 
  fast erscheinen -- Jda anschauen -- Minute -- Gebet ausfüllten -- Punkt zusammengedrängen -- 
  bekennen -- Bekenntnis zürnen -- edeln Freundin -- 
  -- 
  erraten -- 
  -- Punkt Zweifel Freundin -- -- Pfarrer -- 
  O -- zürn -- verwechseln Freund gemein Zelot -- -- 
  -- -- 
  wissen -- Religiosität stehen -- 
  -- Pfarrer -- 
  gewohnen -- gewiß Grade hoch Geistesbildung vermissen -- Religiosität Aberglaube einer sein -- hoffen -- hoch Ausbildung bestehen sehen -- vornehmeren Ständen -- Bildung fast mittelbar unmittelbar französisch-philosophisch Zeitalter herkommen -- 
  Philosophie hinter Rheine Unglaubenssystem Teil Deutschland Hauptstadt verpflanzen -- lockern Sand leicht Wurzel schön ausbreiten -- 
  huldigt Geist -- heilig unheilig Gemüt -- Gottheit -- 
  gut Seele tragen heilig Dienst hinein -- bloß Vernunftdienst eigentlich veröd -- verarm -- menschlich Begriff hinaus liegen -- Besser bringen -- hinein tragen -- 
  Zeitalter leicht frivol -- 
  Apostel Nichtglauben erheben Stimme laut -- 
  Mensch glühend Herz Göttliche ziehen schweigend -- 
  jung Generation verwendet Feuer Vertilgung Glauben -- Witz -- vielmehr Persiflage -- Verspottung -- kalt Verstand erfassen -- 
  Strom schwellen -- strömn fort -- -- kindlich Glaube Herzen ähnlich -- weggeschwemmen -- 
  Aufklärung Losung -- 
  -- 
  Gott anbeten -- Natur greifen -- 
  finden Natur -- Natur heilig Herzens -- 
  Herz Aufklärung durchkälten -- 
  meister Religion weiblich Seele finden -- ergriff Strom -- 
  Mann -- eindämmen -- fortgerissen -- 
  Studierstube liegen voll aufklärend Journale -- 
  Tasche geistliche ragt Gesellschaft hervor -- 
  gut Kopf gelten -- lassen anwerben -- stimmen Chorus -- 
  -- 
  Zeitalter -- reden -- -- 
  Pfarrer -- 
  Folge dauern -- sobald Wirksamkeit verlieren -- 
  gut Köpfe energisch Widerstand anderer Extrem bilden -- Denker -- 
  jung Volk bedurft Kraft Widerstande -- brauchte nachsprechen -- 
  unglaublich Seichtigkeit -- 
  leicht -- Philosoph -- 
  Philosophie allgemein Losung -- müssen Grade popularisieren -- Eigentum Frau -- nämlich Sprache -- 
  leicht Hälfte Menschengeschlecht -- verzeihen -- edeln Freundin -- 
  wissen -- ernst Augenblick Weib vergessen - Unglaube Treu Glaube -- fast Resultat forschend Verstand annehmen -- annehmen -- wohlbekannt Grund forschen -- 
  -- 
  traurig Wahrheit -- Pfarrer -- 
  Pfarrer -- 
  traurig -- Freundin -- 
  Gebiet forschend Verstand spekulierend Vernunft Regel Geschlecht verboten Land -- herb Frucht Baume Erkenntnisse gedeihlich -- o -- 
  schön Ersatz -- 
  -- Vestalinn hoch Sinn - heilig Himmelsfunk -- Glaube -- Liebe Hoffnung -- Menschenbrust bewahren -- keimend Menschheit -- anvertrauen -- unmittelbar Weise -- Kunst fast Absicht -- innerer Notwendigkeit -- mitteilen -- 
  müssen Wesen durchdrungen -- 
  müssen heilig Sinn Emanation aufblühend Menschheit überströmen -- 
  -- 
  wissen geritzt Wunde sanft verbinden -- Pfarrer -- 
  aufgeklärt Zeitalter erlosch heilig Feuer Herz weiblich Welt -- gebildet Welt -- 
  Freund -- teuer Selma -- gewohnen -- wohltätig Erscheinung weiblich Religiosität Verzicht -- sobald beträchtlich Grad Bildung gewahr -- 
  kleingläubig -- furchtsam -- fast hoffnungslos Rücksicht nahen -- 
  erwarten -- Seele -- Geist Eigentümlichkeit vereinen sehen -- isolieren finden -- 
  Stunde wagen -- Gegenstand bringen -- Freude rein Achtung trüben -- 
  wagen -- Punkt Erziehungsgrundsatz fragend berühren -- 
  Strafe Vorwitz tragen -- 
  weiblich Ideal entschwinden -- Punkt nahen -- 
  Kind unschuldig froh -- empfänglich schön -- lernbegierig ernst -- ankommen -- -- Teuer -- Heiligst verschwieg voll reif Vernunft -- -- -- Leidenschaft reif -- Herz -- Stürme kämpfend -- fähig Aufnahme Heiligst -- Frage stehen fürchtend -- hoffend still -- 
  -- Jda Abendgebet Garten hören -- erkennen Freundin Gebet -- 
  wissen -- Kind diktieren -- Geist -- teuer Selma -- erscheinen -- Eindruck -- -- 
  -- 
  gewiß Herz Kind -- 
  irren -- positiv Verdienst zuschrieben -- 
  Erstlich Mutter Regung Frömmigkeit Kind Seele wecken -- -- tun -- 
  brauchen Erwärmend angehauchen -- -- 
  sich Fall -- vorgearbeiten -- schön Moment treffen suchen -- wecken -- Kind -- -- Zeug Freudigkeit Gott lassen -- 
  Mathilde schön Zeitpunkt kommen -- obwohl alt -- Jda -- 
  unedl Leidenschaft früh empor kommen -- früh Behandlung verwahrlosn -- 
  Religion ausländisch Pflanze unbereitet Boden gedeihen -- stark -- weiblich Seele -- gestalten -- Jda -- 
  Pfarrer -- 
  -- Freundin -- -- 
  -- 
  O -- verstehen -- 
  spät -- 
  Stunde kommen -- 
  nah -- Stunde -- 
  Mathilde Jda Gebet gegenwärtig -- 
  -- ehe -- Idee Gott geben -- Gegebenes empfangen -- liebend aufnehmen -- 
  Herz veredeln -- Bedürfnis -- Kraft lieben -- 
  Gott -- Wunsch Bedürfnis -- Wurzel fassen -- entgegengesetzt Wirkung gewünschten -- Pfarrer -- 
  ehr Prinzip -- erwarten Stunde -- 
  lassen mich_es wissen -- seltsam unkindlich Kind kommen -- bitte -- 
  Haus nahe -- scheiden höchst zufrieden -- 
  glänzend Welt mitteilen -- unfreundlich -- 
  -- mitteil wolltest -- Stoff unser Jdyllenlebe stark kontrastieren -- dein Geist Herz verarbeiten -- 
  wissen -- Welt angehörst -- umgiben -- halb Verbannt lebst -- 
  Schließ Freundin innerer Welt -- 
  Bericht mußt zufrieden -- 
  Breiter dürfen -- 
  O freuen -- Welt schreiben -- -- -- 
  Welt Erziehungsbriefe sagen -- 
  Leb -- Emma -- 
  einer - Winter braun Klärch -- Mutter Nähe wissen -- 
  denken -- kern-gesund Natur unser Kind Gesellschaft -- 
  zwanzigst Brief -- 
  wünschen günstig entgegen kommen -- Nachricht erfreuen -- -- sagen Könntest -- Willkommenste -- gute -- 
  lieb Herz beruhigen hart Trennung -- glücklich D * -- billigst -- Kind geschehen -- 
  -- leisest Wunsch Rücksicht respektieren -- 
  finden -- Jda Liebe beneidest -- 
  fürchten -- Brief hell durchschien -- Jda hängen -- können Herz betrüben -- -- -- 
  lieben Mutter -- 
  nah fern Mutter schmelzen Wesen -- 
  leiben -- Wahrnimmst -- Kind Wesen liegen -- 
  Entwicklung herrlich gedeihen -- mußt Anrechn -- 
  günstig Vorfall -- glücklich Umstand -- befördern -- Richtung geben -- Sorge -- verlieren gehen -- Glück senden -- 
  z. B. unser Lebenslauf letzter Monat lahmen Paul missen -- 
  Menge Idee Jda entwickeln helfen -- freilich meistens blind Werkzeug -- 
  -- Geist -- Zufall Werkzeug lenken -- 
  Aufgabe Erzieher -- 
  schönern Art willichsch Familie helfen -- fast absichtslos -- 
  -- öfter Inhalt Gespräch -- 
  -- lieb Emma -- fang -- Mathild entziffern -- 
  mutmaßen vorher -- Gelde -- sorgfältig sammeln -- wovon Groschen ausgeben -- 
  finden gestern schreibbuche -- ungefähr blättern -- Art Brief -- unvermerkt zusammenbuchstabieren -- Bruder -- jung Kornett -- richten -- vorletzt Brief -- ausgeartet verloren Mensch -- Schuld -- 
  Schlimmeres begehen -- festgesetzen -- weit nachforsche erfahren -- 
  Brief -- denken -- unordentlich schreiben -- enthalten ungefähr -- Bruder gräm -- Mensch sagen -- -- ohnedies schämen -- befreien -- wissen -- -- 
  -- Tisch -- Backwerk süß Wein kommen -- selig Eltern dächen -- vollauf -- wünschen -- -- -- Ältest -- -- 
  -- wissen -- -- schämen -- mißvergnügen -- 
  anfangen -- sagen -- -- wohne bös Geist -- Mund innen schlössen -- auftun können -- 
  lieben selig Mutter -- Kaffee Wein Kuchen geben -- genießen -- Wille tun -- kommen -- -- verstehen -- Kind -- Jda glücklich -- u. S. W. ungefähr vornehmst Inhalt -- 
  legen Blatt Buch -- 
  Jda bitten -- Stündchen Woldemar Mentor ausgehen -- -- lassen Mathilde Sofa setzen -- entstehen folgend Gespräch -- 
  -- 
  lieb Mathilde -- weißen -- lang versprachst -- 
  Mathilde -- 
  -- Tant -- halten -- 
  Schuld -- -- -- verschweigen -- 
  Schuld -- 
  N. -- denken böse -- 
  fast lustig -- 
  -- scheuen -- -- 
  -- 
  Mensch sagen -- mißvergnügt -- 
  fehlen -- 
  Jda -- -- 
  Mathilde -- 
  lieb Tante -- gestern Papier -- holen -- 
  lesen -- gewiß böse -- 
  -- 
  Gehen -- hol -- böse -- Hand -- 
  kommen -- -- 
  heit -- Blatte -- 
  -- 
  Blatt richten -- lieb Mathilde -- 
  Brief -- schreibst -- 
  Mathilde -- 
  Bruder -- Kornett -- 
  allererst Versuch -- 
  -- 
  Bruder Kornett sprechen -- 
  Mathild -- 
  lieb Tante -- 
  schämen -- fürcht -- Lieb -- leiben -- -- -- 
  Bruder -- 
  traurig -- Jda könnten -- 
  -- 
  -- leiben -- 
  anvertrauen -- lieb Kind -- 
  -- blickt Schüchter umh -- Nähe -- halb leise -- -- Mathilde -- 
  -- Geld ausgeben -- Wein kaufen Kuchen -- spielen -- Geld verspielen -- Wein trinken -- wissen -- -- unverständig Obere sprechen -- alt General -- fortjagen -- jung -- einsperren -- besseren -- 
  -- 
  Geld hergenommen -- 
  geben -- 
  Mathild -- 
  Leute -- Eltern sein reich -- borgen -- -- dreist -- borgen -- 
  -- 
  -- Mathilde -- 
  Gelog -- lieb Tante -- wissen -- schämen -- -- Jda fragen -- Bruder -- Blume schenken -- 
  gelogen -- lieb Tante -- fühlen -- gestehen -- gestehen -- denken -- halb gelogen -- Bruder Blume bringen -- trösten -- müssen denken -- gelogen -- vergessen -- 
  -- 
  arm Mathild -- bange um Herz -- 
  kommen Wärest -- Herz erleichtern hättest -- 
  trösten -- bitten -- halb Lüge sagen -- halben -- Mathilde -- 
  O gewiß -- weißen schlimm -- 
  Lies Brief -- lieb Tante -- weißen -- 
  Mußt wissen -- 
  sünd -- verschweigen -- 
  laufen Blatt -- 
  -- 
  versprechen -- lieb Mathild -- einst brav -- 
  einer -- wissen -- 
  nämlich gespart Gelde -- 
  -- sagen -- 
  Mathild -- 
  lieb Tante -- 
  wissen -- -- -- 
  Bruder sollen -- -- 
  manchmal denken -- Torten Obst Wein kaufen -- H -- schicken -- gehören -- Leute Gefängnis bekäm Brot Wasser -- 
  anderesmal -- überlegen -- gehören sehen -- denken -- -- -- Geld schicken -- bät -- Leute geben -- borgen -- 
  wusst -- Geld gekauft Sache H -- bringen -- 
  froh -- weißen -- sagen -- -- 
  helfen -- Bruder -- 
  schrecklich -- unglücklich -- -- 
  -- 
  -- Kind -- -- 
  spar Geld Bruder -- 
  -- 
  Meinst -- Gefängnis -- 
  Mathilde -- 
  wissen -- lieb Tante -- 
  -- 
  unangenehm Folge schlecht Betragen fühlen -- Leid tun -- besserem Betragen gewöhnen -- 
  Strafe Besserung dienen -- 
  Mathild -- -- 
  eingesperren -- 
  -- 
  erfahren -- 
  Mathild -- 
  Magd -- Eltern dienen -- dienen unser Nachbar -- Gartenzaun -- Garten -- -- erzählen Bruder -- Kornett -- 
  Casimir wissen -- Prediger auf Land bringen -- -- 
  -- 
  -- wissen -- 
  Herr Platov reden -- Nachricht Kornett schaffen -- Rat geben -- helfen -- 
  Mathilde -- O -- gütig Tante -- 
  fromm froh Jda -- sagen -- denken -- gewiß unvernünftig denken -- 
  -- 
  Bruder leiben -- 
  Mathilde -- 
  -- Tante Selma -- leiben -- schmerzlich -- freuen fast niemals -- denken -- 
  Glaubst -- Tant -- freuen -- Jda Woldemar -- 
  -- leiben -- glücklich -- 
  -- 
  -- Kind -- 
  wenn_es -- 
  lieb Schwester Bruder -- 
  Strafe bessern meistens Mensch äußerer Betragen -- Liebe -- fromm unermüdlich Liebe bessern innen -- böse -- Mathilde -- 
  -- Tant -- fühlen -- -- Liebe bessern -- 
  -- 
  Hättest hart gestraft -- böse -- 
  -- wissen -- alt Grill wiederkommen -- 
  klagen -- 
  -- 
  -- -- 
  schlimmes denksen -- 
  Lieb behalten -- Freude -- 
  Schlecht wissentlich dulden -- böse -- Mathilde -- 
  O -- Küsse -- Tant -- 
  Sage -- liebst -- 
  Schloß wahr Innigkeit Arm -- 
  arm Kind Innerstes aufgeregen -- 
  Mathilde -- 
  Fromm -- Jda -- 
  -- 
  Fromm brav -- -- Jda -- 
  Kind -- Jda -- 
  jeder Weise brav -- -- Mathild -- Jda -- Jda geraten -- jeder -- 
  ungerecht -- -- Jda -- -- 
  -- Herz Wort trösten -- 
  gewiß -- gewiß -- 
  wirken Allgewalt Menschenherz -- Liebe -- 
  Mathilde empfänglich -- bange -- 
  herrlich Triumph -- Wunsch gelingen -- 
  Kornett -- -- 
  Leb -- 
  zwanzigst Brief -- 
  Gertrud -- -- bevorstehen -- entbehren -- 
  -- -- 
  trennen -- notwendig -- -- 
  send Brave Geschöpf Gelegenheit -- anweisen -- beladen tausend lieb Sache -- 
  schön Name send Fremdling -- 
  -- Knabe -- meinetwegen Herrmann -- 
  Mädchen -- nenn Virginia -- 
  Kind Arbeit setzen -- näh Strick fleißig -- Gast -- erwarten -- 
  Idee froh -- 
  nett Sache fertig -- 
  Gertrud mitbringen -- 
  Stand -- kennen -- -- Lage bedarfst -- 
  arm Geschöpf Klemme Sehnsucht -- treu Anhänglichkeit -- 
  zärtlich Jda lieben -- 
  Mathilde -- Gertrud -- 
  Herz -- 
  Mathilde fordern kalt Liebe -- bescheiden -- Gertrud -- -- 
  Gertrud -- Jda Lieblichkeit gewöhnen -- nehmen Hochmut -- 
  hart Wort geben -- taugen -- Mensch -- nahe berühren -- Liebe -- 
  Verstimmung zurückkommen -- Haß Herz eher genesen -- kalt Lieblosigkeit -- 
  arm Mathild voll -- kindlich vertrauen -- 
  schaffen -- Herz geheilen -- lieb Element -- schön frei bewegen -- 
  Platov Z. schreiben -- Nachricht Kornett einzuziehen -- 
  frei -- Jugend Kassation verschonen -- Bezahlung Schuld -- Monat Gehalt Gewißes abziehen -- 
  Mathilde gut Gelegenheit -- erspart brauchen -- 
  Platov bringen -- Kornett Name übersenden -- 
  Kind Wochengeld verdoppeln -- schön Anwendung üben -- 
  Mathilde Kommode bisweilen Privatgeschenk finden -- besonderer Aufmunterung verdienen -- bedürfen -- 
  Jda Herzen mißfällig Regung entstehen -- 
  Paul bedürfen -- bekommen -- 
  Zulage gewinnen -- Woldemar bisweilen Überraschung -- 
  bedürfen -- gewiß -- Bedenken fordern -- 
  Kind belohnen -- gemein Geschöpf -- 
  lieblich herrlich tun -- tun Antrieb schön Natur -- 
  Zulage Woche Rosa grau Seide kaufen -- Geldbörse Bruder -- heimlich stricken -- Gertrud Mathilde wissen -- 
  Geburtstage -- 
  kräftig Woldemar -- fleißig -- nämlich Charakter schön entwickeln -- Platov gewiß berichten -- Gertrud's mündlich Erzählung Bild vollenden -- 
  Gegenwart heit -- 
  O blicken fröhlich Zukunft -- 
  Leb -- Teuer -- 
  hierbei Jda Brief -- 
  fehlerhaft -- Werk -- unsäglich Lust schreiben -- 
  Mußt ansehen -- 
  -- leben -- 
  zwanzigst Brief -- 
  Woldemar's Geburtstag Kind nett begehen -- 
  Jda flocht früh Blumenkranz -- behend Bild unser Wohnzimmer hing -- 
  Geldbörse Brieflein -- -- schreiben -- schicken Gertrud -- 
  Mathilde heimlich -- Geldgeschenk -- -- nett Schreibzeug kaufen -- bringen verschämt hervor -- Gertrud -- 
  Geschenk -- -- 
  Woldemar fliegen -- unbändig Freude auszuschütten -- 
  zerdrückt Jda fast -- Mathilde mild -- freundlich -- 
  Kind Engel Himmel -- 
  Platov schenken -- wozu Uhrband gestricken -- 
  närrisch Mensch stolz -- unaufhörlich besehen -- -- 
  nett Frühstück bereiten -- 
  genoss Musikzimmer -- 
  Jda Liedche lernen -- nachher singen -- 
  Jda Briefchen lesen -- Tante Selma -- 
  lesen -- 
  reichen -- 
  Inhalt -- 
  Bruder Woldemar -- 
  -- herrlich Bruder -- Jda leiben -- 
  Jda leiben -- 
  O -- sagen -- leiben -- 
  denken -- schreiben -- sagen -- Mund -- sehen -- -- 
  freu -- Welt -- Welt -- Schwester -- Bruder -- vorstellen -- Welt wären -- -- 
  denken -- müssen hübsch Welt -- 
  worüber Mutter freuen -- 
  Tante fragen neulich -- wissen -- Geburtstag feiern -- 
  O wusste -- feiern -- 
  Geldbörse gestricken -- mußt Jda denken -- Herausziehst -- 
  rot Streife darein stricken -- lieb Geburtstag fallen -- 
  Streifen Mutter Geburtstag -- breite -- Vater -- -- Tant -- sehen -- folgen -- 
  Brief -- Woldemar -- 
  wissen schreiben -- wissen -- schreiben -- 
  ungeduldig -- sehen -- schreiben -- 
  Komm -- Herzens Woldemar -- -- 
  -- wusst -- lieb Geschöpf früh Bette -- 
  angefeuchtet Tuche Kränzche aufbewahren -- legen Mittag Woldemar's Trinkglas -- 
  Serviett finden dein Deines Mann Brief -- gestern ankamen -- fällig -- 
  Vater Lob Zufriedenheit lesen -- glühen -- 
  Wort -- brav Mensch -- weich -- Platov -- mitlesen lassen -- fragen -- -- -- -- Junger -- geben -- 
  Lern brav -- 
  Reise -- kräftig -- 
  dein Brief -- weich -- Woldemar -- Platov -- -- -- 
  O Mutter -- wert -- Kind -- 
  Tisch fahren Buchnau -- 
  wissen -- reizend Tal sehen -- 
  liegen Schoß zwei Berg -- vielmehr Berge gesondert Gipfel -- 
  Berggipfel schönsten Buche bewachsen -- wovon unten Tal verlieren -- 
  liegen ungeheuer Stein -- behauen -- grau Vorzeit Opferaltären dienen -- 
  anderer Gebirg Süd- Westseit Weinreben Kastanie -- Pfirsich Mandel bepflanzen -- 
  Fleck üppig Vegetation Lande hoch Kraft Fülle zeigen -- 
  Weinlese -- Traube reifen häufig -- 
  Fruchtebene grünt neu -- Frühlingsschmuck -- 
  Strom schlagen silberwellen stolz -- Wand gewaltig schäumend hindurch -- 
  Kind füllt Korb Herbstblume -- mannigfaltig Menge wachsen -- 
  lassen Frucht Traube Weinberg bringen -- -- 
  Sonnenuntergang steigen Anhöhe Weinberg Kastanienwald -- 
  O Hättest Stunde -- 
  unaussprechlich mild Reiz Natur ausgegossen -- 
  eingewurzeln stehen Kind -- Sonne westlich Gebirg versinken sehen -- 
  O Ruhe -- Stille herbstlich Natur -- wirken wohltätig -- 
  fühlen tief Frieden Universum -- klein Kreatur -- 
  Würmche zertreen -- still Natur berühren leise -- haucht heilige heimlich -- 
  Lüftche Leidenschaft regen -- 
  Platov bieten schweigend Arm Herabsteig -- 
  jeder ehren schweigen -- 
  unser Wagen heim schicken -- wandeln gemach Volllicht Mond Haus -- 
  zwanzigst Brief -- 
  Gertrude reisen -- 
  bringen Kind Brief -- 
  Platov schreiben -- -- 
  Arbeit Kind Freude -- 
  beweisen -- Kind ausrichten -- angreifen -- 
  fröhlich Kind -- unsrigen -- 
  Gertrud bringen Maß -- 
  erstaun -- wachsen -- sehen -- 
  Jda schleanken grazienhaft Bewegung -- 
  brauchen Tanzmeister -- 
  lieblich Gang -- 
  Mathilde drücken Gange Charakter -- 
  Tanzmeister ändern -- Frage -- 
  Stolz -- Wesen -- Gang -- 
  Köchin Markt Haus -- leise -- alt Lahmen Paul betrunk Straße liegen sehen -- 
  fürchten -- 
  verbieten -- Jda sagen -- 
  Samstage -- Stunde -- Wochengeld abzuholen pflegen -- bleiben -- 
  Jda betreffen -- meinen -- müssen krank -- 
  trösten -- können -- Hausleut bedeuten -- Nachricht geben -- krank helfen -- 
  Jda zufrieden geben -- bestehen Heftigkeit -- kenn -- Bitte -- Magd hinsend -- hören -- kommen -- Geld bringen -- Fall krank -- 
  -- 
  Magd Bescheid -- krank -- können -- wollen Geld -- 
  Antwort betrübt Kind -- betreffen -- obwohl Anfing -- ahnen -- -- 
  schicken -- lassen sagen -- sollen -- krank -- Jda niemals sehen -- 
  helfen -- 
  -- Anblick Seele -- 
  beschämt verwirrt hoch Grad stehen -- 
  Freut -- Jda zugegen -- 
  -- 
  Wolltest -- Paul -- 
  Jda betrüben -- 
  Paul -- -- 
  Engel schämen müssen -- 
  -- 
  -- Paul -- 
  machst unruhig -- 
  Sage -- tun -- 
  Paul -- 
  Gelübde brechen -- 
  -- 
  -- 
  Paul -- 
  bitte -- sprich -- ehe -- 
  Paul -- 
  -- still Wagen -- Kind gebot -- Branntwein trinken -- 
  glauben -- Gott Kind verbieten -- 
  trinken -- betrunken -- toll Zeug -- Tier Straße liegen -- 
  Gott vergeben -- -- 
  -- 
  Wolltest -- Paul -- 
  -- 
  weißen -- Jda halten -- 
  Paul -- 
  aushalten -- wissen -- 
  wissen -- eher -- abstrafen -- 
  -- 
  -- Paul -- wolltest essen hernehmen -- 
  Paul -- 
  betteln -- -- Stück Brot -- Wasser trinken -- 
  alt Leib abkasteietn -- gewiß wissen -- können -- kommen -- eher sterben -- -- 
  -- 
  Jda sprungen -- 
  O Paulchen -- lieb Paulchen -- -- 
  -- 
  Wolltest -- 
  Paul -- 
  -- Fräulein Jda -- 
  -- Abschied nehmen -- 
  Jda -- 
  Abschied -- Paul -- 
  reisen weg -- wegreisen -- 
  Bleibe -- wissen -- wozu Samstage freuen -- 
  Paul -- 
  Fräulein Jda -- sehen -- Gabe annehmen -- 
  Gott vergelten -- nehmen -- 
  Jda -- 
  fehlen -- Paul -- 
  Armer Paul -- sagen -- fehlen -- 
  Paul -- 
  Gelübde brechen -- 
  Jda -- 
  Meinst -- 
  verstehen -- 
  brechen -- 
  Paul -- 
  Heerstraße Wagen stehen -- sagen -- 
  -- Trinke Trank -- wovon Leute toll Gott leise versprechen -- Branntwein anrühren -- 
  Mittwoch betrunken -- Nacht Straße liegen -- leiben -- -- Gnade -- wissen -- mal -- beten -- Gott Gebet erhören -- 
  Fast sterben -- Gott -- -- 
  Jda weinen -- laut schluchzen -- 
  -- -- -- 
  Paul -- 
  -- Fräulein -- kommen -- 
  -- Gott Himmel kommen -- Haus tren -- 
  Jda -- 
  O warten -- arm Paul -- warten -- laufen fort -- leeren Kasse -- lieh Woldemar -- bringen -- 
  -- nimm -- kaufen Brot -- -- 
  Paul -- 
  -- Fräulein -- Gabe heben Andenken -- sterbe -- begraben -- Christ Ruhe kommen -- 
  weinen -- ziehen golden Tuchnadel Halstuche -- fragend -- -- 
  -- -- Paul -- Andenken Jda -- betrüben -- -- 
  alt nahm_es -- streckt Hand Kind -- umfassen -- lassen sinken -- stammeln -- 
  -- Leben -- -- -- 
  Haus hinaus -- 
  Jda schmerzlich betrüben herauf -- setzen eckchen weinen -- 
  ruhig -- erzählt kläglich Geschichte Mathilde -- alte -- zuvor -- 
  Kind sitzen traulich Fensterbänkch -- 
  -- hinsahen -- Herz -- 
  Mathilde stehen -- treten -- -- 
  -- Tante -- fragen -- -- 
  -- 
  -- Kind -- 
  setzen nah -- lassen hören -- 
  Mathilde -- 
  -- Mensch -- -- können verständig -- 
  Mensch -- Ausnahme -- 
  -- 
  -- Herz -- -- -- -- 
  Mensch Notwendigkeit -- -- 
  Jda -- 
  Paul -- 
  ganz Herz -- 
  O -- begreifen -- 
  -- 
  Paul böse -- 
  schlimm Gewohnheit stark -- -- -- Gott wissen -- -- überraschen -- 
  Jda -- 
  gut Mensch -- gut Tant -- 
  -- 
  -- Mensch -- gut Wille -- verkehrt handeln -- Mathilde -- 
  -- gut Tant -- 
  -- 
  -- gut Wille behalten -- 
  -- 
  -- lieb Mathilde -- 
  -- früh anfangen -- -- kräftig immerfort -- 
  Jda -- 
  Paul tun -- 
  -- 
  Paul hernach reden -- lieb Herz -- 
  Mathild Frage Lippe -- Mathilde -- 
  -- gut Tant -- 
  wissen -- Schuld -- verkehrt Gedanke -- ärgerlich -- mißvergnügen -- 
  andermal lieben -- böse Stunde zuwider -- 
  fürchten -- böse -- 
  -- 
  Neigung fühlst -- Schuld -- versehen der -- früh Kindheit gewöhnt -- vielmehr verwöhnten -- 
  Mathilde -- 
  schlimm -- gewöhnen -- -- 
  -- 
  Irrtum -- 
  meinen -- dein Wille tun -- schön Trieb wild aufschießen lassen -- denken -- Würdest zufrieden vergnügen -- 
  -- geschehen -- wolltest -- Trieb wild ausbrechen -- 
  Mathild -- 
  -- Tante Selma -- 
  öfter mißvergnügt -- -- -- -- treiben Ding -- unmöglich leiden -- 
  wehren -- begreifen -- toben böse -- Leute zuwider -- -- Widerstand rächen -- 
  -- 
  siehst -- zufrieden froh sehen -- Absicht verfehlten -- 
  bloß Irrtum -- 
  Mathilde -- 
  Schuld -- -- 
  -- 
  warst -- wußtest -- -- 
  Schuld fangen Erkenntnis -- 
  Augenblick -- Besser erkennen empfinden -- Kraft ergreifen -- tadelnsweren -- strafbar -- 
  Frage Stimme -- kennsen -- -- 
  Mathilde -- 
  -- leise beschämt -- 
  -- 
  -- 
  -- Anbeginn -- 
  Stimme -- Inneren sprechen -- sprechen Gewissen -- 
  Mensch Engel -- 
  ehren -- -- 
  Mathilde -- 
  Paul ernstlich -- Branntweintrink abgewöhnen -- -- Heftigkeit Verkehrtheit abgewöhnen -- 
  -- 
  Glücklich Kind -- jung -- -- schwer Kraft -- unaufhörlich -- erreichen -- Paul -- wendet Jda -- Entschuldigung -- 
  Soldat -- 
  plagen Soldat -- hören -- Paul Kriegszüg erzählen -- 
  arm Mensch Branntwein fast fertig -- gewöhnen -- 
  trinken -- schaden -- 
  vielmehr -- 
  Jda -- 
  Paul trinken -- -- aufhören -- 
  -- 
  schwer -- 
  Paul zutrauen -- wissen -- Maß verfehlen -- vermutlich betrunken -- unser Wagen Gelübde -- trinken -- meinen unmöglich -- 
  Jda -- 
  begreifen -- 
  Kind Tische Wein gibst -- trinken -- Woldemar Tisch fragst -- Glas wollen -- -- lieb Tante -- -- 
  Woldemar wissen -- jung -- alt Paul wissen -- 
  -- 
  -- gut Kind -- gewöhnen -- eu Maß merken -- Paul Erzog -- 
  dennoch -- lieb Jda -- erinnern -- Woldemar's Geburtstag Weintrauben -- 
  Fleiß überlassen -- warnen -- Traube schmeckn -- 
  folgen -- 
  Jda -- 
  Jda Magenweh Kopfweh -- 
  -- 
  Wußtest -- Obst Traube essen -- 
  Jda -- -- beschämt -- -- Tant -- Paarmal versuchen -- Traube süß -- warntest -- essen -- 
  -- 
  Sieh Kind -- Traube Kirsche Pfirsichen -- Mann stark Getränk -- 
  reizen -- reizen -- 
  -- mächtig reizen -- Gefährlich -- 
  Jda -- O Tante -- laß arm Paul wiederkommen -- tröst -- sagen -- Traube -- Branntwein -- 
  O -- wiederkommen -- 
  -- 
  -- Entzweit -- 
  Jda -- 
  bös -- 
  sagtest Gelübde -- 
  -- 
  -- 
  Gelübde Vorsatz unterscheiden -- verstehen -- Liebe -- 
  zürnt -- Gelübde brechen -- 
  alt -- sprechen -- 
  arm Paul für's überlassen -- 
  Jda -- 
  lieb Tante -- fallen -- 
  -- 
  -- Kind -- 
  Sage -- Jda -- 
  bös -- Leute sehen -- unvernünftig -- trinken -- 
  -- 
  -- Jda -- 
  Findest garstig -- 
  Jda -- 
  O -- vorstellen -- kommen -- Verseh betrunken -- 
  -- 
  Traube Wirkung tun -- 
  Jda springen herauf halten Mund -- 
  O -- bitte -- bitte -- lieb Tante -- sagen -- -- -- aussagen -- -- -- -- 
  alt Paul bös -- bös -- unglücklich schwach -- gut Vorsatz halten -- 
  stark -- -- Kraft versuchen -- 
  Sieh -- lieb Emma -- alt Paul Stoff Gespräch Kind geben -- 
  Übrige -- schreiben -- Laß Gertrud mündlich berichten -- -- O erzählen -- 
  Leb -- 
  zwanzigst Brief -- 
  gewohnt Bericht diesmal inne halten -- 
  Gertrud notwendiger -- wissen -- 
  hauswesen müssen fast neu organisieren -- Glied Kette ablösen -- 
  Ordnung -- vermissen treu Herz täglich -- 
  froh indessen -- -- 
  Bedurftest ungleich -- 
  Ehegester überraschen trefflich Pfarrer N. 
  übergeben Klärch -- Mutter Herzblatt -- Winter -- 
  bringen roh Schelm -- -- -- 
  bleiben Nachmittag -- 
  Besuch Haus lieb Erscheinung -- 
  Klärch Bild gut -- gesund -- stark ausgeprägt Natur -- 
  Vater -- schluchzen weint Tuch naß -- 
  Stunde nachh Kind -- leben -- 
  förmlich Schlaf Wohnzimmer einrichten -- lieb Dreiblatt -- tunlich -- Stück -- notwendig halten -- 
  Pfarrer wohlhabend -- wagen -- brauch Verwöhnung fürchten -- Kind genießen lassen -- frugal Leben gewähren -- 
  Musik Tanz äußern leidenschaftlich Hang -- 
  Schlafengehen musizieren -- 
  spielen -- 
  stark Musik fühlen -- Takt -- 
  Mathilde spielt Ecossoise -- -- Clärchen Wesen tanzen -- 
  Tanzmeister bekommen suchen -- -- 
  sobald Subjekt finden -- dienen -- Tanzstunde angehen -- 
  Woldemar nehmen Stunde -- Wetteifer -- 
  Paar für's -- nehmen Kind Nachbarschaft -- 
  dennoch Unterricht beständig gegenwärtig -- 
  -- Tanzmeister Kunst verstehen -- Weise mitteilen verstehen -- 
  leicht hören Kind -- Kind -- Tanzunterricht -- 
  Kind behandeln -- Unschuld Unbefangenheit respektieren -- verlier Preis äußerer Sorgfalt zwölf Stunde -- 
  entwickeln Eitelkeit -- Gefühl Begriff -- -- schlafen -- schießen schnell üppig -- Treibhauspflanz -- 
  Verlaß streng Wahl -- 
  Finde Tanzmeister -- Ansicht fassen respektieren -- heillos Tanzmeisterkünste -- Eitelkeit aufzuregen -- enthalten -- 
  nehmen -- unternehm Sache eher -- Kind sicher vorgearbeiten -- fürchten brauchen -- 
  Glücklicher Weise bedürfen Kind Aufhülfe Kunst schön Haltung -- 
  schön Zweifel leicht natürlich absichtlos -- Regung Seele ungehindert ausdrücken -- Eckiges -- Verbogen Geniert -- -- bewußt -- 
  --- angenehm Produkt ungestörn harmonisch entfaltet Natur -- schön Belohnung -- womit naturgemäß Behandlung Kind Lebensperiode erfreut -- 
  vollkommenst zeigen unser Kind Naturgrazie Jda -- Ansehung Haltung fast Erinnerung bedürfen -- 
  Mathildes Bewegung -- Gang -- Haltung ganz Anstande drücken heftig Charakter -- 
  mildern -- Ausdrucke finden -- 
  Clärchen Wille eigentlich wünschen -- tüchtig Subjekt finden -- 
  schlimm Verwöhnung Haltung -- Manier roh -- grenzen Bäurisch -- 
  Kunst abhelfen -- -- 
  tun weh -- äußerst sanft -- gutartig Mensch unhold Gang täppisch Manier sehen -- abgeholfen -- 
  Leb -- 
  zwanzigst Brief -- 
  Klaviermeister geben -- 
  Kind zeigen Trieb Musik -- Wetteifer spornen -- 
  Klavier -- worauf artig Fertigkeit erwerben -- Klärch üben -- -- Vater unterrichten -- Instrument wählen -- Mathild Harfe -- Jda Laute -- Klärchen Guitarre -- 
  Woldemar blasen Flöte spielen Violine -- 
  künftig artig Hauskapell -- 
  Jda Stimme hübsch -- zart Gehör intoniert völlig rein -- Wesen zart -- Stimme -- künstlich Singe früh üben -- 
  Mathild Stimme hart -- 
  Clärchen Stimme Mathild Kraft Jda Zartheit -- 
  morgens Schlafzimmer herunter -- setzen Frühstück an Klavier spielen Morgenpsalm -- Kind Seite erheben Stimmchen -- 
  Gesang geendigen -- frühstücken -- 
  Stunde Frühstück -- nennen -- 
  -- Verstand Vernunftübung -- 
  geben nämlich Wort -- Erklärung fordern -- 
  gestern Stunde -- 
  richten Klärch Frage -- 
  -- 
  Lieb Klärch -- beisammen -- 
  Klärch -- 
  -- rasch fröhlich -- 
  lernen -- Tante Selma -- 
  -- 
  lernen -- 
  Cl -- 
  lernen -- 
  -- lieb Tante -- 
  lernen -- -- ausdrücken -- 
  -- 
  -- Kind -- brauchen klingen -- Erwachsener -- 
  lauten -- sehen -- Habest verstehen -- wovon Rede -- 
  Cl -- lernen -- 
  wissen -- J -- närrisch -- sagen -- 
  -- 
  laß -- Kind -- 
  nehmen -- nachdenken -- dunkel Vorstellung deutlich -- deutlich wiedergeben -- 
  Cl -- lernen -- 
  -- ungeduldig -- O wissen -- lieb Tante -- 
  einfältig -- 
  Mathilde Jda -- 
  Schwiege -- 
  -- 
  lernen -- Kind -- 
  -- lachend -- 
  O -- lernen -- 
  -- 
  -- Klärch -- nenn Sache -- lernen -- 
  Cl -- 
  schreiben lernen -- nähen -- kochen -- -- -- 
  ehe anfangen hattest lernen -- wußtest -- -- schreiben -- vollends schreiben -- 
  Cl -- -- 
  Brief -- Vater schreiben -- erhalten -- begreifen -- Gedanke auf Papier heften lassen -- denken -- niemals -- 
  Gespräch auf Papier bringen -- ablesen lassen -- fassen -- 
  Mathilde -- 
  ehe stricken -- unbegreiflich -- Strumpf -- Stricknadeln unaufhörlich Hand bewegen -- 
  -- zusehen -- geschwind -- begreifen -- 
  Jda -- O Klavier -- 
  Mutter schnell spielen hören -- herrlich klingen -- fassen -- Ton Klang einer ausmachen -- 
  hinaus -- schlich an Klavier -- -- greifen gewaltig Klavier hinein -- 
  klingen abscheulich -- 
  -- 
  schreiben lerntest -- Klärch -- -- 
  Cl -- müssen Buchstabe nachmachen -- hernach zusammensetz Silbe -- Wort -- mehrere Wort zusammensetzen -- Gedanke ausdrückten -- mehrere Gedanke ordnen -- spräch -- -- ehe mich_es versehen -- Briefchen fertig -- begreifen -- -- 
  -- 
  -- Mathild -- Stricken lerntest -- Lehrmeisterin -- 
  Mathilde -- 
  stricken langsam -- lassen zusehen -- begreifen -- Masche durchzog -- Nadel abstricken -- Tour herumkommen -- Zeichen -- anfangen -- -- sehen -- Arbeit zunehmen -- 
  lassen versuchen -- Masch durchzuzieh -- aufgestoch -- strickt Masche -- Nadel -- Tour -- 
  üben Zeitlang -- ich_es -- 
  begreifen -- schwer -- 
  -- 
  lernen zweierlei bemerken -- wovon Idee Lernen fassen festhalten -- 
  Jda -- 
  Tante -- sagen -- lernen -- 
  bitte -- laß sagen -- 
  -- 
  Kind -- 
  Jda -- 
  -- Sache -- verstehen -- aufmerksam anzuschau Festzuhalt -- verstehen -- verstehen -- üben -- -- 
  -- 
  -- -- 
  -- Mathilde -- Sage -- Mathilde -- einerlei -- 
  Mathilde -- 
  -- Tante Selma -- einerlei -- scheinen -- 
  -- 
  unterscheidest -- 
  Wenn_es einerlei -- unterscheiden -- Mathilde -- 
  -- Unterschied wissen -- 
  -- 
  erkläre -- jeder heißen -- Unterschied -- 
  Meinst -- 
  Mathilde -- 
  erklären -- kommen gewiß zurecht -- 
  -- 
  Laß hören -- heißen -- Jda Klärch helfen -- Mathilde -- 
  Augenblick Atem holen -- 
  -- 
  Mußt -- lieb Mathilde -- 
  Mathilde -- 
  zwingen -- 
  unterlassen -- 
  -- 
  nennst -- Mathilde -- 
  -- sagen -- 
  -- 
  -- sagen -- 
  meinst Drang Natur -- stark Wille -- 
  nennen Notwendigkeit -- 
  Notwendigkeit fügen -- entziehen -- -- 
  Mathilde -- 
  -- 
  wissen -- wissen sagen -- 
  -- 
  -- lieb Jda -- gemußt -- 
  Jda -- 
  -- gut Tante -- -- -- Minute -- 
  -- 
  -- 
  Jda -- 
  lieb Gertrud neulich morgens 2 -- -- lieb Tante -- aufbliebst -- abreisen sehen -- aufbleiben -- Bette -- bitten -- sagtest -- sehen -- wach bleiben -- 
  -- gewiß -- 
  10 müde -- plauderte fort Gertrud -- munt -- 
  10 nicken -- Klavierspiel -- stricken -- helfen -- 
  müssen schlafen -- 
  2 Gertrud Adieu -- wach bringen -- 
  gehen -- 
  -- 
  Klärch -- gib -- Cl -- 
  neulich Haus reisen -- lustig froh -- wünschen -- -- wissen -- -- lieb Tante -- -- lernen -- wein -- Mutter weinen -- Betty -- weinen sehen -- 
  Wagen steigen -- Mutter Schwester küßten -- müssen laut schluchz -- Herz zerdrücken -- 
  Vater Lebewohl -- -- 
  wissen -- wein -- Vater unterwegs -- vernünftig -- weggingen -- müssen weinen -- helfen -- 
  bisweilen lachen -- Komische sehen hören -- -- 
  -- 
  -- Kind -- sehen -- wissen -- -- Klärch sprechen vorhin Wort -- -- glauben -- verstehen -- -- 
  Cl -- -- lieb Tante -- 
  wissen -- 
  -- 
  -- Kind -- 
  erzähltest -- Vater -- solltest vernünftig -- 
  Glaubtest bloß -- Vater -- -- Cl -- -- fühlen -- -- Mensch vernünftig -- 
  -- 
  -- Mensch vernünftig -- 
  -- -- 
  Cl -- -- -- o sagtest -- gut Tant -- 
  Wort begreifen -- verlieren -- 
  -- 
  Nothwe -- Cl -- 
  Notwendigkeit treiben Vernünftigsein -- Atemhol -- 
  -- 
  -- Klärch -- Weine -- betrüben -- lachen -- Komische siehst hörst -- Jda schlafen -- völlig müde -- 
  fordern Vernünftigsein -- Notwendigkeit -- 
  Liebe deinen Eltern -- Klärch -- -- -- Cl -- -- gut Tante -- -- 
  -- 
  wissen -- -- Mathilde -- 
  -- wissen -- -- -- 
  Sollst vernünftig -- sollst brav -- Tant sehen -- | sehen -- 
  Notwendigkeit -- 
  Jda -- O Tante -- -- sprechen -- 
  Sollst -- sollen -- 
  -- 
  Mensch verschieden Name bezeichnen -- nennen -- Vernunft -- Gewissen -- moralisch Gefühl -- Gesetz Mensch -- meinen Stimme -- Gute hinziehen -- Schlecht zurückhält -- widersteh -- -- 
  -- Notwendigkeit unterliegen -- 
  -- -- unbekannt Stimme gehorch -- tief wohnen herrschen -- Welt herüber sprechen -- heilig vorkommen -- heilig -- Treuer folgen -- -- Gott Stimme erkennen -- 
  -- Kind höchst vergnügt Stunde -- 
  mitteilen -- 
  leben -- teuer Emma -- 
  zwanzigst Brief -- 
  Nachricht Deines Gemahl tumultuarisch Freude versetzen -- 
  Jda Glück fassen -- Schwesterche bekommen -- 
  Hundertmal Tag fangen -- neu bestätigen -- -- 
  bös Mann -- freu -- Mädchen -- Name Wille durchsetzen -- 
  Knabe Mädchen -- hättest Hermann Virginia bestehen -- 
  Mädchen Russin -- Kathinka nennen -- 
  -- zufrieden -- 
  Kathinka klingen hübsch -- 
  Virginia Schützling -- 
  freuen -- Gertrud -- 
  wolltest Beistand verwickelt Verhältnis zurecht -- 
  Gattin sorgsam Mutter zwei -- Welt leben -- repräsentieren -- schwer vereinen -- 
  Gertrud -- 
  pädagogisch Praxis Grundsatz -- sagen -- schön Instinkt kommen -- 
  wahr Demut -- heller sicherer Einsicht unterwerfen -- edeln -- sklavisch Ergebung Wille -- gut erkennen -- sagen -- wert halten -- 
  völlig ruhig sicher -- Deines Mann Aufforderung gesellschaftlich Leben folgen -- Zeit still Familienlebe gestatten -- 
  Herz dennoch Deutschland dein hiesig Kind sehnen -- lassen Mutterherz empfinden -- 
  -- abtreten Mußtest -- Zahl ersetzen -- 
  nächster Gelegenheit -- schick schön Virginia -- gesenkt Blick -- lang Wimper -- 
  hängen Freundin Kinderstübche -- 
  heilig Kathinka Mann sorgen -- -- 
  Kind müssen billig Vorbild Auge -- 
  schreiben -- mußt getreu Bild -- Feder -- vorstellen können -- 
  -- Brief fortlebst -- -- 
  Jda fast Gedanke -- Virginia Kathinka -- 
  Kleidche stricken -- 
  fürcht -- ermüden Arbeit -- lassen Bitte -- bestehen -- gewiß vollenden -- 
  lassen geschehen -- 
  Mathild Kleidchen Blume Kathinka sticken -- 
  Kathinka klingen prächtig -- 
  Liebling erwählen -- 
  Klärch Virginia arbeiten -- 
  halb närrisch Freude -- Virginia Clara -- 
  Jda -- Kathinka herrlich Schwester -- Virginia schön -- süß Schwester -- 
  Geschwätz Kind Vergnügen -- 
  sehen -- jeder besonderer Bild -- 
  nötig -- Kind schreibst -- 
  Unterscheidend -- machen -- 
  -- Imagination -- Bild Kind Originale abwichen -- 
  peinlich -- wissen -- Kind aussehen -- 
  deiner Mann Pinsel tief humoristisch Farbe tauchen -- aufnehmen -- kommen Jda Charakteristik -- 
  Klang Namen liegen -- Kathinka stark -- lebhaft -- Virginia sanftern -- zart Schwester denken -- 
  Kind lassen bedeutend Erfahrung -- 
  -- Fall -- Umstand -- Verschiedenheit Individualität bestimmen zeigen -- 
  Geschlecht -- Mutter gleich einerlei mütterlich Gesundheitszustand gebären -- Moment völlig gleich Grundsatz behandeln -- etwaig Verschiedenheit -- erscheinen -- Rechnung Äußeren -- rein personell individuell Unterschied -- 
  beobachten -- wichtig -- 
  4 Woche spätestens Nachricht -- Kunde schnell entwachsen -- 
  -- Erzieherinnen Schulmeisterei Bedürfnis -- 
  Glaubst -- ordentlich gräm -- Kathinka's Virginia Erziehung mitwirken -- 
  welch stehen bevor -- deinen jünger Kind Deutschland zurückkehrst -- -- 
  dein D -- wiederzusehen -- Freude -- obgleich reizen -- 
  wissen Bösewicht -- Hold -- 
  Gott -- welch Leben -- -- vereinen -- trennen -- 
  meister frohlocken Vater Sohne -- 
  schön Milde Charakter Feuer -- Kraft vereinen -- Vater entzücken -- 
  Woldemar lernen fleißig -- 
  Frühling Herr Platov bedeutend Fußreise -- 
  wahrscheinlich Schweiz -- 
  zurückkommen -- ziehen auf Land -- 
  Landhäuschen Neuenburg hübsch -- 
  Pfarrer Willich bringen neulich Zeichnung -- 
  Pfarrer -- Deborah allzuglücklich -- Pflanzort bewohnen -- täglich -- 
  -- 
  sehen Gewitter fern herziehen -- Blitz Glück Leben zertrümmern -- 
  Deborah leben -- 
  -- sicher ahnen -- -- 
  Deborah verbergen Schwäche stet Anstrengung -- 
  Täuscht Ahnung -- 
  hoffen -- nächster Sommer ruhig Beisammensein vergönnen -- 
  übel pflegen schnell Mensch enden -- 
  Leb -- 
  Dreissigster Brief -- 
  Tanzmeister -- 
  wöchentlich zweimal -- 
  kein Kind hart Verbiegung Körper -- zurecht bringen müssen -- Anfang -- 
  Stunde scheinen Kind leiben -- 
  Mann scheinen völlig unschädlich Mensch -- 
  verstehen -- lassen bedeuten -- -- 
  Mr. Breton -- fürchten Mädchen -- meinen -- müssen -- Klärch -- 
  -- 
  weisen Sanft zurecht -- 
  gewöhnlich Fade französisch Tanzmeister -- 
  -- ehe Stunde angingen -- -- bitten -- keins Kind auszeichnen -- Kein Unkost loben -- aufstellen -- Loben taugen -- nehmen finden -- 
  sein ohnedies wohnen -- vorzügliche bemerken -- 
  einleucht -- gewohnt Begriff Effet etonnants d'une nobel Emulation -- 
  begreiflich -- edle Wetteifer -- eigen innerer Quell entspringen müssen -- Kind voll Kraft Feuer geben können dürfen -- eifersüchtig eingepredigt Strebe -- -- zuvor -- verschieden -- 
  letzterer Hochmut -- Eigensucht -- Neid -- nahe verwandt -- erster schön Ehrtrieb stammen -- Mensch innerlich spornen -- Kraft versuchen -- sehen -- vermögen -- 
  Begriff -- versprechen -- Loben Spornen Wetteifer enthalten -- 
  tun -- 
  Klärch sauersen -- Fuß -- arm Rücken Gesetz Grazie fügen -- 
  Clar stark Knochenbau -- -- 
  unermüdlich Versuch -- 
  Jda Woldemar brauchen Zurechtweisung -- 
  Mathilde entschieden Taktgefühl -- schlimm -- obgleich steif Haltung -- Wunsch -- 
  meistens freuen -- Stunde schlagen Mr. Breton hören -- 
  gestern schlimm ablaufen -- 
  Tisch treten Mensch Hof Zug abgerichtet Hund -- lassen fragen -- Künste zeigen sollen -- 
  Ekelhaft -- 
  Kind Sache neu -- vorstellen -- bat -- Kunst lassen -- 
  hund Herr Dame kleiden -- Dame verschleieren -- 
  Tänzer Tänzerinn sitzen Chais -- Hund Bedienter hinten -- 
  Pferd vorgespannen -- 
  Kind stark frappieren -- 
  Künstler lassen Tänzer aussteigen -- spielen -- Tanz beginnen -- 
  Mathilde tot lachen -- versuchen -- hunden kümmerlich Gestalt Gebärden -- 
  Hund müde -- Tanz austanzen -- 
  Mensch wild -- prügelen unbarmherzig -- 
  Jda geraten Weine -- 
  Woldemar Mensch -- garstig Mensch -- besseres lernen -- Tier quälen -- 
  Klärch weggelaufen -- 
  schicken Mensch -- heißen -- Woldemar Händel zuziehen -- 
  Tische Kind vergnügen gewöhnlich -- Jda Mathilde erscheinen erstenmal grell Kontrast -- Platov Tisch fühlen stimmen -- Kind Sache reden -- 
  4 schlagen Breton -- Jda verschwinden -- 
  Anfang Reihe treten -- Kompliment -- 
  Jda fehlen -- 
  -- ou | est donc Mlle -- 
  Ida -- stellen Malade -- -- fragen Breton -- 
  -- Non -- Monsieur -- ell Se poren bien -- ell va Dabord Paroeitre -- 
  hinaus -- suchen -- suchen -- Bett verstecken -- finden -- -- 
  ernst -- -- 
  -- Jda -- fragen kalt -- 
  O lieb Tante -- Tanze lernen -- Hund tanzen sehen -- 
  -- 
  freilich garstig -- Mensch sehen schön -- tanzen -- 
  lieb Tante -- Mathilde schön -- hunden nachtanzen -- 
  unschön sehen -- 
  sehen -- lieb Mathilde -- 
  -- -- kommen herunter -- tanz -- Klärch Woldemar tanzen -- -- 
  -- Jda -- O Tante -- laß tanzen -- -- 
  garstig Hund sehen -- bitte -- bitte -- Laß tanzen lernen -- 
  Liebe allzutiefe Eindruck Abscheus -- Kind -- -- 
  -- Jda -- sollst tanzen -- bittest -- 
  Gehen Wohnzimmer -- übe unterdessen Klavier -- 
  Tanzsaal -- 
  -- -- Ida ne viendra pas -- Mr. Bretton -- -- 
  -- erzählt Vorfall -- Jda wirken -- 
  -- Mais -- Madame -- Ken est trop -- c'est Caprice -- 
  il falloit Pourtantvenir -- -- 
  -- -- eher Stunde -- Eindruck auslöschen -- wünsch tanzen -- 
  freilich Quadrill denken -- Abwechslung vornehmen -- 
  -- weg Quadrille Tanz -- Kind Abscheu -- 
  weniger unumgänglich nötig Kunstfertigkeit Geschicklichkeiten Kind strenge anhalten -- 
  Musik Tanz Kind erlassen -- Widerwille -- 
  führen Beispiel -- Künstler anfänglich Zwang härt Musik anhalten -- stark Kunst -- 
  Beispiel erleben -- ähnlich Vorkäme -- beweisen -- Zwang bleiben -- Kunst -- 
  Künstler -- Bildner abgewarten -- lebendig Trieb erwachen herausgebrochen -- beantworten -- 
  froh -- Kind früh reg Trieb Musik -- 
  entbehren -- -- 
  Jda Tanz -- Lust wiederkommen -- 
  will_es Weile erwarten -- 
  Besorgnis entstehen -- Jda Nachgeben eigensinnig -- 
  -- fürchten -- 
  weißen -- intoleranen Eigensinn Kind -- 
  Sorge -- lieb Emma -- 
  freilich wachsam Auge Nichtwollen -- Neigung Abneigung -- sorgen -- Phantasie wichtig Rolle spielen -- 
  Beharrt widerwillen Tanze -- Kind französisch Schauspiel bringen -- Ballett geben -- 
  helfen -- 
  Schauspiel -- sehen -- erzählen -- 
  erwarten -- Kind anziehen müssen -- ergehen -- 
  Engel's dankbar Sohn geben -- 
  Kind verlieren Anblick Stück -- 
  Sergeant bramarbasieren -- -- Woldemar krampfhaft arme zucken -- 
  -- 
  Tante -- raunen Ohr -- Kerl Kragen fassen -- prügeln -- arm Leute ängstigen -- 
  -- auszuhaln -- -- 
  Jda still -- scheinen fürchten -- 
  -- Klärch andächtig -- Kirche -- 
  Brief Sohnes rühren tief -- 
  Jda Wirkung -- Unterschied Stände Begriff -- scheinen unmäßig Freude alte fassen -- Sohn Königs Tafel speisen -- König Vater Gesundheit trinken -- 
  meinen -- Besonderer -- 
  Mathilde verstehen -- fühlt Komisch bäuerisch Freude alte -- 
  Sohn auftreten -- weinen Mädchen sanft Rührung -- 
  Woldemar seufzen still Lust -- 
  alt Mutter vornehmen Sohn -- Schwester Bruder Kapitän fürchten -- -- beklommen Klärch -- Mathilde fühlen schmerzlich Szene -- 
  Jda Ohr -- Tante -- begreifen -- fürchten -- 
  Woldemar Prinz -- Hofrat -- General -- fürchten -- Bruder -- 
  äußern Kind willkürlich unwillkürlich Eindruck -- -- 
  kommen höchst zufried Haus -- Privatunterhaltung hindurch einzig Schauspiel -- 
  roh gesund Natur überall wirken -- wirken -- 
  -- Schauspiel -- Gegenstand Darstellung Sphäre frisch lebendig herausnehmen -- verschönen darstellen -- 
  hoch Kunst -- Stoff ankommen -- hoch Bildung -- 
  Wert fühlen -- 
  Schiller's Wilhelm Tell unglaublich größeres Publikum finden -- begreifen -- Jungfrau Orléan -- 
  Tell' Charakter begreifen jeder gesund Menschenherz -- Erscheinung Jungfrau -- Kunstprodukt -- nirgends Wirklichkeit existieren -- Künstler poetisch Gemüt begreifen -- 
  -- Dichter für Volk sorgen -- tun -- Kind kindlich Mensch -- 
  -- entbehren -- 
  Kind sehen lassen -- Edelknabe -- 
  Kind Hang Art Vergnügung unglaublich -- 
  Punkt befriedigen -- 
  Leb -- Emma -- 
  dreissigst Brief -- 
  Kind Geographie lernen -- Bericht schuldig bleiben -- 
  Woldemar Stunde -- Mädchen -- 
  Jda Mathilde hierher reisen -- aufmerksam -- deutsch Meile zubrachten -- 
  wiederholen unser Lustreise -- Rückreise N -- 
  wissen Länge deutsch Meile vorstellen -- 
  spazieren fahren -- lassen Grenze unser Stadtgebiet bemerken -- 
  zeigen Charte Deutschland -- spezialchart Provinz -- 
  Charte Europa -- Umfang unser Erdboden -- wissen -- Meil -- Ausdehnung Land 20 Meile Länge 13 Meile Breite denken -- 
  Provinz Breite durchreist -- schwer -- Chart sehen -- gleichfalls versinnlichen -- 
  merken -- Studium besonderer Vergnügen -- 
  fing -- Provinz Deutschland Hauptstadt aufsuchen lassen -- Lage Flüsse merken -- 
  nehmen Gaspari's Atlas -- Stadt Name bloß Zeichen angeben -- Erinnerung Name Hauptort nennen -- 
  Zeitlang üben -- Atlas -- Charte Charte -- nachzeichn -- gezeichnet Name eintragen -- 
  Weise schreiben Sache unauslöschlich Gedächtnis -- 
  ursprung Lauf Hauptfluss -- 
  länderkund Skizze Geschichte jeder Land verbinden -- 
  merkwürdig Tatsache alt Geschichte erzählen gleichfalls -- Wunsch äußeren -- 
  -- Vorbereitung eigentlich Studium Geschichte bleiben -- 
  Schlimm -- brauchbar Buch hierzu schreiben müssen -- 
  Weltgeschichte jung Mädchen fehlen gänzlich -- 
  Lektüre Kind fast -- 
  Mangelsdorf's Exempelbuch alt neu dienen -- Ton rüde roh -- Mangelsdorf annehmen -- 
  besseres Art -- Zeit passen -- 
  Erziehe gleich nötig Hilfsbücher schreiben -- ausführbar -- täte Not -- Geschichte -- 
  Weltgeschichte Kind Knittelversen existieren freilich -- -- Kind heiter Lebensmorg Knittelwelt glauben -- 
  Lebensabend -- hören schön Unwille sagen -- Stimme Herzen -- 
  Früh Mensch bedauern -- verachten -- -- nimmer -- 
  burlesk Geschichte menschlich Gebrechen -- 
  Kind schön erkennen lernen -- 
  Schattenseite Weltgemälde kehren nämlich Jugend für -- 
  -- stark -- sehen -- wohlan -- elegisch Ernste zeigen -- Sache gebühren -- 
  trauernd Ernst allmählich flammend Enthusiasmus heilig Jugendsinn kühlen -- 
  lächelnd Spott -- geißelnd Satyrs -- -- höhnend Persiflage niemals -- deutsch Boden bleiben ewig fern -- 
  weiblich Gemüt Satyr einkehren -- fein -- 
  fromm weiblich Seele schlagen Stunde -- Unschuldsparadie Kindheit schließen -- Mensch anderer Gestalt erscheinen -- glücklich Lebensmorg erblickten -- 
  traueren schön Seele -- richten -- heben hoch -- blicken Gestade ferner Welt -- lernen Leben Finsternisse still ertragen -- 
  erwachen Unschuldstraum schrecklich plötzlich kommen -- unsrig Drama Leben -- stark -- Akt sehen -- 
  O Geschichtsbuch schrieben -- denken -- -- 
  Mangelsdorf's Haus bedürfen Exempelbuch dienen -- Bedürfnis bleiben -- 
  einstweilen Berg Buch Seite -- nehmen -- jedesmal bedürfen -- 
  fähig weiblich Kopf freundlich lassen -- Auszug Geschichte liefern -- zwölf -- sechzehnjährig Mädchen brauchen -- 
  Studium Erdbeschreibung sorgen -- 
  kürzlich brauchbar Charten Europa erscheinen -- Erlernung alt Geographie -- 
  späterhin eigentlich Geschichte trefflich Dienst -- 
  Kind Winter vorlesen lassen -- 
  O -- 
  gering Freude Reisebeschreibung -- 
  lassen lesen -- 
  Land -- -- 
  jeder Kind bearbeiten Gärtche -- 
  Kind häuslich Verrichtung helfen -- Deborah's Aufsicht eigentlich Haushaltung lernen -- 
  sehnen Jda hinaus -- 
  letzter Brief fragtest unser alt Paul -- 
  kommen -- 
  Jda Wochengeld Samstag hingeschicken -- 
  letzter Samstag bringen Magd -- -- 
  verreisen -- 
  -- tot müssen -- 
  dennoch leiben -- laut -- 
  -- Jda tote sehen -- wenigster alt Paul -- leiben -- -- Anblick tief schmutzig Armut Tod unästhetisch -- ohnedies -- 
  Toter -- sehen -- 
  wissen Mädchen verschleiert Wahrheit -- 
  arm Mensch begraben -- Jda wissen -- hingereisen -- 
  Reise -- bevorstehen -- reden -- 
  abwarten -- Erscheinung sichtbar Welt ibre unendlich Umwandelung hoch Standpunkt überschauet -- Unsichtbar Unendlichen tief selber gewiß -- 
  einfach Erzählung -- Mensch sterben -- unbrauchbar geworden Körper begraben -- -- 
  freilich forschen Frage -- gewohnt -- Antwort Frage hinaus setzen sehen -- 
  sagen -- groß Menschenbildner roh junge -- können tragen -- 
  Wort Erzieher heilig -- 
  Wort Moment sprechen -- 
  Wort Unsterblichkeit -- -- 
  Leb -- lieb Emma -- 
  dreissigst Brief -- 
  erstenmal Kind neulich Konzert -- 
  Erwartung äußerst gespannt -- 
  dennoch Glanz Licht Putze herrlich geschmückt brillant Welt überraschen -- hineintraen -- 
  behalten nah Seite -- Eindruck wahrnehmen -- Sache -- 
  mehrere Dame Stadt -- Erziehungsmethode seltsam vorkommen -- halten stark -- äußerst begierig -- Kind Nähe sehen -- elegant Welt fern halten -- 
  freilich Welt Winter entziehen -- wöchentlich Gesellschaft Haus -- 
  Gertrud -- lassen Kind Auge arbeiten -- 
  -- überlaß Kind -- geben bestimmt Aufgabe -- 
  besuch Zirkel Haus -- lassen Kind Haus -- 
  Herr Platov Mentor -- 
  Welt Scheines zurückhalten -- ferner -- fest Boden fühlen -- 
  glänzend Welt nehmen -- Sprößling früh Kunst -- geben -- belehren -- 
  früh -- Konzert kommen -- 
  neugierig umringt Dame Bekanntschaft -- -- Ferne flüstern hören -- Wunderkinder sehen -- 
  Mathildes dreist frei Anstand ziehen Blick -- 
  redete Französisch -- fassen schnell Antwort -- 
  Gefühl Geistesgegenwart -- beherzter antworten verständig -- 
  -- Dame sehen -- vermutlich Kind scheu Blödigkeit erwarten -- freilich Erfolg eingezogen Kindheit -- kindlich Geist Weise Freiheit bewahren -- öfteren Anblick Welt -- 
  Reihe Klärch -- rotbackig Pfarrerstochter -- nennen hören -- 
  Gesicht strahlt Gesundheit Freude -- 
  erstenmal Konzert -- fragen -- 
  -- 
  --- fällen -- -- 
  wissen -- Antwort -- gehören -- 
  --- gefall geputzt Leute -- -- 
  O sehen -- lauter Licht sehen -- 
  -- Dame lachen laut -- 
  Kleinste -- Jda wendeten -- 
  böcs Tante Nichtchen eher Konzert bringen -- 
  Jda Maß Dame -- böse aussprechen -- Auge unten -- 
  treten -- gut Tante -- Dame -- verstehen -- -- 
  Dame wissen -- leiben -- -- 
  Wort Kinde machen betreffen -- 
  böse meinen -- -- 
  treten Frau Z -- herzu -- Jda bedauern -- Wein Leckereien bekommen -- häufig sticheln -- seltsam Art Kind mitten Stadt einsiedlern erziehen -- beobachtet Jda scharf -- 
  Jda bemerken -- schlagen lieb Auge verschämt nieder -- fragen leise -- sehen Dame bös -- 
  halb laut -- 
  Dame böse -- sehen -- verständig Kind -- 
  schön -- schön Kind -- hören ziemlich laut flüstern -- 
  treten lieb R. herzu -- Erziehungsmethode Händedruck einst Schutz -- 
  bitten leise -- setzen -- Kind Mitte -- 
  Klärch -- Mathild -- Jda Frau R. 
  lassen Kind Gespräch -- 
  Jda Erwartung zutraulich -- 
  Frau hold Freundlichkeit -- Kind inne -- Herz fassen -- 
  fragt Jda Teilnahme gewohnt Lebensweise -- Kind malt lieblich Farbe -- hoch Interesse horchen müssen -- Kind Innerstes aussprechen hören -- 
  Dame -- dicht -- -- vorhin Kind sprechen -- herausbringen -- aufmerksam -- 
  Jda bemerken -- Dame -- sprechen -- 
  groß Feuer rühmen unser Sommeraufenthalt N. -- lieben prächtig Pfarrersleut -- 
  Clärchen Wang brannten -- 
  sprechen Jda Bruder Woldemar herrlichen Freund -- 
  Frau V. R. entzücken Kind -- 
  Musik -- 
  Ouvertüre Don Juan -- womit Konzert anfehen -- 
  Kind hingerissen Gewalt Mozartischen Genius -- 
  folgen Violinkonzert -- vortrefflich -- Kind voll Wirkung -- 
  Bravourarie brav Sängerin singen -- inner Ohr vorbei -- 
  folgen lieblich Duo -- freut Kind innig -- 
  Platov singen -- 
  -- Akkompagnement -- -- 
  Clärchen Lippe bebt Bereitschaft -- singen -- 
  zuletzt blind Künstlerin Orchester hingeführen -- Harmonika stehen -- 
  versäumen -- Kind vorbereiten -- 
  wirken stark -- 
  Mathild ergreifen -- zitteren -- 
  Klärch schluchzen laut -- erinnern müssen -- stören -- 
  Jda zerfließen still Trauer -- 
  bitten Frau v. R. -- setzen -- unbemerken Kind hinausschlüpfen -- 
  decken unser Rückzug -- -- 
  Unrecht -- Kind Instrument unvorbereitet hören lassen -- 
  --- schön Märzabend -- Vollmond -- 
  spazieren Weilch Esplanade Läng Flusse -- kommen heit Sanft bewegen Haus -- 
  -- Haus müssen Kind Beschreibung Harmonica geben -- 
  wissen -- Instrument machen -- 
  Jda fragen -- himmlisch Instrument ausgedachen -- 
  nennen Erfinder -- führen schön Büste ehrwürdig alte -- kurz besitzen -- 
  folgend versprechen Kind Lebensgeschichte merkwürdig Mann -- 
  spät Abend bekannt Lebensgeschichte Franklin's Auszug -- dienlich -- 
  Bearbeitung -- Freude -- Gedanke -- merkwürdig Mensch Art Biographie entwerfen -- Schreibübung diktieren -- 
  setzen freilich Arbeit -- Kind Freude -- üben -- Hauptbenefiz -- -- unvermerkt schreiben -- 
  Freude Musik Konzerk merklich Erhöhet -- 
  Klavierstunde erwarten -- 
  üben brauchen anzufeuern -- 
  Winter letzter Konzert -- 
  Woche ziehen auf Land -- Musik ernstlich fortsetzen -- Kunst -- 
  Ruhe Landleben gedeihlich -- 
  Leb -- gut Emma -- 
  dreissigst Brief -- 
  Übungsstunde sprechen -- 
  Kind poetisch Stunde -- wöchentlich -- mehrmals halten -- stimmen fühlen -- 
  Stunde beginnen -- jeder Kind selbstgewählter auswendig gelernt Lied Fabel hersagen -- zuvor -- verstehen -- erklären -- 
  les sprech -- helfen Mangel Deklamation -- der heißen geben richtig -- Kind verfehlen -- deklami äußerer Mäßigung Affekts -- Ausdruck einstudieren -- Wahrheit Eindruck hinaus -- Gedicht -- 
  Getadelt Kein -- -- Klärch -- fehlerhaft deklamiert -- fast Rhythmus Reim hören lassen -- 
  Getadelt weder schwach stark Ausdruck -- Vorlese korrigieren -- bleiben froh Laune Stunde -- 
  Klärch -- allzufest Reim halten -- gewöhnlich roh Ohr wohltut -- -- bekommen fast reimlos Gedicht Aufgabe -- 
  hersagen -- jeder -- Stück fällen -- 
  zuletzt sagen Urteil -- nämlich Geist Sprache abfassen lassen -- 
  les groß Gedicht -- -- 
  vorletzter Stunde Hector's Abschied Voß -- ens Übersetzung Ilia -- 
  O hingegeben -- 
  Stelle Odyssee Ilias -- kindlich Geist fassen -- stark exaltieren -- 
  andermal nehmen Gesner'sch Jdillchen -- -- 
  gewohnt Gebrauch finden eigentlich klassisch Dichter Kindheit angemessen -- unser Kinderpoesium -- 
  Messiade Szene -- rein kindlich Kind fassen Herz Sinn aufnehmen -- 
  O Kind Stunde lieben -- 
  heilig -- geben -- zuvor allzufremdartig Ding befangen -- 
  letzter Stunde Jda -- Kennst Land -- lernen -- 
  kennst Hang süßen Schwärmerei Kind -- 
  Lied schwermütig Geist stark bemächtigen -- 
  wählen -- Notenbücher Zelter's Komposition sehen -- erklärend Wort gehören -- drücken schön höchst rührend -- 
  sprechen Sehn unbekannt Land -- Verheißung Busen tragen -- Sehnsucht Mignon's Italien wunderbar hinreißend -- 
  fließen beide -- 
  locken Dichter Herz behaglichen -- bequem Frieden Alltagswelt heraus Zauberland -- dämmernd Frühe Leben tief Ferne anstrahlen -- 
  -- Erzähle -- lieb Tante -- arm Mignon -- schön Land hinwolln -- -- 
  erzählen -- Kind -- klein -- Schloß Eltern spielen -- verlaufen -- Räuber entführen -- fremd kälter -- rauher Land bringen -- Härte allerlei peinlich -- unnatürlich Anstrengung Glied zwingen -- 
  Räuber umhergeschleppen -- Herumzieh schön Mutterland vergessen -- Herz behalten -- Herz sehnsüchtig hingewenden -- böse Mensch entfernen -- 
  erzählen -- Kraft Mut gewinnen -- Mißhandlung Tyrann entziehen -- freundlich sanft Manne anvertrauen -- böse Herr befreien -- nehmen -- hübsch kleiden väterlich versorgen -- heiß -- innig lieben -- willig horchen -- dennoch Sehnsucht schön warm Mutterland hingezog -- herrlich Lied eingegeben -- 
  väterlich Freund trefflich Freundin bringen -- Natalia heißen -- Geist -- Herz Leibe schön zart Liebe pflegen -- dennoch Sehnsucht vergehen -- unbekannt Land wohnen -- herrlich -- Italien -- 
  O Kind horchten -- 
  arm Mignon lieben -- 
  Frage tun -- 
  fragen fast -- wissen Geschichte -- 
  Jda Klärch unerschöpflich Frage schön Land -- 
  meister beschäftigter dunkel Wolkenstege Berg -- führen -- 
  müssen Schweiz Tirol Alpen erzählen -- 
  bekennen -- geographisch Belehrung -- -- lassen andermal nachholen -- -- lassen Kind Phantasie walten -- malen herrlich Schweizerland lebendigsen Farbe -- beschreiben Gotthard Jungfrau -- Schreckhorn -- Furka Wetterhorn -- 
  -- 
  besprech Untereinander -- anfangen möchten -- bereden -- Reise Schweiz -- -- Italien -- 
  weißen ungefähr -- Freundin poetisch Sinn unser Kind entfalten suchen -- 
  freuen Stunde -- fast erwarten -- 
  Heiterer lebendig -- 
  Störung Stunde -- angenehmsen -- ungelegen -- 
  Fürcht -- Hang süßen poetisch Schwermut überwiegend -- 
  Prosa Leben behaupten -- 
  nächster Stunde Mathilde Perlenkranz Pfeffel Aufgabe -- 
  Klärch Hölty Elegie Landmädchen wählen -- Jda -- Bürger's Blümchen Wunderhold -- 
  Erklärt gewählt aufgegeben Stück unverstanden -- 
  mehrere dunkel Stelle Nachsinn dunkel überlassen -- 
  weiß Buch -- 
  Preis unbekannt Gedicht -- Stelle groß einschreiben -- Gelernt hersagen -- 
  bekommen Sammlung -- gedrucken -- geben -- 
  schön Jahrszeit Stunde Freie halten -- Spaziergang -- angeschlagen Sait sanft schön verklingen -- 
  Stunde botanisch -- naturhistorischen -- 
  moralisch ästhetisch Gehalt gelesen Gedicht unterwegs sprechen -- 
  erzählen -- umherschweifen -- schön Platz ausruhen -- einzeln Zug Geschichte -- lassen erzählen -- 
  fast stolz Freude sehen -- Geist -- Sinn Körper Mädchen herrlich entfalten -- 
  Krank -- 
  verschied Kind -- Innigkeit Liebe -- Kindheit zurücksehnen -- Kinderlebe teilen Wechsellieb leben -- 
  schön Verhältnis -- Klärch Jda Mathilde stehen -- 
  roh kerngesund Natur einigen schön gebildet Natur Jda teils verwildert -- teils verbogen Mathilde stehen Mittlerin -- 
  Kind verlieren -- Klärch verließen -- 
  Vater Mutter wünschen -- Ältest Zeitlang Klärch Aufnehme -- 
  fast -- 
  wäre_es Schade Klärch -- 
  stehen schön Blüte -- 
  Deborah schwach -- bedürft Beistand Haus -- Pfarrerskinder -- 
  Betty bildungsfähig Kind -- 
  -- 
  Betty für Mutter -- 
  Klärch Ausbildung unterbrechen -- 
  fast unzertrennlich verflochten -- 
  dreissigst Brief -- 
  danken -- gelieben Emma -- 
  liegen -- lieblich Bild Virginia Kathinka -- 
  O sagen -- Maler -- Engelsunschuld Kindheit auffassen -- personifizieren hinzaubern -- 
  Albano heißen -- 
  Kind Monat alt -- Bedeutung Zügen -- 
  verschied Ähnlichkeit -- 
  Bild ausgepacken -- Freude kommen -- hing Sofa -- lassen Kind -- 
  Freude unglaublich -- 
  Jda erkennen Virginia -- 
  -- O süß freundlich Virginia -- 
  händchen ausstrecken Kathinka -- -- -- 
  Mathilde -- schön Kathinka lachen -- 
  Auge -- prächtig Haar -- -- -- 
  Klärch -- Virginia schön Löckchen runder Händchen -- -- 
  Jda -- 
  sieh süß Mund -- 
  -- Kathinka küssen -- -- -- 
  schwärmt Kind Bild -- -- 
  Woldemar -- -- 
  -- O allerliebsten himmlisch Kind -- 
  O Tante -- Tant -- Schwester -- -- 
  -- Wunsch schön zuvorgeeilen -- lieb Emma -- 
  fast sagen -- dürftest Schicksal zürnen -- alt Kind trennen -- scheinen -- 
  schön Ersatz geben -- 
  Erziehungsbericht austauschen -- 
  interessieren -- Verschiedenheit Kind bemerken -- 
  O sagen -- unterscheidend Kind -- innerer äußerer Entwicklung wahrnimmst -- 
  Jda glücklich -- schwesterchen kennen -- sehen -- 
  fast notwendig -- 
  Platov Woldemar verlassen -- 
  Reise -- Sommer hingehen -- 
  finden Plan -- Platov entwerfen -- sagen -- schmerzlich Trennung -- 
  gemächlich Tagereise Deutschland Richtung durchziehen -- merkwürdigst Ort verweilen -- Woldemar nötig -- oberflächlich Kenntnis erwerben -- 
  Art -- Geographie studieren -- vollständig -- instruktiv -- 
  Sprache Mensch dreizehn Monat Platov' Leitung tun -- 
  Studium unterwegs jedesmalig Aufenthalt merkwürdig Ort Woldemar fortsetzen -- 
  Übung Musik hintangesetzen -- 
  -- lassen nächster Winter nachholen -- 
  unterwegs Virtuose hören -- -- 
  bedeutend Ort schreiben -- 
  Brief gesandt -- Mittelpunkte wohnen -- Send -- 
  brauchen Beobachtungsgeist Zwang anzutun Wiederholung -- 
  freu Journal herzlich -- 
  verstehen -- Werkstätte Künstler Handwerker häufig besuchen -- 
  Plan umfassend -- vermutlich mehrere Sommer ausfüllen -- 
  Woldemar Deutschland bedeutend Beziehung kennen lernen -- Sommer fertig -- 
  Land Reihe -- 
  -- lassen Mann Sorge -- 
  -- Vater Mentor scheinen völlig einverstand Punkt -- 
  finden -- Paar ordentlich Winterquartier ziehen -- 
  Geschwister fremd -- wovon Gedanke schmerzlich -- Monat Freude Umgang -- 
  Reisekoffer -- Wanderern Post nachfolgen -- Mädchen fleißig arbeiten -- 
  gestricken nähen -- 
  schön Geldbörse reisend auf versorgen -- 
  Monat lassen Kind morgens Stunde wecken -- fertig schaffen -- 
  Wetteifer erstaunlich -- 
  gestern -- fertig -- bat Erlaubnis -- Arbeit unten Koffer packen -- jeder praktiziert Privat- Andenken listig hinein -- schlimm Konterbande -- 
  Jda Löckchen Haar abschneiden -- Woldemar fast spielen -- sauber Papierchen wickeln schreiben -- Woldemar's Locke -- 
  Klärch echt kindlich Landwitz Vergißmeinnicht zeichnen -- drunter schreiben -- Klärch -- 
  Mathilde hoch Stil Tempel Freundschaft Symbol Ansprüche Andenken wählen -- 
  Sache unterwegs finden -- 
  Idee glücklich -- 
  wispern untereinander -- 
  -- hübsch Portefeuille Platov sticken -- unermüden -- fertig -- 
  Familienlebe verlieren -- 
  eilen -- auf Land -- lieben Mädchen Einfluß männlich Geist ihrigen entbehren -- 
  überzeugen -- weiblich Herz weiblich Herz -- Geist verwandt Geist bilden Weib Tiefe weiblich richten müssen -- 
  gewiß -- Einwirkung männlich Geist Sinne Bildung Vollendung gedeihen können -- 
  Natur Veranstaltung vergessen -- 
  bleiben Mensch -- ordnen -- sicher vollkommener Erziehung erdenkbar -- Eltern Haus -- Schoß Familie -- 
  Schicksal Unfähigkeit Eltern unmöglich -- Fremd Familienerziehung nähern -- weiblich -- 
  Mädchenherz zart Mutterpfleg nimmer gedeihen -- 
  Geist stark -- Mutterlieb -- 
  gefall weiblich Kraft -- Kraft -- 
  Wendet weg -- Milde erscheinen -- zart Innigkeit Liebe -- 
  -- Milde Schwäche -- lieb Krankheit Weibe -- Sonne Geist männlich Kraft -- Herz stählen Verkehr fest rauher Natur -- 
  hierbei erinner Unterredung unser Pfarrer N. 
  Gespräch ungefähr nämlich Inhalt -- beginnen -- 
  nähern Bekanntschaft schwer Erziehung fremd Kind glauben -- Grund fast unmöglich halten -- jung Herz -- Mädchen -- -- warm Familienlieb herausgerissen -- notwendig erkalt gewöhnen müssen -- Liebe leben -- 
  -- -- geben Kind -- Eltern Auge erziehen -- Familie -- wiederfinden -- Eltern geben -- 
  geschehen Knabe Mädchen -- Antwort -- 
  lassen für bestimmt Mädchen-Erziehung bleiben -- Idee ausgehen -- 
  Art -- Erziehung jung Mädchen denken -- gewöhnlich Pension -- Vorsteherin Anstalt verheiraten -- Mutter Familie -- Witwe -- überall unverheiraten -- 
  Erziehung Familie -- Geschäft Erziehung fremd Kind -- -- Freundin -- unbedingt anraen -- 
  Bleibe für Pension -- -- anmerken -- Übel halten -- notwendig gehören -- 
  -- 
  Glaubensbekenntnis Sache -- 
  Pfarrer -- 
  notwendig -- wählend klein Übel halten -- Vorsteherin verheiraten Mutter -- Witwe unverheiraten -- 
  Fall finden Hindernis -- 
  -- 
  wählen -- wählen -- 
  Pfarrer -- 
  -- 
  -- 
  Grund -- Freund -- 
  Pfarrer -- 
  verheiraten Erzieherin glücklich -- jung -- hoffen Häuflein Kind -- erwarten -- Herz -- geliebt Manne bewohnen -- Liebe fast Kind teilen -- Raum fremd Kind -- 
  erwarten -- Mutter fremd Kind aufopfernd hingeben -- -- 
  -- notwendig Rangordnung Liebe entstehen -- wirken fremd Kind Seele -- 
  -- 
  schlimmsen Seite Verhältnis -- schlimm -- 
  Pfarrer -- 
  -- bleiben -- reich weiblich Gemüt Liebe Erbarme -- Klugheit Güte erbarmend Liebe Fremdling Gestalt Mutterlieb kleiden wissen -- Kind Unterschied wahrnehmen -- 
  wissen -- Mann sagen -- Natur verheiratet Weib auflegt -- unfähig physisch Zustand -- unerzogen Kind sorgen -- 
  Tante -- Schwester Freundin Stellvertreterin -- 
  Eltern -- Kind jung Mutter anvertrauen -- Fall Vertrauen Person übertragen -- 
  glücklichst Verhältnis erziehend Familie annehmen -- lassen glücklich setzen -- ehegatter Rausche Leidenschaft erwachen -- gleichgültig -- Eheherr Herr Haus Strenge ausüben -- Erzieherin Hand binden -- -- wofür stehen -- vortrefflich -- 
  Beispiel -- Geist Herzen trefflich Gattin Ehestande äußerlich Reiz verlieren -- sinnlich Mann hinziehen -- 
  Beispiel -- Paar trefflich Mensch Zeitlang total mißverstehen -- -- Selbsttäuschung Zwang Umstand -- eigentlich Wahl Herzens -- kommen -- 
  -- 
  nehmen schlimm Fall -- Freund -- 
  Pfarrer -- 
  gehören seltensten -- 
  vollkommen glücklich Verhältnis Ehe gewiß alltäglich Erscheinung -- 
  müssen häuslich Verhältnis -- Erziehung fremd Kind nachteilig -- nachteilig -- Benefiz Familienlebens aufgewogen dürfen -- 
  -- 
  glücklich Paar Sprößlinge aufziehen -- Freund -- 
  Pfarrer -- 
  Verhältnis schlimm -- -- 
  Mensch traurig Entdeckung -- Wahl Lebensgenosse total irren -- groß Wohltat -- Kind erweisen -- -- Mißverhältnis entfernen -- Zeug Mißstimmung -- Person -- teuer -- unausbleiblich schlimm Wirkung Charakter tun -- 
  dennoch unglücklich Sprößling eigentlich Mesalliance erwarten -- -- Vater Mutter -- lieben -- 
  denken unglücklich Menschenpaar -- fremd Kind erziehen -- -- 
  Weib -- gut leidend -- Mut -- heit Liebe hernehmen -- anvertraut Kind schuldig -- 
  -- 
  -- Erzieherin jung -- Kind ziehen -- fang fremd Familienlebe -- verheiraten -- fremd Kind männlich weiblich Umgebung -- warm Strahl Familienlieb sonnen -- 
  Pfarrer -- 
  welch Ideal weiblich ausdauernd Energie fordern -- Freundin -- 
  nennen lebend Weib kennen -- -- Aufgabe Leben lösen -- Geist Gemütskraft -- schwerer Tagewerk beginnen -- -- enden -- 
  -- 
  freilich Witwe Jungfrau -- Blüte Leben Beruf -- Adoptivkinder leben -- ausschließend hingeben -- 
  Pfarrer -- 
  -- Witwe Jungfrau -- freiwillig -- Schicksal völlig abgefunden -- frei Geist Leidenschaft -- Wunsch Hoffnung Rücksicht erheben -- 
  -- 
  fordern -- Freund -- 
  Pfarrer -- 
  les Inner streng Forderung -- 
  wissen -- zürnen -- Geschlecht erwarten -- 
  -- Erzieherin Herz -- zartesen -- innigst -- glühendst Liebe empfänglich -- Reichtum Herzens Mutterliebe Adoptivkinder -- Mangel Naturtriebe angenommen Kind gewöhnlich Mutterlieb unterscheide -- innig Erbarme Schwachheit weis Besonnenheit immerdar verschmelzen -- Schwäche ausarten mögen -- 
  -- 
  wissen -- Freund -- Gemüt ehrend Ansicht bestochen -- 
  fühlen überwältigen -- entgegen setzen -- 
  -- männlich Hilfe ungern Mädchen erziehen -- 
  Pfarrer -- 
  engherzig Ideal Erzieherin -- 
  anerkennen -- männlich Hilfe -- vornehmlich wissenschaftlich Unterricht -- Geschlecht entbehren -- Manne anvertrauen -- nötig Kenntnis besäße -- geben -- Verstandeskultur Manne ausgehen -- 
  Eins vorbehalten -- Bedingung nehmen lassen -- 
  unmittelbar Einfluß Entwicklung eigentlich Charakter -- Weiblichkeit -- Zartgefühls -- 
  -- 
  Seele sprechen -- 
  eingreifen -- verwundend an Herz greifen -- 
  wissenschaftlich Bildung betreffen -- männlich Unterricht vorziehen -- 
  -- Heller -- klar -- tief Blick männlich Geist -- 
  Sache eigentlich Haus meinen -- Zeugnis -- können trefflich vortragen -- 
  Mann mäßigen Fähigkeit -- Gegenstand auslassen -- völlig Traume reißen -- 
  Pfarrer -- 
  Erkenn weiblich Größe -- 
  -- 
  demütig Gefühl unser Unvermögen -- 
  Pfarrer -- 
  -- Freundin -- 
  Erkenn unterscheiden Gebiet Männlich weib Höchsten -- -- 
  vergebens leicht liebenswürdig Schnellkraft Geist ringen -- 
  vergebens streben Tiefe -- Ideenverkettung -- Zusammenhäng Ordnung denken -- ernst Wissenschaft fordern -- 
  Mann weiblich Geist Ordnung denken -- eigentlich Wis führen -- kindlich Herz weiblich Herz gedeihen -- 
  zart weiblich Sinn Weibe entfalten -- 
  Mädchen -- -- Knabe -- Mann auferzogen -- behielten minder Lebenlang Unweiblich -- 
  -- 
  setzen hinzu -- Weiber -- lauter Weiber aufwuchsen -- z. B. Kloster -- zahlreich Pensionsanstalt -- weiblich Kleinigkeitsgeist beherrschen -- späterhin entrinnen -- 
  elender -- weiblich Kleingeist -- 
  Pfarrer -- 
  unausbleiblich Folge Einseitigkeit Leben -- 
  Mann -- wohltätig Einfluß Geschlecht leben -- jämmerlichst Pedanterie gestraft -- 
  Rache beleidigten Natur -- 
  Übrige Gespräch entfallen -- 
  Stunde teils aussprech Gedanke -- teils Pfarrer Ansicht klar entschieden Punkt -- worüber Rein -- ich_es fühlen -- Mann Umgang gewinnreich -- 
  Seele Götter lieben -- schenken Freund -- Pfarrer -- 
  Lebe -- 
  dreissigst Brief -- 
  lieb Hausgenoss fort -- hoch -- Fortmache -- 
  Haus Einöde -- sprechen liebend -- hausgötterch ausnehmen -- der heißen Lieblingsbilder -- begleiten -- 
  Kind ungeduldig -- Stadt verlassen -- fast anfangen -- 
  --- ziehen dannen -- 
  Winter hart -- Frühling beginnen unbeschreiblich schön -- 
  wahres Arkadienlebe -- 
  Pfarrer Häuschen nett äußerst bequem einrichten -- 
  Eins bange -- Dahinschwinde gut Deborah -- 
  richten Natur -- 
  Klärch halb närrisch Freude -- Eltern bleiben -- förmlich verabreden -- lieb Dreiblatt beisammen behalten -- 
  fast Familie Pfarrersleut ausmachen -- 
  stehen Zeremoniell Abschiednehmens bevor -- woran diesmal Kind nehmen -- wunderlich Geschwätz -- 
  Kind zeigen -- 
  minde Instruktion gebräuchlich Form geben -- 
  -- herumfahren -- unser sämtlicher Bekannten Abschied nehmen -- fragt Jda -- geschehen -- 
  Dame leid -- lieb Tante -- -- 
  nahe -- wissen -- glauben -- 
  -- -- Viertelstund -- verlassen -- Wort Verbeugung Lebewohl sagen -- täglich bemerken -- Mathilde -- 
  -- Tant -- -- Gewohnheit -- fast denken -- 
  -- 
  -- Gewohnheit -- Bewußtsein Absicht Zweckes verlieren -- 
  Mathilde -- 
  tun -- denken -- 
  bloß Anstellen -- wovon -- Unwürdig -- 
  -- 
  Mensch -- Wahrheit -- denken -- Form bloß Höflichkeit abschaffen -- Wort gebrauchen -- denken -- Gedachten bewußt -- 
  Frage -- Stelle setzen -- 
  -- Klärch -- 
  sagen -- 
  -- sagen -- freundlich Wort -- bedeuten -- 
  Irre -- -- lieb Tante -- 
  -- 
  -- Klärch -- 
  -- Wort Höflichkeit abbrauchen -- bedeuten -- sprechen wahrhaft Gemüt -- 
  indessen Volk Nation Sprache Wort gebräuch Höflichkeit -- freundlich begrüßen -- 
  menschlich Herz Bedürfnis liegen -- Wohlwollen ausdrücken -- -- Weile sehen -- sehen -- 
  Begrüßen Abschiednehm -- -- Ursprung -- Mathilde -- 
  -- eigentlich Wohlwollen Mensch -- 
  Mensch -- lieben -- 
  -- 
  eigentlich Liebe -- fühlen unser innere -- Wohlwollen -- 
  Mensch -- verdorbenst -- Mitgeschöpf wert bleiben -- allgemein Wohlwollen Mensch -- Herz verlieren -- früh Form Ausdruck Mensch Gebrauch bringen -- 
  Gefühl nötigen -- trotz unser Unwillen Nichtachten einzeln Mensch -- Formel aussprechen -- 
  Gewohnheit tun gewiß -- -- Mensch zornig -- grüßen -- 
  erinnern Gebrauch Brüdergemeinde -- Quäker -- heißen -- irgendwo Deutschland antreffen -- 
  gewohnter Begrüßungs-Formel abschaffen -- Stelle setzen -- 
  Z. z. gut sagen -- gut -- gut Abend -- bekannte erblicken -- sagen Quäker -- 
  -- 
  Frage Teilnahme dienen gewöhnlich Grußes -- 
  Leute untereinander begegnen -- hört Frage -- bemerken -- fast Antwort achteten -- Klärch -- 
  bedeuten Art grüßen -- 
  -- 
  -- lieb Klärch -- Vorsteher -- worauf antworten -- 
  -- alt Formel Höflichkeit weggeworfen -- abgenutzen -- taugen -- 
  wählen -- Leute denken -- werfen Weg -- brauchen -- -- -- Mathilde -- 
  -- 
  -- 
  Gehalt gruße gewinnen -- 
  müssen fast Monat Formel ändern -- 
  Klärch -- 
  -- höflich aufrichtig können -- 
  aufrichtig gewiß -- höflich -- 
  -- 
  -- lieb Klärch -- 
  sicheres -- 
  Jda -- 
  O gut Tante -- sagen -- 
  kennen -- 
  -- 
  liegen liebevoll Herz -- 
  Herz Wahrheit sündigen -- Form Höflichkeit wünschen -- 
  Augenblick -- gewohnt Wort aussprechen -- Gesinnung Wohlwollen bewußt -- -- hegen Inneren Gefühl -- widerspräche -- 
  gebildeter Ständen nötig -- allgemein Formel aussprechen -- 
  geistvoll Mensch -- herzvoll -- Sprache -- folgen hergebracht Gebrauche -- nötig -- 
  geben -- Kind -- strafen -- Wort aussprechen hören -- Gefühl stimmen scheinen -- 
  -- Kind sehen verwundern -- unmöglich -- -- 
  Abreise Abschiedsbesuch Dame Bekanntschaft -- -- Klärch -- 
  -- Tant -- unfreundlich -- Monat Stadt -- Zeichen geben -- gleichgültig -- 
  Jda -- 
  wünschen -- unterdessen vergnügen froh -- -- 
  -- 
  ist_es -- Kind -- 
  -- zeigen -- -- leiben -- hören -- unterdessen ergehen -- obgleich geliebt Freundin -- Bekanntinne -- 
  Leben laut auserwählt Herzensfreund Freundinne -- 
  meister Mensch -- leben -- bleiben bekannte -- Nachbar u. S. W. Klärch -- 
  lieb Tante -- Bekanntinne Freundinne sprechen -- erklär -- Freundschaft gehören -- eigentlich Unterschied Freund gut bekannte liegen -- 
  bisweilen nachgesonnen -- fertig -- 
  -- 
  hoch Sinn Wort gehören Freundschaft -- 
  Fragtest -- vollkommenst Sinn Wortes Stadt Freundin -- 
  müssen sagen -- 
  Jda -- 
  Tante Frau R. leiben -- Konzert freundlich sprechen -- Gefallen hinaus -- 
  Freundin -- 
  leiben -- 
  -- 
  -- 
  gewiß -- leiben -- 
  Jda -- 
  -- lieb Tante -- nennst Freundin -- 
  Freundschaft -- Mensch herzlich -- 
  -- 
  -- Freundschaft heißen -- Unwahres -- 
  Stufe Grade Freundschaft -- gewöhnlich nennen -- freilich gering Grad -- Klärch -- 
  Freundschaft -- hoch Sinn Wortes -- sagen -- 
  sagen -- 
  -- 
  gehören -- Paar Mensch stark hinziehen fühlen -- -- -- 
  gehören -- Neigung -- Wunsch Urteil -- lieben lieben -- werth- wertschätz -- Übereinstimmung -- fest glauben -- der h. hoch Gewißheit brav -- Edel halten -- stehen -- -- 
  gehören -- Maß Geistesgabe verschieden -- 
  völlig Fähigkeit Neigung -- Freundschaft -- 
  Treffen -- -- Mensch -- persönlich nah -- ahnen Augenblick Geist Gemüts-Verwandtschaft -- schauen innerste Tiefe Seele -- 
  Alsdann suchen wünschen beständig nahe -- schwer entbehren -- lassen nimmer -- verstehen -- 
  Mann -- verteidigen errett Blut Leben -- Not tun -- 
  Hierüber nächster poetisch Stunde Geschichte erzählen Paar Freund -- Damon Phidias nennen -- Sache lebendig Auge bringen -- 
  Mathilde -- 
  kennen Freund -- 
  -- 
  Höchste Freundschaft -- Liebe Freund mächtig -- lieb Leben -- 
  Höchsten -- edl Natur erheben -- Stufe herab -- Freundschaft nennen pflegen -- Grade -- gewöhnlich Höchste annehmen -- Freundschaft Rede -- 
  Mann -- stark Freundschaft -- -- finden Grad selten -- 
  behaupten -- Mensch ehemals -- Klärch -- 
  -- schnell unterbrechend -- Mann stark Freundschaft -- -- gut Tante -- glauben -- 
  -- 
  schwer Frage -- Klärch -- beantworten -- würden Kind Antwort verstehen -- 
  Erlassen Zeitlang -- 
  lassen Trost -- vortrefflichen Fähigkeit überkommen -- -- 
  Gespräch mancherlei störend Zurüstung Reise unterbrechen -- 
  machen Besuch -- 
  unmöglich -- schreiben -- 
  Stunde Abreise -- 
  send Brief Post -- ziehen -- 
  Adio -- 
  Gedruckt Kaufmann Friederich Mannheim -- 
  1807 -- 