Franz Sternbald's Wanderung -- 
  altdeutsch Geschichte herausgegeben Ludwig Tieck -- 
  -- 
  Berlin -- Johann Friedrich Unger -- 1798 -- 
  Buch -- 
  Kapitel -- 
  alt Buch -- Sammlung befinden -- folgend Stelle vorzüglich wohlgefall lesen -- -- O Jugend -- 
  Frühling -- sonnenbeschienen vorn Anfang Leben liegst -- 
  zart Äugelein Blume umh -- Wald neugrün Blatt -- fröhlich Stimme winken -- zujauchzen -- 
  Paradies -- spätgeboren Mensch betreten -- neu verlieren -- -- 
  -- Gefilde voll Seligkeit -- überhangend Blüte -- durchirren Ton -- 
  Sehnsucht wehen spielen dein süß Hain -- 
  Vergangenheit gold -- Zukunft wunderbar -- sirenengesang Nachtigall locken Dorther -- mondlich Schimmer breit Weg -- lieblich Düft ziehen Tal herauf -- Berg nieder Silberquell -- 
  O Jüngling -- glänzt Morgenröte -- rücken Strahl wunderglänzenden Wolkenbilder herauf -- folgen -- Spur sogar verfließen heimlich Sehnsucht -- Liebesengel ziehen fort -- -- 
  Dunst bunt Schatten -- wonach brünstig Arm Strecktest -- 
  -- Wolke winken Hand -- Finger rot Rose -- winken schmeichlerisch Kose -- stehst Fragst -- wohin Weg wenden -- 
  sing Frühlingslüft -- duft kling Blumendüft -- Lieblich Rauschen Tal entlang -- 
  -- mutig -- bingen -- 
  Siehst Mond Schimmer -- Quelle hüpfend Geflimmer -- 
  Wolke golden Hügel -- Morgenröte himmelbreit Flügel -- entgegen zieh Glück Liebe -- Beute golden Netz Van -- leise lieblich -- Ausflucht bleiben Umzingel -- tun -- 
  -- Glück beginnen -- 
  O Frühlingsnachtigall -- singst drein -- 
  dringen sehnend Liebe -- -- Mondglanz weben Sinn -- 
  -- Bang mir_es -- gefangen geben -- nahen -- Scharen Wonne Heeresmacht -- 
  verloren -- verträumen fliehend Leben -- rüsten Liebe Glück Schlacht -- 
  Kampf beginnen -- fühlen Wonn Durchströmen Brust -- 
  O -- selig Gefilde -- kommen -- Milde Erquickt ermatten Leben Lust -- 
  Winket Himmel Freude Gewimmel -- lagern -- 
  Boden -- fühl Freuden Gewühle -- streben dringen entgegen Quelle Getöne -- Blümchen schön -- lieblich Blick -- winken -- deuten schweigen -- wünsch Leben Glück -- -- -- 
  Kind grün goldglänzend Strahl entgegen -- bangen Harren -- klopfen Herz -- fliehen -- 
  -- Quelle schwiegen -- dünken -- dunkl Schatten steigen -- löscht Wald grün Flamme -- faln Blume Putz -- 
  freundlich Blüte fort -- Frucht stehen selbig Ort -- Nachtigall verstecken Gesänge Wald 
  Echo Einsamkeit schallen -- 
  -- Morgenröte Haus gehen -- 
  Ruft Kind -- strecken Hand -- weinen -- O kommen -- erlösen Bangen -- wolltest golden Netz fangen -- gewiß böse meinen -- 
  gerne drein ergeben -- -- Opfre jung Leben -- O -- kommen -- Himmelsschein -- 
  hoch steigen Licht -- bescheinen tränend Gesicht -- Nachtigall fliehen waldwärts -- Quell Fluß breit -- 
  -- -- Hinüberflieg -- 
  locken -- -- Morgenglanz -- Ton jenseits liegen -- stehen -- fühlen Leid -- -- 
  Nachtigall singet Fern -- -- locken -- Lebest -- Sehnst -- Matter Sehnst -- -- -- töricht Leben wähnstn -- -- -- -- -- wähl alt -- kindlich redend Lied Eingange Buch Geschichte -- 
  unbekannt Verfasser beweinen Wort entflohen Jugend -- Erinnerung legen Ton sanft Bild -- ansprechen -- -- Stelle lesen -- -- 
  indes verflossen -- 
  -- lang -- kenn -- Buch aufschlagen -- Wort rühren -- 
  -- geliebt Leser -- ewig Jugend -- 
  Vergangenheit erinnerst -- vergehen -- Ahnung künftig Zukunft Gegenwart -- Verwandelung Natur scheinbar -- fliegend Wolke umhüllen Wirklichkeit innerer Sonne -- 
  Sonnenblicke wechseln Schatten -- ewig Erneuerung Alter -- 
  fahr Geschichte fort -- 
  Laß vorig Gemüt zurückkommen -- glauben -- Geist Künstler -- leben -- umgeben kennen -- glauben -- 
  Gestalt Ergötze finden -- vorüberführen -- 
  Franz Sternbald Freund Rudolf Florestan durchwanderen Elsaß -- 
  -- Frühling Baumknospe schlafen -- Vögel unbelebt Zweig aufwecken -- 
  Sonne scheinen Blaß gleichsam blöd warm -- dampfend Erde hernied -- Gras Schoße gebar -- 
  Sternbald erinnern -- Pflegeelter verlassen -- Albrecht Dürer Nürnberg lernen -- Wetter friedlich Dorf verlassen -- 
  gehen -- Rudolf fröhlich Geschichte erzählen -- schön Gegend -- 
  Straßburg liegen -- sehen erhaben Münster -- nächster Stadt Mann erwarten -- Rückreise Italien begreifen -- 
  Straßburg Franz Sebastian folgend Brief schreiben -- -- -- Sebastian -- -- freuen -- 
  Seele ergreifen Ferne Nahe -- Gegenwart Vergangenheit gleich Liebe -- Empfindung tragen sorglich Kunst hinüber -- 
  quäle -- überzeugen -- leisten -- leisten -- 
  Leben -- unser Beängstigung verkürzen -- 
  Künstlergeist Druck äußerer Zwang -- edl Baum mancherlei Zweig Äst ausbreiten -- streben Kraft Wolke -- Mitwirkung erzeugen erhaben Pflanze -- Eich -- Buch Zypreß -- myrt Rosengesträuch -- Keim beschaffen -- Höhe sproßen -- 
  musizieren jeder Vögelein eigentümlich Lied -- 
  freilich zuweilen nach- zuvortun -- verfehl Weg -- Mensch geschehen -- 
  selber überlassen -- 
  Künstler -- edl Maler -- geschehen gewiß -- Freund Rudolf lachen täglich unschlüssig Ängstlichkeit -- verlieren -- 
  rein Sinn spiegeln Empfindung -- lassen nachher Spur -- Gemüt aufbewahren -- nähren heimlicherweise Sinn Kunst verlieren -- 
  trösten hemmen Beklemmung -- überwältign -- 
  fast magisch Weise -- zauberisch himmlisch -- wissen -- nennen -- Phantasie Engelsbilde anfüllen -- sprechen -- 
  wunderbar -- 
  Gestalt -- Blick -- Zug Munde -- stehen deutlich deutlich -- dämmern Ungewisse -- vorüberschwebend Erscheinung Seele -- festhalten -- Sinn Erinnerung brünstig ausstrecken -- wahrlich gewahr Eigentum gehen -- Schönheit Landschaft innigst empfinden -- Größe Gedankens -- Glauben Gott -- 
  -- Dämmerung -- Mondschein -- Augenblick helles Tageslicht -- 
  Geist ewig Arbeit -- rastlos Streben -- Kette aufrichten -- Körper Boden halten -- 
  O -- Sebastian -- 
  -- lieblich fühl Regung Lebenskraft heit Jugend -- 
  herrlich -- Rheinufer -- Berg wunderbar Krümmunge Gewässer verkündigen -- 
  Münster andermal reden -- voll -- 
  Straßburg reich Mann heilig Familie malen -- 
  erstemal -- Kraft Stunde vertrauen -- begeistert ruhig fühlen -- 
  Madonna suchen Gestalt hinzuzeichnen -- Innere erleuchten -- geistig Flamm -- sehen -- -- -- lieblich Widerscheine verschönen strahlend -- 
  Male unaufhörlich Kampf Deutlichkeit Ungewißheit -- gelingen -- 
  Gestalt -- wahrhaft anschauen -- irdisch -- tragen Merkmal -- vergegenwärtigen körperlich -- 
  Gegenteil auf's erfinden -- bleiben Gebilde gewöhnlich luftig allgemein -- wagen ungewiß Ferne heraus -- 
  -- Geliebte -- nennen -- -- Ideal -- Meister streben -- Kunst Rede -- 
  -- sagen sogar -- Sebastian -- -- Unbekanntschaft -- Fernsein -- Streben Geist -- gegenwärtig besitzen -- Begeisterung -- Bild malen -- 
  ungern Hand -- Phantasie ungewissern -- manchmal stehen gemalt Madonna Auge -- denken -- genau müssen unbekannte gestalten -- 
  einst finden -- Künstlertalent Endschaft erreichen -- -- 
  -- glauben -- 
  Fest Mut Eroberer Gebiet Kunst vorrücken -- fühlen -- Herz Edle Schöne entzücken -- Gebiet -- Eigentum -- schalten einheimisch fühlen -- 
  Wirf Stolz -- Sebastian -- tätest Unrecht -- 
  bleiben -- -- 
  Himmel schenk Gesundheit -- -- 
  Wald -- Feld Berg grün Obstbaum blühn -- Himmel heit blau -- sanft Frühlingslüft spielen erstenmal Sonnenschein fröhlich Natur -- 
  Sternbald Rudolf entzücken -- Hügel hinab überschwenglich Pracht hineinschauten -- 
  Herz -- fühlen neugeboren -- Himmel Erde Liebe magnetisch anziehen -- 
  O -- Freund -- rufen Sternbald -- liebreizend Frühling plötzlich aufgeschlossen -- 
  Melodischer Gesang -- angeschlagen Harfensait Blüte -- Blatt herausgequollen -- strecken liebkosend -- warm Luft entgegen -- 
  Winter fort -- Verfinsterung -- Sonnenblick Natur hinweggehoben -- 
  Sieh -- keimt Sproßt blühen -- klein Blume -- unbemerkt Kräuter drängen hinzu -- Vögel singen jauchzen flattern umh -- fröhlich Ungeduld Schöpfung Bewegung -- sitzen Kind -- fühlen Herz mütterlich Natur nächsn -- 
  Rudolf Flöte -- blies lustig Lied -- 
  schallen fröhlich Berg hinunt -- Lämmer Tal fangen tanzen -- 
  Frühling schnell vorübergingen -- Rudolf -- Morgenbegeisterung -- Natur aushalten -- 
  geben -- Sternbald -- Fülle -- Allmacht Lieblichkeit saugen -- hellst Bewußtsein Schatz aufzusparen -- 
  wünsch -- Tönen Gesang übrig Mensch Gefühl geben -- Musik Frühlingswehen dichtet -- hoch Lied sängen -- Geist Mensch ausgeströmen -- 
  fühlen jedesmal -- Musik Seele erheben -- jauchzenden Klang Engel himmlisch Unschuld irdisch Begierd Wunsch fern abhalten -- 
  Fegfeuer glauben -- Seele Schmerz geläutert reinigen -- Gegenteil Musik Vorhimmel -- Läuterung wehmütig Wonne geschehen -- 
  -- Rudolf -- Musik empfindest -- gewiß Mensch übereinstimmen -- 
  überzeugen -- rufen Franz -- 
  -- Rudolf -- sieh lebendig Wesen -- Ton Harfe -- Flöte -- jeder angeschlagen Instrument ernst -- Gesänge -- Fuß lebendig Kraft Tanz ermuntern -- gießen schmachtend Sehnsucht -- unbekannen Wehmut Gemüt -- 
  Jüngling Mädchen mischen Reigen -- such Gedanke jenseits Tanze -- geistiger Genuß -- 
  O -- Einbildung -- Rudolf lachend -- augenblicklich Stimmung trägst übrig Mensch hinüber -- 
  denken Tanze -- Reigen durchführen -- hüpfend Schwarm lebendig Art ergötzen -- fröhlich Augenblick Vergangenheit Zukunft vergessen -- 
  Tänzer sehen blühend Mädchen -- -- Auge begegnen glänzend -- Sehnsucht empfinden -- gewiß -- schildern -- 
  leichtsinnig -- antworten Franz -- erstemal -- bemerk -- vorsätzlich schön Gefühl ableugnest -- sinnlicheren Schwärmerei nachzuhängen -- 
  grell Unterschied -- rufen Rudolf -- ewig Punkt unser Streit -- 
  verstehen -- 
  -- schließen Florestan -- Gespräch umständlich -- reden andermal -- 
  Franz Freund erzürnen -- erstemal -- Stritt -- 
  Florestan betrachtet Gegenstand leicht sinnlich -- Empfindung -- Franz Wort ausdrücken -- fügen -- Sternbald Gedanke äußern -- Rudolf Gefühl -- vorher Freund widersprechen -- 
  Mensch Meinung wechseln -- entstehen blind Spiel Zufall -- Wunsch -- mitteilen -- entstehen Sucht streiten -- widersprechen -- bemühen -- Wort verstehen -- 
  Franz Weile geschwiegen -- fahren fort -- 
  O -- Florestan -- wünsch -- eigentümlich Handwerke ausdrücken -- Geist Herz bewegen -- Fülle Anmut -- ruhig -- scherzend Heiterkeit -- umgiben -- 
  Male -- Luftraume edl Geist bewegen -- Frühling schreiten -- Bild ewig Frühling unverwelklich Blüte prangen -- Auge Tod neu aufging freundlich Willkommus entgegenbrächen -- 
  Meinst -- Künstler -- Historiengemälde -- Weise fremd Herz deutlich hingeben -- empfinden -- 
  glauben -- antworten Florestan -- gelingen -- vorsetzt -- 
  Gehen Rom -- Freund -- ewig Frühling -- Sehnst -- blühen Haus Agostino Ghigi -- 
  göttlich Raffael hingezaubern -- nennen Bild gewöhnlich Geschichte Amor Psych -- 
  Luftgestalt schweben -- blau Äther umgeben -- bedeutungsvoll frisch Blumenkranz Rahmen einschränken absondern -- 
  -- Bildung Auge durchwanderst -- -- Betrachtung -- 
  Geschichte lieblich zart -- Bild ewig Jugend -- Jünglingsgeiste -- prophetisch Sanzius -- schön Entzückung hingemalt -- Verkündigung lieb Blumenschönheit -- erhaben Reiz -- 
  -- ausdrücken -- poetisch Offenbarung Natur Lieblichkeit -- Menschenherz vertraulich nahe rücken -- 
  Frühling hoch Blüte stehen -- schließen Geschichte Bild hoch Pracht Götterversammlung -- schön Leben einzeln Gestalt vereinigen -- Seligkeit Olympus sterblichen Auge enthüllen -- 
  Gedulde -- Franz -- Rom -- 
  -- Raffael -- Franz Sternbald -- reden hören -- Leben anträfe -- 
  Lied Frühlinge singen -- Rudolf -- 
  stehen -- Florestan singen -- 
  präludiert Flot -- Strophe spielt Ton -- wunderbar Liede paßten -- Hörer gleichsam erläutern -- 
  Vöglein hergezogen -- setzen dürren Ast -- 
  -- -- -- fliegen -- Angelockt Frühlingsrest -- 
  klagen -- -- 
  -- Schmetterling schwärmen -- Bie sumsen Ton -- suchen Honig -- finden -- 
  Frühling -- 
  Frühling -- kommen hervor -- 
  Höre Lied -- Gib Blatt -- Horch -- singen Ohr -- 
  grün Laub -- 
  Laß Blatt spielen -- warm Sonne fühlen -- Keines Frost Raub -- 
  -- singen lieblich leise -- 
  Spricht drauf Frühlingswelt -- 
  alt Weise -- Reise -- Furcht rückwärts halten -- 
  grün Äugelein -- Knosp erschließ Vögelein grüßen -- kosten Sonnenschein -- 
  Baum Waldgeist sumsen -- 
  -- Kind Frühling -- Storch -- Schwalbe -- oftmals -- 
  lerch Grasmückt -- hergereifen -- 
  Streckt grün Arm entgegen -- lassen wohnen schattig Zelt -- Zweig Zweig regen -- jubel singen frisch Welt -- 
  regen rauschen Zweig -- Quelle neu Leben spielen -- Ästen Lust Kraft Wühle -- Baum zeigen -- 
  rauscht_es stehen grün Pracht -- Abendwolken Wälder ziehen -- schön Wipfel glühn -- grün Hain golden Feuer anfachen -- 
  Gebiert Tal Blume Licht hold Liebe Welt verkünden -- lächeln winken still Grund sanft Veilchen Angesicht -- sinnig Vergißmeinnicht -- 
  Winke -- süß Blick -- Geliebten Mädchen reichen -- Vorbote zukünftig Glück -- Auge -- schmachtend entgegen neigen -- 
  bücken schalkhaft Sinn grüßen -- vorübergehen -- sanft Blick verschmähen reich weiß Finger -- 
  erscheinen Frühling Frühlingszeit -- lieb Gegenliebe finden Liebe entzünden -- glänzt Pracht Blume hell -- 
  Rose Stock Leben -- brechen hervor liebreizend Prang -- süß Röt aufgeglommen vereint Schmuck dicht hängen -- 
  Frühling Frühlingszeit -- Küsse -- Liebesküsse Busch bestreuen -- Rose -- süß Blüte -- Blume Blume -- Kuß dein Lippe malen -- O Ros -- -- Mund strahlen küssend Liebe -- Andacht Heiligtum -- 
  Höher erschwing -- Schöner Rose Frühling bringen -- lassen Nachtigall Sehnsuchtslieder klingen singen Vögelchor -- Nacht schwellen Gesang hervor -- 
  Rose -- süß ros Blatt neigen -- Sommer Vögelchor weichen -- Nachtigall Tön schweigen -- 
  Küsse Tal verblühen -- Dichtkunst Zweig ziehen -- 
  Kapitel -- 
  Feld begegnet Mann -- nächster Stadt aufsuchen -- fangen zufälligerweise Gespräch -- erkannten -- 
  Mann nennen Bolz -- Bildhauer -- Nürnberg -- Wohnort -- reisen -- 
  Italien -- Gefährt -- Mönch kleiden -- 
  Franz erfreuen -- sehen -- lieb Vaterstadt erblicken -- Dürer sprechen -- Fremden aufrichtig Freude Freundschaft entgegen -- 
  Bolz Mönch scheinen Sternbald sonderlich Rücksicht nehmen -- 
  unterhalten Kunst -- Franz fragen begierig -- 
  edle Raffael Urbin -- 
  sehen -- 
  Mönch Wort -- 
  -- -- schön Zier edel Malerkunst Erde verlassen -- vorig sterben -- 
  Kunst Italien entwichen -- 
  sprechen -- rufen Bildhauer Bolz -- unsterblich Michel Angelo -- hoch Höhe Kunst erreichen -- Raffael niemals -- 
  zeigen -- erhaben Reiz -- Ideal alt genau Studium wirklich Natur verbinden -- 
  leben -- jung Freund -- stehen lächelnd Ziel Skulptur Malerei -- hoch Genius -- Schüler Streben andeuten erleichtern -- 
  Wunsch Herzens versagen -- Franz -- Mann sehen -- Freund Dürer -- Dürer bewunderten -- 
  freilich -- rufen Bolz -- alt gutherzig Dürer bewundern -- freilich Raffael -- 
  Stande -- Agnolo's Größe verstehen -- Kunstwerk erhalten -- 
  Erlauben -- Florestan -- Kenner Kunst -- tausenden gehören -- Raffael Kleinod Erde nennen -- wahrlich -- Auge Gefühl trauen -- leuchten erhaben Göttlichkeit Werk -- 
  Dürer sprechen -- Franz -- wahrlich -- 
  wissen fremd Werk schätzen -- selber Künstler -- 
  lieben Euer deutsch Vaterland -- Künstler gering denken -- 
  Erzürnt -- Mönch -- rauh -- wild Art -- übertreiben -- 
  dünken -- Gigantisch schön -- Sinn übrige scheinen versagen -- 
  -- Deutschland einheimisch Kunst -- rufen Bolz ergrimmen -- 
  armselig handwerksmäßig ausüben schätzen -- 
  wahr Künstlergeist unfruchtbar deutsch Boden -- trüb Himmel besuchen -- 
  Kunst -- 
  kalt gefühllos Mensch -- dürftig Häuslichkeit Zierat -- 
  streben sogenannter Künstler -- Höchste Vollkommenst erreichen -- begnügen -- kalt dürftig Natur nahe -- Zug Zusammenhang abzulauschen -- glauben -- Machwerk kahl Unbedeutsamkeit stehen lassen -- tun -- 
  euer gepriesen Albert Dürer -- euer Lukas Leiden -- Schoorel -- obgleich Italien -- Schweizer Holbein verdienen Maler zählen -- 
  kennen -- rufen Franz unwillig -- verkennen Vorsatz -- 
  Mann Kunst Trefflichkeit -- erschöpfen beendigen -- -- anderer Kranz greifen -- 
  beengen klein müssen himmlisch Gebiet -- einzig Geist durchschwärmen -- Herkul Grenze Säule setzen -- Nachwelt sagen -- können -- 
  scheinen Barbarei Hartherzigkeit -- Entwürdigung Künstler -- vergöttern -- ausschließlich Kunst beilegen -- 
  scheinen Dürer Maler Welt -- vorstellen -- -- Herrlichkeit -- 
  Michael Angelo -- -- jenseits Weg Größe Erhabenheit -- 
  Italien -- Bolz -- sprechen -- 
  -- Augustin -- fallen Mönch -- 
  reich Kunstwelt -- jung Mann nachher schwerlich sprechen -- 
  fallen euer Übertreibung -- Eurer erzwungen Einseitigkeit -- glauben -- Enthusiasmus Verfolgungsgeist geben können -- 
  Sternbald gewiß Rom Florenz Dürer getreu bleiben -- gewiß Angelo Erhabenheit Rafael's reizend schöne gleich Liebe umfassen -- 
  -- -- rufen Rudolf Ungestüm -- -- 
  -- ungestüm Bruder Augustin -- nennen -- Ehre -- Gesinnung Redensart lieblich Italien bringen -- Norden -- Eisländer hätten reisen -- 
  sprechen deutsch Barbarei -- fühlen -- groß Barbar -- 
  Italien -- Herz sitzen -- Vatikan Rafael's Unsterblichkeit standen -- 
  müssen Ungestüm Jüngling lachen -- lacht Herz -- obgleich Tran Auge stehen -- begeistert Rede hervorbringen -- 
  Römer -- -- gestehen -- Rom unaussprechlich lieben -- Raffael -- Rom ausgeschmücken -- hauptsächlichst Gemälde befinden -- 
  vergebt -- -- -- gewiß heftig widersprechen -- 
  Raffael sterben -- fing Franz neu -- friedlich Feld gehen -- 
  alt -- 
  dreißig -- Mönch -- 
  Karfreitage -- heiligen gebären -- merkwürdig Geburtstag Erde hinweggehen -- 
  bleiben Lebelang Jüngling -- Werk sprechen mild -- kindlich Geist -- 
  letzter Gemälde Transfiguration -- Christi Verklärung -- worin apotheose malen -- 
  Herrlichkeit Erlöser -- allgemein Liebe Blick -- Glaube Apostel -- umgeben übrig Menschenleben -- elend -- einheimisch -- Unglückliche -- Erlöser Heilung bringen -- Zweifel -- Hoffnung Zutrauen Umstehenden -- 
  Rafael's Sarg stehen Malerstube -- letzter vollendet Gemälde -- Verklärung -- 
  Finger ruhen -- Bild Leben Bewegung zaubern -- bunt freundlich Welt -- hervorgehen -- stehen blass Leiche -- 
  Rom Bewegung -- -- sehen -- Träne enthalten -- 
  -- rufen Franz -- Träne Anblick enthalten -- 
  Kunstgeister widmen -- voll -- entzückt Herz -- andächtig Verehrung -- 
  unbefangen -- kindlich Rührung -- völlig Hingebung unser eigentümlich Selbst -- voll Glaube edl Trefflichkeit arbeiten -- groß einzig Lohn -- 
  Träne Auge -- Abgeschieden liegen denken -- Gemälde -- letzter Schöpfung dicht -- kürzlich Kunstgeist belebn bewegen -- 
  O -- denken -- lebendig Gestalt verändern -- Schmerz Verzweiflung entflohen Raffael äußeren -- 
  Bildhauer -- 
  -- gewiß -- lebhaft Imagination -- meinen -- Gemalter Christus Tod erwecken -- 
  Raffael sterben -- rufen Sternbald Begeisterung -- 
  Albrecht Dürer jemals sterben -- 
  -- Künstler verlassen -- -- Geist -- Kunst bleiben freundlich wohnen -- 
  Nahme Feldherr spät Enkel nennen -- groß Triumph genießen Künstler -- 
  Raffael ruhen Kunstwerk glänzend -- Sieger ehern Grabmäler -- lassen Bewegung edlen Herzen -- Gedanke -- begeistert -- sichtbar Bildung -- lieblich Kläng -- Gestalt bieten ungeboren Enkel Hand -- bewillkommen -- jeder Gemälde drücken entzückt Beschauer Herz Rafael -- fühlen -- Geist Maler liebevoll umfängen erwärmen -- glauben Atem wehen hören -- Stimme Grußes vernehmen -- Stunde Lebenszeit stärken -- 
  Bolz -- 
  euer Lebelang Maler -- erhitzen Not -- Kunst abführen -- 
  Unrecht -- Mönch -- 
  kenn Italien alt Mann -- Geschichte erzählen -- merkwürdig dünken -- 
  erhellt -- Meinung Mann -- Kunst ruhig Geist Fordre -- 
  ausgemachen -- fahren Rudolf fort -- alt Mann -- kennen -- Gedanke bringen -- -- 
  fallen -- Mönch -- Geschichte sonderbar -- jung Maler wunderbar Weise ähnlich sehen -- alte denken -- gehen -- 
  Geschichte erzählen -- fragt Franz -- 
  Mönch anfangen -- Jagdhörner Hundegebell hören -- 
  Trupp Reuter jagen vorüber -- benachbart Wald hinein -- 
  Berg geben Ton -- schön musikalisch Gewirr lärmt einsam Gegend -- 
  Bolz stehen still -- -- 
  lassen Himmel willen euer langweilig Erzählung -- freuen Konzert -- -- Gefühl -- Brust erregen müssen -- 
  kennen Schöneres -- Jagdmusik -- Hörnerklang -- Widerhall Walde -- wiederholen Gebell Hunde -- hetzend Hallo Jäger -- 
  Italien verlassen -- gelingen -- Gelegenheit Jagd überaus reizend Mädchen Leben retten -- 
  -- Herr Maler -- Szene -- Darstellung würdig -- 
  grün dunkelschattig Wald -- Getümmel Jagd -- blond geängstigt Mädchen -- -- Schreck halb ohnmächtig -- Baum hinaufklettern -- Busen halb frei -- lang Haar auflösen -- Fuß Bein Stellung entblößen -- Mann -- Hilfe leisten -- -- 
  Reizend sehen -- Mensch Mädchen Abschied Italien meister erschweren -- 
  Franz dachen unwillkürlich unbekannte -- Mönch -- 
  Gegenstand malerisch finden -- alltäglich bedeutungslos -- 
  Maler nehmen dürfen -- fallen Franz -- einzig Gegenstand Interesse -- 
  könnten euer Gezänk abbrechen -- Rudolf -- einig -- 
  Berg hinangestiegen -- stehen ermüdet still -- 
  Aussicht ergötzn -- rufen Franz -- dünken -- sehen Ferne Münster -- 
  sehen -- jeglicher glauben -- entdecken -- 
  Münster -- Bolz -- Werk -- deutsch Ehre -- 
  euer Begriffen Idealisch Erhaben passen -- antworten Franz -- 
  Begriff -- Bildhauer -- Knie Gedanke Geist nieder -- allmächtig Bau entwerfen ausführen -- 
  Wahrlich -- ungemein Geist -- wagen -- Baum Ästus -- Zweig Blätt hinzustellen -- hoch Wolke Felsmasse entgegen -- Werk hinzuzaubern -- gleichsam Bild Unendlichkeit -- 
  Sternbald -- 
  ärgern -- Riesengebäude verächtlich sprechen hören -- ehemals begegnet -- Zeichnung kennen -- 
  Führt Tadler -- -- griechisch römisch Baukunst sprechen -- Straßburg -- 
  stehen voll Herrlichkeit -- fertig -- -- bedürfen Verteidigung Wort Papier -- verschmähen Zeichne Linie Bög -- Wirrwarr Geschmack edl Einfachheit -- 
  erhaben Größe Erhabenheit darstellen -- Vollendung Symmetrie -- kühn allegorisch Dichtung menschlich Geist -- Ausdehnung Seite -- Himmel hinein -- Endlose geordneter -- Notwendigkeit Gegenüberstehenden -- Hälfte erläutern fertig -- eins Wille -- gotisch Größe Herrlichkeit ausdrücken -- -- 
  Baum -- Wald -- -- allmächtig -- unendlich wiederholt Steinmas drücken Erhabeneres -- ungleich Idealischeres -- 
  Geist Mensch -- Mannigfaltigkeit sichtbar Einheit verbinden -- kühn Riesenstreben Himmel -- kolossal Dauer Unbegreiflichkeit -- Geist Erwin sehen furchtbar sinnlich Anschauung stehen -- 
  entsetzen -- Mensch Fels Abgründe einzeln Stein hervorholen -- rasten ruhen -- ungeheuer Springbrunn lauter Felsenmasse hingestellen -- ewig -- ewig ergießen -- Stimme Donner Anbetung Erwin -- sterblichen Gebein hineinpredigen -- 
  klimmen unbemerkt unkenntlich Wesen -- Baumeister -- Wurm -- Zinne umher -- hoch hoch -- letzter Schwindel flach -- sicher Erde hinunternötigen -- -- demonstrieren -- Erwin barbarisch Zeitalter bedauern -- -- o wahrhaftig -- begehen -- arm Sünder -- Verleugnung Petri Herrlichkeit göttlich Ebenbild -- 
  Bildhauer Maler Hand -- -- 
  hören -- -- 
  trennen -- fahren fort -- Scheideweg Straße -- 
  -- jung Freund -- Italien -- glänzend Epoche feiern -- 
  verdienen Mann antreffen -- schöne -- erkennen -- 
  meister arbeiten Stille -- 
  -- -- Aufheben Kunst -- sprechen schreiben -- Schule errichten -- Geleis gehörig Ordnung bringen -- wahrscheinlich Kunst -- 
  tun -- vermögen -- Überzeugung -- fürcht -- stehen falsch Prophet -- erzwungen Ehrfurcht erheucheln -- 
  schätzen Kunst Künstler -- entstehen Afterenthusiasmus -- wahrhaft Edle herabwürdigen -- 
  -- Leben -- 
  gehen -- Franz überdachen letzter Wort -- unverständlich -- 
  Kapitel -- 
  Rudolf Franz Weg fortsetzn -- sprechen Begleiter -- verlassen -- 
  Franz -- 
  erklären -- Augenblick empfinden unbeschreiblichen widerwill Bildhauer -- Wort -- sprechen -- vermehrn -- 
  freundschaftlich Art -- Abschied -- Herz zuwider -- 
  geistliche -- antworten Rudolf -- Gegenteil Anlockende -- zutrauen gewinnen -- scheinen sanft -- freundlich Mensch -- wohlwollen -- 
  -- fahren Sternbald fort -- Geschichte alt Mann erzählen -- sprechen -- 
  lernen -- 
  gewissenhaft -- Freund -- Rudolf -- 
  Welt bestimmen Einfluß Gemüt -- 
  Fußsteig führen dicht kühl Wald hinein -- bedacht -- nachgehen -- 
  erquickend Luft ziehen Zweig -- mannigfaltigst -- anmutigste Konzert Vögel erschallen -- 
  lebendig Gewimmel Gebüschen -- buntgefiedert Sänger springen -- Sonne flimmeren einzeln Stelle dichen Grün -- 
  Freund gehen schweigend -- schön Anblick nossen -- 
  stehen Rudolf still -- -- 
  Maler -- Freund Sternbald -- vorzüglich Waldszen studieren darstellen -- 
  Gedanke Gemäldes entzücken -- 
  dämmernden Schatten Göttin Diana vorübereilend denken -- Bogen gespannt -- Gewand aufgeschürzt -- schön Glied umhüllen -- Nymph munter Jagdhund -- stellen -- Fußweg dicht Gebüsch hineinwenden -- Baum hoch wunderbar -- einzeln Laute klingen verschlungen Laub -- plötzlich stehen Grotte -- kühl Bad -- Göttin -- Begleiterinnen -- entkleidet -- 
  -- Franz -- tief Walde Grabmal -- Freund ausstrecken liegen tote beweinen -- dunkelgrün Schatten -- frisch Rase -- einzeln zerspalten Sonnenstrahl -- müssen vortrefflich Gemälde Schwermut ausbilden -- 
  Fühlst -- sprechen Rudolf -- wunderbar Zug Deines Herzens Wunderbar Seltsame entgegen -- 
  Traumbilder erwehren -- erwarten höchst sonderbar Fortsetzung unser gewöhnlich Lebenslauf -- 
  -- Geist Ariost Dichtung hinwegfliegen -- kristallen Wirbel fassen -- horch Zukunft begierig -- Erscheinung -- bunt Zaubergewänder vorübergehen -- 
  -- Waldstrom Melodie deutlich aussprech -- Baum Zunge lösen -- Rausche verständlicher Gesang dahinrinnen -- 
  fangen Liebe fern Flötentön heranzuschreien -- klopfend Herz entgegenflieg -- Gegenwart mächtig Bannspruch festgezaubern -- glänzend Minute wagen -- entfliehen -- 
  Zirkel Wohllaut halten magisch Kraft einschließen -- verklärter Existenz schimmeren rätselhaft Mondlicht wirklich Leben hinein -- 
  O Dichter -- rufen Franz -- leichtsinnig Wärst -- solltest Wundergedicht erschaffen -- voll gaukelnd Glanz irrend Kläng -- voll Irrlichter Mondschimmer -- hören Freude -- Herz wunderbar Wort ergreifen -- 
  hört rührend Waldmusik spielend Horn Ferne -- stehen still horcht -- Einbildung Wirklichkeit -- Melodischer Gesang quellen Baum rieselnd Bach entgegen -- Franz glauben -- Geisterwelt plötzlich aufgeschlossen -- -- wissen -- zaubernd Wort finden -- geheimnisvoll unsichtbar Strom Weg lenken -- Flut aufnehmen -- 
  -- gehen nah -- Waldhörner schwiegen -- süß melodisch Stimme singen folgend Lied -- Waldnacht -- 
  Jagdlust -- 
  Leis -- ferner Kling Hörner -- Heben -- jauchzt frei Brust Ton -- tön nieder Tal Freuen -- freuen allzumal Baum Strauch munter Schall -- 
  Klinge Bergquell -- Efeuranke umschwanken -- Riesle Klüfte schnell -- Fliehet -- fliehen Leben fort -- Wandelt -- -- Halltr -- zerschmilzt luftig Wort -- 
  Waldnacht -- 
  Jagdlust -- 
  Liebe bleiben -- wohnen bleiben -- treu Brust -- 
  Wandelt -- wandeln allzumal -- Fliehet Hörnerschall -- Einsam -- einsam grün Tal -- 
  Klinge Bergquell -- 
  betrog Wasserwog Rauschen abwärts schnell -- 
  Liebe -- Leben eilen -- Kein tragen Gewinn -- -- gebären -- 
  Stimme schweigen -- Hörner fallen schmelzend Akkord darein -- verhallt -- Stimme singen entfernter Ort -- Treulieb -- nimmer -- Kummer Leid Kehrt Liebe -- Freude -- kehren hold Gruß -- Händedrücken -- Zärtlich Blicken -- Liebeskuß -- 
  Treulieb nimm -- Gang Einsamkeit -- weihen -- 
  schön -- begrüßet Küsset Freudentran -- -- 
  Hörner schließen Gesang überaus zärtlich Ton -- 
  Franz Rudolf indes nah geschriten -- stehen still -- alt Baum gelehnen -- fast beschatten -- 
  sehen Gesellschaft Jäger grün Hügel lagern -- -- vorher begegnen -- 
  schön Jüngling -- Franz verkleidet Mädchen halten -- sitzen Mitte -- Lied singen -- Ferne sitzen jung Mann -- schön voll Brust Antwort singen -- übrig Jäger zerstreuen -- Fuße Hügel liegen ermüdet Hund schnaufend -- 
  Franz bezaubern -- Mädchen erheben -- schön schlank Gestalt -- tragen Helm grün Feder kopfe -- Anzug Bänder schmücken -- glich -- Jagd erhitzen -- Göttin -- 
  reisend gewahr -- freundlich -- erkundigen -- Weise dorthin kommen sein -- 
  Rudolf merken -- verirren müssen -- sehen Weg -- Fußsteig -- 
  Befehl Jägerin reichen Wein Bechern Erfrischung -- erzählt unverhohl Wanderschaft -- 
  schön Jägerin hören -- Sternbald Maler -- bitten Freund -- Zug nahe gelegen Schloß folgen -- Sternbald sollen ausruhen -- nachher wollen -- malen -- 
  Franz begeistern -- wünschen -- Nähe wundervoll Wesen bleiben -- erscheinen -- 
  Jäger steigen Pferd -- boen Franz Rudolf Hengste -- 
  steigen -- Rudolf vorderst Zug -- wobei ausländisch Tracht -- Hute flatternd Band ausnahmen -- 
  Sternbald -- Pferd bestiegen -- ängstlich bleiben hinten -- wünschen -- Fuß folgen lassen -- 
  eröffnet Wald -- schön Ebene Gebüschen krausen Hügel Ferne liegen -- 
  Pferd wieheren laut fröhlich -- Rückkehr Heimat merken -- Schloß Gräfin liegen glänzend Fenster Zinn lieblich Anhöhe -- 
  Jäger -- Rudolf Zug anführen -- bieten -- Wettlauf Schloß anzustellen -- Rudolf willig -- spornten Ros fliegen gleich Eile Ebene -- Rudolf jauchzen triumphieren -- Mitkämpfer Vorsprung abgewann -- übrig folgen langsam fröhlich Musik Hörner -- 
  Mittagszeit -- Zug Schlos ankommen -- Gesellschaft setzen Tafel -- schön Jägerin zugegen -- 
  Tischgesellschaft desto lustig -- Rudolf Reit erhitzen -- überdies Wein trank -- beinahe auslassen -- 
  Desto belustigt Gesellschaft -- müde -- Einfall belachen -- Franz fühlt Leichtigkeit unbeholfen Fähigkeit Umgange -- 
  ältlich Mann -- Haus aufbewahren -- gelten Dichter -- Vers -- ungemein gefiel -- -- Vorbereitung deklamieren -- 
  lauten Beifall Gesellschaft singen folgend Trinklied -- 
  Glas anfüllen -- -- Freund -- Stoßet -- edl Traubensaft entquillt brav Mann -- 
  Mund Mund voll Glas -- krank -- trinken gesund -- 
  Himmel Sonnenschein schenken Freude Trost -- wachsen lieb süß Wein -- rauschet Most -- 
  Mund Mund voll Glas -- krank -- trinken gesund -- 
  Talent Mann bewunderten -- Rudolf Unwillen -- 
  geschehen Wein sonderlich Ehre -- Art loben -- klingen beinahe -- Not Dichter wäret -- lieben Wein besingen -- Gegenstand vorsetzen -- Gelübde -- Widerwille bezahlen -- 
  qualten -- Vers -- 
  Wein fünfzig strophen verfolgen -- Herkunft anfang Erziehung durchgehen -- 
  Art Gedicht Flachsbau durchsingen -- jeder Manufakturprodukt -- 
  hören ungern -- rufen Jäger -- 
  Mann Dichter halten -- anderer -- unser Glaube irren -- 
  leicht tadeln -- -- rufen -- 
  Poet selber aufbringen -- fremd Ankömmling Lorbeer streitig -- 
  bieten berauscht Florestan dichterisch Zweikampf -- Gesellschaft nachher entscheiden -- 
  Florestan Zustimmung -- alt Sänger beginnen sogleich schön Lied Wein -- Gemüt entzücken -- Franz Freund Ausgang Krieg billig Besorgnis geraten -- 
  Liede Tafel aufheben -- Florestan Bestieg Tisch -- Hut aufsetzen -- grün Laube putzen -- vorher trank Glas Wein -- Zith Hand -- artig spielt singen -- Erwacht Melodien tanzen Sait -- Ha -- Auge glüh Sorge erdwärts fliehen -- Himmelwärt entflatteren jauchzend Sinn -- 
  golden Pokale verbirgt Freude -- funkeln Schalen Ha -- Weine lieb Strahl -- regen Welle schimmernder Stern -- 
  tief Bergesklüft Gold Edelstein keimt -- Meeres fern Schlucht Adler hoch lüften -- Nirgend Wein glücklich Erde schäumen -- 
  suchen Schlünd selber Bergmann graut -- felsigen Gewinden -- Wonne finden freundlich Becher beschauen -- 
  --- Rudolf halten inne -- 
  -- Herr Poet -- fragen bescheiden -- vergönnen -- Silbenmaß verändern -- 
  Dichter besann Weilchen -- nickt Kopf -- Freiheit zugestehen -- 
  Rudolf fahren erhöht Stimme fort -- 
  Glück Erde wenden -- Geschick Götter verbannen -- stehen Fels kahl -- verstummn Liebenden Lied -- Mond betrübte hernied -- Verging Blume Tal -- 
  Sorge Angst Gram Arbeit bewegt Hand -- Trübe tränend feurig Blick -- Sehnsucht selber entschwund dacht vorig Stunde -- wünschen heimlich -- 
  -- unterbrechen Rudolf selber -- arm Menschheit traurig Lage -- plötzlich golden Zeitalter verlieren -- 
  hören -- 
  Götter Erbarme Sahe hinunt arme -- verderben Entschluß -- 
  O -- Mensch verbleiben -- Gott -- Liebe -- Sehnsucht -- Kuß -- -- 
  Bacchus -- jung Gott Lächelnd Wange Blick munt -- verlaßen Erde hinunt bewegen Menschheit Not -- 
  sprechen Silberstimm -- 
  Freund wild -- eigensinnigen Grimm Unterliegt Menschenbild -- 
  Tod Gott betasten Höh Sterblichkeit -- -- Zorn belasten -- Leben fühlen bitter Leid -- -- 
  -- Freund -- Singens Trinken überdrüssig -- 
  Wort springen Tisch herunter -- 
  berauscht Gesellschaft entstehen Gemurmel -- streiten -- Poet Preis verdienen -- 
  meister Stimme scheinen alt Sänger -- -- Vorliebe gut Verstand Anzudeut glauben -- nehmen Florestan Eifer -- Sternbald -- 
  wissen -- jung Mensch Gesange Liede -- alt -- 
  Weinlied still Gang fortgeh -- brav Lust bekommen -- mitzusingen -- blinken -- klingen Singt angebracht -- allenthalben finden -- 
  dergleich Geschichte -- 
  freilich -- Florestan -- -- -- lieben Freund -- Wein selber -- 
  Wasser trinken -- bleiben vieler Mäßiger -- 
  -- schrie anderer -- Wein mäßig -- Genuß -- genießen -- gänzlich Verstand -- 
  Rudolf lachen -- wodurch ausgesöhnen Partei übergingen -- 
  Tadel -- Sternbald -- Gedicht Schluß -- 
  Schluß -- rufen Florestan -- entzückend Poesie -- 
  Fangt spielen -- aufhören -- 
  Denkt Spaziergang Zurückgehen -- 
  schön -- Ton leise verhallen -- Wasserfall fortbrausen -- Nachtigall verstummen -- 
  Müßt Winter -- Frühling genießen -- 
  -- -- antworteten -- Weinlied -- reinste Fröhlichkeit atmen -- Schlusse entbehren -- 
  sprechen -- rufen Florestan tollen Mute -- hastig herumdrehen -- 
  Schluß -- Endschaft Genuß -- Ergötzen -- 
  Baumgang hinuntergehen -- schön -- letzter Baum -- stillzusteh denken -- gehen -- 
  Leben sein Liebe -- Freude Entzück Quale -- unaufhörlich sein -- Vergangenheit -- zukünftig Glück -- -- Manne bewundernswert Tat gehören Tod unentbehrlich Größe -- Stande -- ordentlich Summe Vortrefflichkeit ziehen -- Ruhe bewundern -- 
  Kunst Schluß -- Ergänzung Anfangs -- 
  wunderlich Mensch -- alt Poet -- singen euer Schluß -- unentbehrlich -- 
  zufrieden -- Florestan -- 
  -- Genug geschehen -- 
  --- Zith Hand -- spielen singen -- 
  Bacchus lassen Reb sprießen -- Saft Blatt fließen -- Läßt weich Lüfte fächeln -- 
  sonett lächeln -- Ulme hingeschlungen Steht Pflanze Licht -- Herrlich gelingen -- reuen Arbeit -- 
  Läßt Blüte rötlich schwell Beer saftig quell -- Fürchtend Götter Geschick Traube verkleiden Welt -- 
  Menschlein hergegangen kosten süß verlange Frucht -- glühend Most -- finden Gott -- himmlisch Trost -- 
  Kelter springen mutwillig Götterknabe Mensch allerliebsen -- trinken Wein -- kosten Glück -- schleichen golden -- 
  schön Rausch erheiteren Gesicht genießen froh Sonnenlicht -- spüren selber Götter Zauberkraft Gabe schaffen -- 
  Blick feurig angeglomm Zwing Venus zurückkommen -- Göttin fliehen mächtig rückwärts ziehen -- 
  Götterschar erstaunen bewogen -- zurückziehen -- 
  wohnen -- Mensch bauet Thron -- 
  brauchen euer Geschick -- 
  tönen Erde Antwort -- Gram entbehr Wein Liebe gewähren -- 
  schweigen still -- legen anständig Verbeugung Zither weg -- 
  gottlos -- rief Zuhörer -- euer Schluß Unerlaubteste -- vorgesungen -- 
  Streit Wert Dichter fing neu -- 
  Sternbald hitzig Freund -- einigemal Name Florestan nennen -- Poet aufmerksam -- fragt -- erkundigen -- Gespräch Wendung -- 
  finden -- Streitenden verwandte -- umarmt -- freut -- Unverhofft antreffen -- Vergleichung Talent denken -- 
  Kapitel -- 
  Gesellschaft zerstreuen hierauf -- Franz verlassen Getümmel Haus -- Schloßgarten begeben -- 
  geschmückt Dame -- anfangs erkennen -- begegnet Gang -- -- Jägerin -- 
  grüßen freundlich -- kurz Gespräch trennen -- 
  Franz betrachten sinnend künstlich Springbrunn -- kristallen Strahlen Luft lieblich abkühlt -- sanft Geräusch ertönen lassen -- nah Vogel willig angenehm singen -- 
  hören mannigfaltig Wohllaut -- Wechselgesang -- Fontan gleichsam Waldbewohner führen -- Geist verlieren entfernt wunderbar Zaubergegend -- 
  täuschen -- -- selber -- ungewiß -- allenthalben süß Bild begegnen -- Phantasie Gestalt erkennen -- 
  Gräfin gleichen -- nennen wissen -- such ra -- leben gewiß verlieren -- 
  Flöte ertönt Gebüsch -- Franz setzen schattig Rasenbank -- Tönen ruhig zuzuhören -- 
  spielend Weile musizieren -- singen wohlbekannt Stimme folgen¬ Holdes -- holder Sehnsuchtrufen -- Wald -- Tale -- Klimm -- herab Felsenstuf -- Folge Oreade Rufen vertrauen weit Meer -- 
  sehen Gestalt wanken bewegt Zweig schwanken -- entschimmern Gedanke -- Schlaf hinweggefachen -- 
  komm Erinnerung -- lieb Treue -- Arm ruhen -- Nahe flüsternd weihe Brust -- fühlen Scheue Kraft Lebensmut -- 
  Kind lieben Scherz töricht Kind -- Treue verblieb Herz -- Leichtsinn froh Scherz -- sinnen -- 
  Wald Tal grün Hügel Kennt wünsch Brust -- golden Flügel Abendröte Hügel ziehen Lust -- 
  Erde Himmel Küssen Liebesscham entbrennen -- -- 
  Frevel büßen -- Holde miss Herz nennen -- 
  morgenröte gehen -- Bande frei -- Erde Himmel bräutlich prangen -- -- gefang -- Einsam süß Mai -- 
  lieb Mailust verschwinden -- Mai Blick -- Rose erfinden -- Flieht eilen träg Stunde -- Bringen Braut -- 
  Rudolf -- hervortreten -- Sternbald Rand Springbrunnen niedersetzen -- 
  erkennen -- Franz -- zärtlich Gesange stören -- siehst munterer -- erwarten -- 
  vergnügen -- Florestan -- heutig heitersn -- kennen Schöneres -- mancherlei empfinden -- deutlich fühlen -- Kopf Herz gleichsam golden Stern ziehen -- schwer Mensch lieben wohltätig Flamm durchschimmern -- 
  täglich Stimmung frisch Anklang erleben such Trägheit alltäglich Gewöhnlichkeit verlieren -- 
  Schluß deiner heutig Trinklied -- antworten Franz -- fallen -- unerlaubt -- Art Leichtsinn scherzen -- 
  O -- Freund -- rufen Rudolf -- schwerfällig -- augenblicklich Begeisterung ernst Strenge nimmst -- 
  Laß unschuldig Poesie Gang -- klar Bach ergießen -- Scherz Scherz bedeuten -- Entweihung Feierlichen Erhabene nehmen -- Tust nahe -- 
  sing Lied -- 
  Franz müssen vorig Lied wiederholen -- Florestan begleiten Flot -- endigen -- Rudolf -- 
  Gesang Nachmittag aufgeschrieben -- Abendrot Anfing heraufzurücken -- hört Flot anspielen -- Ton Instrument Verse -- 
  Beitrag Lied -- Sternbald -- Antwerpe sangst -- 
  aufgeschrieben -- manchmal finden -- Überschrift passen -- 
  tun -- Florestan -- unpassend -- -- -- mitfühlen -- beweisen -- 
  gleichsam Akzent -- Instrument freiwillig übergingen -- lebendig Wesen sprechen ausdrücken -- 
  -- Lust -- Gesprächstück mancherlei Tön aussinnen -- 
  -- antworten Franz -- Blume gewissermaßen vorstellen -- 
  freilich Charakter Ding -- Mensch wahrnehmen vermögen -- 
  geschehen Kunst -- antworten Florestan -- Tier richtig fühlen -- nah stehen -- 
  Lust -- Lämmer -- Vogel Tier Komödie formieren -- Blume Liebesstück Tön Instrument Trauer -- -- nennen -- Geisterspiel -- 
  meister Leute fantastisch finden -- Sternbald -- 
  Absicht -- antworten Rudolf -- Mühe geben -- niederzuschreiben -- 
  indes Abend -- 
  Kennst Dante's Gedicht -- 
  -- Franz -- 
  ähnlich allegorisch Weise lassen Offenbarung Natur schreiben -- voll Begeisterung prophetisch Geist durchdrungen -- 
  einigemal seltsam Art spanisch Poesie sprechen -- Getraust Wechsellied singen -- beschreiben -- 
  können versuchen -- Franz -- mußt Silbenmaß setzen -- 
  Rudolf fing -- 
  lieb Frühling aufgeschlag Zelt blühn Welt -- 
  Wolke abwärts jagen -- Tal voll Sonne -- Wald Wonne Lied durchklingen -- 
  -- Liebe schön Werk gelingen -- Franz -- 
  Liebe schön Werk gelingen Winter kalt entwich -- holdselige bezwungen -- 
  Blume süß Quell -- Fluß -- Befreit Bande Winter harct Schlaf erstanden -- 
  Rudolf -- 
  Winter hart Schlaf erstand Wechselsang Echoklang -- Waldgezweig finden -- 
  Nachtigall Gesänge schallen -- Lindendüft Liebkose liebevoll Frühlingslüft -- 
  Franz -- Liebkosen liebevoll Frühlingslüft -- 
  Blumenschaar beuten dar Rose glühn Felsenklüft -- lauben schwanken Geissblattranke -- Himmel Ferne Erhelle tausend golden Stern -- 
  Rudolf -- 
  Erhelle tausend golden Stern golden klein Flimmerschein Erleuchtet Erde gerne -- 
  Liebesblicke -- beglück Schaut grüßend nieder Liebe -- freuen Grüße -- Franz -- 
  Liebe -- freuen Grüße -- Blumenwelt zusellen -- gesandter Wald Lied -- schicken ros kos dank Streckt entgegen Geissblattsranken -- 
  Rudolf -- 
  Streckt entgegen Geissblattsranken Lilienpracht Grüßt fern Liebe erkranken leise drücken Blick Lilie Wange Liebe empfangen -- Franz -- 
  Liebe empfang Mädchenmund Geküßt Stunde -- Nachtigall plaudern Gesange -- 
  Liebe höret schwöret -- wachen Eide Verfolgt Frevelnde bitter leiden -- 
  Rudolf -- 
  Verfolgt Frevelnde bitter leiden -- Mädchen fliehen sehen -- gerne meiden -- 
  Hand welken Ros -- Nelken -- Himmelslichter Erblasse schlecht Dichter -- 
  aufhören -- Rudolf -- Aufstand -- gehören siebst reinsten -- 
  Freund gehen -- Abend dichtesn Schatten Garten ausstrecken -- Mond -- 
  Franz stehen sinnend Fenster Zimmer -- gegenüberliegend Berg -- Tann Eiche bewachsen -- hinauf schweben Mond -- erklimmen -- Tal glänzen funkelndgelben Licht -- Strom brausend Berg Schlos vorüber -- Mühle klapperen sau Ferne -- entlegen Fenster nächtlichen Hörnertön -- Monde entgegengrüßt -- drüben Einsamkeit Bergwald verhallten -- 
  Ton Leben verfolgen -- seufzen Franz -- zufrieden Ruhe -- dringen feindlich Schar innerst Gemüt -- wecken krank Kind -- Erinnerung unbekannt Sehnsucht -- 
  drängen Herz -- Flügel hinüberfliegen -- höh Wolke hinaus -- herab Brust neu -- schön Klang anfüllen schmachtend Geist hoch -- letzter Wohllaut ersättigen -- 
  Welt Liebesgesang durchströmen -- Mondschimmer Morgenröte anrühren -- Leid Glück widerklingen -- Melodie Baum -- Zweig -- Blatt Gräser ergreifen -- spielend Gesang Million Zunge wiederholen müssen -- -- -- 
  folgend früh aufgestand Schloß durchwanderen -- 
  Zimmer hing Brustbild Mann -- kostbar Hut blau Feder schmücken -- Miene ziehen -- genau betrachten -- glauben kopf Gesicht Mönch entdecken -- Bildhauer Bolz begleiten -- 
  Bild untersuchen -- überzeugend finden Ähnlichkeit -- -- 
  treten Rudolf -- Entdeckung mitteilen -- Florestan finden leichtsinnigen Art sonderlich wichtig -- brechen Gespräch -- -- 
  gestern -- Franz -- anderer Gedicht schreiben -- versuchen -- Stimmung ausdrücken darstellen -- Seele erfüllen -- 
  lesen -- Mondscheinlied -- 
  Träuft Himmel kühl Tau Blume Kelche -- Spätrot sehen scheidend Au -- Flüstern Pappel -- sinken nieder nächtig Ruhe -- 
  Schatten Wolke bleiben spät ziehen schwer -- unbeholfen Lauf erfrischt Matt -- 
  Stern schwind Bllck winkend flüchtig nieder -- Wohnt Wald Dunkelheit Dehnt Finster breit -- 
  Hinterm Wasser flimmend Flamme -- Berggipfel Gold beschienen -- Neig rauschend ernst grün Gebüsch blinkenden Häupt -- 
  Welle -- rollst herauf Schein Monde freundlich Angesicht -- 
  merkt_es freudig bewegen Hain Streckt Zweig -- entgegen Zauberlicht -- 
  Fangen Geist Flut springen -- Nachtblum Kling -- Wacht Nachtigall dickst Baum verkünden dichterisch Traum -- hell -- blendend Strahl Ton niederfließen Bergeshang Widerhall grüßen -- 
  Flimmer Welle -- Funkel wandernd Quelle -- Streife durch Gesträuch Feuerwürmche bleich -- 
  -- Wolke wandeln Sehne -- Gedanke dunkel hell -- Hüpfen Wunsch Quell -- Kenne brennend Träne -- 
  nah -- -- Glück erblühen -- 
  -- Hand bieten Mond Einsamkeit -- 
  Kommt_es Walde -- schleicht_es Tal -- Steigen Berg hernied -- 
  alt Schmerz -- 
  Wolke entflohen Qual -- 
  Zukunft Vergangenheit -- Bleiben Strom ruhig stehen -- -- 
  Glück entgegen -- Liebesglück einst Vergangenheit -- 
  Wolke schwinden -- finden Blume -- Jugend einst entschwinden -- -- Frühlingslieb Stunde -- steige Sehnsucht nieder -- 
  Kapitel -- 
  indes verflossen -- Sternbald Gräfin malen anfangen -- müssen Ritter zeichnen -- Mönch ähnlich -- 
  Geist Schönheit Gegenstand beschäftigen -- wissen -- Gegenwart Jägerin unbekannte erinneren -- Bildung selber Liebgewann -- 
  lassen Jägerin darstellen -- fast -- erstenmal sehen -- 
  lassen Musik Saal bringen -- -- Hand sicher geläufig -- Geist Kunst lieblich antreiben -- 
  zittert -- zart Umriß Busen anblicken abzeichnen -- Glanz schalkhaft feurig Auge ausdrücken -- 
  Florestan Schloß verlassen -- schwärmt benachbart Gegende umher -- niemals Ort verweilen -- 
  Franz benutzen -- Dürer Sebastian weitläufig Brief schreiben -- verschieben -- 
  sprechen Gräfin -- malen -- Aufmerksamkeit gewöhnlich zerstreuen -- 
  Gräfin Laune -- sogar Stunde Stimmung Gemüt auffallend verändern -- 
  Franz fühlen Teilnahme -- traurig -- quälend Verlegenheit -- vertraulich Lustigkeit nah -- 
  Musik trösten beruhigen -- -- angeschlagen Akkorde dreist kühn machen -- Ton Beistand zärtlich Freund nahe -- Hand arbeiten schnell Williger -- Gemüt durchsichtig rein hell Bach -- 
  Gräfin scheinen gewinnen -- Franz gewöhnlich stumm -- sprechen desto -- lebhaft Beweglichkeit ertrug Stillstand Minute -- schaffen -- erzählt hundert Geschichte -- Sternbald selten Munterkeit stören -- 
  erfahren Erzählung -- verwandte Italien Rom -- Brief mitzugeben versprechen -- 
  schildern Lebensart Familie Eigenheit Charakter klein Umstand -- -- Stellung Miene nachahmen -- wodurch Franz zuweilen Male aufhalten -- unterließ -- Arbeit Laune unterbrechen -- Garten spazieren -- 
  verlieren plötzlich trübselig Nachsinn -- wehmütig Klage -- Franz vieler Anstrengung Amt tröstend Freund übernehmen müssen -- 
  Sternbald Kopf fast vollenden -- Abschilderung Ritter -- Lebhaftigkeit erhöhen -- 
  müßn wissen -- Freund -- -- Bild wahr Stümper edl Kunst herrühren -- verstehen -- holdselig Angenehme Antlitzes fühlen ausdrücken -- -- Kopf gewöhnlich Sinn fertig -- Original Grobe ähnlich sehen -- 
  müßt Klarheit Auge -- süß lächeln freundlich Lippe vorstellen -- Bild Anweisung dergleichen -- 
  O -- -- ständ -- Arm schön Nack schlängen -- 
  unmöglich vorstellen -- Gemälde notwendig kalt -- 
  freilich sehen ähnlich -- kalt fühllos -- 
  umherirren -- -- 
  stehen -- Franz müssen Malerei Seite legen -- gehen benachbart Gehölz -- 
  letztemal -- fahren Gräfin fort -- steigen Roß -- heuchlerisch Lebewohl -- wollen Abend wiederkommen -- Seele Abend -- -- 
  undankbaren vergessen -- Andenken -- Bild Herz verstoßen -- glücklich zufrieden -- vormals -- 
  töricht Herz -- Welt aufsuchen -- wissen -- wohin -- 
  finden niemals -- -- -- setzen Schatten nieder -- Stillschweigen fahren Dame fort -- kürzlich Geschichte erzählen -- unbedeutend -- Eurem Wesen -- Blick Eurer Auge -- zutrauen abgewinnt -- 
  unglücklich -- verlassen fühlen -- sehnen Mitleider gut Seele -- herrlich Gabe -- leiden vertrauen -- 
  nachher -- Tod Vater Besitz Gut setzen -- erscheinen Nachbarschaft jung Ritter -- vorgeben -- kommen Franken -- 
  jung -- schön liebenswürdig -- allenthalben -- 
  verging -- scheinen -- Gegenwart meisten gefall -- freu -- Bezug -- 
  schmeichelt Vorzug -- entgegen -- -- schenken reinst Wohlwollen -- Fehler unser Geschlecht -- List Verstellung glauben -- Irrtume blenden lassen -- können Betrüger niemals betrügen -- 
  weitläufig -- 
  kennen Herz -- gehören hinterlistig Rotte -- 
  gestehen Liebe -- Zuneigung -- nennen Name -- bekannt -- arm Edelmann -- Glück anbieten können -- Herr Besitztümer -- finden -- Eigentum -- schenken -- 
  Verlobung -- Vermählung bestimmen -- plötzlich Jagd Stelle verlassen -- 
  wollen Freund Nachbarschaft besuchen -- Vorgebe -- lächelen -- Fortritt -- sehen -- 
  Franz Erzählung antworten -- bleiben kehren -- wünschen Freund Florestan -- Lage Leben Leichtigkeit finden -- 
  indes Abend -- Jäger kommen Jagdmusik Walde -- Gespräch beendigen -- 
  Sternbald verdrießlich -- Gegenstand Gespräch hart Gemüt fallen -- Eindruck bemeistert Lebenslauf stören -- 
  lang wunderbar Mensch sprechen hören -- benachbart Berg aufhieln -- halb wahnsinnig -- Einsamkeit leben -- niemals öd Aufenthalt verlassen -- 
  Franz anziehen -- -- abenteuerlich Eremit Maler -- gewöhnlich -- besuchen -- Bildniß Malerei zeigen -- billig Preis verkaufen -- 
  erzählen Wunderbar Manne -- Franz Begier unmöglich widerstehen -- selber ausuchen -- 
  Florestan zurückkommen -- Gräfin Jagd -- Lieblingsergötzung anstelln -- schön Weg -- bezeichnet Aufenthalt suchen -- 
  unterwegs überdachen lang Veränderung Leben -- scheinen sonderbar gewöhnlich -- wünschen Fortsetzung Schicksal fürchten -- erstaunen selber -- Enthusiasmus -- Reise antreiben -- selten besuchen -- 
  stehen Hügel -- Tale versammelt Jagd -- Schloß ausreten -- Ebene verbreiten -- 
  klang musikalisch Ton hinauf -- frisch Berg widerschallen -- Eich Tanne rühren bedeutungsvoll -- 
  verlieren Jagd Gesichte -- Musik Hörner verschwinden -- wenden tief Gebirge hinein -- Gegend plötzlich anmutig Charakter verlieren -- wild verworren -- Aussicht eben Land schließen -- verlieren voll herrlich Strom Gesicht -- Berg Fels kahl unfruchtbar -- 
  Weg Wand eng schmal Fels hindurch -- Tannengebüsch wechselt kahl Boden -- Stunde stehen Franz hoch Gipfel Gebirges -- 
  Vorhang niedergefallen -- Blick öffnet Ebene -- kahl Fels verlieren lieblich grün Gemisch Wälder Wiese -- unfreundlich Natur verschwinden -- lieblich Aussicht eins -- übrig verschönern -- dienen selber Gegenstand verschönern -- 
  liegen Herrlichkeit Strom ausbreiten -- glauben plötzlich Anblick weit -- unendlich -- mannigfaltig Natur vergehen -- -- herzdurchdringend Stimme hinaufsprach -- feurig Auge Himmel glänzend Strom heraus blicken -- Riesenglieder hindeuten -- 
  Franz strecken Arm -- Unsichtbar ungeduldig Herz drücken -- erfassen festhalten -- wonach Sehnsucht drängen -- Wolke ziehen unten Horizont blau Himmel -- Widerscheine Schatten streckt Wiese -- wechseln Farbe -- fremd Wunderton gehen Berg hinab -- Franz fühlen festgezaubern -- Gebannter -- zaubernd Gewalt stehen -- unsichtbaren Kreis -- trotz Bestreben -- entreißen -- 
  O -- unmächtig Kunst -- rufen -- setzen grün Felsenbank nieder -- lallend kindisch Ton -- voll harmonisch Orgelgesang -- innerst Tiefe -- Berg Tal Wald Stromesglanz schwellend -- steigend Akkord heraufquillt -- 
  hören -- vernehm -- ewig Weltgeist meisternd Finger furchtbar Harfe Kläng greifen -- mannigfaltigst Gebilde Spiel erzeugen -- umh Natur geistig Flügel ausbreiten -- 
  Begeisterung Menschenherzen hineingreifen -- ringen müde matt Kampfe Hohe -- Natur leise lieblich regieren -- Hindräng -- Winken Hilfe Allmacht Schönheit wahren -- 
  unsterblich Melodie jauchzen -- jubeln stürmen hinweg -- Boden werfen schwindeln Blick starr Sinn -- 
  O -- Töricht -- Meinung -- allgewaltig Natur lassen verschönen -- Kunstgriffen kleinlich Hinterlist eur Ohnmacht Hilfe eilen -- -- Natur ahnden lassen -- Natur Ahnung Gottheit -- 
  Ahnung -- Vorgefühl -- urkräftig Empfindung -- sichtbar wandelt Höh Tiefe Religion -- empfängen tragen gütig Erbarme Anbetung -- 
  Hieroglyphe -- Höchste -- Gott bezeichnen -- liegen tätig Wirksamkeit -- Arbeit -- selber auflösen aussprechen -- fühl Bewegung -- Rätsel Begriff schwinden -- -- fühlen Menschheit -- -- 
  hoch Kunst erklären -- Gesang -- Inhalt vermögen -- 
  Unger verlassen Sternbald Begeisterung -- Gegend -- entzücken -- trauert Wort -- Gedanke -- aussprechen -- frisch Kraft aufbewahren können -- Eindruck Idee Empfindung vertilgen überschüten -- 
  dicht Wald empfangen Höhe -- werfen Blick -- scheiden ungern -- Leben verließen -- 
  einsam Schatten erregt frei Landschaft seltsam Empfindung -- Brust beklemmen Ängstlichkeit zusammengezogen -- 
  halb Stunde gehen -- stehen Hütte -- -- antreffen -- 
  ermüdet werfen Baum -- betrachtet beschränkt Wohnung -- dürftig Gerät -- vieler Rührung alt Laute -- Wand hing -- Saite fehlen -- 
  Palette Farbe liegen stehen umher -- Kleidungsstücke -- Sternbald uralte versetzen -- erzählen hören -- Tür Riegel kennen -- Frevler betasten -- 
  alt Maler -- wunderen -- Fremdling Schwelle antreffen -- Hütte -- räumen -- spielen Zither -- Zugeg -- 
  Franz betrachtet alt Verwunderung -- indessen Kind Haus sitzen -- erkennen -- Heimat -- befreundet -- wohlbekannt Ton Instrument -- 
  Spiel geendigen -- packen Kräuter -- Moos stein Tasche -- legen sorgfältig Schachtel zurecht -- jeder aufmerksam betrachten -- 
  lächelen -- anderer scheinen Verwunderung anzuschauen -- Hand zusammenschlagen -- ernsthaft Kopf schütteln -- 
  Sternbald -- Haus hineintreten -- Gruß anbieten -- 
  alt Mann Hand -- nötigen schweigend -- niederzusetzen -- weder verwundert -- fremde genau beachten -- 
  Hütte mannigfaltig Stein aufgeputzt -- Muschel stehen umher -- durchmengen seltsam Kräuter -- ausgestopft Tier Fisch -- höchst abenteuerlich ansehen erhalten -- 
  Stillschweigend holen alte unser Freund Frucht -- ebenfalls stumm Gebärde vorsetzen -- 
  Franz gegessen -- wunderbar Mensch beobachten -- fing Wort Gespräch -- 
  lang freuen -- sehen -- hoffen -- zeigen euer Malerei -- vorzüglich begierig -- edl Kunst bekennen -- 
  Maler -- rufen alt -- wahrlich -- freuen -- sehen -- begegnen -- 
  jung -- schwerlich Sinn Kunst -- 
  tun mögliches -- antworten Franz -- gute -- fühlen freilich -- zureicht -- 
  -- rufen -- freilich Wenige geben -- wahrst Höchste ausdrücken -- eigentlich nähern -- unser Zweck gewißlich erreichen -- erkennen -- Allmächtige hineinlegen -- 
  Welt -- Vorsätz leben -- eigentlich handeln liegen jenseits -- bestehen gewiß eigentlichst -- wirklich Gedanke -- bunt Welt liegen -- 
  großmächtig Schöpfer heimlich kindlicherweis Natur unser schwach Sinn offenbaren -- -- sprechen -- dermalen schwach -- verstehen -- winken -- Moose -- jeglich Gestein geheim Ziffer verbergen -- Hinschreibe -- völlig erraten lassen -- beständig wahrnehmen glauben -- 
  fast Künstler -- wunderlich -- fremd -- unbekannt Licht scheinen heraus -- lassen zauberisch Strahlen kristall Kunst übrig Mensch entgegenspallen -- erschrecken -- Weise verstehen begreifen -- 
  vollenden Werk -- Geoffenbarten liegen weit Land -- unabsehlich Aussicht -- Menschenleben -- himmlisch Glanz überleuchten -- heimlich Blume hineingewachsen -- Künstler selber wissen -- Gott Finger hineinwirken -- ätherisch Zauber anduft unmerkbar Künstler Liebling Gott verkündigen -- 
  sehen -- denken Natur Kunst -- 
  Franz Erstaunen fesseln -- Wort anreden -- erschrak selber -- Mund Mannes -- übrig Leute wahnsinnig nennen -- eigen Gedanke deutlich aussprechen hören -- Bannsprüche Seele fern Hinterhalt hervorgezaubern -- unkenntlich Ahnung anschaulich Bild schwebten -- 
  willkommen Ton -- rufen -- irren -- still Glaube anlangen -- behilflich würden -- Irre zurecht finden -- 
  irren -- alt -- irren -- jenseits Irrtum liegen gewiß Wahrheit -- stehen gewiß entgegen -- Wort -- Mensch Unbehilflichkeit dichten -- bezeichnen -- meinen -- 
  Versteht -- 
  -- Sternbald -- 
  alte fahren fort -- 
  malen -- sprechen singen -- eigentlichstes bewegen -- übrig helfen -- Geist verschmähen Wort Zeichen -- aufdrängen -- hantieren -- gebrauchen Spiel -- 
  entstehen Kunst -- eigentlich denken beschaffen -- 
  Franz erinnern -- Dürer einst Gedanke fast nämlich Wort ausdrücken -- 
  fragen -- halten Höchste -- wohin Mensch gelangen können -- 
  zufrieden -- rufen alt -- Ding zufrieden -- verwandeln himmlisch Kunstwerk -- läutern Feuer Gottheit -- 
  bringen -- fragt Franz -- 
  -- fahren fort -- -- -- meister -- Geist seltsam Welt verkümmern -- 
  entstehen -- selten -- selten selber inne -- 
  suchen euer Gemälde -- Sternbald -- finden -- euer Gespräch Kunst erwarten -- 
  -- alt einiger Verdruß -- Kunst gebären -- verunglückt Künstler -- eigentlich Beruf antreffen -- 
  ergreifen Gelüste -- Leben elend -- 
  Kindheit Bestreben -- Kunst leben -- unwillig abwenden -- niemals Sohn erkennen -- dennoch arbeiten -- geschehen gleichsam Rücken -- 
  öffnet Tür -- führen Maler Stube -- voll Gemälde hing -- 
  meister Kopf -- Landschaft -- Historie -- 
  Franz betrachten vieler Aufmerksamkeit -- indes alt Mann schweigend verfallen Vogelbauer ausbesseren -- 
  Bild spiegelt streng -- ernst Gemüt -- Zug bestimmen -- Zeichnung scharf -- Nebendinge Fleiß wenden -- Gesicht schweben -- Blick anziehen zurückstassen -- sprechen Auge Heiterkeit -- grausam nennen -- seltsam entzücken -- erschreckt furchtbar Miene -- 
  Franz fühlen unbeschreiblich einsam -- vollends Fenster Berg Wald hinübersehen -- fern Ebene Mensch -- Haus unterscheiden -- 
  Franz Betrachtung geendigen -- alt -- glauben -- Besonderer Bild finden -- seltsam Stimmung verfertigen -- 
  malen -- deutlich bestimmt sehen -- eigentlich darstellen -- 
  manchmal Schein Abendsonne Hütte sitzen -- frischen -- Berg herab -- Flur hingehen -- rausch Bildnis Apostel -- heilig Märtyrer Bäume -- sehen Miene -- ben -- fordern -- abzuzeichnen -- 
  greif Pinsel Palette -- bewegt Gemüt -- Inbrunst hoch Mann -- Liebe verflossenen ergreifen -- schattiern Trefflichkeit irdisch Farbe -- Sinn -- Auge erglänzen -- 
  glücklich Mann -- Franz -- Rede erstaunen -- 
  -- alt -- Künstler Urteil niemals arbeiten -- Begeisterung -- 
  Maler -- -- darstellen -- 
  Gemüt Strom bewegen -- innerer Welt tief Grund erschüttern -- ordn bunt Verwirrung Gestalt -- Brüdern offenbaren -- 
  Glaube -- Künstler Art begeistern -- sprechen Begeisterung -- natürlich Ding -- unerklärlich -- -- -- Frühlingslicht -- unvermuten Wolke niederkommen -- -- ehe Genießest -- zurückgeflohen -- 
  Franz verlegen -- antworten -- ungewiß -- alt Maler Wahnsinn befallen -- Sprache Künstler reden -- 
  zuweilen -- fahren alt fort -- reden umgebend Natur -- erregen -- Kunst üben -- 
  Versuch niemals Natur -- such Charakter Physiognomie herauszufühlen -- fromm Gedanke hineinzuleg -- Landschaft schön Historie verwandeln -- 
  hierauf jung Maler Landschaft aufmerksam -- abseits hing -- 
  nachtszene -- Wald -- Berg Tal liegen unkenntlich Masse -- schwarz Wolke tief Himmel hinunt -- 
  Pilgram Nacht -- Stabe -- Muschel Hute kennbar -- zog dichte Dunkel -- selber verstohlen Mondstrahle erschimmeren -- finster Hohlweg deuten -- Hügel fern glänzt Kruzifix -- Wolke teilen -- Strahlenregen Monde ergießen -- spielt heilig Zeichen -- 
  sehen -- rufen alt -- zeitlich Leben überirdisch -- himmlisch Hoffnung malen -- sehen Fingerzeig -- finsteren Tal herauf mondig Anhöhe rufen -- 
  -- wandernd -- verirrt Pilgrim -- 
  unser Weg erhellen -- Licht -- 
  Kreuze dringen lieblich Gewalt Strahl Welt hinein -- beleben -- Kraft aufrecht halten -- 
  sehen -- suchen -- Natur verwandeln -- menschlich künstlerisch Weise sagen -- Natur selber reden -- sanft Rätsel niederlegen -- entfesseln -- leicht errat stehen -- erhaben -- Natur Bedeckung schlagen -- 
  -- antworten Franz -- Gemälde allegorische nennen -- 
  Kunst allegorisch -- Maler -- nehmen -- 
  Mensch darstellen -- einzig bestehend -- abgesondern ewig geschied übrig Welt -- Gegenstand sehen -- 
  Kunst -- 
  fügen -- suchen einzeln Sinn aufzuheften -- entstehen Allegorie -- 
  Wort bezeichnen wahrhaft Poesie -- hoch Edle suchen -- Weg finden -- 
  Gespräch Hänfling unvermerkt Käfig entwischen -- alt Tür Zerstreuung gelassen -- 
  schreien erschreckend -- Verlust bemerken -- suchen umher -- öffnet Fenster -- locken pfeifend liebkosend Flüchtig -- wiederkommen -- 
  Weise zufrieden geben -- hören Sternbald Wort -- trösten suchen -- 
  Sternbald -- zerstreuen -- 
  glauben einsehen -- Landschaft denken -- dünken -- -- 
  Zweig Blatt -- genau Kopie Gräser Blume -- 
  Pflanze -- Berg abschreiben -- Gemüt -- Stimmung -- Moment regieren -- selber festhalten -- übrig verständigen mitteilen -- 
  -- rufen alt -- kümmern -- Hänfling -- 
  leiben -- fragt Franz alt verdrießlich -- 
  leiben -- lieben -- 
  machen sonderlich Unterschied -- 
  denken schön Gesang -- Liebe -- beweisen -- Treulosigkeit vermuten -- 
  Gesang -- durchfliegen Wald -- einzeln -- bekannt Vogel vermischen übrig Geschlecht -- 
  gehen hören -- sehen -- kennen -- halten fremd Person -- 
  Freund verlassen -- 
  Freund -- sterben -- tun -- allmächtig Erde vermischen -- unkenntlich -- 
  Wald hineingeflogen -- kennen -- herausfinden -- 
  Tor -- verlieren wähnen -- Kind -- schreien jammern -- Eltern Verstecken's spielen -- Gestorbene -- kurz Augenblick Wiederfinde rechnen -- 
  Gleichnis vollenden -- 
  Freundschaft Käfige -- trennen Vogel übrig -- kennen lieben -- umgeb Gefängnis -- eigentlich abzusondern -- 
  Freund sondern Freund übrig Welt -- halten ängstlich arme einschließen -- lassen -- -- zärtlich -- liebevoll -- Eifersucht bewachen fremd Liebe -- verlören Strudel Welt -- Freund verlieren abgestorben -- -- 
  Sieh -- Sohn -- Futter verzehren -- leiben -- verlassen -- 
  sorgfältig pflegen -- Freiheit -- 
  Mensch gewißlich Herz lieben -- rufen Sternbald -- 
  -- -- Tier stehen nah -- kindisch Kind -- Liebe unterhalten -- ungewiß unbegreiflich -- Mensch rechnen -- Bezahlung wahrnehmen -- vermissen Liebe -- Tier duldend -- Trefflichkeit bemerken -- stehen -- dumpf Existenz fühlen einsehen -- entstehen magisch Freundschaft -- Mitleid -- Zuneigung -- sagen Furcht -- mischen -- erklären lassen -- 
  kürzlich Geschichte Auszuge erzählen -- begreifen -- hierher geraten -- 
  verlassen Hütte -- setzen Schatten alt Baume -- schwieg Weile -- fing alt Maler folgend Erzählung -- 
  Italien gebären heiß Anselm -- 
  Jugend sagen -- 
  Eltern sterben früh -- hinterlassen Vermögen -- zufiel -- mündig -- 
  Jugend leicht Traum verflogen -- Erinnerung Gedächtnisse haften -- Erfahrung -- 
  entflohen Art nossen -- zufrieden vergnügen -- 
  -- Leben eintreten -- -- -- Platz anzufüllen -- Rede -- achten -- 
  Kindheit Trieb Kunst spüren -- Malerei -- Seele anziehen -- Ruhm damalig Künstler begeistern -- 
  Perugia -- Pietro besonderer Rufe stehen -- Lehre geben -- 
  ermüdet Geduld -- lernen jung Leute kennen -- ähnlich Gemütsart vertrauen Freund -- 
  lustig -- singen -- tanzen scherzten -- Kunst denken -- 
  Franz fallen Rede -- fragen -- erinnern -- Meister Pietro Raffael Lehre stehen -- 
  Raffael Sanzio -- 
  O -- alt -- unbedeutend Knabe -- sonderlich Rücksicht -- 
  erstaun -- Name eigentlich wissen -- 
  erstaune -- -- rufen Sternbald -- 
  wißen -- Knabe Maler -- Munde führen -- anbeten -- 
  sterben -- Europa trauern Verlust -- Mensch wohnen -- Kunst kennen -- -- Göttlichkeit Malerei tief ergründen -- 
  Anselm stehen Weile kehren -- brechen -- 
  O -- wunderbar Vergangenheit -- 
  Bestrebe bleiben -- kommen -- unbekannte innigst Wunsch ergreifen Eigentume -- 
  -- wahrlich umsonst leben -- 
  Erzählung beendigen -- 
  scheinen Welt glänzend jung Leben hinein -- erblickt Freundschaft Liebe -- 
  Mädchen -- kennen lernen -- ziehen Aufmerksamkeit -- lieben innig -- Woche Gattin -- 
  hemmen Freude Entzückung -- blendend -- ungestört Strom Lebenslauf -- 
  Gesellschaft Freund Liebe -- Wein erhitzen -- -- wunderbar Kraft Innerst entwickeln -- beginnen Welt Epoche -- 
  Stunde -- Freude übrig lassen -- legen Kunst -- zuweilen -- Himmel herab golden Strahl Herz hineinschienen -- Lebensgeister erläutern erfrischt -- 
  drohen gleichsam ungeboren unsterblich Werk -- Hand ausführen -- übrig Kunst -- Gemein Alltäglich hinab -- warten selber Sehnsucht Malerei -- hoch Genius ankündigen -- 
  glücklich Leben -- 
  indessen Vermögen aufgehen -- 
  Freund kälter -- Freude erlosch -- Gattin krank -- Entbindung nahe -- fing -- Kunsttalent zweifeln -- 
  dürrer Herbstwind weht Empfindung hindurch -- Traum frisch Geist entrückt -- 
  Not groß -- suchen Hilfe Freund -- verlassen -- entfremdeten -- 
  glauben -- Enthusiasmus erlöschen -- können Glück niemals mangeln -- plötzlich einsam -- 
  erschrak -- Streben Töricht erscheinen -- Innerst ahnden -- Kunst niemals lieben -- 
  O -- drückend Monat zurückdenke -- 
  Herz entwickeln -- grausam Wirklichkeit Phantasie losarbeitet Trennt -- 
  suchen allenthalben Hilfe -- versuchen schmählichsen -- fristen -- 
  fühlt treiben Welt -- lernt Not kennen -- arm Bruder teilen -- 
  vorher menschlich Tätigkeit -- mitleidswürdig Arbeitseligkeit verachten -- Träne Auge verehren -- schämt zerlumpt Tagelöhn -- schweiß angesichts täglich Brot erwerben -- hoch hinausdenken -- neu beginnen -- 
  vorher Welt schön Form lachend Auge aufsuchen eingeprägen -- angespannt Pferd Ochsen Sklaverei -- Dienstbarkeit -- Landmann ernähren -- neidisch schmutzig Fenster Hütte hinein -- seltsam poetisch Idee antreffen -- Hausstand Glück Familie berechnen -- 
  O -- erröten -- Wort Kunst aussprechen -- fühlen unwürdig -- -- vorher Göttlichste erscheinen -- müßig -- zeitverderbend Spielwerk -- Anmaßung leidend arbeitend Menschheit -- 
  Dasein überdrüssig -- 
  Freund -- helfen -- verreisen -- 
  überließ Verzweiflung -- 
  Gattin sterben Wochenbett -- Kind tot -- 
  liegen Kammer -- erlosch Auge -- 
  -- gelieben -- treten fürchterlich Gleichgültigkeit -- -- halten -- Fremdling Abschied -- 
  Gestalt Welt -- -- Inneren bewegen -- verwirrn verwildern -- 
  -- verlieren -- Fremdest -- verhaßteste -- 
  Rang Kampfe -- sterben -- verlieren Vernunft -- 
  wahnsinnig -- 
  wissen Herumtrieb -- erleben -- 
  Kapelle Meile finden Besinnung -- 
  Traume erwachen -- längst vergessen Freund stehen sehen -- seltsam überraschen -- erschrecken -- selber -- 
  Wohn -- 
  Gemüt Himmel widmen -- 
  vergessen -- 
  brauchen -- besitzen Gutheit Mensch -- 
  -- fahren einiger Stillschweigen fort -- Natur vorzüglichst Studium -- 
  finden allenthalben wunderbar Bedeutsamkeit rätselhaft Winke -- 
  Blume -- Muschel erzählen Geschichte -- erzählen -- 
  Seht wunderbar Moose -- 
  wissen -- dergleichenin Welt -- bestehen Welt -- 
  trö übrig Mensch -- 
  unendlich Mannigfaltigkeit Gestalt -- bewegen -- gleichsam Leben erstreben andeut -- leben -- beruhigen -- müssen -- Bahn niemals verirren -- ehemals wähnen -- 
  -- indessen spät -- 
  Franz -- vorher abkaufen -- leicht Art Geschenk können -- 
  umh -- begriff selber -- Bild entgehen -- bemerken -- 
  genau Bildnis unbekannte -- Zug -- Miene -- erinnern -- 
  hastig herab -- verschlingen Auge -- Herz klopfen ungestüm -- 
  fragen -- erzählt alt -- jung Frauenzimmer -- malen -- besuchen -- holdselig Gesicht Gedächtnisse eingepragen -- nachh Leichtigkeit zeichnen -- 
  Nachricht Mädchen geben -- 
  Franz bitten Bild -- alte bewilligen -- 
  Franz drücken hierauf größ Geschenk Hand -- anfangs zugedenken -- 
  alte stecken -- Goldstück besehen -- umarmen -- 
  Bleibe herzlich treu sinnen -- Sohn -- lieb Kunst -- -- 
  Künstler selber lieben -- verehr -- nachteilig Verachtung Zugang verstatn -- 
  Ding glücklich -- 
  Franz drücken Brust -- Berg hinunter -- 
  Erzählung alt Maler wehmütig -- leuchten -- -- Bestimmung irren -- frisch Kraft Andenken Bild geliebter Seele zurückgekommen -- 
  Schlos -- Weg bemerken -- Gräfin vermissen -- Bildnis begierig -- müssen folgend malen -- 
  Franz finden ungemein liebenswürdig -- Gesellschaft verlegen -- erzählt Wallfahrt alt Maler -- Geschichte kürzlich wiederholen -- 
  Gräfin -- 
  wahrlich -- alt Einsiedler ungemein Art liebgewonnen -- sprechen -- Gefälligkeit -- Fragenden einzig Wort antworten -- wissen -- Einzig Geschichte erzählen -- 
  Franz zeigen hierauf Gemälde -- kaufen -- Zusammenhäng erwähnen -- Bild Leben -- 
  Gräfin erstaunen -- 
  -- -- rufen -- arm -- unglücklich Schwester -- 
  euer Schwester -- Franz erschrocken -- nennen unglücklich -- 
  -- antworten Gräfin -- Monat tot -- 
  Franz verlieren Sprache -- Hand zittert -- unmöglich -- malen -- 
  fahren fort -- tragen quälen unglücklich Liebe -- Leben wegzehren -- Reise Deutschland -- zerstreuen Gesunder -- sterben -- 
  alte sehen -- erfahren -- nachher malen -- 
  Franz erschüttern -- 
  stehen verlassen Saal -- 
  irren umher -- werfen weinend dichtest Stelle Gehölz nieder -- Wort -- betäuben -- schallt Ohr -- -- 
  ewig verlieren -- niemals -- rufen -- 
  O -- hart Weise -- Schicksal Wahnsinne heilen -- 
  O -- Blume -- süß Wort -- erfreulich -- holdselig Schreibtafel -- tragen -- -- -- vorüber -- 
  -- Jugend beschließen -- jung Wunsch -- liebreizend Hoffnung verlassen -- ruhen tief Grab -- 
  Leben Leben -- Ziel -- streben -- hinweggenommen -- einsam -- 
  Haupt -- Sonne -- Blume wenden -- liegen Grab unkenntlich -- 
  -- Anselm -- weit Wald hineingeflogen -- lieb Sängerin -- Herz beherbergen -- Gesang erinnern -- fließend Waldbäch ermuntern -- fort weinen -- selber -- 
  Kunst -- Ruhm -- -- Fuß legen -- 
  folgend Rudolf -- Franz Geheimnis geflissentlich verbergen -- fürchtet heiter Mutwille Freund -- Schmerz Spötterei Preis geben -- 
  Rudolf erzählt kurz Wort Geschichte Wanderschaft -- herumgetrieben -- erleben -- 
  Franz hören -- Verlust innig beschäftigen -- 
  verwandter finden -- Sternbald -- dünken -- Freust sonderlich -- 
  Familie -- -- ziemlich ausbreiten -- niemals Ort bleiben -- Vetter Muhme antreffen -- 
  dergleichen Ungewöhnlich -- 
  langweilig Mann -- sprechen -- sagen wissen -- 
  führen langweilig Leben -- -- Sternbald -- traurig verdrießlich -- Ziemt -- 
  sorgen -- Beschäftigung -- womit vertreiben -- 
  dien Schloß Seite bringen bereden -- -- Mädchen Nachbarschaft einladen -- folgend lustig Fest Walde begehen -- 
  Franz entschuldigen -- Gesellschaft leisten können -- Florestan hören -- 
  vergnügen -- Franz -- -- Jugend vorüber -- arbeiten -- Zukunft geschäftig -- 
  folgend erscheinen -- 
  Florestan anordnen -- 
  versammeln Nachmittag Walde -- Gräfin Erlaubnis erteilen -- kühlst -- schattig Platz aussuchen -- dickst Eiche stehen -- Rase grünsen -- 
  Rudolf empfangen Ankömmling fröhlichen Schalmeilied -- Mädchen zierlich putzen -- Jäger Diener Bänder bunt Zierat schmücken -- 
  kommen Spielleute -- lustig aufspielen -- wobei Wein verschieden Kuchen Runde gehen -- 
  Hitze Tag Ort dringen -- Bäch fern Gewässer spielen lieblich Waldorgel -- Gemüt fröhlich -- 
  grün Grase lagern -- Lied singen -- Fröhlichkeit atmeten -- 
  lieb Kuß Rede -- schön Busen erwähnen -- Mädchen lachen fröhlich -- 
  Franz wehren anfangs Freude -- beseeln -- suchen Traurigkeit -- hell -- lieblich Strom ergriff kristallen plätschernd Welle -- Genoß Gegenwart vergessen -- verlieren -- 
  sitzen blond Mädchen -- freundlich Gespräch beginnen -- rund frisch Mund -- lieblich Auge -- hebend Busen ununterbrochen betrachten -- 
  Kühler -- ordnet rund Rasenplatze lustig Tanz -- 
  Rudolf Art fantastisch schmücken -- glich schön idealisch Figur Gemälde -- 
  Ausgelassenst -- spiegelt Fröhlichkeit lieblichsen -- 
  Franz tanzt blond Emma -- Händedruck erwidern -- Reigen herunter entgegen -- 
  Platz Tanz fast eng -- sondert -- auszuruhen -- Florestan -- Sternbald Blonde -- 
  Abseits befestigten Franz Rudolf Seil dick -- nahestehend Eiche -- Brett finden Schaukel fertig -- 
  Emma setzen furchtsam hinein -- fliegen Takt schwung Musik Waldschatten -- 
  lieblich -- hinauf Wipfel schwanken -- Göttin herabkam -- leicht Bewegung schön Zirkel beschreiben -- 
  Franz finden schön -- Busen verräterisch halb bloß -- Bewegung Schaukel entblössen zierlich Wade schön runder Knie -- Schwung hoch treiben -- entdecken lüstern Auge rund -- weiß Schenkel -- sitzen ängstlich unbefangen -- denken -- vorsichtig -- vorsichtig Fall befürchten -- 
  -- Freund -- rufen Rudolf öfter -- vergnügen -- 
  Laß Grill schwinden -- 
  Franz reizend Gestalt -- Luft bewegen -- 
  tanzes überdrüssig -- setzen nieder -- ergötzen Lieder aufgegeben Rätsel -- 
  ertrug Sternbald Mutwille Poesie -- alt Reimen Reize Liebst lobpreisen -- 
  stimmen -- verlassen blond Emma niemals -- Auge -- 
  Abend brechen -- gespalten Schimmer fließen Abendrot Wald -- lieblich -- still Luft umgeben Natur -- bewegen Blatt Baume -- 
  Rudolf -- Phantasie geschäftig -- lassen Tafel bereiten -- Blume Speise setzen -- Licht -- Wind erlosch -- ruhig fortbrannen -- zauberisch -- berauschend Anblick gewähren -- 
  aß schallend Musik -- Tisch schieben -- umh Bäumen verteilen -- Wachskerze brannten -- 
  mutwillig Pfänderspiel Gang -- Sternbald herzlich Kuß blonder empfangen -- wobei jedesmal Blut Wang steigen -- 
  Nacht -- müssen trennen -- 
  Leute Dorfe Stadt gehen -- Rudolf Sternbald begleitet Zug -- Laterne gehen voran -- folgen Spielleute -- fast beständig Musik erschallen lassen -- Zug Takt erhalten -- Franz führen Emma -- schlingen Arm Leib -- Hand fallen schön Brust -- wagen -- Dunkelheit -- Musik berauschen -- Gewand zurückzuschieben -- widersetzen schwach -- 
  drücken schön voll Brust zitternd Finger -- mutwillig entgegenquoll -- -- 
  stehen Dorfe -- herzlich Kuß Abschied -- Emma stumm -- Wort hervorbringen -- 
  schweigend Rudolf Wald -- heraustrat -- glänzt Ebene herüber aufgehend Mond entgegen -- Schloß brennen sanft golden Flamme -- 
  Kapitel -- 
  Bildnis Gräfin fremd Ritter beendigen -- zufrieden -- belohnten Maler reichlich -- Freund erwarten -- 
  Franz Emma sehen -- Franzen Wunsch Bitte ungestüm ungeduldig -- denken Bekanntschaft ungern Abreise -- Rudolf erinnern -- ängstigen -- 
  Franz erstaunen einsamen Stunde selber -- Ungenügsamkeit -- peinigen -- 
  betrachten wehmütig Ungeduld Bild ehemalig geliebter -- Phantasie vorig Klarheit zurückzaubern -- Geist Sinn ehern Bande Gegenwart festhalten -- 
  bravor -- Rudolf Freund -- gefällst -- sehen -- Lernst -- 
  ahmst -- Liebschaft -- Lebensgeister Tätigkeit erhalten -- glauben -- Leben zurecht -- 
  verschöneren Gegend -- Name Dorf Stadt teuer bedeutend -- Einbildung lieblich Bild anfüllen -- allenthalben ersehnt Heimat fühlen -- 
  wohin führen Leichtsinn -- fragt Franz -- 
  wohin -- rufen Rudolf -- o Freund -- verbitt dergleich Frage dein schön Lebensgenuß -- wohin führen Leben -- 
  Sinnlichkeit -- Franz -- hörst rechtlich Mensch sprechen -- 
  O -- rechtlich Mensch -- Florestan lachend -- wissen -- -- 
  Himmel Mühe -- Sinn anschaffen -- -- schämen -- unser löblich Tod Himmel Beistand Freude gebärden -- 
  Mädchen -- fragen Franz -- Gegend Antwerpe besuchtesen -- 
  O -- Geschichte -- antworten -- erzählen -- 
  Reise -- riten über Feld -- schnell fortkommen -- 
  müde -- Pferd fing hinken -- Meile unendlich -- 
  singen Liedche -- besann hundert Schwänk -- Stunde erquicken -- vergebens -- 
  abquäle -- sehen hübsch niederländisch Bäuerin Weg sitzen -- Auge abtrocknet -- 
  Frage -- fehlen -- erzählen liebenswürdigsen Unbefangenheit -- gehen -- müde fühlen -- Eltern Haus -- wein -- billig -- 
  Dämmerung indes einbrechen -- Entschluß fassen -- 
  Rat fragen -- bieten müde Pferd -- bequem fortkommen -- 
  lassen Weile zureden -- steigen hinauf -- setzen -- 
  halten arme fest -- 
  fing -- Meile lang wünschen -- niedlich Fuß schweben -- Bewegung entblößen -- frisch rot Wange dicht meinig -- freundlich Auge nahe -- 
  ziehen Feld -- Herkunft Erziehung erzählen -- 
  vertraut -- sträubt Küs -- 
  Nacht -- Bangigkeit -- erfüllen -- erlauben -- dreister -- 
  kommen Nähe Behausung -- steigen behend Herunter -- Abred nehmen -- 
  eilen voraus -- bleiben Weile -- zwingen Pferd -- Art Galopp Haus sprengen -- 
  alt -- weitläufig Gebäude -- abseits übrig Dorfe liegen -- Mädchen entgegen -- treten verirrt Fremdling -- bitten demütig Nachtlager -- 
  Eltern bewilligt -- spielt Aufgabe -- zeigen verstohlen -- Kammer schlafen -- einräumen -- Tür lassen -- 
  Abendessen -- umständlich Gespräch -- schlafen -- Freundin Wirtschaft allerhand besorgen -- 
  betrachten indessen Kammer -- führen Seite Schlafzimmer Mädchen -- lang Gang -- äußer Tür öffnen -- 
  Freundlich scheinen rund Scheibe Mond -- schön Licht locken hinaus -- Garten empfangen -- 
  durchwandern -- gehen Gattertor -- verlieren voller Erwartung Feld -- 
  indessen sorgsam -- Tür verschließen -- letzter Geschäft Vater -- Riegeln Haus sehen -- 
  Bestürzt kommen -- Gartentür verschließen -- ruf -- klopfen -- hören -- versuch überzusteigen -- Mühe vergebens -- 
  verwünsch Mond Schönheit Natur -- sehen Freundlich -- erwarten Zöger begreifen -- 
  Verwünschung unnütz Bemühung nötigen -- frei Feld abwarten -- hunde wach -- Mensch hören -- einlassen -- 
  O -- segnen Strahlen Frührot -- 
  alt bedauert Unglück -- Mädchen verdrießlich -- anfangs sprechen -- versöhnen -- müssen fort -- versprechen -- Rückreise England gewiß besuchen -- 
  sahsen -- Wort halten -- 
  -- Verdruß klopfend Herz Garten bekannt Mauer -- suchen Auge Mädchen -- Sache indessen verändern -- 
  verheiraten -- wohnt Haus -- schlimme -- lieben sogar Mann -- besuchen -- bitten hoch Angst -- eher fortzugehen -- 
  gehorcht -- Glück stören -- -- Siehst -- Freund -- unbedeutend Geschichte Bekanntschaft -- endigen -- erwarten -- geschehen -- Franz -- manchmal dein übertrieben Mutwille bestrafen -- 
  O -- allenthalben Übertreibung finden -- rufen Florestan -- besorgt -- Gedanke Gefühl mäßigen -- 
  gelingen niemals unmöglich -- Gebiet messen wägen -- Maß Gewicht anerkennen -- 
  freuen -- verlieben sehen -- 
  Franz -- 
  wissen -- verlieben -- ängstigest dein Rede -- wozu -- abreisen -- 
  Florestan lachen -- Antwort -- -- 
  -- neulich Lied fallen -- -- Licht -- Wald -- 
  -- Mühe wert -- fröhlich -- 
  stellen Sternbald -- singen altfränkisch Gesang -- 
  Gasse schwärm Suche suchen sanft Frühlingswärme -- Stehen Liebste Tür -- 
  erwartest Platz -- -- 
  -- 
  such Schatz -- 
  Komme -- Schatz -- Findest Treuer -- -- 
  -- Schönst -- Erde -- Auge liebst Licht -- -- 
  Nimm Frist -- Allzutreu löblich -- 
  -- Küsse lassen -- 
  Kind -- Gehen -- -- fang hassen -- gewinnen -- 
  wider Wille küssen Mund -- Frevler Bund -- -- 
  schön Küs -- Lippe Kirschenrot -- Berühren honigsüße -- vergeße -- Not -- 
  Mädchen -- -- klopfen Herz -- 
  Freude -- Schmerz -- -- -- Laß Herz -- Schelt frech Hand -- -- gelten -- Aufzulösen jeder Band -- 
  Suchst Herz List -- Mund Busen küssen -- -- 
  O -- frei Gewänd schön prangst -- Häßlich putz Bänder -- gewandlos Ruhm erlangst -- verdunkeln Kleid -- Überschatten Neid -- 
  Herrlich -- Hülle Gliede neigen -- zart Busen Fülle Unserem Blick entgegensteigen -- Knie entblößen -- Gürtel Hüft lösen -- 
  marterst -- Sternbald -- Rudolf endigen -- sprich -- niemals Meinung -- 
  leichtsinnigen Augenblick vergessen -- freiwillig Sinn Sieg einräumen -- erniedrigen -- 
  Maler -- sprichst -- rufen Rudolf -- o -- Laß Kunst fahren -- Sinn -- vermagst Rührung hervorzubringen -- 
  euer Farbe darstellen ausrichten -- Sinn schön Weise ergötzen -- 
  Künstler Phantasie gefangen nehmen -- Reiz vollendet Schönheit -- -- Form entdecken -- wonach gierig Auge allenthalben suchen -- 
  finden -- Sinn -- Bewegung -- Entzückung erschüttern lieblich Weise -- 
  frei unverhüllt Körper hoch Triumph Kunst -- beschleieren Gestalt -- 
  treten Gewänder heraus -- ängstigen -- 
  Gewand höchstens Zugabe -- Nebenschönheit -- 
  griechisch Altertum verkündigen nackt Figur göttlichst Menschlichst -- 
  Dezenz unser gemein prosaisch Leben Kunst unerlaubt -- heiter -- rein Region ungeziemlich -- Dokument Gemeinheit Unsittlichkeit -- 
  Künstler Bekanntschaft verraen -- erkennen -- Kunst Liebste gute -- gestehen -- aussprech -- verschlossen Innerst -- begehren -- 
  Abreise beschließen -- Gräfin versprochen Brief italienisch Familie schreiben -- Sternbald Gleichgültigkeit Brieftasch legen -- zeigen Freund -- sogar ungewiß -- abgeben sollen -- 
  heißesen -- Sternbald Abend Gehölz besuchen -- Gedanke überlassen -- 
  Walde erreichen durchfließend Bach schönst Stelle ziemlich Breite Tiefe -- Ort abgelegen -- dicht Gebüsch wachsen umher -- Kühlung schön -- 
  Franz entkleiden -- werfen kühl Welle Fluß -- 
  Gemüt heiter -- ring frisch Element umgeben spüren -- Gebüsch rauschen -- Auge verlieren schön Dunkelheit dicht Wald -- fallen allerhand Gemälde -- ähnlich Darstellung antreffen -- 
  Walde hineinschauen -- Emma Dunkelheit hervorkommen -- 
  traut Auge -- -- 
  verbergen dicht Gebüsch -- nah -- scheinen Hitze Tag Weg ermatten -- sinken Rasen -- frisch Grün Bach umkränzen -- lös te Schuh -- erprobt nackt Füße Bein Kälte Wasser -- 
  Sternbald finden schön -- wandt Auge Moment -- schüchtern vorsichtig umh -- Busen frei -- lös te schön goldgelb Haar -- 
  dünn Gewand bekleiden -- schön -- voll Form Körper verraten -- Augenblick stehen nackt -- verschämt errötend -- steigen Bad -- 
  Franz Verborgenheit lang zurückhalten -- stürzen hervor -- erschrak -- grün Rase -- dicht Gebüsch Zeuge Versöhnung Glück -- -- 
  Schloß verlassen -- Freund weit Heerstraße befinden -- gestehen Franz vertraute Vorfall -- erzählen -- Emma Abschiede weinen -- wünschen -- wiederzusehen -- 
  Rudolf bleiben Erzählung nachdenklich -- fröhlich leichtsinnig -- -- scheinen Erinnerung bekämpfen -- beinahe schwermütig machen -- 
  Mensch -- rufen -- froh Laune verbürgen -- Augenblick Empfindung -- Kerker verschließen -- frei geben -- 
  denken -- Not Zweck herumtreiben -- indessen vernachlässig -- einzig Glück Welt -- 
  Wahrlich -- Augenblick schwermütig -- weint -- tiefsinnig Elegien niederschrieben -- Instrument Ton hervorsuchen -- Stein Fels Mitleide hineinzwängen -- 
  O -- Freund -- unnütz Gram gegenwärtig Augenblick verkümmern -- Gegenwart -- -- zweitenmal -- sorgen -- 
  -- Freund -- Welt Feld Berg Tal Blume Blümlein Zahl -- 
  -- Ort Freude hegen froh Herz schlagen -- 
  -- Freund -- entschlag trübselig Gedanke -- schlecht Frucht menschlich Seele Verderbtheit hervorbringen -- Reue -- 
  frisch froh anderer Mensch -- -- quäle vergeblich Wunsch -- Vergangenheit zurückruft -- Herz fürchterlich Leere anfüllen -- begehen unbekümmert Torheit -- Umstand bringen -- 
  Abend -- schön Himmel erglänzt wunderbar -- buntgefärbt Wolkenbilder -- 
  Sieh fahren Rudolf fort -- Maler dergleichen darstellen könnten -- euer beweglich Historie -- euer leidenschaftlich verwirrt Darstellung unzählig Figur erlassen -- 
  Seele grell Farbe Zusammenhäng -- Gold ausgelegt Luftbild ergötzen genüg -- Handlung -- Leidenschaft -- Komposition vermissen -- -- gütig Natur tun -- rosenrot Schlüssel Heimat aufschließen könnten -- Ahnung Kindheit wohnen -- glänzend Land -- grüne -- azurnen Meer goldenst Traum schwimmen -- Lichtgestalt feurig Blume Hand reichen -- Herz drücken möchten -- 
  O -- Freund -- wunderlich Musik -- Himmel dichten -- euer Malerei hineinlocken könnten -- 
  fehlen Farbe -- Bedeutung gewöhnlich Sinn Bedingung Eurer Kunst -- 
  verstehen -- Meinst -- Sternbald -- freundlich Himmelslichter entwanken entfliehen -- sprechen -- 
  Harfe Musizierst -- Finger Ton suchst -- dein Phantasie verbrüdern -- gegenseitig erkennen -- Ton Phantasie Umarmung gleichsam entzücken hoch -- Himmelwärts jauchzen -- -- Musik -- unmittelbar -- kühn Künsten -- einzig Herz -- aussprechen -- anvertrauen -- übrig Auftrag halb ausrichten -- gut verschweigen -- 
  geben -- -- Freund -- glauben -- Musik -- Poesie Malerei Hand bieten -- ausrichten -- 
  freilich nötig -- Handlung -- Begebenheit Gemüt entzücken -- scheinen sogar schwer bestimmen -- Gebiet Kunst schönsn Lorbeer antreffen -- erinner schön -- still -- heilig Familie -- antreffen -- liegen unendlich Musik -- nennen -- 
  Religion -- Heil Welt -- Anbetung Hoch Kindergespräche offenbaren ausdrücken -- 
  Figur bloß Figur denken -- Gruppierung Nebensach -- Ausdruck Miene -- fern gegenwärtig Geschichte -- wirklich Zusammenhäng beziehen -- 
  Maler Gelegenheit -- Einbildung erregen -- Geschichte -- Beziehung vorbereiten -- 
  -- gemäld Landschaft scheinen Veranlassung geben -- 
  Meinung -- fragen Rudolf -- Landschaft Figur ausstaffieren -- Leben Interesse Bild hineinkommen -- 
  einsehen -- antworten Franz -- scheinen unnötig -- 
  Landschaft Wunderbares ausdrücken -- Einsamkeit vortrefflich Wirkung tun -- 
  mancherlei Empfindung erregen -- Vorschrift schwerlich allgemein Wort fassen lassen -- 
  selten Figur -- Teilnahme erregen -- beleben -- bloß brauchen -- scheinen Kunst begreifen -- Spiel Idee -- Musik erregen helfen -- Kunstwerk geheimnisvoll Wunderwerk -- 
  denken Waldgegend -- Hintergrund öffnen -- Durchsicht Wiese lassen -- Sonne steigen herauf -- Ferne ländlich Haus gewahr -- rot freundlich Dache -- Grün büsch Wiese lebhaft abstichen -- erregen Einsamkeit lebendig Gestalt wehmütig -- unbegreiflich Empfindung -- 
  meister -- Malerei wünsch -- allegorisch Gemälde einleuchtend -- Rudolf -- 
  -- erinnerst -- rufen Franz -- Ort -- Maler Imagination -- Sinn Magie Kunst offenbaren -- 
  gleichsam Grenze Kunst hinausschreiten -- Dichter wetteifern -- 
  Begebenheit -- Figur Nebensach -- Bild -- Ruhe Lebendigkeit -- Fülle Leere -- Kühnheit Gedanke -- Zusammensetzung finden Platz -- 
  ungern gehören -- Gedicht Mangel Zierlichkeit vorrücken -- tätig Bewegung schnell Reiz Handlung fordern -- einzeln Mensch Menschheit ausdrücken -- vorfalls erhaben Ruhe -- 
  anscheinend Kälte -- Unbiegsamkeit Stoff -- wehmütigen Schauder Betrachtung erregen -- allgemein Begriff sinnlich Gestalt ernst Bedeutung aufstellen -- Kind Greis Empfindung vereinigen -- unzusammenhängend erscheinen -- menschlich Leben -- einer notwendig -- Leben Verkettung reißen -- ungemein erhaben erscheinen -- 
  erinneren -- antworten Rudolf -- alt Bild Pisa -- hundert alt -- fallen -- Irre -- Andrea Orgagna malen -- 
  Künstler Dante besonderer Vorliebe studieren -- Kunst ähnlich dichten -- 
  Bild menschlich Leben wehmütig Art abbilden -- 
  Feld prangen schön Blume frisch glänzend Farbe -- geschmückt Herr Dame umh -- ergötz Pracht -- 
  Tanzend Mädchen ziehen munter Bewegung Blick -- Bäumen -- Orang Glühn -- erblicken Liebesgötter -- schalkhaft Geschossen herunterzielen -- Mädchen schweben Amorin -- geschmückt Spaziergang Vergeltung zielen -- 
  Spielleute blas Instrument Tanz -- bedeckt Tafel stehen Ferne -- 
  -- sehen steil Fels -- Einsiedler Buße andächtig Stellung beten -- lesen -- melken Ziege -- 
  Dürftigkeit armutselig Leben üppigen Glückselige Herzhaft stellen -- 
  -- unten sehen König -- Gemahlinn Jagd reien -- heilig Mann eröffnen Grab zeigen -- König verwest Leichname sehen -- 
  --- Luft fliegen Tod -- schwarz Gewand -- Sense Hand -- Leiche Stände -- hindeuten -- -- Bild treuherzig Reimen -- Person Mund -- Bild menschlich Leben hervorbringen -- wissen -- Blind Taub bewegen -- 
  Gespräch dicht Stelle Walde kommen -- abseits Eich gelehnen liegen Rittersmann -- Pilgrim beschäftigen -- Wunde verbinden suchen -- 
  Wanderer eilen sogleich hinzu -- erkannt Ritter -- Franz -- -- Mönch sehen -- Sternbald Schloß malen -- 
  Ritter Ohnmacht sinken -- Blut verlieren -- vereinigt Hilfe -- 
  Pilgrim dankt Freund herzlich -- helfen -- arm verwundeter pflegen -- machen Eile Trage Zweig Blätter -- worauf legen abwechselnd tragen -- 
  Ritter erholen -- bitten -- möchten Mühe unterlassen -- versuchen -- Fuß -- gelingen -- Beschwerlichkeit langsam fortbewegen -- übrig führen unterstützen -- 
  Ritter erkennen Franz Rudolf ebenfalls -- gestehen -- -- neulich Verkleidung treffen -- 
  Pilgrim erzählen -- Loretto wallfahren -- Gelübde bezahlen -- Sturm See tun -- 
  dunkel -- tief Wald hineingeriet Weg bemerken -- 
  Franz Rudolf rufen laut -- herbeizulocken -- raten -- Irre führen können -- vergebens -- hört Echo Stimme -- 
  -- Verworrenheit Gebüsche fern Glöcklein vernähmen -- sogleich richten Schalle Schritt -- 
  Pilger insonderheit ermüden -- wünschen Ruheplatz antreffen -- gestehen ungern -- übereilt Gelübde reuen -- schuldig bezahlen -- Gott irren -- 
  seufzen fast Schritt -- Ritter unterlassen -- ermüden selber -- bisweilen spotten -- 
  Franz Rudolf singen Lied -- Ermüdet trösten anzufrisch -- sehnt herzlich ruhig Herberge -- 
  sehen Licht ungewiß Zweig schimmern -- Hoffnung stärken -- Glöcklein lassen hören -- vernehmlich -- 
  glauben Nähe Dorf befinden -- Weile gehen -- stehen Hütte -- Licht brennen -- entgegenglänzen -- Mann sitzen -- lesen vieler Aufmerksamkeit Buch -- Rosenkranz hing Seite -- Hütte Glocke angebrachen -- abwechselnd anziehen -- Schall verursachen -- 
  erstaunen -- Gesellschaft Betrachtung stören -- freundlich -- 
  bereiten schnell Kräuter Saft -- Wunde Ritter verbinden -- wonach sogleich Linderung spüren -- Schlafe neigen -- 
  Franz müde -- Pilgrim Winkel Haus eingeschlafen -- Rudolf bleiben munt -- verzehrt Früchte -- Brot Honig -- Einsiedler auftragen -- 
  Einsamkeit willkommen -- Florestan -- täglich Gebet Gott -- Gelegenheit geben mögen -- zuweilen -- wider erwarten kommen -- 
  bring Andacht Bete -- lassen gewissen Gebet Glöcklein erschallen -- Hirt Bauer Walde -- Leute nächster Dorfe wissen -- munt Herr danken -- einzig -- Vergeltung Wohltat Stande -- 
  Rudolf bleiben Einsiedler munt -- sprechen allerhand -- lassen alt vorgesetzt Gebet abwendig -- wiederholen Erzählung -- Franz hören Schlummer sprechen -- zuweilen Glöcklein klingen -- Gesang alte -- dünken Träum höchst wunderbar -- 
  Schlief Rudolf -- Mühe -- wach bleiben -- alte singen indes -- morgens Strahl funkeln tief fern Tal Leutlein munt -- 
  regen Arbeit preisen Schöpfer fest -- Weicht Nacht Schlaf hinunter -- ' süß Licht -- Morgenröte Öde -- Hell entzünd Gott Liebe verkünden -- 
  Morgenrot brechen liebreich herauf -- schimmert Baumwipfel -- hell Wolke -- Strahlen Sonne Wald leuchten -- 
  Vogel regen -- Lerche jubeln Wolke herab -- Morgenwind schüttelt Zweig -- 
  Schläfer wach -- Ritter fühlen stärken munt -- Einsiedel versichern -- Wunde bedeuten -- 
  Franz Rudolf machen Spaziergang Wald -- Anhöhe erstiegen niedersetzten -- 
  Mensch wunderlich -- fing Florestan -- Pilgrim kreuzen Welt -- verlassen geliebt Weib -- selber erzählen -- Gott Gefallen Kapelle Loretto besuchen -- 
  Einsiedler Nacht Geschichte erzählen -- 
  Welt verlassen -- unglücklich lieben -- Mädchen -- entzücken -- ergeben -- Leben Einsamkeit beschließen -- Rosenkranze -- Buch Glock beschäftigen -- 
  Franz dachen Bildnis -- Tod geliebter -- seufzend -- 
  O -- Laß -- -- tadle streng Glückseligkeit anderer Mensch -- Deinig -- 
  gelieben -- Welt -- 
  geliebter Welt abgestorben -- Leben ununterbrochen Andenken -- immerwährend Opfer -- Schönst bringen -- 
  -- Andacht vermischen Liebe -- lieb Religion -- Herz bleiben rein geläuteren -- 
  strahlen Morgensonne Gedächtnis -- -- gewöhnlich Leben Bild entweihen -- Madonna -- Gefährtin Lehrerin Gebet -- 
  O -- Freund -- Stunde -- -- Einsamkeit ergeben -- Vergangenheit Zukunft Abschied nehmen -- 
  Rauschen Wald -- Wiederkehr gleichförmig -- ununterbrochen leis Fluß -- unvermerkt Alter hineintrügen -- jeder Rauschen andächtig Gedanke -- Lobgesang -- 
  einst irdisch Glück trennen -- 
  Reichtum Liebe Kunst -- 
  edelst Geist Abschied nehmen -- schwach -- einzulernen -- 
  Florestan verwundert Freund -- Bezwang diesmal Mutwille -- antworten Scherz -- Franz ernstlich sprechen -- 
  vermutet Herz Sternbald geheim Kummer -- schweigend Hand -- Arm Arm gehen herzlich Hütte arm Klausner -- 
  Ritter stehen ankleiden Tür -- 
  Röte Wang zurückgekommen Gesicht glänzt Sonnenschein -- Auge funkelen freundlich -- schön Mann -- 
  Pilgrim Einsiedler Andachtsübung vereinigen -- sitzen tiefsinnig Gebet Haus -- 
  setzen Grase nieder -- Rudolf fassen Hand Fremden lachend Gesicht -- Herr Ritter -- wahrlich verargen -- Neugier bezähmen -- überdies ziemlich herstellen -- Mühe Erzählen nehmen -- 
  Freund euer Bildnis Schlos schön Dame antreffen -- vertraut -- verbinden -- anderer -- rückhalen -- 
  -- jung Ritter -- neulich -- -- fassen herzlich vertrauen Eurem Freund Sternbald -- erzählen -- selber wissen -- Verwirrung befinden -- 
  bedingen -- -- erzählen -- seltsam Geheimnis erwarten -- bitte bloß -- wissen -- verlegenheiten künftig euer Mangel Verschwiegenheit setzen dürfen -- 
  Wißt -- deutsch -- edl italienisch Familie entsprossen -- Name Rode rigo -- 
  Eltern geben frei Erziehung -- Vater -- übermäßig lieben -- Wildheit -- alt gut Rate nachkommen -- -- Wort achten -- 
  Liebe erlauben -- streng Mittel gelind Verweis Zuflucht nehmen -- wild Ausgelassener -- 
  verbergen -- unbesonnen Streich Vergnügen Zufriedenheit Kummer empfinden -- seltsam Lebenslauf desto sicher -- 
  Jugend wild Bursche -- Vorliebe Lebensweise behalten -- Jugend glänzend aufleben -- 
  übrig bestimmt begeistert -- jung Mensch Alter -- Ludovico nennen -- vertrautest Freund -- 
  unzertrennlich -- streifen Romanie -- Kalabrien Oberitalien umher -- Reisesucht -- verlangen -- fremd Gegende sehen -- fast stark -- knüpfen -- 
  wunderbar Mensch sehen -- Ludovico -- sagen -- Charakter vorher Imagination vorkommen -- 
  heit unbesonn -- verdrießlichst Lage fröhlich voll Mut -- Gelegenheit ergreifen -- Verwirrung bringen -- groß Freude bestehen -- Not Gefahr verwickeln -- nachher stecken lassen -- 
  unbeschreiblich gutmütig -- niemals zürnen -- 
  vertraut -- niemals entdecken -- eigentlich -- Familie angehören -- fragen -- weisen Antwort -- dergleichen völlig gleichgültig bleiben müssen -- wirklich Freund -- 
  verlassen Woche -- schwärmen umher -- erzählt Abenteuer -- wiederfanden -- 
  vernünftig Mensch Welt -- rufen Rudolf heftig -- wahrlich -- Lust -- Leben Art leben -- 
  O -- freuen -- kennen lernen -- fahren Gott Wille Eurer vortrefflich Erzählung fort -- 
  Ritter lächelen Unterbrechung -- fahren folgend Wort fort -- 
  fast Stand -- Verkleidung erdenken -- Land durchstreifen -- Bauer -- Bettler -- Künstler -- Grafe ziehen umher -- spielleut musizieren Hochzeit Jahrmärkt -- mutwillig Ludovico verschmähen -- zuweilen artig Zigeunerin herumzuwandern -- Leute -- hübsch Mädchen -- Glück verkündigen -- 
  lächerlich Drangsale -- überstehen müssen -- verliebt Abenteuer -- ergötzn -- lassen schweigen -- ermüden -- 
  gewiß -- Rudolf -- -- fällen -- glauben -- würden Mannigfaltigkeit Eurer Erzählung müde -- 
  -- Ritter -- 
  Freund glauben heimlich -- Eltern entlaufen -- Glück Welt herumtreiben -- 
  begreifen -- fast niemals Gelde fehlen -- verschwenderisch unbeschreiblich großmütig umgehen -- 
  fast verlassen -- reich Börse -- 
  groß Aufmerksamkeit schön Mädchen Ständen richten -- kurz Bekanntschaft außerordentlich ausbreiten -- aufhieln -- Eltern ungern sehen -- selten verfolgen -- entging genau Not Rache beleidigten Liebhaber -- Nachstellung Mädchen -- Schönheit aufopferten -- 
  Gefährlichkeit Würze unser Leben -- vermeiden gut Wille -- 
  Reiselust ergriff Freund gewaltsam Weise -- weder Vernunft -- selber Einwürfe hören -- Tor -- 
  Italien kennen glauben -- plötzlich Afrika übersetzen -- 
  See Korsaren beunruhigen -- Schiff überfuhr -- lachter -- erzählen -- Zwang beinahe -- Begleiter -- schifft glücklich Wind fort -- 
  stehen Verdecke singen verliebt Lied -- Matrose -- drängen -- afrikanisch Küste liegen -- 
  plötzlich entdeckt Schiff -- zusegelen -- Seeräuber -- 
  hartnäckig Gefecht -- Freund Wunder Tapferkeit -- erobern gefangen fortführen -- 
  Ludovico verlieren Munterkeit -- verspotten Kleinmut -- Korsaren beteueren -- tollkühn Wagehal sehen -- 
  Leben -- Sprache -- lernen -- -- fort -- froh -- Pflicht tun -- wissen -- -- Angesicht zukünftig Stunde sehen -- 
  Spott Falte -- Zürn -- Saturn Vorüberflieg vorhälen -- alt -- Wacker -- lächeln Verspottung -- bitten -- alt Kind -- nachh Unfreundlichkeit -- 
  -- -- Glück lieben -- Unglück willkommen heißen -- 
  Leben Sorge wert -- 
  stehen Kette -- wahrlich -- 
  vergaß Heldenmut Elend -- 
  -- an Land setzen Sklave verkaufen -- trennen -- nicken Ludovico freundlich Lebewohl -- 
  arbeiten benachbart Garten -- verlieren Dürftigkeit -- Unterjochung Mut -- hört Ferne gewöhnlich Lied singen -- -- freundlich vergnügen -- -- 
  -- Besonderer vorgefallen -- 
  innerlich Leichtsinn Herzen böse -- lächelnd Gesicht -- Zorn verschwinden -- vergessen -- 
  Woche steckt Briefchen -- Christensklave Seite bringen -- Fahrzeug bemächtigen entfliehen -- 
  melden -- mitnehmen wollen -- Vorsatz Flucht viele erschweren -- sollen Mut verlieren -- 
  verlassen Glück -- Vorsatz gelingen -- 
  kommen Nacht Ufer See -- bemächtigten Schiff -- Wind anfangs günstig -- 
  tief Meer hinein -- glauben italienisch Küste nähern -- anbrucher Morgen Sturm erheben -- stark -- 
  raten -- an nächster Land zurückzufahren -- verbergen -- Sturm legen -- Freund anderer Meinung -- glauben -- können unser Feind entdecken -- schlagen -- See bleiben -- Gnade Sturm überlassen -- 
  Überredung drang -- ziehen Segel -- suchen erhalten -- überzeugen -- Ungewitter verfolgen -- 
  Wind drehen -- Sturm Donner nehmen -- empört Meer werfen Wolke -- verschlingen Abgrund -- 
  verlassen Mut -- brechen Klage -- Vorwurf Freund -- 
  Ludovico -- unablässig arbeiten Element gerungen -- erstenmal Leben zornig -- Ergriff werfen Schiff Boden -- 
  -- Elender -- rufen Freund -- unterstehst klagen -- Sklave -- 
  Roderigo -- munt fröhlich -- Rath -- -- Gewog bleiben -- Teufel Name sterben -- 
  Wort setzen derben Faustschläg -- Besinnung verlieren -- Donner -- See Sturm vernehmen -- 
  -- Land -- Sturm legen -- liegen arm Freund -- 
  Vergib -- leutselig -- retten -- Italien -- Hättest Mut verlieren -- -- 
  Hand -- Herz -- Mensch künftig vermeiden -- Glück Leben gleichsam Weise nachstellen -- Vorsatz vergessen -- ehe an Land steigen -- -- eigentlich Glück -- 
  Rudolf -- gespanntest Aufmerksamkeit zuhören -- lang halten -- springen heftig -- rufen -- 
  -- heilige -- euer Freund wahr Teufelskerl -- 
  lumpig -- erleben -- worauf manchmal -- Mensch -- 
  kennen lernen -- wahrhaftig -- Seltenheit an Welt laufen -- 
  leben -- antworten Roderigo -- lang -- sehen -- 
  Vorfall weitläufig erzählen -- einigermaßen Begriff Charakter geben -- 
  Eltern priesen glücklich -- wiedersahen -- Ludovico Abenteuer verwickeln -- 
  Schweiz Deutschland besuchen -- Gesellschaft Reise unternehmen -- geringer -- Ägypten -- seltsam uralt Pyramid -- wunderbar rot Meer -- Sandwüste sphinxen -- fruchtbar Nil -- Gegenstand -- Kindheit hören -- -- dorthin rufen -- 
  Abschied überaus zärtlich -- versprechen -- Italien zurückkommen -- Eltern Urlaub -- treten Reise Deutschland -- 
  fühlt Gefährt einsam verlassen -- Mut anfangs einstellen -- aufrecht halten -- 
  hoch Gebirge Schweiz Tirol -- furchtbar Majestät Natur -- stimmen traurig -- bereute -- wider Wille folgen Wahnsinne nehmen -- 
  einigemal Begriff -- Familie zurückkehren -- Sucht -- fern Land -- fremd Mensch sehen -- treiben vorwärts -- Scham -- Lebensart untreu -- höchst Glück ausmachen -- 
  einzeln Vorfall verschweigen -- Begebenheit wenden -- Ursache -- antreffen -- 
  lustig Abenteuer -- angenehm Bekanntschaft langt Gegend Schlosses -- -- 
  sitzen Anhöhe überdacht Mannigfaltigkeit Lebenslauf -- fröhlich Jagdmusik aufmerksam -- 
  Zug Jäger näh -- Mitte schön Dame -- Falke Hand tragen -- Einsamkeit -- schimmernd Anzug -- tragen -- ungemein reizend darstellen -- 
  Sinn gefangen nehmen -- Auge abwend -- Schönheit -- sehen -- scheinen alltäglich -- Zug -- entzücken -- Wuch -- Farbe Wang Blick Auge -- geheimnisvoll Weise -- 
  Gefühl Busen -- empfinden -- durchdrang -- weit Welt -- jenseits Besitz liegen Wunsch Welt -- 
  suchen Bekanntschaft -- verschweigen Name -- 
  finden Wünsch neigen -- hoch Gipfel Seligkeit -- 
  arm Leben -- entsagen Schwärmereie -- 
  Hochzeit festsetzen -- 
  O -- Freund -- beschreiben -- selber begreifen -- wunderbar Veränderung -- vorging -- 
  bestimmt Glück liegen -- Glück festgeschmieden -- 
  Meeresstille Anker liegen -- sehen -- Mast Segel Schiff heruntergeschlagen -- -- ewig festhalten -- 
  O -- süß Reiselust -- selber -- geheimnisreich Ferne -- Abschied nehmen Heimat besitzen -- 
  Lockt weg -- euer Ton vergeblich -- ziehend Vogel -- Schwalbe deinen lieblich Gesang -- lerch deinen Reiselieder -- 
  Stadt -- Dorf glänzend Fenster entgegenblicken -- denken -- 
  weiblich Gestalt stehen Vorhang -- sehen Berg herauf entgegen -- 
  fremd liebreizend Gesicht einfallen -- 
  bekannt -- Busen meinig ruhn -- Lippe Küsse vertraut -- 
  Gemüt hin zurückziehen -- häuslich Heimat -- rätselhafen Fremde -- stehen Mitte -- wissen -- wohin -- 
  wünschen -- Gräfin lieben -- Anderer Gunst verdrängen -- zürnend verzweifelt verlassen -- umherzustreifen -- Berg -- Talschatt -- frisch -- lebendig Geist wiederzusuchen -- verlassen -- 
  hing Feuer Liebe -- zählen Minute -- zubrachen -- hadert Kälte -- 
  lieben -- Fülle Glück übertäuben -- 
  sehnsüchtig Wandersmann -- Landstraße vorüberziehen -- -- -- ungewiss Glück suchst -- 
  finden -- 
  riten -- sammeln -- 
  halten Einsamkeit Undank -- 
  Welt Liebe -- reden selber -- sehen -- -- zufrieden -- begnug -- Erober -- einsamen abend Sehnsucht Herzens erwünschtest -- wonach Wälder jagtest -- Bergstrom entgegensangen -- unnennbar Glück -- -- Seele -- umh suchen -- entgegen kommen -- 
  -- Dorf Haus seltsam liegen -- Heimat engen beschränken dünken -- 
  Abendrot scheinen Welt hinein -- riten niedrig Bauernhause vorbei -- Hofe stehen Brunnen -- Mägdlein -- bückt -- schwer gefüllt Eimer heraufzuziehen -- 
  herauf -- stillhieln -- Abendschein liegen Wang -- knapp Mied schließen traulich schön voll Busen -- genau Umriß verbergen lassen -- 
  -- 
  -- betrachten -- 
  grüßter -- danken lächelen -- 
  riten fort -- retten Dämmerung Wald hinein -- 
  Herz klopfen -- Tod entgegen gehen -- Licht Schlos entgegenglänzten -- 
  warten -- -- freundlich Abendessen bereiten -- sorgen -- müde -- trocknen Stirn -- 
  -- lieben -- rufen -- lieben -- 
  Nacht tönt Lauf Bergquellen Ohr -- Winde rauschen Baum -- Mond steigen herauf -- -- Natur frei -- willkürlich Bewegung -- fesseln -- 
  Sonne aufgehen -- Dorf reten -- treffen -- Mädchen Brunnen stehen -- 
  mächtig -- 
  steigen Pferd -- -- antworten freundlich Frage -- Leben erstenmal Weibe verlegen -- Vorwurf -- wissen -- sprechen -- 
  Tür Haus dicht Laube -- setzen nieder -- schön blau Auge sehen -- frisch Lippe widersteh -- Kuß einlud -- streng -- vergessen Stunde -- 
  Nachdenkend riten -- wissen bestimmen -- Einschränkung -- Ehe schön Gräfin glücklich -- 
  Belacht -- gewechselen Ring Freiheit fortschenken -- verstehen Sinn Redensart -- 
  vermied Gräfin -- Schönheit locken -- verachten -- Entschluss -- 
  Hochzeitstag indes nahe herangerücken -- Braut Anstalten -- hört künftig Einrichtung sprechen -- Herz schlagen Wort -- 
  erzählen -- letzter Unglück Markus Antonius wunderbar Ton Instrument gehören -- wodurch Schutzgott Herkules Abschied nehmen -- 
  hören Lerchengesang -- Klang Trompet -- jeglicher Instrument Glück -- Abschied wehmütig zurufen -- 
  liegen gründämmernd Laube Sinn -- blau Auge -- voll Busen -- 
  entschließen -- 
  -- Ludovico -- rufen -- untreu -- 
  sollst Sklave wiederfinden -- Kette losgemachen -- 
  Ehemann -- lieben -- 
  seltsam Folge -- 
  Abschied -- versteckt Kleidung Mönch -- streifen umher -- treffen Bildhauer Bolz -- Italien zurückkommen -- 
  glauben Züge Freund antreffen -- entdecken seltsam Leidenschaft -- 
  Begleiter -- 
  genau lernt Laube -- Haus Garten geliebter kennen -- 
  sitzen Nachtstunde Arm Arm geschlungen -- Vollmond Gesicht scheinen -- 
  Kleidung gemein Bauer Eltern Bekanntschaft -- schmecken lang Süßigkeit sonstigen Lebensweise -- 
  brechen plötzlich -- wohnen schön Mädchen -- Eltern Kloster bestimmen -- beweinen Schicksal -- 
  bereit -- Nacht entführen -- vertraut Gefährte Plan -- Tückisch -- anbeten -- locken hierher dicht Wald -- versetzen heimlich Wunde -- 
  verlassen schnell -- 
  Seht -- Geschichte -- 
  Unaufhörlich schweben Bild Gräfin Auge -- 
  lassen -- wiederfinden -- Wesen Leben opfern -- 
  Franz -- euer Geschichte seltsam -- Liebe heilen -- Beschränkung glücklich fühlen -- Liebe -- 
  voreilig -- Freund -- Florestan -- Mensch -- genau nehmen -- weißen -- beschaffen -- 
  Einsiedler -- Wunde Ritters sehen -- bessern -- 
  Rudolf Schreibtafel schreiben hinein -- Franz sinnend Walde -- 
  halb Stunde suchen Florestan Freund -- lesen folgend Gedicht -- Sternbald bewegen -- 
  Kind -- 
  -- 
  schön Welt -- 
  Ruht freundlich Glanz grün Berg -- Winkt golden Strahl Baum -- dicht Wald -- 
  welch schön Land Bergen anfangen -- Höre bunt Hähn dorth kräh -- Höre Hündch bellen -- locken -- folgen -- 
  Wiese Blume schön Kind entgegen -- golden Haar hängen Stirn -- Herrlich -- wunderbar Spielzeug halten Hand -- freundlich geben -- 
  Lippe küssen -- Gingen bunen -- blumenglänzend Wiese -- 
  -- 
  einsam stehen -- Kind -- kennen -- fallen -- spielen wein Herrlichkeit Ferne suchen -- 
  O -- stark -- dürfen Vater schelten -- Mutter sorgen -- eilen hinein Welt -- suchen -- wünschen -- 
  Jüngling -- 
  Rastlos irren Land -- über Meer -- drängen Mut -- Suchen unbekannt -- locken Stern -- Zimmer ferner zauberisch Ferne -- Suchen Meer Land gebrach -- finden -- 
  schmachtend stets -- Nirgend Erde Glück -- 
  O Tor -- finden -- wonach Sehnsucht rang -- Herz entgegen Drang bittersüß Stunde -- 
  -- Herz gerissen entgegen Wonneküsse -- 
  Trauer beengt Brust -- Vergällt Lebenslust -- Herz verstehen -- Jedweder Sinn abgewanden -- treiben -- treiben -- nirgend Leben Gewinn -- 
  schwesterseel Geist finden -- Seele Seele fest verbinden -- halb Wort -- Blick -- Ton -- Rede verständlich -- Sehe -- Auge Holdseligkeit -- Geist süß Gruß brut -- Lippe -- küssen -- Küssen Geist -- Himmelsothem umwehen Engelsschwing -- Pulse Wonne Entzück klingen -- 
  Sehnsucht wecken Wald Ton -- Blicken hold Augenster -- Fliegen Geist Strom -- Lockt zauberreichen Fer -- Bleibe Heimat -- 
  Mann -- 
  Irrte Mensch schön Leben rastlos Klippe Fels -- glücklich Mensch -- suchen Berg -- Tal befreundet Wesen -- bleiben fremd -- selber getreu -- Vernunft durch Leben rasch Jüngling geleit -- Leben Verschwender verlören -- Suchend -- niemals einzig finden -- glauben -- Mutter Erfahrung belehren -- 
  Lernte Nutzen Kraft beherrschen -- Zerstörung Jugend brauchen -- -- 
  Hobe Mut Geisterkraft empfind Inneren -- Würdige geschehen -- -- Tälern schön Hoffnung begeistern -- -- -- Wohltat jeglicher -- Heiter sehen Abend Leben -- beruhigen -- wirken nützen -- tun -- Geschick erlauben Platz niemals Besseren verdrängen -- 
  Greis -- 
  lang Lebensreise müde -- Tod Tor kommen -- Sitz schau Weg -- 
  --- mühevoll Schritt -- vergeblich -- reuen -- 
  Unerfüllt Jüngling Kind Sehnsucht -- Hoffnung Manne betrügen -- Traut Darob -- 
  Baumschatt ruhend Schau Wohlgemut gepflanzt Blume -- süß Düft erquicken -- denk Blume Gegend -- -- fern liegen -- locken Ferne -- 
  Rasche Jüngling nennen Blumensorge Spiel Alter -- gewinnen stürmend Kraft -- 
  Blume wachsen -- blühn duft -- Wunsch erfüllen -- 
  Leben hart Fels stecken -- Hoffnung wünschen Gedeihe -- selten -- Same grün emporschießen -- selten -- Blüte tragen -- 
  sammeln Kind freuen -- Spielwerk schnitzen -- sehen ernst Mann lächeln -- Geschäft Leben weihen -- 
  Nennt Beginn kindisch -- wissen unzufrieden Kind -- Spielzeug nimm -- Töricht -- auf abzutreiben -- Seele Heimat Erde suchend -- Erde nirgend -- 
  Blume zittern Abendrot versinken Berg -- 
  O -- kühl grün Erde sänken -- suchen frei Seele Luftraum schön Heimat gestirn -- fänden geliebt Bruder -- vergeblich Schmerz suchen -- treffen wirkend Kraft Dauer -- vergeblich Arbeit abgequalten -- 
  Franz Sternbald suchen Ritter -- Florestan verlassen -- -- vorher Freund willfährig -- dreist -- Geschichte alt Mann bitten -- erwähnten -- Straßburg treffen -- 
  erinnern -- Ritter -- erzählen -- 
  -- einsam Wanderung Gehölz -- einsam Fels führen -- Tor gegenüberstanden -- 
  bewundert seltsam Symmetrie Natur -- schön Baumgang aufmerksam -- Fels eröffnen -- 
  hindurch -- finden weit Platz -- Allee Bäumen ziehen -- schön Heller Bach fließen Seite -- Nachtigalle singen -- schön Ruhe laden -- niederzusetz Plätscher Fontan hören -- dicht Gebüsch herausplauderen -- 
  sitzen Weile -- lieblich Ton Harfe aufmerksam -- umsah -- Büste Ariosstes gewahr -- Altar erhaben stehen -- spielen schön Jüngling Instrument -- 
  -- Erzählung Ritter sonderbaren Vorfall unterbrechen -- 
  Buch -- 
  Kapitel -- 
  Klause entstehen Geräusch Gezänk -- Eremit Pilgrim erhitzen heraustreen -- Walde ansehnlich Mann -- Roderigo sogleich hinzueilen -- Arm schließen -- 
  O -- Ludovico -- rufen -- -- 
  kommst hierher -- -- Freund -- 
  Entzück Roderigo's Wort -- indessen heilig Mann eifrig Gezänk fortfuhren -- 
  Florestan Name Ludovico nennen hören -- verlassen Sternbald -- eilen -- aufrufen -- 
  Gott danken -- Ludovico -- 
  Einsamkeit unaussprechlich willkommen -- 
  Ludovico umarmt Freund -- Sternbald voll erstaunen verlassen stehen -- lustig -- 
  freuen -- sehen -- streitend Partei bringen -- 
  fremd schön Mann zukommen sehen -- -- Sache müssen -- Zwist schlichen -- lassen freiwillig -- 
  edl Gestalt bezaubern -- Roderigo Freude trunken -- Freund besitzen -- Florestan Auge verwenden -- 
  heilig Mann -- fragen Ludovico -- 
  eremit fing -- Unster erzählen -- 
  Pilger -- Geliebte heiraten -- Entdeckung unvermuten Gebet hervorgetan -- erbittert -- Überfluß ärgsn Feind Herberge geben müssen -- 
  Pilgrim verantworten -- Schuld -- Gastfreiheit handeln Schimpfrede überhäufen -- 
  Ludovico -- Pilger -- Großmut Seele heften -- überlaß eifrig Liebhaber bisherig Frau -- bewohnen Klaus -- 
  -- hierher zurücksehnen -- gewiß zweitenmal Tausch eingehen -- 
  Rudolf lachen laut wunderlich Zank lustig Entscheidung -- Franz erstaunen -- Einsiedler -- heilig Mann unheiligen gemein Leidenschaft -- Zorn -- Raum verstatten können -- 
  Pilgrim Wille -- Frau verlassen -- Waldbruder -- Eremit schämt Heftigkeit -- 
  Partei ausgesöhnen -- setzen friedlich Gemüter Mittagsmahl -- 
  verändern -- Roderigo -- 
  verändern -- rufen Ludovico -- -- Ägypten Pyramid heißen Sonne anhaben -- 
  lächerlich -- Mensch -- ernsthafter Gesicht zurückkommen -- entfernt Gegende sehen -- alt Gebäude wunderlich Sitte -- 
  -- 
  -- Roderigo -- hüt anderswerden -- meister Mensch Jugend gute -- -- Fall -- bekommen -- 
  Wahrheit -- Frau Ausnahme leiden -- 
  -- Pilgrim -- 
  kommst -- 
  stehen Ägypten -- fragt Florestan -- seltsam Fremden bekannt -- 
  alt Sache stehen alt Fleck -- -- -- vergessen -- vorher verwundern -- 
  gewöhnlich -- Walde -- 
  Mensch wissen -- -- Sehnsucht Fremde fühlen -- -- -- 
  Lächerlichste -- Ort bleiben seltsam Kunstsache Augenschein nehmen -- fragt Franz bescheiden -- 
  Auge treten -- Ludovico -- ziemlich genau betrachten -- 
  sphinxen sehen eins wunderlich Auge -- stehen fern Altertum gleichsam spöttisch -- fragen -- 
  -- -- 
  Gegenwart Tollkühnheit schämen -- vernünftig Leute tadelen -- mittlerer Alter loben -- 
  O -- euer Gefährte -- rufen Franz -- Gegenden wahrhaftig sehen -- Imagination Kindheit stehen -- Örter besuchen -- gleichsam Wieg Menschheit -- 
  wunderbar Lauf alt Nil folgen -- Ruine fremd -- schauerlich -- halbverständlich Sprache anreden -- Sphinx Sand -- hoch Pyramid -- Memnon wundersam Bildsäule -- Gefühl alt Geschichte herumzutrag -- einzeln lebend Laute längst entflohen Heldenzeit -- vernehmen -- über Meer Griechenland hinüberzublicken -- träumen -- Vorwelt Staube emporgearbeiten -- griechisch Flott landen -- -- o -- unbegreiflich Gegenwart -- euer Glück undankbar -- -- 
  -- Ludovico -- Empfindung Berg -- Seeküste Brust gehen -- 
  fassen Handvoll Sand -- denken -- 
  mühsam -- Gefahr -- reisen -- teilch Erde sehen -- Sage Geschichte nennen -- 
  übrig Erde jüng -- 
  Heimat verwundern -- 
  Sieh ewig Fels -- Ätna Sizilium -- alt Schlund Charybdi -- 
  Mußt verwundern -- glücklich -- -- 
  selber -- 
  Tor -- 
  Tor -- wahrlich -- verachten Augenblick Mensch -- Torheit begehen -- 
  mancherlei Erzählung verstreichen -- Einsiedel -- 
  begreifen -- Eurer Gesellschaft -- sogar lustig -- Lebensweise angenehm -- -- 
  stecken Reisesucht -- glauben Torheit Leben hinüber -- wecken Lust -- 
  folgend nehmen Abschied -- Pilgrim Einsiedel völlig versöhnen -- schied Freund -- Ludovico führen Zug -- übrig folgen -- 
  Weg erkundigen Ludovico Sternbald Gefährten Florestan -- lacht -- Mühe -- bemerken -- Sternbald still -- begleiten tief Gedanke -- 
  Ludovico Franz -- hören -- Maler -- 
  -- Freund -- treiben Eurer Kunst -- 
  Gesellschaft Künstler -- gewöhnlich wunderlichst Mensch -- fallen seltsam Beschäftigung Laun Auge -- Leute -- 
  Stolz wunderlich Kontrast übrig Verhältnis Leben -- poetisch Begeisterung tragen Stunde -- unterlassen selten -- Gemeinheit Leben Kunstbeschäftigung hineinzunehmen schmeichelnd Sklave -- verachten Stolz -- Künstler -- 
  Mißhelligkeit entstehen gewöhnlich Charakter -- lustig Auge fallen -- 
  Franz beschämt -- streng Ritter -- Herr Ritter -- 
  Ludovico fahren fort -- 
  Künstler sehen -- Augenblick bemerken -- gewöhnlich Mensch -- 
  fast unnötig verschließen zudringlich offenherzig -- 
  zuweilen üben -- dergleich Leute darstellen -- niemals unterlassen -- Seltsamkeiten hellst Licht stellen -- 
  fallen gewiß schwer -- Mensch übrigen bleiben -- Leben zubringen -- treiben -- wovon glauben -- übermenschlich -- 
  Augenblick fühlen -- übrig Menschengeschlechte zusammenhängen -- 
  sterblich leben Tön -- Zeichen -- gleichsam Luftrevier Feen Kobolde -- scheinbar -- glauben Erde betreten sehen -- 
  Hinsicht Unrecht -- Franz -- 
  Kunst ergeben -- -- -- Mensch -- aufopfern -- 
  schlimm -- such Leute -- Künstler halten lassen -- allerhand Seltsamkeiten auffallend Torheit -- eigentlich Schau tragen -- Orden Ordenskreuz -- Ermangelung -- Ferne erkennen -- halten -- wirklich Kunst -- 
  Hüten -- Herr Maler -- 
  erzählen Manne -- Franz -- dergleich Torheit frei bleiben -- 
  Nennt -- rufen Ludovico -- 
  Sternbald -- 
  edeln Malergeist Raffael Sanzio Urbin -- 
  -- heftig Ritter -- -- fahren Nachdenken fort -- lassen Rede auffallen -- brauchen -- 
  einzig Name beschämt Flucht schlagen -- Wort erschein Lästerung menschlich Größe -- 
  Tor -- ausmachen gelten lassen -- 
  Roderigo -- Seite schildern -- 
  -- Freund -- besseres Schlechter -- 
  lassen Kunst selber sprechen -- 
  Stunde wünschen -- Maler -- 
  Sternbald fragen -- 
  kommen -- 
  Erstlich -- antwortet jung Ritter -- Vergnügen -- Mädchen Farbe hinzustellen -- ehemals -- schön abzuzeichnen -- manchmal glücklich Stunde Gemüte gewahr -- 
  erleiden zuweilen sonderbar Begeisterung -- Geist heftig bewegen -- glauben -- Geschicklichkeit Gebot ständ -- wunderbar merkwürdig Sache ausarbeiten -- 
  sehen -- Freund -- einsam -- schauerlich Gegende abschildern -- morsch zerbrochen Brücke schroffen Fels -- Abgrunde hinüber -- Waldstrom schäumend drängen -- verirrt Wanderleute -- Gewänder feucht Wind flattern -- furchtbar Räubergestalt Hohlwege heraus -- angefallen geplündert Wäg -- Kampf reisend -- -- 
  Gemsenjagd einsamen -- furchtbar Felsenklippe -- kletternd Jäger -- springend -- gejagt Tier herab -- schwindelnd Abstürze -- 
  Figur -- schmal überragend Stein Schwindel ausdrücken -- Fall ergeben -- Freund -- Hilfe eilen -- Ferne ruhig Tal -- 
  einzeln Baum Gesträuch -- Einsamkeit ausdrücken -- Verlassenheit aufmerksam -- 
  -- Bach Wassersturz -- Fischer -- angelt -- Mühle -- drehen -- Monde beschienen -- 
  Kahn Wasser -- ausgeworfen Netz -- 
  -- zuweilen kämpfen Imagination -- ruhen zufrieden -- Unerhört ersinn Stande bringen -- 
  Äußerst seltsam Gestalt hinmalen -- verworrenen -- fast unverständlich Verbindung -- Figur -- Tierart zusammenfänden unten Pflanze endigen -- Insekt Gewurm -- wundersam Ähnlichkeit menschlich Charakter aufdrücken -- Gesinnung Leidenschaft possierlich furchtbar äußern -- sichtbar Welt aufbieten -- Seltsamst wählen -- Gemälde -- Herz Sinn ergriffen -- erstaunen Schauder erregen -- wovon Ähnlich sehen gehören -- 
  find Kunst tadeln -- Meister ungefähr Ziel hinarbeien -- löblich -- weniger Abänderung alte -- 
  Franz Augenblick stumm -- -- würden Weise Gebiet Kunst erweitern -- wunderbar Mittel Wunderbarst erringen -- euer Bemühung erliegen -- 
  euer Einbildung lebhaft lebendig -- zahlreich Gestalt Erfindung -- Unmöglichste leicht Spiel dünken -- 
  O -- billig Forderung Künstler aufgeben -- wirklich Arbeit schreiten -- 
  stimmt Pilgrim plötzlich geistlich Lied -- Tageszeit kommen -- Gelübde absingen müssen -- 
  Gespräch unterbrechen -- aufmerksam zuhörten -- eigentlich wissen -- -- 
  Schlus Gesange treten anmutig Tal -- Herde weiden -- Schalmei tönen Herüber -- Sternbald Gemüt heit mutig stimmen -- frei Stück Florestan's Schalmeilied Ergötzen übrigen wiederholen -- geendigen -- steigen mutwillig Ludovico Baum -- singen Tönen Wachtel -- Kuckuck Nachtigall herunter -- 
  Pflicht tun -- -- verdienen -- ausruhen -- wobei jung Florestan Liede erquicken -- 
  setzen Rase nieder -- Florestan fragen -- Inhalt Liede -- 
  -- antworten Ludovico -- -- -- zufrieden -- gemütlich -- Inhalt Inhalt Gedicht ausmachen -- 
  Rudolf singen -- 
  Himmel ziehen Vögel Zug -- Wanderschaft begreifen -- hören zwitschern gepfiffen Klein Melodien -- 
  singen fein Stimme -- krächzt Grimm stottern -- schnarren -- Drossel -- Gimpel -- Schwalbe -- Star -- wissen -- -- wissen_es sagen_es -- reden scheinen -- Gerede Gewicht -- 
  -- -- Holla -- Reise -- -- -- 
  Weise -- 
  -- -- bleiben jeglicher Stunde -- -- -- 
  Erde -- allenthalben -- 
  arm Lerche Jagd -- Schnepf Dohn gefangen -- Vöglein aufgehangen -- Rückfahrt denken -- 
  -- Art sprechen -- 
  arm Vögel Hals brechen -- 
  -- -- verständlich Sprache -- rufen Mensch -- dienen Sache -- Natur Sprache regieren -- eins Krieg führen -- Räsonniert beweisen -- einer aufgespeisen -- Strom Meer verschlungen -- Schicksal Mensch bezwung -- tapferst Magen -- nimmermehr essen reuen -- alt Fabel besagen jung Gericht einst Jagd -- 
  Speis nachher -- letzter Gericht -- 
  Rudolf singen toll Vers lächerlich Bewegung -- Lachen enthalten -- 
  Pilgrim ernsthaft -- feierlich -- 
  Verzeiht -- Trunkener -- begleiten -- Pilgerschaft gleichsam Narrenreise -- 
  verzehrt Wiese Mittagsmahl -- mitnehmen -- Ludovico müde -- Roderigo allerhand Neuigkeit erkundi gen -- 
  Roderigo verschweigen -- Art Scham -- Erzählung wiederholen -- Geschichte -- 
  Zufall Luth Reformation sprechen -- 
  O -- schweigen -- rufen Ludovico -- Verdruß hören -- 
  Jedweder -- klug halten -- nehmen unser Partei Mann -- gewiß redlich meinen -- Idee wissen -- hinaus -- 
  erstaunt -- Franz -- 
  deutsch -- fahren Ludovico fort -- Nürnberger -- nehmen Wunder -- gut Sache annehmen -- erscheinen -- 
  glauben -- Luther wahrhaft Geist -- gewogen -- 
  schlimm -- Mensch einreißen -- Wand Hofs -- Lust kriegen -- neu Gebäude aufführen -- 
  eingesehen -- Irr -- irren jenseits -- gerade lieblich Straße bleiben -- 
  sehen Voraus -- gegenwärtig fast notwendig hervorbringen -- Mann Wunder Jahrhundert halten -- eigentlich -- 
  fangen untersuchen -- untersuchen -- tasten Göttlichkeit Religion -- wunderbar Gedicht liegen -- verständlich -- verstehen -- ergrübeln widerleg -- Tracht vorwärts dringen -- Blödsinne gelingen -- Gegenteil hoch Vernunft Untersuchung Netzen gefangen fühlen -- edle Poesie glauben -- Unmündig erklären -- 
  O -- Martin Luther -- seufzen Franz -- kühn Wort sprechen -- 
  Ludovico -- 
  eigentlich -- Mißbräuch Zeitalter Schutz nehmen -- vornehmlich eifern -- dünken -- führen -- ängstlich streben -- Gemein -- edelster ergreifen -- 
  Mensch -- Nachfolger selber verstehen -- erzeugen Fülle göttlich Religion dürre vernünftig Leerheit -- Herz schmachtend zurücklassen -- ewig Strom voll Bild kolossal Lichtgestalt trocknen -- dürr gleichgültig Welt bleiben einzeln -- zerstücken -- ohnmächtig Kampf erobern -- verlieren -- Reich Geist entfliehen -- einzeln Engel kehren -- 
  Prophet -- Roderigo -- sehen -- Freund -- ägyptisch Weisheit heimgebracht -- 
  -- Pilgrim -- Weise töricht Ding Atem sprechen verrichten -- 
  fromm Gemütsbewegung zutrauen -- -- 
  Rudolf stehen Ludovico Hand -- -- Freund -- für's dulden -- begleiten -- wohin -- Meister -- euer Schüler -- 
  opfern -- Braut Vater Geschwister -- 
  Geschwister -- fragen Ludovico -- 
  Bruder -- antworten Rudolf -- lieben Kindesbein -- sehen -- fühlen Sehnsucht -- Italien wiederzusehen -- 
  Ludovico -- 
  Welt traurig -- -- Schwester -- Bruder -- 
  Glück versagen -- Welt treten -- Geschwister antreffen -- Herz nächster gehören -- 
  Bruder lieben -- voll Freude begegnen -- Seele seinigen fest hineinwachsen -- Kinderspiel teilen -- 
  einsam finden -- toll Glück -- wunderlich Landschwärmen gering Ersatz Bruderliebe -- suchen -- 
  Zürn -- Roderigo -- gut Freund -- 
  Wesen fänden -- Vater -- Temperament -- Laun wahrnähmen -- Erschrecken Freude Entzücken zueiler brüderlichen Arm schließen -- 
  -- wahr Sinn -- fänden -- 
  --- einsam Kindheit verleben -- -- Herz beworben -- -- Mensch wahr Art lieben verstehen -- Geschwister lernen Liebe -- Kindheit lieben Herz schönsn -- -- 
  hartherzig -- selber Zufalle verspielen -- Hinzubring -- 
  schön Sehnsucht unbekannt bleiben -- brüderlich Herz wissen schmachten -- Arm weit Welt hineinstrecken -- schlagend Herz entgegen -- 
  Franz trocknen Träne -- unterdrückt Schluchze -- 
  -- drängen unsichtbar Gewalt aufzustehen -- Hand Unbekannt fassen -- Arm stürzen ausrufen -- 
  Nimm Bruder -- 
  fühlt Einsamkeit -- leer Herz -- Ludovico sprechen Wunsch -- still Stunde ängstigen -- Klage -- Jammer frei Lauf lassen -- innerlich fühlen -- -- Mensch fremd -- Bruder -- Liebe verspoten -- 
  allerhand Lied -- andächtig Gesang Pilger wunderlich abstach -- gehen -- 
  Roderigo -- 
  Freund -- paarmal Deines Vater erwähnen -- Name sagen -- 
  wissen -- fallen Rudolf hastig -- euer Freund dergleichen Frage lieben -- 
  quälen -- 
  kennsen -- -- Ludovico -- denken -- Kamerad -- 
  Freund Sternbald betrüben -- 
  Sternbald -- 
  trauern -- Mensch verlassen -- leben -- 
  Reise fortsetzen -- aufhalten lassen -- 
  wissen -- -- Zweck fast vergessen -- 
  Zweck vergessen -- fallen Ludovico -- vernünftig Mensch einrichten -- Zweck -- 
  lachen -- Leute Anstalt sehen -- Leben fahren -- Leben -- ehe Vorbereitung fertig -- 
  Gespräch ziehen marsch Feld -- 
  Rudolf voran -- Pfeife munteres Lied blies -- Band fliegen Hute spielend Luft -- Schärpe tragen Säbel -- 
  Ludovico seltsam kleiden -- Gewand hellblau -- schön Schwert hing zierlich gewirkt Bandelier Schulter -- golden Kette tragen Hals -- braun Haar lockig -- 
  Roderigo folgen Rittertracht -- Pilgrim Stabe einfach Anzug kontrastieren -- 
  Sternbald glauben seltsam Zug alt Gemälde ansehen -- 
  Abend -- ermüden -- lassen Stadt -- Dorf antreffen -- 
  wünschen gutmütig still Einsiedel finden -- bewirten -- horcht -- Glockenschall vernähmen -- Bemühung Erfolg -- 
  Ludovico schlagen -- Walde Nachtlager aufschlagen -- -- Florestan -- -- groß Lust bezeigen -- Handwerk Abenteurer sonderbar auffallend anfangen -- 
  Pilgrim glauben -- verirren -- vergebens -- Weg antreffen -- 
  Rudolf lang Streit anhören -- bleisen Pfeife -- 
  Verwirrung -- sprechen -- Vorschlag -- gehören -- 
  Streites ziehen groß Eile fort -- flöhen -- Strecke Wege zurücklegten -- 
  Pilgrim sinken fast atemlos nieder -- nötigt Weise -- still halten -- 
  erholen -- glänzt Wolke Abendrot -- gehen langsam -- 
  -- ziehen -- angenehm Gehölz -- finden rund -- grün Rasenplatz -- liegen Garten -- Staket umgeben -- Stab Verzierung hindurchblicken -- 
  artig einrichten -- Geländer allenthalben durchbroch arbeiten -- eisern Tür zeigen etlicher Stelle -- Palast sichtbar -- 
  dicht Baumgänge liegen -- kühl Felsengrott -- Springbrunn hört Ferne plätschern -- 
  stehen still -- zauberischen Anblicke verlieren -- erwarten -- spät Rose glüht schlanken -- erhaben Stämmen entgegen -- stehen dunkelrot Malve -- Krause gewunden Säule dämmergrün Gang stützen scheinen -- 
  umher still -- Menschenstimm vernehmen -- 
  Feengart -- rufen Roderigo -- Zauberei hierher kommen -- 
  Besitzer Haus sein -- erquicklich müssen -- anmutig Grott ausruhen -- dunkel Gänge spazieren -- süß Früchte abzukühlen -- 
  Mensch wahrnähm -- Erlaubnis erteilen -- 
  Ludovico Baum schön Früchte gewahr -- Garten stehen -- saftig Birn hochrot Pflaume -- 
  schnell Entschluß fassen -- 
  lassen -- gut Freund -- rufen -- Zeremonie Spalier Garten steigen -- Grott ausruhen -- Früchte sättigen -- Mondschein abwarten -- Reise fortsetzen -- 
  Verwegenheit Verwunderung setzen -- Rudolf sogleich Meinung -- 
  Sternbald Pilgrim widersetzen längsten -- sprechen -- Ludovico -- hinzuhören -- Garten klettern gesprung -- helfen Florestan -- Roderigo rufen Rückbleibende ebenfalls -- Sternbald bequemen -- Pilgrim -- Obste gelüsten -- finden bedenklich -- Gesellschaft Reise fortsetzen -- 
  nachh Einwendung -- hören -- Ludovico fing Kraft Baum schütteln -- reichlich Obst hergaben -- übrig vieler Emsigkeit aufsammeln -- 
  setzen kühl Grotte essen nieder Ludovico -- 
  antrifft -- -- 
  müssen ungesitten -- bitte Verzeihung hören -- stark -- vereinigen widerstehen -- 
  Pilger Weile gegessen -- fing -- Reue fühlen -- Florestan lustig Mute -- Seht -- Freund -- leben eigentlich Stande Unschuld -- golden Zeitalter -- zurückwünsch -- eigenmächtig -- Stunde erschaffen -- 
  O wahrlich -- frei Leben -- Räuber führen -- erobern -- gänzlich verachten -- 
  verwöhnen Sicherheit Ruhe -- 
  geben -- höchstens Kampf -- 
  bewaffnen -- fürchten -- sichern -- 
  horchten -- -- Ferne Ton Waldhörner vernähmen -- Klang verstummen -- 
  unverzagen -- rufen Ludovico -- tun -- Haus wäret -- stehen -- 
  Pilgrim müssen Springbrunn -- flasch Wasser füllen -- trank Reihe groß Wohlbehag -- 
  Abend kühl -- Blume dufteen süß -- Erinnerung Herz wecken -- 
  weißen -- Roderigo -- fing Ludovico neu -- Italien -- Rom Liebe -- -- -- 
  verlassen schön Land gewiß Widerstrebe -- unaussprechlich Sehnsucht Stadt -- Marie Zurückblieb -- 
  Kurzem kennen lernen -- fast vorschlagen -- zurückzureisen -- bleiben -- -- Gesellschaft -- 
  O Roderigo -- Vollendung Weibe sehen -- sehen -- süß -- geheim Zauber -- Gestalt umschweben -- heilig -- blau verklärt Auge entgegenblicken -- Unschuld -- lockend Mutwille -- Wange -- liebreizenden Lippe abbilden -- -- schildern -- 
  Gegenwart empfinden Jugendgefühle -- -- Mädchen spräch -- Gleichen vorkommen -- 
  Zug glatt schön Augenbraun -- Phantasie Ehrfurcht halten -- stehen Braune -- lang Wimper golden Netz Liebesgott -- Seele -- Wunsch -- fremd Auge wegzufangen -- 
  sehen -- sehen Mädchen -- Blick -- verstohlen lächeln locken -- wohnen Holdseligkeit Brust -- Herz treibend Feder -- -- Gasse -- Garten nachdrängen -- himmelsüß Blick Vorübergehen streifen -- zittern Seele -- schwindeln Auge Blick rot lächeln Lippe hinunt -- Lieblichkeit Wang verirren -- ungern schön Busen festhalten -- erraten -- 
  O Himmel -- gib Mädchen Arm -- übrig Welt -- -- Köstliches -- Neid überlassen -- 
  schwärmsen -- Roderigo -- Sprache niemals sprechen hören -- 
  Sprache -- fahren Ludovico fort -- -- Taub blind -- 
  fehlen -- Rudolf Lied sängen -- 
  Ein leicht -- scherzend Lied -- Erde berühren -- luftig Schritt golden Fußbode Abendrot -- Welt hineingrüßen -- 
  Laß Liebe -- empfandesen -- Herz aufzittern -- sprich Rätselsprach -- eingeweihte verstehen -- 
  -- dienen -- Rudolf -- fallen Lied Sehnsucht -- fallen -- 
  Blume Köpfchen senken -- Rose blaß -- 
  -- 
  Träne Blatt Lilie hängen -- Vergang schön frisch Gras -- 
  Blume erbleichen -- Farbe entweichen -- -- allerholdseligster Maid -- 
  Anmut Feld -- süß Blüte Baume -- Farbe -- Ton durchstreif Welt suchen Schönste umher -- 
  Tal leer Wiederkehr -- -- bringen fesseln schön Farbe -- Ton -- 
  Regenbog leuchten voran Blume folgen -- Nachtigall singen Bahn -- Rieseln silbern Bach -- 
  Frühling vergehen -- bringen gefangen -- Frühling Herbst alsbald -- Herrscht Winter kalt -- 
  -- 
  finden -- finden -- Auge -- Schönste suchen -- mangeln Liebe Augenlicht -- ermüden Suchen -- 
  Treibt Blume Sache fröhlichen Scherz -- -- nehmet Herz -- holden Engelskinde Frühling Weg gewißlich finden -- 
  Kind entdecken Spur -- O -- hören -- o -- hören ängstlich Flehn -- Müßt tief Auge sehen -- Blick bezaubern -- verblenden -- 
  Wesen bestehen -- all Liebe vergehen -- Liebe -- 
  Bedenkt -- Frühling Blumenglanz Fuß wandeln -- -- leicht Tanz -- Frühling Nachtigall -- spät früh behelfen -- bittersüßen Liebesträne einsam Schönst sehnen -- 
  bleiben -- bleiben -- wiedersehen -- Blume Frühlingston Herzeleid -- indes bitterst Tod vergehen -- 
  selber strafen -- Grab tief schlafen -- fern Lied -- fern Sonnenschein Toter -- 
  -- 
  brechen Sehnsucht Heimlich Herz treust Brust -- Treue schwer bitter Lohn -- 
  sünd innig bewußt -- 
  Liebste erfreuen -- quälendsten Pein -- 
  Treulose Hoffnung -- Lächelst -- -- Verlorener Mann -- 
  lieblich -- Gebüsch umh Tön gleichsam erregen -- verspätet Vögel erinnern Frühlingslieder -- wiederholt schön Schläfrigkeit -- 
  Roderigo Freund beherzt -- erzählt Abenteuer schön Gräfin -- Freund hört Geschichte erzählen -- 
  -- sagen -- 
  schließen Roderigo -- verlassen -- denken -- -- sehen Auge schweben -- wissen Stunde peinigend Angst lassen -- 
  edl Anstand -- munter Auge -- braun Haar -- -- Zug Einbildung -- 
  Nächte hellgestirnten Himmel wandeln -- Glück voll -- zaubert Gestalt Auge -- -- Stern hell funkeln -- Dach Himmel Freude auslegen -- 
  sagen -- Freund Ludovico -- Sinn dienstbar Sklave nachgezogen -- Auge erblicken -- sanft -- reizend Bewegung beschreiben Linie schön Musik -- Wald -- leicht Gewand Fuße -- Lende geschmeidig anlegen -- Pferd steigen Galopp Kleid auf niederwogen -- Tanz Göttin schweben -- Wohllaut -- sehen -- sehen -- vergessen Bewegung vorigen -- 
  Wollust -- Auge verfolgen -- arme ruhn -- 
  Wein fehlen -- rufen Florestan -- Liebe Bild zugegen -- 
  denken -- sprechen Roderigo erhitzen -- anderer Liebe bewirben -- freundlich Auge anblicken -- unsinnig -- 
  böse -- vorübergehen -- 
  beneid Gewand -- zart Körper berühren umschließt -- 
  laut Eifersucht -- dennoch verlassen -- 
  Ludovico -- verwundern -- 
  Mädchen -- lieben -- eifersüchtig -- -- hübsch -- 
  artig Mädchen bemerken -- kennen -- wissen -- stehen Begier Bilde gleichsam Wache -- neidisch böse -- Zufall Haus -- grüssen höflich danken -- 
  -- Sprache freundlich -- unbekannte mehrere auszeichn merken -- hassen -- 
  O -- Eifersucht unbegreiflich Liebe -- Weiber Mädchen unser Eigentum -- lüsternen Auge lassen Schranke setzen -- Phantasie Fass danaider -- Sehne umfängen umarmt jeglicher Busen -- 
  finst -- müde Pilgrim eingeschlafen -- Hörnertöne erschallen -- fast nah Sprechenden -- singen angenehm Stimme -- Treulieb -- nimmer -- Kummer Leid Kehrt Liebe -- Freude -- kehren hold Gruß -- Händedrücken -- Zärtlich Blicken -- Liebeskuß -- 
  Obstdieb ertappen -- rufen Ludovico -- 
  kennen Melodie -- kenn Wort -- Sternbald -- erinneren -- -- Ton -- fahren Stimme fort singen -- Treulieb -- nimmer -- Gang Einsamkeit -- weihen -- 
  schön -- begrüßet küsset Freudentran -- 
  kommen durch Gebüsch Gestalt -- Dame gehen voran -- mehrere Diener folgen -- 
  fremd Gesellschaft indes aufstehen -- Roderigo treten -- Ausruf Entzücken liegen arm unbekannte -- 
  Gräfin -- Freude Sprache wiederfinden -- 
  -- rufen -- o gütig Schicksal -- danken -- 
  anfangs erzählen -- 
  -- zerstreuen -- Freundin Jugend besuchen -- gehören Schloß Garten -- 
  unerlaubten Übersteigen Rede -- 
  Abendmahlzeit stehen bereit -- Pilgrim lassen mühselig Wanderschaft -- Franz Freundin Adelheid's -- Name Gräfin -- vorziehen -- Kunst vorzüglich lieben -- 
  Gemahl sprechen Malerei -- loben Albert Dürer vorzüglich -- schön Stück besitzen -- 
  berauscht -- legen früh schlafen -- Roderigo Gräfin bleiben lang munter -- 
  Franz bemerken -- Roderigo Gräfin völlig ausgesöhnen -- vermähl -- lang zögern -- Reise fortsetzen -- Vorwurf -- säumen -- 
  Roderigo Erzählung fortsetzen lassen -- eremit Anfange abbrechen -- finden Gelegenheit -- 
  Herr Schlosses nötigen bleiben -- Franz fürchten -- laufen -- Italien -- 
  Abschied -- Ludovico Freund bleiben -- Florestan bleiben -- 
  fühlen Sternbald -- lieb Rudolf -- ergriff unerklärlich Wehmut -- Ludovico Hand Abschiede reichen -- 
  Florestan Weise rühren -- versprechen unser Freund -- Italien folgen -- binnen kurz gewiß Rom antreffen -- 
  Sternbald Träne zurückhalten -- Tür Hinausging -- Garten flüchtig Blick durchirren -- 
  Pilgrim Gefährt -- 
  draußen frei Landschaft -- Schloß verschwinden -- fühlen einsam -- 
  frisch -- stumm Pilger -- erinnert Gespräch -- führen -- Begebenheite -- Rudolph Gesellschaft erleben -- 
  Kopf wüst -- -- Freude Leben verlieren -- 
  Pilgrim verrichtet Gebet -- sonderlich Sternbald kümmern -- 
  Nachher geraten Gespräch -- worin Pilger genau Zustand Haushaltung erzählen -- 
  Sternbald erfahren Armseligkeit gewöhnlich Leben -- Kaufmann mittelmäßig Glücksumständen -- trachen -- gewinn Lage verbessern -- 
  Franz -- Empfindung drückend -- leicht poetisch Leben wirklich zurückführen -- antworten -- Mühe -- Hinzuhör -- 
  Schritt Wege sauer -- einsam -- -- Freund verlassen kümmern -- 
  kommen Stadt -- Franz Brief Sebastian finden hoffen -- gehören -- 
  trennt Pilgrim eilt bezeichnet Mann -- 
  Brief -- Erbrach begierig -- lesen -- Liebster Franz -- 
  glücklich -- frei -- schön Welt herumwanderst -- Erfüllung -- Entfernung dachtest -- Glück sehen vollkommen -- 
  -- Bruder -- manchmal vorkommen -- Lebenslauf verlieren -- Mut entgehen -- Kunst -- Leben fortfahren -- 
  kommen -- tröst könntest -- tun -- 
  Meister fangen -- kränkeln -- gesund Reise -- schöne verlieren -- 
  Stunde melancholisch -- 
  müde -- sprechen -- gut Schicksal wünschen -- 
  fleißig -- Arbeit wahr Art Stelle rücken -- fehlen Mut -- Hand beleben -- wehmütig Gefühl ziehen Staffelei -- 
  -- schreibst seltsam Liebe -- fröhlich Gesellschaft -- -- Franz -- verlassen -- arm -- vergessen verachten -- Kühnheit -- Liebe traurig Leben hineinzuwünschen -- 
  sprech Freude -- machst -- lachen -- toll -- -- 
  vorstellen -- einst Wesen lieben -- lieben dürfen -- 
  gehen trüb Wetter Stadt -- betrachten Gebäude Turm -- mühselig Arbeit -- künstlich Schnitzwerk -- gemalt Wand -- Frage -- 
  wozu -- 
  Anblick arme betrüben -- Auge aufheben -- 
  Mutter sterben -- Vater liegen Vorstadt krank -- 
  Handwerk nähren -- -- 
  Meister Dürer -- helfen gut Art -- fühlen lassen -- zeitlebens vergessen -- 
  -- 
  fallen sechzehnten -- Maler -- 
  ordentlich Handwerk ergreifen -- selber Vater ernähren -- 
  dünken töricht -- Ausarbeitung Geschichte arbeiten -- indessen wirklich Leben vergessen -- 
  Leb -- bleiben gesund -- 
  Ding glücklich -- 
  Liebe dein Sebastian -- 
  Franz lassen Blatt sinken Himmel -- 
  Freund -- Dürer -- Nürnberg ehemalig bekannt Gegenstand kommen frisch Kraft Gedächtnis -- 
  -- glücklich -- rufen -- fühlen -- glücklich -- 
  Leben spinnen golden Faden -- 
  Reise -- finden Freund -- annehmen -- lieben -- Kunst wider erwarten fortgeholfen -- -- 
  leben -- Gräfin irren -- -- tot -- -- Emma lieben -- arme schönst Glück nossen -- 
  Leben Rudolf Sebastian -- 
  wissen -- Eltern finden -- 
  O Sebastian -- wärst zugegen -- Hälfte Mut geben -- 
  Kapitel -- 
  Sternbald Stadt streifen -- glauben Ferne Bildhauer Bolz bemerken -- Person -- halten -- verlieren Auge -- 
  Franz ergötzen -- Gewühl unbekannt Mensch herumirren -- 
  Jahrmarkt -- benachbart Stadt Dorf Mensch Art versammeln -- verkaufen einkaufen -- 
  Sternbald freut Fröhlichkeit -- Gesicht beherrscht -- verworren Ton laut erregen -- 
  stellen abseits -- Ankommende -- eingekaufn zurückgingen -- 
  Fenster Markt Mensch anfüllen -- verworren Getümmel heruntersahen -- 
  Franz -- 
  welch schön Gemälde -- -- darstellen -- 
  angenehm Unordnung -- Bild nachahmen lassen -- 
  ewig Wechsel Gestalt -- mannigfaltig -- durchkreuzend Interesse -- Figur Augenblick Stillstand geraten -- -- wunderbar schön -- 
  Art kleidung Farbe verirren -- Geschlecht Alter -- Mensch -- dicht zusammengedrängen -- nächststehenden nehmen -- selber sorgen -- 
  suchen holen -- wünschen -- lachend Mute -- Götter plötzlich Füllhorn Boden ausschütten -- emsig Tausend herausraffen -- bedürfen -- 
  Leute ziehen Bild umher -- erklärt -- Menge Volks versammelen -- 
  schlecht -- grob Figur Leinwand malen -- 
  Geschichte Handwerker -- Wanderschaft Seeräuber Hand geraten -- Algier schmählich Sklavendienste -- 
  darstellen -- Christ Garten Pflug ziehen müssen -- Aufseher fürchterlich Geißel antrieb -- 
  Vorstellung Bild seltsam Ungeheures -- Erklärer behaupten -- jüngst mittelländisch See gefangen -- 
  Menschenkopf Panzer Brust -- Füß Hand bilden Floßfeder hingen herunter -- hinten Pferd -- 
  Volk erstaunt -- 
  -- Franz -- Menge -- fällen -- 
  wunderbar Schicksal -- wovon glauben -- ergreifen -- Mensch treffen -- Stand seinigen -- 
  lächerlich Unmöglichkeit -- 
  sehen -- Künstler erfüllen -- abgeschmackt Neigung befriedigen -- fallen -- 
  Arzt Seite Marktes Gerüst aufschlagen -- bieten kreischend Stimme Arzneien -- 
  erzählt ungeheuerst Wunder -- vermittel Medikament verrichten -- 
  Zulauf -- Leute verwunderten kaufen -- 
  verlassen Gewühl -- vor Tor -- lebhaft ruhig Einsamkeit lärmend Geräusch empfinden -- 
  Bäume auf abging -- begegnen Bolz -- Bildhauer -- 
  erkennen sogleich -- gehen erzählt Begebenheite -- 
  Franz -- 
  niemals glauben -- Stande wäretn -- Mann verletzen -- Freund halten -- 
  entschuldigen -- 
  O -- jung Mann -- rufen Augustin -- niemals beleidigt -- Galle -- 
  Roderigo ruht Schmähwort eher -- Stoß versetzen -- Schuld -- 
  reizen -- zurückhalten -- 
  Franz -- Streit anfangen -- lassen Entschuldigung gelten -- Bolz fragen -- 
  Stadt aufhalten gedächen -- 
  abreisen -- antworten Sternbald -- 
  raen -- bleiben -- Bildhauer -- neigen -- einträglich Arbeit nachweisen -- 
  Stadt liegen Nonnenkloster -- -- -- Gemälde Öl Wand erneuern -- 
  ungeschickt Maler senden -- vorschlagen -- 
  Franz Antrag -- wünschen -- Pinsel groß Figur üben -- 
  Bolz verlassen Versprechen -- Abend wiederzusehen -- 
  Bolz -- Sonne untergegangen -- 
  Vertrag Äbtissin Klosters -- Sternbald zufrieden -- 
  gehen Stadt hinaus -- Bolz scheinen unruhig -- -- jung Maler mitteilen -- brechen -- Sternbald -- Geist Malerei beschäftigen -- achten -- 
  finster -- 
  benachbart Berg hineingewenden -- Gespräch fallen Kunst -- 
  -- Sternbald -- unsterblich Werk Michael Angelo begierig -- halten Höchste -- Kunst hervorbringen -- 
  hervorbringen -- rufen Bolz -- Vortrefflichkeit -- Schönheit Rede -- schön -- vortrefflich -- 
  übrig Künstler gleichsam Vorbereitung -- Ahnung einzig Manne ansehen -- Kunst verstehen -- wissen -- ausrichten -- 
  -- Sternbald -- verehren -- Vollkommenheit streben -- 
  einsehen -- Bildhauer -- 
  Menge Kunst -- Ideal -- unterhalten reizen -- verstehen -- niedrig Geist Werk richten wissen -- selber Geistesbedürfnissen Menge -- Liebhaber unkenner vertraut -- 
  erblicken echt Künstler Mangel -- glauben Fehler Schwäche urteilen -- vorsätzlich verschmähen -- Liebling fällen -- 
  Künstler Größe erstreben -- 
  richtig Begriff Kunst -- gute -- 
  -- Künstler -- 
  Talent Rechenschaft geben -- blindlings ausüben -- zufrieden -- leichtest Wohlgefalle erregen -- Weg -- 
  wissen -- Kunst -- woher erfahren -- Kunst hoch -- letzter Spitze -- 
  Michael Angelo Kunst gebären -- Schule ausgehen -- einzig -- 
  meinen -- fragen Franz -- Kunst beschaffen -- 
  -- Bolz -- unnütz Bestrebung -- schlecht Manier niederlegen -- allmächtig Buonarotti folgen -- 
  ausgeübt Kunst -- vollenden -- erhaben Geist aufstehen -- Irrende zurufen -- dorthin -- Freund -- Weg -- 
  Buonarotti tun -- nachh Zweifel fragen -- Kunst -- 
  jeglicher Darstellung Sinn liegen -- gewöhnlich verschmähen -- fallen -- 
  nehmen fast Künstler Sinn Anspruch -- Interesse erregen -- Ideal verstehen -- 
  dunkel -- 
  Mond steigen unten Horizont herauf -- fernh Hammerschlag gehören -- stehen Eisenhütt -- arbeiten -- 
  Anblick schön -- Fels stehen schwarz umh -- Schlack liegen aufhäufen -- einzeln grün Gesträuch -- fast unkenntlich Finsternis -- 
  Feuer funkend Eisen offen Hütte erhellen -- hämmernd Arbeiter -- Bewegung -- glich bewegt Schatten -- hellglühend Erzklumpe angeschienen -- 
  hinten wildbewachsenen Berg sichtbar -- alt Ruine Spitze aufgehenden Monde beschimmern -- leicht Streifen Abendrot Himmel -- 
  Bolz rufen -- 
  Seht schön -- bezaubernden Anblick -- 
  Sternbald überraschen -- stehen Weile Gedanke schweigen -- rufen -- 
  -- Freund -- könnten sagen -- Künstler Gemälde wunderbar Szene darstellen -- 
  Handlung -- Ideal -- Schimmer verworren Gestalt -- fast unkenntlich Schatten bewegen -- 
  Gemälde sähetn -- würden mächtig Empfindung Gegenstand hineinsehnen -- 
  übrig Kunst Natur Zeitlang Eurem Gedächtnisse hinwegrücken -- -- 
  Stimmung euer Innere ausfüllen -- bleiben wünschen übrig -- -- künstlich -- fast tändelnd Spiel Farbe -- 
  Handlung -- Ideal -- Vollendung -- hoch Sinn -- -- Künstler Trefflichste -- kennen Fremdartig hineinnimmen -- 
  Wahrlich -- -- alt Welt Wunder auftun -- stehen fabelhaft Kyklope -- Mars Achilles Waffe schmieden -- 
  Götterwelt Gedächtnis -- 
  sehen -- -- schön Erinnerung entwickeln innerer Seele -- lebendig wach -- Schlief -- 
  -- Freund -- innigst überzeugen -- Kunst Natur -- Schönheit -- 
  Bolz still -- Künstler ergötzt Anblick -- suchen Rückweg Stadt -- 
  Mond indes heraufgekommen glänzt voll Licht entgegen -- Hohlweg -- durchkreuzten -- feucht Wiese herüber -- Berg zauberischen widerscheine -- 
  Gegend Maß verschmelzen -- verschieden Grund gesondern -- andeuten -- auszeichnen -- Wolke Himmel -- -- Meer unendlich golden Glanzwog sanft Wiese Wald ausströmen Herüber Fels bewegen -- 
  Könnten Natur genau nachahmen -- Sternbald -- begleiten Stimmung -- Werk arbeiten -- frisch Kraft -- voll Neuheit hinzustellen -- empfinden -- ergreifen -- wahrlich -- können Handlung Komposition entbehren -- -- herrlich Wirkung hervorbringen -- 
  Bolz wissen -- antwort -- nachgeben -- Franz widerlegen -- Stritt -- verwunderten -- Stadt erscheinen sehen -- 
  Bolz suchen Weg -- inne -- verirren -- 
  Wanderer verdrießlich -- müde sehnt Abendessen -- scheben Gebüsch -- Hügel -- blendenden Schimmer Monde erlaubt Aussicht -- 
  Streit Kunst hören -- denken -- zurecht finden -- 
  Bolz -- Seht -- Freund -- Kunst Natur vernachlässigen -- gegend hineinsehnen -- Herauswickel möchten -- 
  gaben Ideal Kunstwörter Ruhestelle -- 
  sprechen -- Sternbald -- Rede -- 
  euer Schuld verirren -- stehen -- spotten -- 
  setzen ermüden Stumpf abgehauen Baume nieder -- 
  Franz -- 
  übernachn -- sehen möglich Ausweg -- 
  -- rufen Bolz -- Not -- Not finden -- 
  sprechen -- Lied singen -- schlafen -- lassen -- 
  Aufgange Sonne munt -- kehren Stadt -- 
  Fangt singen -- 
  Sternbald -- 
  Besseres wissen -- Lied Einsamkeit singen -- schicken unser Zustande -- 
  hellgestirnt Himmelsdach -- Mensch Schlaf ergeben -- Ruhend mühevoll Leben -- -- Haus wach -- 
  trübe brennen Licht herunter -- Fenster schauen -- -- nüber fern Auen -- 
  Auge bleiben munter -- 
  Strahl ergehen Mondes Aufgang suchen -- 
  Sieh -- flimmeren Buche -- Weide Bach Walde stehen -- 
  -- kommen Weide Freund -- sehen -- -- seither geschehen -- qualenvoll -- bitter Scheiden -- 
  Busen mächtig drücken -- sagen -- ofen bangen -- inniglich verlangen -- süß Auge blicken -- 
  Schatten bleiben Zweig -- Mondenschein -- herein -- Freund zeigen -- 
  sterben begraben -- vergessen -- ich_es übergern vergessen -- arme -- 
  Fluß murmelnd Klüft -- Sucht Ferne Melodie -- Unermüdet sprechend spat früh -- Wehen Berg Septemberlüfte -- 
  Ton fallen Welt -- Lustige Pfeife -- fröhlich Schalmeie -- -- bekannter -- 
  wandern über Feld -- 
  Fernab ertönen -- wissen -- Freund verlassen -- lieben -- hassen -- Kümmert -- wohnen -- 
  Ziehe Netz lustig See -- Höre fern Gelache -- Seufze kümmerlich -- 
  Tut Busen weh -- 
  -- 
  Bild bleiben -- Engelsbild schön Kind -- 
  Freude übrig -- Unterstund -- lieben -- 
  Gatte längst finden -- fern Schimmerschein -- fallen Name -- dein gut Stunde -- 
  Licht ausgehen -- Sitz Dunkelheit -- Denke -- gefreut -- Nachtigalle singen -- 
  -- 
  warst einsam -- 
  -- Herz verstehen -- verbinden -- 
  Gehen Mondesschimmer -- 
  Lösche -- lösch letzter Licht -- 
  Freund umgeben -- Führ einsam Leben -- Lösche -- lösch letzter Licht -- Unglückliche brauchen -- 
  hört Stimme singen -- 
  lustig Mut Arbeit tragen rasch Arm stets bewegen -- Welt schlagen -- 
  Träge sitzen -- wissen stürzen Haus -- voll Segel munt Fährt froh Leben hinunter -- 
  Singende Kohlenbrenner -- nah -- 
  Bolz Sternbald gehen -- stehen Hütte nahe -- bemerken -- 
  freundlich -- bieten frei Stück Haus Nachtlager -- 
  Ermüdet folgen -- 
  Drinn Abendessen zurecht -- Licht brennen -- Span -- Herde unterhalten -- erleuchtet Hütte -- 
  jung Frau geschäftig -- fremd Sitz Bank bereiten -- Tisch schieben -- 
  setzen nieder -- aß Schüssel -- Franz sitzen Frau Köhler -- lustig Auge essen nötigen -- 
  finden artig -- bewundert Wirkung Lichtes Figur -- 
  Köhler erzählt nah Eisenhammer -- meister Kohle liefern -- spät Weiler besuchen -- 
  Hund gesellen äußerst freundlich -- Frau -- lebhaft -- spielen sprechen -- Kind -- 
  Sternbald fühlt Hütte ruhigen -- fromm Empfindung -- beglücken -- 
  prägen Figur Erleuchtung Gedächtnisse -- Gemälde darstellen -- 
  essen beinahe fertig -- klopft Tür -- kläglich Stimme fleht nächtlich Herberge -- 
  verwunderten -- Köhler öffnet Hütte -- Sternbald erstaunen -- Pilgrim hereintreen -- 
  Köhler Wallfahrer ehrerbietig -- Speis herbeigeschaffen -- Stube hell -- 
  Pilgrim erschrak -- hören -- Stadt nahe -- verlassen -- unbegreiflich Art verirren -- Zurechtweisungen unrecht Weg ergreifen -- halb Meile Ort entfernt -- ausgehen -- 
  Wirt erzählen allerhand -- jung Frau geschäftig -- Hund Sternbald zutunlich -- 
  Mahlzeit fremd Streue zubereiten -- Wallfahrer Bolz sogleich ausstreckten -- 
  Franz Erwarten munt -- 
  Köhler Frau gehen Bette -- Hund Behausung Hof bringen -- Sternbald bleiben schlafend -- 
  Mond Fenster -- Einsamkeit fallen Bildhauer Gesicht Wachende -- Physiognomie -- Heftigkeit Ungestüm ausdrücken -- 
  Franz begreifen -- anfänglich widerwill Mensch überwinden -- umgehen -- sogar vertrauen -- 
  Bolz scheinen unruhig schlafen -- werfen umher -- Traum ängstigen -- 
  Franz vergessen beinahe -- -- umher erhalten sonderbar Bedeutung -- 
  Phantasie erhitzen -- währen -- glauben Räuber befinden -- Leben ansehen -- jeder Wort Kohlenbrenner -- erinnern -- verdächtig -- erwarten ängstlich -- Spießgesell Tür herauskommen -- Schlafe umzubring Plünder -- 
  Betrachtung schlief -- fürchterlich Traum ängstigen -- entsetzlichst Gestalt -- seltsamsen Wunder -- erwacht drückend Beklemmung -- 
  Himmel sammeln Wolke -- Strahl Monde fallen -- Baum Hütt bewegen -- 
  zerstreuen -- schreiben folgend Schreibtafel nieder -- 
  Phantasie -- 
  alt Mann -- Ecke fest binden -- rühren regen -- 
  Vernunft halten Wache -- Sieht erkunden Miene -- 
  alte verdrießlich -- tausend Falte Mantel schlagen -- 
  launig Phantasus -- wunderlich Alter -- folgen stets närrisch Laune -- festgebunden -- Posse lassen -- Vernunft denken stören -- arm Mensch irren -- Tagesgeschäft Ruhe vollbringen -- Nachbar verständig sprech Tor erscheinen -- 
  alt Kluges Sinn -- tändeln Spielzeug kramen -- lärmen sehen -- 
  alt Mann schweigen runzelen Stirn -- Rede ungern vernähmen -- Schilt langweilig -- Kram taugen -- 
  Mensch handeln -- denken -- Pflicht indes stets tun -- fallen Auge Abendrot hinein -- Stehen Schlummer Schlaf Winkel Schimmer merken -- 
  Vernunft ruhn Bett bringen -- Schlummer singen Wiegenlied -- Schlaf ruhig -- Kind -- -- 
  mußt denken -- unermüdet schön -- -- lieben Mensch Ehre bringen -- schätzen -- Schlaf ruhig -- Schlaf -- -- 
  Vernunft bleiben -- Mensch -- Gehe -- Erinnerung -- suchen -- 
  Erinnerung treffen schlafend -- Gefällt Ruhe -- Nickt Gefährtin -- 
  -- gewiß alt Hand frei -- Denkt Mensch -- fürchten -- 
  Schlaf alte geschlichen -- -- 
  Bester -- mußt erlahmen -- Glied frei -- Pflicht -- Vernunft Verstand bringen herunter -- gutwillig -- Kind -- -- 
  Schlaf Hand -- alte schmunzeln -- danken -- Mühsam erzog -- veracht alt Mann -- kindisch -- gebrauchen -- 
  -- Liebster -- nimmst -- bleiben Kamerad -- 
  alte sehen Bande frei -- schütteln Freude -- 
  breiten weit Mantel -- Falte stürzen wunderbar Sache Wohlgefalle ansehen -- 
  kehren Mantel spreiten umher -- bunt Tapete unter Seite -- 
  hantieren Phantasus Zelt wissen Freude lassen -- 
  Glas Kristallen bauen Schlösser -- Läßt Zinnen Zwerg kucken -- Kopfe wackeln -- 
  unten Fontän Garten spazieren -- Röhr sprudeln Blume Luft -- singen alter seltsam Lied klimperen Gewalt Harfe -- 
  Mensch sehen Spiele freuen -- vergessen -- Vernunft Wesen herrlich -- 
  Spricht -- Fahr fort -- Alter -- 
  alte lassen bitten -- Schreite Geistergestalt heran -- Zieht Marionett Faden lassen Ferne groß scheinen -- 
  Tummel Reuter Fußvolk -- Hängen Engel Wolke -- Abendröt Mondschein -- 
  verschämt schöne sitzen Lauben -- Wang rot -- Busen wissen -- Gewand blinkend Strahl weben -- 
  Heer Kobolde lärmen tanzen -- alt Held Troja -- Achilles -- greis Nestor -- versammeln Spiel entzweien Knabe -- -- 
  -- alt -- sprechen Singt -- Laß Tat fahren -- Streben -- Mensch -- Grübeleien -- Sieh -- golden Kegel schenken -- Spiel -- silbern Kugel -- Männche -- Bein stehen -- Leben freuen -- 
  bleiben beisammen -- Vertreiben Gespräch -- Lehre tausend Ding -- weißen -- -- 
  blinkend Spielwerk stechen Mensch Auge -- recken Hand gierig -- erwachen Vernunft -- 
  Reibt Auge gähnen dehnen -- Mensch -- 
  Tat stärken -- 
  rufen alte hören Stimme fangen zittern -- Mensch schämt -- lassen Kegel Kugel fallen -- Vernunft treten Gemach -- 
  alt Wirrwarr Ruft Vernunft -- lassen locken kindsch Geist -- selber wissen beginnen -- -- 
  alte fangen weinen -- Mantel umgekehrt Schulter hängen -- arme Bein festgebunden -- 
  sitzen grämlich -- 
  Spielzeug eingepacken -- Kleid stecken Vernunft -- ne drohend Mien -- 
  Mensch Geschäft -- Sieht alt Seite zucken Schulter -- 
  verführen lieb Mensch -- 
  Grämelt alt Phantasus -- matt tot -- kindisch -- Leben genießen -- 
  gut Freund sitzen binden -- meinen -- 
  verzehren -- halten -- Überklug Umgang verleiden wissen -- -- 
  Schlaf weg stehen -- 
  brechen indessen -- übrig Haus munt -- Franz lesen Bildhauer Vers -- lachen -- 
  Gedicht -- Freund -- rühren Phantasus -- sehen -- Nacht schreiben -- Mann -- scheinen -- Spott Ernst leiben -- 
  dunkl Gemach erhellen -- Köhler treten Frau herein -- 
  Franz lächelen nächtlich Einbildung -- Tür -- gefürchten -- deutlich stehen -- Furchtbares sichtbar -- 
  Gesellschaft frühstücken -- wobei munter Köhler allerhand erzählen -- 
  -- Nonne benachbart Kloster Gelübde ablegen -- Feierlichkeit Leute umliegend Gegend versammeln -- 
  beschreiben Zeremonie -- vorfielen -- freut Fest -- Sternbald scheiden Pilgrim -- Bildhauer Stadt -- 
  Sternbald lassen Kloster melden -- Äbtissin vorstellen -- betrachtet alt Gemälde -- auffrischen -- 
  Geschichte heilig Genoveva -- Sohne einsommen Fels Wildni sitzen -- freundlich -- liebkosend Tier umgeben -- 
  Bild scheinen alt -- Zeichen bekannt Künstler entdecken -- 
  Denksprüche gehen Mund heilige -- Sohn Tier -- Komposition einfach Künstlichkeit -- Gemälde Gegenstand einfältigst Weise ausdrücken -- 
  Sternbald Wille -- Buchstabe verlösch Ausdruck Figur erhöhen -- Äbtissin -- -- Herr Maler -- müßn Bild lassen -- -- Wort stehen lassen -- 
  -- Gemälde zierlich -- 
  Franz deutlich -- weiß Zettel Täuschung aufhöben unnatürlich sein -- gewissermaßen Gemälde vernichteten -- Äbtissin antworten -- 
  -- geistlich -- beweglich Historie weltlich Art ausdrücken -- Reiz -- Maler Schönheit nennen -- gehören Bild -- Erbauung dienen heilig Gedanke erwecken -- 
  Steif -- altfränkisch erwünscht -- tragen gewiß Erhebung -- 
  Wort eigentlich Erklärung Gemäld -- gottselig Betrachtung nimmermehr Ausdruck Miene ersetzen -- 
  sogenannter Wahrheit Täuschung liegen -- 
  überzeugen -- Kirche Wildni Tier Fels antreffen -- -- annehmen -- Tier sprechen -- Wort hingeschrieben -- malen -- 
  entstehen Geheimnisvolle -- wovon sagen -- worin liegen -- 
  übertrieben Mien Gebärde zuwider -- 
  Maler alt Methode bleiben -- stets Schranke gut Sitte halten -- Ausdruck Wort führen gleichsam Aufsicht Werk -- 
  Gemälde bleiben gutgemeint Spielerei -- niemals ernsthaft treiben -- 
  Franz betrüben hinweg -- folgend anfangen -- 
  Gerüst einrichten -- Farbe zubereiten -- Kirche stehen -- trüben Gitter hineinsehen -- fühlen unbeschreiblich einsam -- lächelen selber -- Pinsel Hand führen -- 
  fühlen -- Handwerker gedungen -- -- wobei Kunstlieb -- Talent völlig überflüssig -- 
  geschehen -- selber -- Antwerpe konterfeie sonderlich Liebe -- Gräfin Roderigo nachher malen -- verlieben -- stehen -- Denksprüche -- geworfen Gewänder -- Hirsch Wölfe neu anzustreichen -- 
  Nonne Hora versammeln -- fein -- wohlklingend Gesang schwingen wundersam hinüber -- erloschen Genoveva scheinen Hinzuhör -- gemalt Kirchenfenster ertönten -- 
  Lust erwachen Franz -- Palette Pinsel frisch Mut färben Genovevas dunkl Gewand -- 
  Maler -- -- allenthalben -- unwürdig Ort -- Spur Dasein lassen -- 
  allenthalben Monument schön Existenz schaffen -- selten zart Geist ergreifen rühren -- danken -- Trübseligkeite schön Stunde hervorsuchen -- 
  nämlich -- Gesichte Genoveva Bildnis teuer unbekannte abzuschildern -- -- 
  Figur Gedanke teuer -- Arbeit -- 
  suchen Wohnung Bildnis hervor -- alt Maler geben -- -- Emma stehen unwillkürlich Auge -- 
  Gemüt wunderbar beängstigen -- wissen -- wofür entscheiden sollen -- 
  Liebreiz -- Heiterkeit Phantasie Emma's Angedenken -- lüsternen Bild Erinnerung -- offenbart -- Zauberlicht -- Bildnis teuer angesichts herrlich Ferne entgegenleuchten -- Gesänge Engel -- dorthin rief -- schuldlos Kindheit -- wehmütig Sehnsucht -- Goldenst -- Fernst schöne -- erwünschen erlangen -- Sebastian's Freude erstaunen -- Grab -- 
  Verworrenheit Vorstellung bemächtigen -- wein Anfing -- Gedanke erhascht -- Tröst -- 
  -- innerst Seele brennend Träne Auge hinausweint -- nachher wünschen hoffen dürfen -- ungewiß -- irrend Reue verfolgen können -- 
  Kunst -- Streben -- edl Künstler -- wirken Erde erscheinen Armseliges -- Kaltes jämmerlich Dürftig -- 
  Dämmerung gehen Gestalt Meister vorüber -- Arm ausstrecken -- vorüber endigen -- wovon Anfang erwarten -- 
  schweift Stadt -- bunt Haus -- Brücke -- Kirche künstlich Steinarbeit -- reizen -- genau betrachten -- einprägen -- -- Werk schaut Vergänglichkeit zwecklos Spiel trüb Auge -- spöttisch Miene -- 
  Mühseligkeit Handwerker -- Emsigkeit Kaufmann -- trostlos Leben Bettler scheinen -- -- Klüfte trennen -- Figur Verzierung Gemälde -- Wald -- Bergstrom -- Gebirge -- Sonnenaufgang Anhang trüben -- dunkel Historie -- Dichtkunst -- Musik machen Wort Denksprüche -- ungeschickt Hand hineinschreiben -- 
  wissen -- rufen Unmute -- Mute -- vielgeliebt Sebastian -- lesen selber dein Brief -- entsetzen -- -- 
  sagen sprechen -- denken -- tot Instrument -- beherrschen -- angeschlag -- Ton angeben -- glauben vernehmen -- 
  Melodie Liedes Einsamkeit Gedächtnis -- unterlassen -- Gedicht leise Hinzusing -- wobei Straße laufen -- Getümmel Marktes verlieren -- 
  stehen Gedränge still -- fallen -- bewegt unzählig Mensch Gedanke Empfindung kennen -- Arg herumgewanderen -- weniger vergessen -- Erschüttre -- klüg vorkommen -- 
  bewegt Gemüt -- -- unergründlich Strudel hinabschauen -- Woge Woge drängen schäumen -- Welle -- Flut verwirren trennen -- wirbeln -- Stillstand -- Ruhe -- Melodie wiederholen -- Abwechslung ertönen -- Stillstand -- Bewegung -- rauschend -- tosend Rätsel -- endlos -- endlos Wut erzürnt -- stürzend Element -- 
  Käufer Verkäufer schrien lärmn -- Fremd -- zurechtfragten -- Wagen -- gewaltsam Platz machen -- 
  Art eßwaren umher lagern -- Kind Greise Gewühl -- Stimme Zunge verwirrt Unisono vereinigen -- 
  Seite drängt Volk voll Neugier -- Franz ungestüm Strome ergriffen fortgezogen -- bemerken -- Stelle -- 
  nah stehen -- hören Geräusch Stimme -- öfter Unterbrechung -- Frage -- Antwort Verwunderung folgend Lied singen -- 
  Matte Wolke ziehen -- Schatten Leben fliehen -- 
  eilen Stillestand -- Verweil -- halten Band -- 
  Freude ketten Leben -- froh retten Zeit schier -- 
  Stunde -- verschwinden sinnen -- 
  Kuß golden Wein -- mal süß Sonnenschein -- 
  nahen Schatten Vergänglichkeit -- begaten Freude -- 
  nehmen Freude sperren -- 
  müßt Unsterblich -- 
  Mädchen -- Lied absang -- Franz unvermutet Wendung dicht Sängerin stehen -- Gedränge preßen -- genau betrachten -- glauben Ludovico erkennen -- 
  Strom Mensch entfernen -- Sache gewiß -- Leierkast fallen schwerfällig Ton Ohr -- Stimme singen -- 
  Wolke froh Stunde -- O Mensch gesunden -- Laß Leiden Bangigkeit Liebchen Kuß Herz erfreuen -- 
  Küsse weben Zauberseg -- verwegen -- schadet_es -- donner rollen -- rot Mund schmollen -- 
  Franz erstaunt -- glauben begleitend Sänger Florestan erkennen -- 
  alt Mann gestalten -- verstelln -- Sternbald glauben -- Stimme -- zweifelhaft -- -- 
  kurz Auge verlieren -- bemühen -- Mensch hindurchzudrängen -- 
  Gestalt liegen Sinn -- Kloster -- vergessen -- aufsuchen -- vergebens -- 
  malen -- Äbtissin Nonne hinzu -- Arbeit zuzusehen -- groß schlagen Schleier -- Franz erschrak Schönheit -- Majestät angesichts -- plötzlich Auge fallen -- 
  rein Stirn -- dunkel Auge -- schwermütig -- unaussprechlich süß lächeln Lippe Auge gleichsam Gewalt gefangen -- Gemälde -- Gestalt Herrlichkeit trübe unscheinbar -- 
  glauben schlank Wuchs sehen -- fallen paar Stelle alt Gedicht -- Dichter siegend Gewalt Allerholdseligsten sprechen -- unüberwindlich Waffenrüstung schön -- 
  -- alt Lied -- 
  Laß -- Gotteswill Gib arm Sklave frei -- Laß Auge verhüllen -- Glanz tödlich -- 
  mußt Kette schleifen Stärker Diamantstein -- 
  Schicksal ergreifen -- Kriegsgefangener -- -- 
  -- denken Sternbild -- Manne -- Arm freundlich öffnen -- heilig Mund Kuß entgegenbringen -- 
  Grazie übermenschlich Engelsgestalt Eigentum -- 
  Nonne betrachtet Gemälde Maler nachdenklich Stellung -- Bewegung lebhaft -- wider Wille Auge nachgerufen -- -- Hand erheben -- Auge entzücken -- Linie mitzugehn -- beschreiben -- 
  Franz gedachen Roderigo's Wort -- Gräfin -- Bewegung Musik schrieben -- Biegung Gelenke Wohllaut -- 
  gehen fort -- Gesang Nonne erklingen -- 
  Franz fühlen verlassen -- schön Heiligen knien -- Andacht hingegossen -- Auge richten -- wohin ihrig blicken -- glauben -- höchst selig Gefühl müssen -- Wort singen -- denken -- 
  widerlich Farbe -- auftragen -- Figur -- neu beleben -- 
  Abend sprechen Bildhauer -- 
  schildern Schönheit -- sehen -- Augustin scheinen beinahe eifersüchtig -- 
  erzählen -- Mädchen -- Kurzem Gelübde ablegen -- Köhler sprechen -- Stande unzufrieden -- müssen Wille Eltern fügen -- 
  -- fahren Franz fort -- heilige nennen -- Gestalt sehen -- Hohes -- Überirdisches ausdrücken -- 
  denken züchtig Busen entfesseln -- Wang Scham Liebe kämpfend -- Lippe Küsse entbrennen -- Auge Trunkenheit geben -- Himmlische Weibe Widerspruch schön Bestimmung erfüllend -- -- o -- Erde glückselig gebenedeit -- Geliebter -- 
  hoch Wonne mager Erde reif -- bescheren -- vergessen Erde -- -- 
  scheinen sprechen -- plötzlich brechen -- verlassen Sternbald unnütz Nachsinn verlieren -- 
  Franz Arbeiten Unentschlossenheit Beklemmung -- schämen eigentlich malens Ort -- Gegenwart majestätisch Gestalt -- 
  besuchen regelmäßig betrachten genau -- 
  Gestalt prägen jedesmal tief Phantasie -- scheiden Ungerner -- 
  Malerei rasch fort -- denken -- 
  Genoveva teuer unbekannte ähnlich -- suchen Ausdruck Physiognomie erhöhen -- geistreich Schmerz unschuldig Gesicht Tiergestalt abstechen lassen -- 
  Orgel zuweilen ertönen -- fühlt schauerlich Einsamkeit entrücken -- fühlen Mitleid Geschichte -- darstelln -- erschreckt wehmütig Blick -- unbekannte Wand herab werfen -- Tier Denksprüche rühren innerlich -- 
  fast sehnt Arbeit -- 
  manchmal glauben -- schön Nonne Teilnahme Rührung betrachten -- scheinen zuweilen -- Blick aufhaschen suchen -- Auge wenden -- begegnet bedeutend Blick -- 
  rot -- Glanz Auge treffen Blitz -- 
  Äbtissin Weile entfernt -- übrig Nonne zugegen -- Sternbald unten Gemälde beschäftigen -- schön Mädchen plötzlich Papier Hand drücken -- 
  wissen -- geschehen -- verbergen schnell -- 
  wunderbarst Altertum ungeheuer Märche -- dünken -- nahe treten -- berühren -- gewöhnlich Leben ewig völlig entschwunden -- 
  Hand zitteren -- Gesicht glüht -- Auge irren umh -- Scheut -- ihrige begegnen -- 
  schworen Herzen Treue fest Kühnheit -- unternehmen jeglicher Gefahr -- scheinen Kleinigkeit -- Gräßlichst ihretwillen Unternehmen -- 
  Geist Entführung Verfolgung -- flüchtet Gedanke Genoveva unzugänglich Wüste -- 
  denken -- -- steinern Fußboden Kloster betreten -- Leben Anfang nehmen -- gelingen können -- Unmöglichste halten -- 
  versammelt Nonne Chor -- Glocke schlagen Ton -- Herz reden -- lassen -- herzdurchdringend -- einfach Gesang heben -- 
  atmen -- scheinen Ton mächtig arme umfassen dicht entzückt Brust drücken -- 
  ruhig -- befinden -- Brief hervor -- Hand zittert -- erbrechen -- erstaunen -- Aufschrift -- Ludovico -- lesen -- -- 
  schämen selber -- stehen Weile tief nachsinnend -- arbeiten neu Inbrunst Antlitz Heiligen -- Zusammenhäng begreifen -- Sinn verwirrten -- 
  Gemälde scheinen alt Vers anzureden -- Genoveva Untreue -- Wankelmut vorwerfen -- 
  Abend -- Kloster verlassen -- 
  Kirchhof Feld -- dumpf Leiertöne auffielen -- 
  alte nennen Name -- 
  Florestan -- 
  Sternbald erstaunen finden -- -- Sieh -- Freund -- menschlich Leben -- nehmen kurz wehmütig Abschied -- Triffst unerwartet -- alt Mann -- künftig niemals traurig -- Freund verlässen -- 
  Ludovico abgeben -- 
  Sternbald ahndet Zusammenhäng -- zitternd Hand Brief -- Nonne empfangen -- 
  Florestan empfangen freudig -- 
  Franz befragen -- antworten lustig -- Sieh -- Freund -- Abenteuer -- Ludovico lieben -- -- wenige entführen -- Anstalt treffen -- führen Leben Himmel -- Gefahr -- glücklich überstehen -- Gegende -- Lied Gesinnung -- 
  Franz empfindlich -- 
  -- Eifer -- Schlachtopfer Verführungskunst -- Treulosigkeit -- 
  nimmermehr -- 
  Rudolf hören -- bitten -- Augenblick verweilen -- müssen Ludovico sprechen -- sogleich zurückkommen -- 
  Ding sollen Bildhauer Bolz Wort entdecken -- 
  Franz bleiben zufrieden geben -- wissen -- sagen sollen -- 
  setzen Baume nieder -- Rudolf kurz -- 
  -- liebst Freund -- -- Zettel mußt schön heilige übergeben -- entscheiden Schicksal -- 
  -- rufen Franz bewegen -- erniedrig -- herrlichste Geschöpf vernichten helfen -- 
  Rudolf Gleichmute Unternehmen beginnen -- 
  -- Freund -- Verführer warnen -- raten -- vergessen lieben -- erzählen -- sinnn -- 
  unbesonnen -- Florestan -- schadest -- 
  lieben -- zittern Einkleidung -- Flucht frei Entschluß -- übrigen -- 
  Ludovico niedrig begegnen -- 
  -- kennen -- -- sagen -- verändern -- 
  beten -- himmlisch -- überirdisch Wesen -- Gattin -- treu Leben widmen -- 
  leben -- verlieren -- sprich Bildhauer Wort -- lassen Brief -- Ludoviko's Freund -- trauen Schändlichkeit -- 
  Wort eilt Florestan fort -- Sternbald Stadt -- 
  weichen Bildhauer -- verraten -- 
  folgend erwartet Herzklopfe Gelegenheit -- schön Nonne Billet zustecken können -- 
  Erröt -- verbarg Busen -- 
  lilienweiß Gesicht legen holder Schamrot -- gesenkt Auge glänzen Hell -- Franz Himmel verklärt Wesen sehen glauben -- 
  scheinen Vertrauen Franz Augen fürchten -- Majestät sanft lieblich -- 
  Franz innerst Herz bewegen -- 
  verging -- Arbeit Gemälde naht Vollendung -- 
  Bolz scheinen Unternehmen schwanger -- Freund Sternbald vertrauen -- 
  -- Male -- letzter Arbeit -- finden Kloster groß Bewegung -- 
  laufen unruhig -- suchen -- fragen -- erkundigen -- schön Novize vermissen -- Einkleidung nahe -- 
  Sternbald schnell Arbeit -- Herz unruhig ungewiß -- vorwerfen -- 
  Freut -- Gemälde vollenden -- wissen -- Kloster besuchen brauchen -- Schönheit -- Auge aufsuchen -- 
  erhalten Äbtissin Bezahlung -- betrachtet Gemälde -- über Feld Stadt -- 
  zittert Freund -- schön Nonne -- suchen Bildhauer -- nirgends antreffen -- 
  verlassen folgend Stadt -- Italien nähern -- Rom erwünscht Ort sehen -- 
  Mittag finden Weg Bildhauer Bolz liegen -- entkräften -- 
  Franz erstaunen -- finden -- 
  Hilfe Vorüberwandernden bringen nahe Städtchen -- verwunden -- entkräften verbluten -- Gefahr -- 
  Franz sorgen -- -- Augustin -- trefft -- Freund -- gewiß euer Erwartung -- vertrauen -- Eurer Hilfe bedienen -- Unglück begegnen -- 
  Nonne -- weniger einkleid -- entführen -- bereden -- Kloster verdingen -- 
  zuvorgekommen -- 
  verwichen Nacht treffen Gesellschaft unbekannt Mann -- fallen überwältigen -- 
  zweifle -- Streiche Roderigo -- kennen -- Rauben -- 
  Franz bleiben -- bessern -- Abschied -- lassen Geld Pflege Bildhauer -- 
  Kapitel -- 
  Florenz antworten Franz Freund Sebastian folgendermaßen -- 
  Liebster Sebastian -- 
  sagen -- muts -- stand wärest -- Wort hören -- 
  beschaffen -- trösten vermöchte -- selber trösten können -- 
  schweigen -- liebst Freund -- überdies trüb Vorübergegang -- 
  Fall -- Bruder -- verlieren Mut Leben -- bedenke -- traurig gewiß fröhlichen vorübergeh -- veränderlich Welt dauernd Stelle -- 
  Unglück trösen übermütig Fröhlichkeit dämpfen -- 
  -- Liebster -- Reise -- 
  innig genießen -- 
  sagen -- lerne erfahren -- neue sehen sehen -- 
  überschütten überwältigen -- ängstig -- Gedächtnis -- Sinn aufbewahren -- 
  Welt Kunst reich -- vorher glauben -- 
  Fahre eifrig fort malen -- Sebastian -- Name würdig Künstler nennen -- gelingen gewiß eher -- -- 
  Geist unsten -- wankelmütig -- schnell Neuheit ergreifen -- leisten -- -- 
  Gemüt auf's heftigste Meister bewegen -- venezianisch Tizian -- allerlieblichst Antonio Allegri Correggio -- 
  -- sagen -- übrig Kunst vergessen -- edl Künstler Gemüt erfüllen -- letzterer beinahe ersteren verdrängen -- 
  wissen Gedanke Holdseligeres vorstellen -- Auge bringen -- Welt lieblich -- vollreizend Gestalt -- malen verstehen -- 
  -- Gott Liebe selber Behausung arbeiten Hand führen -- 
  unterfangen -- lieb Wollust darstellen -- Geist Glorreiche Sinnenwelt offenbaren -- 
  Köstliches -- Unbezahlbares -- Göttliche -- Maler -- Natur Reizendes finden -- Imagination veredeln vollenden -- Gleichnisse -- Tön -- Erinnerung Nachahmunge aufbewahren -- kräftig fertigst Weise selber hinstellen -- 
  Hinsicht Malerei vollendet Kunst -- Geheimnis Farbe anbetungswürdig -- 
  Reiche -- Correggio's Gemälde -- Leda -- badend schön Nymphe besitzen -- blühen Palast ewig Jugend -- allerhöch Reiz einheimisch -- wonach glühend Phantasie suchen -- stumpfer Sinn vorstellen -- leben weben -- Göttin -- Geliebte -- lächeln -- Gegenwart -- 
  -- Bild sehen -- Kolorit geringschätzend sprechen -- 
  Allmacht Schönheit besiegen -- nackt unverhüllt -- Liebe hingegeben -- zeigen wagen -- -- 
  Studium himmlisch Jugendgeister Zauberei erfinden -- unser Auge -- 
  Gesänge liebend Petrarca Ferne herüberwehen -- Schattenbild Wasser -- Woge wegfließen -- Ariosstes feurig Genius lüstern Ferne zeigen -- wonach sehen entdecken -- Walde fernab ungewissest Spur -- dunkel Gebüsch verhüllen -- irr suchen -- stehen allerholdseligst Gegenwart dicht -- 
  -- Venus Knabe selber besuchen -- Genuß Bild hoch Schule Liebe -- Einweihung hoch Mysteri -- Gemälde verehren -- verstehen ergötzen -- lieben -- Leben unnützen -- mühselig Beschäftigung wegwerfen -- verbergen -- anfangen -- 
  Zeichnung Edel -- Farbe bringen Lebenswärm -- innig -- körperlich Umfang Bildsäule -- 
  glücklich schätzen -- Allegri Leben antreffen -- sterben -- 
  dürftig -- unbekannt Leben führen -- 
  Phantasie -- Liebe entbrennen -- gewiß entschädigen -- 
  geistlich Komposition spiegeln liebend Seele -- Gürtel Venus verbergen -- wissen -- Figur heimlich tragen -- 
  Auge Herz bleiben verweilend zurückziehen -- Mensch fühlen Heimat glücklichst Poesie -- denken -- -- -- suchen -- finden verzweifelen -- 
  Vulkan's künstlich Netz ziehen unzerreißbar -- schließen eng eng Venus -- vollenden Schönheit -- 
  herrschen Bild halb Lüsternheit -- verstohl ungern erkennen -- Maler erraten lassen -- zurückzögen -- verantworten -- verantworten -- gemein Sinnlichkeit -- edler Geist empört -- bloßzustellen -- frech Schande triumphieren -- reinst hellst Menschheit -- schämt -- schämen brauchen -- glückselig -- 
  -- sagen -- Frühling -- Blüte Menschheit -- voll -- schwelgend Genuß -- Schönheit emporgehoben vollst Herrlichkeit -- Kraft spielend übend Leben -- frischen -- 
  Herbst -- Winter vergessen -- Blume -- Düft grünglänzend Blatt märchen -- Kind erfinden -- 
  -- weichen -- ermattend erfrischend Luft Italien Seele einzögen -- innerer Gemüt ewig Frühling hervortriebe -- außen glänzt schwellen treibend blühen -- 
  Himmel fast heit -- Wolke ziehen Norden -- Sorge -- Unzufriedenheit -- 
  O -- liebst Bruder -- solltest -- Harfenstimm Geist -- Blumenhand unsichtbaren Engel berühren heilen -- 
  weniger Reise Rom -- 
  verständig Mann -- Kunst lieben -- Begleiter -- jung schön Frau reisen ebenfalls Rom -- 
  Castellani -- 
  mancherlei unterdessen arbeiten -- womit sonderlich zufrieden -- 
  erleichtern Verdienst Reise -- 
  Laß niemals Nachricht mangeln -- 
  Leb -- lieben dein Franz Sternbald -- 
  Franz Brief endigen -- Zither spielen -- wodurch bewegen -- folgend Vers niederzuschreiben -- 
  Frühling -- 
  lieb Erde Winterkleid ablegen -- Hügel Brust Liebe bewegen -- Finsternis -- Wolke -- Braut -- jung Witwe Sinn -- 
  schön Leib schmücken -- tausend Blume schön Gewand sticken -- bunt Rock kunstreich April weben -- hell -- glänzend Farbe leben -- 
  Lilien wissen -- Rose rötlich -- golden Blume blank Schein -- flimmern Silberne hinein -- Erde Sternenhimmel -- 
  Auge sehen blau Blume -- Lippe rufen rot Blüte -- wandle duftend -- farbend Meer -- Herrlichkeit winken Ort Ort -- 
  hören Vöglein singen -- Stimmlein klar Liebst Grüß bringen -- 
  schwingen Gesang süßen Duft -- Wohllaut zitteren warm Frühlingsluft -- Berg Wind leutselig spielen scherzend Blumenbeet wühlen -- 
  O süß Frühlingszeit -- 
  Blume Bringerin -- Liebe Führerin -- Erde Schmückerin -- herrlich Halle breit -- 
  pflegst Blumenkind -- Liebe Hand -- Geschmückt Rosenband -- erkennen liebend Küs sinnen -- 
  Kapitel -- 
  Franz bleiben lang Florenz -- vornehmen -- neu Freund Castellani krank -- Sternbald gutherzig -- Gesellschaft leisten -- Florenz fast fremd -- 
  Bitt jung Frau -- freundlich Lenore -- widersetzen -- Florenz Kunst lernen finden -- gereute Abschub -- 
  ereignet Sonderbarer Vorfall -- 
  fügen -- Besuch Freund sprechen -- Lenore -- ehe bemerken -- fesseln -- 
  -- sehen -- 
  Lenore scheinen Franz gefällig -- schalkhaften Auge sehen lustig -- mutwillig Gespräch beleben -- 
  entdecken unverhohlen -- Castellani verheiraten -- Reise -- leben -- Turin kennen lernen -- liebenswürdig vorkommen -- 
  Franz verlegen -- antworten sollen -- entzückt leicht -- flatterhafen Sinn Weibe -- obgleich verdammen müssen -- Gestalt -- Freundlichkeit -- 
  sehen öfter einverstanden -- Franz Vorwurf -- schwach -- Band zerreißen -- 
  gelingen -- Maler Florenz Bekanntschaft geraten -- -- Franz Rustici -- Stadt Italien groß ansehen stehen -- 
  verschafft Bild malen -- scheinen Sternbald Anteil nehmen -- 
  sehen öfter -- Franz Rustici's Freundschaft aufnehmen -- 
  Maler lustig -- offen Mann -- ernst -- -- leicht Scherz übrig behalten -- 
  Franz besuchen -- lernen sinnreich Gespräch ergötzen -- 
  Rustici angesehen Mann Florenz -- gut Familie -- Andrea Verocchio berühmt Leonard Vinci Kunst erlernen -- 
  Franz bewunderten Ausdruck Bild -- überdachen Komposition -- 
  sehen -- Rustici Sternbald -- deutsch Freund -- besuchen künftig Sonnabend Garten Tor -- lustig -- Künstler ziemen -- 
  fröhlich Gesellschaft -- Maler Andrea gehören -- kennen -- del Sarto Vater nennen pflegen -- -- 
  Reihe -- Schmaus geben -- kommen -- euer Geliebt mitbringen -- tanz -- lachen scherzen -- 
  -- mitbringen -- antworten Franz -- O -- Freund -- Florentiner -- gut Künstler halten -- fehlen -- 
  Liebe halb Malerei -- gehören Lehrmeister Kunst -- 
  Vergessen -- Gesellschaft fröhlich -- 
  Franz verlassen -- 
  Castellani Genua reisen -- Arzt -- Freund -- sehen -- Geliebte Florenz zurückbleiben -- 
  Franz bitten Gesellschaft kommend Schmaus -- zusagen -- Rede Leute kümmern -- 
  Fest kommen -- 
  Lenore schönsn Putz anlegen -- liebenswürdig -- gewöhnlich -- 
  Franz zufrieden -- Aufmerksamkeit Flüster erregen -- Straße Stadt führen -- 
  scheinen Seite fallen -- Franz blühendst Periode Leben -- ansehen munt -- Auge feurig -- Wang rot -- Schritt Gang edel -- beinahe stolz -- 
  Demut Schüchternheit fast ablegen -- fremde kennbar -- 
  geraten -- -- Verlegenheit -- Maler Arbeiten loben -- gewöhnen -- 
  Sternbald finden Gesellschaft versammeln -- jung Mann Mädchen schön Weiber bestehen -- 
  grüßt Meister Andrea freundlich -- kennen -- gewöhnlich Leichtsinnige blöd Art danken -- 
  erwartet Wirt -- Schüler Bandinelli erzählen -- fertig Gemälde Stadt Eigentümer bringen -- ansehnlich Summe empfangen -- 
  Garten anmutig Blumengäng schmücken -- schön grün Rasenplatz dunkel -- schattig Gänge -- 
  Wetter schön -- erfrischend Wind spielt lau Luft -- erregen stet Flüstern bewegt Bäume -- 
  Blume duftet -- Gesicht fröhlich -- 
  Francesko Rustici -- erwarten -- nähert Gesellschaft freundlich -- Körbchen Hand -- Barschaft tragen pflegen -- 
  Grüßte Höflich -- bewillkommen Franz vorzüglich freundschaftlich -- 
  Andrea aufgeräumen -- -- 
  -- Freund -- vorher ansehnlich Geschäft abgemachen -- legen dein Schatz -- Last fallen -- vergiß Malerei -- fröhlich -- 
  Francesko werfen lachend leer Korb Gebüsch -- rufen -- 
  O -- Freund -- fallen Geldsumme Last -- -- 
  bezahlen -- rufen Andrea -- -- kenn vornehmen reich Leute -- wissen begreifen scheinen -- Not arm Künstler geraten -- fertig Arbeit bringen -- leer Hand zurückgehen -- 
  manchmal böse -- Pinsel Palette nachh Winkel werfen Malereikunst verfluchen -- 
  böse -- Francesko -- mußt Paar Unnütz Gang verdrießen lassen -- 
  bezahlen -- jung Mann -- Maler kommen -- 
  Geld lassen -- fragt Andrea verwundern -- 
  kennen Art -- fahren fort -- arme sehen -- beschenken -- Geld -- 
  sehen Palast bekannt Korb Arm -- Bettler folgen -- Gutherzigkeit -- 
  reichlich -- übel -- -- gestern geben -- heimlich -- antworten lachend -- 
  Freund -- essen -- 
  alt Mann stehen Seite Austeile -- heftet Auge aufmerksam Korb -- seufzen -- 
  Gott -- Geld -- Korbe -- 
  Francesko unvermutheterweise gehören -- 
  alte -- fragen -- glücklich -- 
  O -- Familie -- rufen -- böse -- denken -- hören würden -- 
  -- sogleich kehren launig Francesko Korb -- schütten alt Bettler ledern Mütze -- -- abwarten -- 
  edl Mann -- rufen Sternbald -- 
  O -- irren -- Maler -- Besondere -- arme sehen -- jammern -- geben -- -- 
  alte fallen -- unnütz Ausgabe Leben -- Aufopfre -- Tapet kostbar Hausgerät versagen -- 
  denken -- Geld bekommen -- Gemälde malen hättest -- 
  Kind alt zerlumpt Gattin Gedanke -- heiß Sehnsucht Rückkehr erwarten -- 
  handeln -- Andrea -- Geben Einhalt -- 
  -- betrüben -- fahren Rustici fort -- Gutherzigkeit einschränken -- -- Wohltat -- -- -- geben -- 
  sonderbar Fügung Schicksal -- Überfluß Pracht drückend Mangel dicht bestehen -- Armut Erde niemals aufheben -- Mensch sein -- müssen betteln -- geben -- 
  trösten -- einfällen -- Kunst befinden -- indessen -- hart Arbeit -- fleißig -- Mangel leiden -- 
  Erde See Weltmeer -- ström Fluß -- leiden heiß Ebene -- weniger Pflanze ersterb Mangel nötig Wasser -- 
  nützen -- jeder Wesen Natur Wille -- -- 
  -- Gespräch unser Gastmahl vergessen -- 
  versammelen hierauf Gesellschaft -- 
  schön Knabe Korbe voll Blumenkränze herum -- müssen nehmen Stirn drücken -- 
  setzt rund Tisch -- Schattig kühl Platze Garten decken -- Ort stehen schön Blume -- Speise aufgetragen -- 
  Gesellschaft malerisch -- -- voll -- bunt Kränze -- sitzen Geliebten -- Wein herumgegeben -- Gebüsch erschallt Instrument unsichtbar Musikante -- 
  Rustici stehen -- voll Glas -- 
  -- rufen -- Stolze Toskana -- groß Manne -- florentinisch Vaterland hervorbringen -- Michael Agnolo Buonarotti -- -- 
  stoßen -- lassen -- leben -- -- ertönen -- 
  Schade -- Andrea -- wahnsinnig Camillo verlassen -- Rom herumwandern -- Rede halten -- Gelegenheit schicken -- 
  muntere Trompet ertönen Gesundheite -- Flöt waldhörnern mischen klingen -- Schwiege -- entfernt Garten -- 
  Schöne erheiteren -- legen Schleier -- lösen Locke Fessel -- Busen bloß -- 
  Franz -- 
  Künstler Welt Freude wahr edelst Art genießen -- Geheimnis erfinden -- Gold verwandeln -- 
  Italien -- Wollust Vögel singen antreeben -- kühl Baumschatt Liebe duften -- Bache Mund legen -- Wonn rieseln scherzen -- 
  Fremd -- Norden Freude Klage -- wagen -- vorüberschwebend Engel golden Flügel herunterzuziehen -- 
  Mädchen Blumenstrauß weiß Brust -- werfen Franse Auge -- ausraufen -- sollten Dichter -- Freund -- Maler -- sollten lieben -- täglich Sonette hören lassen -- 
  Nehmt Eurem geliebter -- rufen Sternbald -- begeistern -- 
  Blume Andenken euer Schönheit aufbewahren -- 
  welken -- -- lieblich Brunnquell -- Duft emporsteigen -- versiegen -- fallen -- lassen Häupter sinken -- freilich vergehen -- schön nennen -- 
  Franz wundervoll Versammlung -- Blume -- schön Mädchen -- Musik Wein begeistern -- stehen singen -- Klage -- Blume sinken Asche zerfallen -- 
  lüstern Auge winken alt Glanz entstellen -- 
  Kraft nachzuringen -- fest halten schöne Hand -- -- 
  -- Liebe leihen mächtig Schwing Vergänglichkeit -- knüpfen Band -- 
  -- Glück -- Liebe -- 
  beten ewig bleiben -- Schönheit anfesseln -- 
  Trennung drohen -- Eifersucht Ungetreue schweigen -- Liebe neigen -- Fürchten Geliebte Tod -- -- 
  Vergänglichkeit knüpfen Kette -- Entrinn bleiben -- lieb Treue retten -- hart Gesetz schreiben -- 
  geiz Küsse -- Beug schöne Knie -- Winke -- Lippe -- Lächel grüßen Allzuoft Freude -- 
  endigen -- schämen Rausch -- Rustici rufen -- Seht -- Landsleute -- deutsche -- Italiener beschämt -- 
  schön abtrünnig -- 
  Andrea -- 
  Glück -- Bräutigam -- Frau besorgt -- 
  sehen -- sitzen ernsthaft -- Leichenrede dächen -- 
  fallen Lehrer Piero di Cosimo -- trübselig Gedanke beunruhigt -- Tod Maß fürchten -- sonderbaren Phantome abängstigen -- reizenden -- beinahe sagen -- leichtfertig Phantasie ergötzen -- 
  Rustici -- 
  gewiß eins seltsamst Gemüt -- Erde leben -- Bild zart Geist Wollust Lieblichkeit beseeln -- sitzen -- gefangener -- selber einschließen -- Hand ragt Kerker hervor -- übrig Mensch -- 
  Kunst lustwandelen grün Wiese -- Phantasie Tod herbeirief -- toll -- schwermütig Maskerade erfinden -- 
  Gespräch Maler unterbrechen -- Mädchen jung Leute sprechen allerhand lustig Neuigkeit Stadt -- wodurch Sprechende überstimmen -- 
  lebhaft Mädchen -- Laura heißen -- erzählt Nachbarinn Stadt überaus fröhlich Geschichte -- Franz anstößig finden -- 
  sitzen schwarz Auge -- unablässig verfolgt -- lebhaft Bewegung -- vorüberbogn -- schön Busen sichtbar -- Arm frei -- zeigen weißeer Rundung -- 
  -- Lenore eifersüchtig -- entblößt Arm -- Gegnerin vergleichen -- übrig Mädchen lachen -- 
  Minute Gespräch munter -- 
  schlagen Gesang -- sanft Instrument begleiten -- Lenore Laura rezitieren bekannt Wechselliedchen n. Lenore -- 
  Geliebte ziehen -- süß Auge Treue gefangen -- treu treu verlangen Schönheit entglühen -- 
  blühen Blume -- lästig Schwarm -- innerst Herz arm -- 
  Laura -- 
  Blick schweifen leer Weite -- Sehnsucht fortführen -- gewinnen verlieret -- arm gering Beute -- leit treu Treue -- holden Blick holdselig Reich -- 
  Lenore -- 
  Fuß Tanz hebet -- schön Knie Bändern prangen -- voll Hüft schwangen -- Mädchen Welle schwebet -- Lebet treu Treue -- Zieht fort lassen Pein -- 
  Laura -- 
  sehen Deine Busen Glänzen -- lockend entgegen Reget -- innerst Gemüt beweget -- Vergisst Tänze -- Kränzen Liebe -- -- treu treu Glück -- 
  -- 
  neid Freude -- 
  wandern Trieb fern -- Stern Liebe nahe -- 
  lieb Krone Treue wohnen -- 
  Glückes freuen -- Zwietracht nimmer entzweien -- Neid Wonne entweihen -- 
  Küs süß Umarm -- Erwarme Herzen -- Scherzen Eide -- Grüß -- winken -- Küs -- gönn -- lieben -- brennen Freude hell Allhier -- scheid Zürn vermeid Beglücke eintracht Lieblichst -- 
  Mädchen singen lebhaft Wettgesang unaussprechlich Anmut -- Bewegung Miene -- jeder Winken Auge lüstern verführerisch -- Tafel klatschen -- endigen -- jung Mann -- Laura Fest führen -- verdrießlich einsilbig -- 
  Strom Freude -- 
  Andrea Francesko abseits Baum setzen -- führen ernsthaft Gespräch -- Wein begeistern -- 
  verstehsen -- Rustici Eifer -- Sinn verschließen -- geben Bemühung -- 
  Glaube -- Bester -- Ding Offenbarung gehören -- unser Sinn mitteilen -- Geist plötzlich herabsteigen -- unser Geist fremd Einfluß durchdringen -- 
  erhaben Kunst Alchemie beschaffen -- 
  bleiben unbegreiflich -- langsam Andrea -- Zeichen wunderbar -- unverständlich Verbindung ausrichten -- 
  Laß -- eifert Francesko -- Verbindung wunderbar -- erscheinen einfach klar unser Auge -- 
  anscheinend Verwirrung abschrecken -- Ordnung -- Buchstabe -- unverständlich Hieroglyphe gleichsam stammelnd Ferne anredet -- 
  Trete dreist nah hinzu -- Silbe deutlich -- verwundern -- vorher verwundern -- 
  Geist Sternbald eingegeben -- sagen -- Hand Künstler Gold verwandle -- 
  schwierig Anfang jeglicher Kunst -- 
  Welt verwandeln unkenntlich Masse fremdartig Masse erziehen -- 
  Metallen -- 
  schweben Natur wohltätig Geist -- Seltsamkeiten aushauchen -- Atmosphäre Unbegreiflichkeit leben -- Mensch ähnlich -- Element umher -- feindselig -- träge Alltäglichkeit herumbewegen -- anrühr Wunder umschaffen -- 
  Geist glauben -- wirken -- mußt Begeisterung Male vertrauen -- weißen -- -- woher -- Geisteratmosphär umwehen geschehen -- -- unser innerlich Seelenothem Geisterwelt herbeisaugen -- Herz magnetisch reißen -- sehen -- Natur -- bloß Gegenwart unbegreiflich Wunder wirken -- 
  Andrea antworn -- Trompet laut ertönt -- sonderbares Gespräch unterbrachen -- 
  -- schalkhaft Laura -- unser Gesang ernsthaft -- Absicht -- 
  Verzeiht -- antworten freundlich Rustici -- Natur beherrschen -- süßen Ton Instrument Sängerin ziehen Melancholie -- 
  fragen -- woher -- -- selber Rechenschaft geben -- 
  trübselig Gegenstand erinnern -- Laura -- 
  -- -- fahren Maler fort -- Gegenteil innerlich -- Freude -- gefangen Adler Kette sitzen -- schlagen einemmal munter -- tapfer Schwing -- 
  fühlen -- Kette zerreißen -- Erde halten -- Wolke hinaus -- Bergspitze hinüber -- Sonne entgegen Flug wenden -- 
  verlieren Farbe -- Abwechselung Absonderung bunt Welt -- 
  frei -- Freiheit genügen -- kehr reiß neu empor -- 
  -- Stimme erinnern -- einst glücklich -- Glück neu hoffen müssen -- 
  Musik -- sprechen -- hören abgebrochen Laute ehemalig verloren Welt -- Musik -- Teil -- Abgesondertheit -- einzig Wohllaut -- laut Biegsamkeit Glück dahinschweben -- Geist weichen Schwanenfeder tragen -- süßest Tön Stein liegen -- Unglück fühlen beklagen -- 
  helfen -- phantastisch Maler Freund -- Laura lachend -- weiß Hand reichen -- ehrerbietig küßen -- 
  drehen -- sprechen Getümmel übrig Mädchen umher -- beschließen -- -- kühl -- munter Tanz aufführen -- fröhlichen Landleute Italien tanzen pflegen -- 
  Tanz -- Sternbald Lenore bleiben -- wagen -- leicht -- schnell ungewöhnlich Bewegung mitzumach -- übrig Ungeschicklichkeit verwirren -- 
  Laura tanzt zierlichst -- Bemühung gelangen schwierig Stellung schnell Veränderung -- 
  Franz ergötzen leicht -- flatternd Gewänder -- schön verschlungen Figur -- 
  zierlichst Fuß schweben -- trippelten springen -- Schwunge Rock leicht -- wohlgeformt Bein sichtbar -- weiß arm Busen -- üppig Hüft -- Gewand decken verraten -- ziehen Auge -- verwirrt fröhlich Tumult -- 
  Laura jung Mädchen auslassen -- sprung Arm Tänzer fliegen -- heben Schwunge -- Luft schwebend singen Stelle Liebeslieder Musik hinein -- 
  wild bacchantisch Taumel beschließen -- anderer Tanz -- Zärtlichkeit ausdrücken -- anordnen -- Lenore Sternbald schließen Reihe -- 
  -- sanft Musik erklingen -- Paar umschlangen schweben hinauf hinab -- Hand Arm begegnen -- Busen Busen Busen schmiegen -- beginnen Wendung -- 
  verführerischsen Stellung knüpfen -- Gelenke Biegsamer -- Franz Trunkenheit verlieren -- 
  Luft duften Wonne Freude entgegen -- Welle Musik schweben Laura's Lenore Arm einh -- tanzend Gesicht schalkhaft Engel entgegen -- Entzück predigen -- 
  drücken Laura's Hand -- Zärtlichkeit erwidern -- 
  ruhen Schatten Baum -- 
  Knabe geben geben kühlend -- wohlschmeckend Frucht herum -- Schöne lageren Grase -- 
  Andrea Tanz erhitzen -- sehen -- Freund Sternbald -- müßen deutsch Italien -- lernen -- schön -- offenbaren Natur Kunst -- 
  Eurem trüben Norden Imagination unmöglich -- Flügel auszudehn Edle empfinden -- 
  Lehrmeister -- Albrecht Dürer -- Franz -- Mann erkennen müßen -- -- 
  Andrea -- 
  wünschen Kunstfreund -- hierher bemühen -- einsehen -- -- lernen -- Talent ausrichten können -- 
  -- -- merkwürdig -- Bedeutung Kunst -- Italiener geringer Talent Sieg tragen -- 
  unbillig -- fahren Sternbald -- undankbar -- -- Erfindung Eurer gemäld Figur behelfen -- 
  müßt heftig -- lindernde Francesco -- -- Dürer Andreas hülfreich Freund -- verlästern -- Dienst bewußt -- leisten -- 
  Gespräch abbrechen -- erhitzen -- 
  Musik lärmen -- Andrea -- streitsüchtig -- Meinung -- Tänze fangen neu -- 
  Abend -- Gesellschaft gehen Haus -- Diener Pferd bringen -- 
  Rustici lassen eins schön Pferd Garten -- setzen hinauf -- Baumgäng riten -- mutwillig Laura lassen hinaufheben -- leicht Galopp riten -- Maler sitzen -- arme festhielen -- 
  Franz bewunderten schön Gemälde -- glauben Raub Dejanire sehen -- Kranz Haaren schwanken droht herabzufallen -- sitzen -- Ängstlichkeit beunruhigt -- schön -- Pferd heben majestätisch -- Beute stolz -- 
  Trompeten bliesen mutig Marsch -- prächtig Ton begleitet Bewegung Ross wiandte stark Rustici sitzen Gott -- 
  zurückgeblieben Freund führen Francesko Teil Garten -- 
  rund Zirkel Bäumen -- Feston Girlande allerhand Blume hing Zweig schaukelt Abendwind -- farbig Lampe brannen -- dämmernd Laube Baumnissch anlegen -- 
  Wein Frucht genießen -- zärtlich Paar sitzen -- Musik ermunteren -- Liebesgespräch führen -- Laura's Tänzer Abschied nehmen -- Franz umschlang Mädchen Lenore arme -- 
  spät trennen -- Laura Lenore gehen -- Dirne bleiben Nacht -- Franz freudig Einladung -- verweilen -- 
  Kapitel -- 
  Castellani zurückgekommen -- Franz Lenore Gesellschaft Florenz verlassen -- 
  Rom -- Sonne -- steigen Wagen -- erhaben Anblick genießen -- 
  mächtig Glut hing Stadt -- Riesengebäude -- Peterskirch -- ragen Haus hervor -- Gebäude sehen Hütte -- -- 
  Sternbald's Herz klopfen -- -- Jugend vieler Inbrunst wünschen -- stehen Stelle -- ahnungsvoll vorgeschweben -- Träum sehen -- 
  fahren Tor -- steigen Quartier -- 
  Sternbald fühlen begeistert -- Straße -- Haus -- reden -- 
  spät Mondschein -- verwundern -- Lenore Gemach -- erwarten -- 
  Castellani Freund Kunst -- studieren unablässig -- schreiben -- sprechen Freund -- 
  Sternbald Liebling -- Gedanke mitteilen -- verbergen -- 
  Rom bekannte -- meistens jung Leute -- schließen -- besuchen gewissermaßen Schule Akademie bilden -- 
  gewiss Camillo -- Andrea del Sarto erwähnen -- besuchen -- 
  Camillo Greis -- stark -- Ausdruck Mien Seltsame -- feurig Auge erschrecken -- plötzlich herumrollen -- 
  Art sprechen auffallend -- gelten bekannte wahnsinnig -- behandelt Unverständig -- schonen müssen -- Schwächere -- 
  sprechen -- hören -- Castellani freundlich -- Rücksicht -- 
  Sternbald besucht Kirche -- Gemäldesammlung -- Maler -- 
  Ruhe -- erfahren -- -- Vorstellung ordnen -- 
  Mühe -- Begriff -- eigentlich Wesen Natur Kunst eindringen -- 
  fühlen Castellani freundschaftlich hingezog -- meister Ausbildung -- Erkenntnis gewinnen -- besucht Gesellschaft fleißig -- bestrebt -- Wort -- -- lernen -- verlieren Castellani's Begriff Kunst erhaben -- lebend gestorben Künstler Musterbild -- vollenden gelten lassen -- 
  belächelen Sternbald's Heftigkeit -- Raffael -- Buonarotti -- Albrecht Dürer nennen -- ungern Vergleichungen einlassen -- meinen -- Höchste Trefflichst -- 
  jung -- alt Freund -- -- Künstler Kunst verehren -- einseh -- gebrechen -- 
  Sternbald gewöhnt Überwindung Art denken -- zwingen -- heftig -- Gefühl sprechen lassen -- Verstand Urteil Anspruch nehmen -- 
  jemals -- Kunst -- Künstler Beschäftigung Rechenschaft geben können -- 
  einrichten -- Gesellschaft zweimal Woche versammeln -- jedesmal Kunst disputieren -- wobei Castellani Reden hervortaen -- 
  Nachmittag versammeln -- Camillo zugegen -- abseits Ecke stehen hinzuhören scheinen -- 
  weichen -- Sternbald Freund Castellani -- meister Eurer Zeitgenosse -- Buonarotti's jüngstes Gericht Triumph Kunst halten -- 
  nachwelt -- Castellani -- gewiß Meinung -- Mensch Frage untersuchen -- 
  Kunst -- 
  -- 
  Abred -- töricht -- dergleichen leugnen -- Michael Angelo ausgezeichnet Geist -- Übereilung Zeitalter -- Raffael übrig Sterbliche hinüberzuheben -- sagen -- sehen -- Kunst erfüllen -- 
  jeglich Kunst eigentümlich Gebiet -- Grenze -- hinausschreien -- versündigen -- 
  Poesie -- Musik -- Skulptur Malerei -- 
  Gebiet streifen -- Künstler Heimat kennen -- 
  jeglicher Frage genau untersuchen -- 
  Mittel vernünftig Mensch leisten Stande -- 
  Historie wählen -- Gegenstand überdenken -- Unwahrscheinlichkeit Schuld lassen -- Einwürfe kalt -- richtend Verstand Zauber Komposition zerstören -- 
  Gegenstand wählen -- Augenblick Handlung fleißig überdenken -- groß -- interessantesen herausheben -- mal -- darstellen lassen -- 
  Mensch kennen -- Gemüt fremd Gesinnung beobachten -- Eindruck hervorzubringen -- gereinigt Geschmack Bizarre vermeiden -- täusch Hinreiße -- rühren erstaunen -- 
  wohlüberdacht Urteil Maler Forderung erfüllen -- -- genannt Studie beflissen -- 
  hoch Grade ausbilden -- ehe Künstler Forderung anerkennen -- 
  namentlich Buonarotti sprechen -- glauben -- Kunst wichtig Schritt zurückgebrachen -- helfen -- Erfordernis gut Kunstwerk gesündigt -- 
  richtig Zeichnung einzeln Figur -- Gelehrsamkeit Bau menschlich Körper -- Gemälde -- 
  jüngstes Gericht ungeheuer Wand voll Figur mannigfaltig Stellung -- Verbindung -- Wirkung -- 
  Zweck Darstellung Schönheit -- Handlung -- -- anschauen -- darstellen lassen -- Erzählung vortragen lassen -- 
  tausend Begebenheite -- einzig verbinden lassen -- 
  schwebend Gestalt -- ruhend selig Verdammt -- Engel Madonna -- 
  Auge finden Ruhepunkt -- fragen -- 
  sehen -- 
  Mythologie alte christlich Idee vermischen -- Verzerrung Verzweiflung -- 
  Augenblick Gemälde unentschieden -- Engel Zubereitung beschäftigen -- allgemein Moment Entsetzen -- unten Verdammung Vieler entscheiden -- 
  scheinen -- jung Gericht fertig -- Maler Überlegung beweisen -- 
  genießen fühlen -- Ausführung Tadel verdienen -- 
  -- rufen Camillo -- hoch Unwille hervortreten -- 
  glauben -- -- übergroß Buonarotti denken -- entzück -- mächtig Werk entwerfen -- 
  O -- Kurzsichtig -- Meer Bechern erschöpfen -- Strome Herrlichkeit Ufer -- unselig Geist kommen -- verwegen -- 
  glauben Kunst ergründen -- ergründen euer Engherzigkeit -- Geist Gott richten -- erhaben Ebenbild Schöpfer beseeln -- 
  lästeren Kunst -- erheben -- Spiel Eurer nichtigen Eitelkeit -- 
  allmächtig Sünder dulden -- erlauben Angelo Größe -- unsterblich Werk -- Riesengestalt dulden -- sprechen -- beide wunderbar -- 
  verlassen Zorn Saal -- erheben laut lachen -- 
  verstehen -- Sternbald's Nachbar -- halten Unsinn -- 
  Sternbald Wort Gebärden Greise tief ergriffen -- enthusiastisch Unwille anfassen -- verlassen schnell Gesellschaft -- entschuldigen -- Abschied nehmen -- 
  alt Straße -- treffen Nähe Vatikan -- 
  Verzeiht -- Sternbald -- anreden -- gehören -- Meinung ihrig -- Herz empört -- Ehrwürdigst Welt umgehen -- 
  Tor -- Greis -- -- geschehen -- Hitze übereilen lassen -- 
  wozu Wort -- 
  verstehen Rede -- 
  Franz Hand -- gehen Vatikan -- alt eilt Kapelle Sixtus -- 
  fallen Abend Dämmerung herein -- Sal ungewiß erleuchten -- 
  stellen jung Gericht -- schweigend fort -- 
  ruhig Einsamkeit schaut Sternbald erhaben Gedicht demütigen Auge -- 
  Gestalt scheinen herab bewegen -- gewaltig entsetzen Augenblick's bemächtigen -- 
  stehen -- bitten Figur -- Geist Michael Angelo Verirrung -- 
  Apostel Decke sehen ernst ewig Züg Mien -- Schöpfungsgeschicht liegen wunderbar -- allmächtig Sturmwinde herfahrend -- 
  donnernd Gewitter stehen vorzüglich jung Gericht Auge -- fühlen innerlich neu verändern -- neu schaffen -- Kunst Heeresmacht zugekommen -- 
  verklären -- Buonarotti -- Eingeweihter -- Franz -- schweben furchtbar Rätsel -- kümmerst -- verstehen -- 
  Kapitel -- 
  Franz finden bisherig Leichtsinn Lebensweise nüchtern ungenügend -- bereut Stunde -- -- innig Kunst widmen -- 
  brechen Umgang schön Lenore -- fühlen Innig -- lieben -- 
  Freund Castellani verspotten -- bedauern Anlage -- notwendig verderben müssen -- Franz empfinden Leerheit Mensch -- achten -- 
  lieb Kunst erwachen -- Jugendleben Nürnberg -- Freund Sebastian treten frisch Lieblichkeit Seele -- 
  Vorwurf -- Dürer Sebastian Gedächtnisse verlieren -- 
  geliebt Schreibtafel hervor -- küßen -- verwelkt Blume rühren Träne -- -- verwelken -- seufzen -- 
  Bildnis -- Berg mitnehmen -- stellen -- -- 
  fallen Brief Gräfin Hand -- vergessen -- 
  beschließen -- Familie aufsuchen -- fühlt Bedürfnis Freund -- 
  Franz Brief erkundigt Wohnung -- bezeichnen -- 
  Leute -- suchen -- leben Stadt Garten -- 
  Diener empfangen -- leiten angenehme Baumgänge -- Garten -- voll Obst Gemüse -- 
  klein niedlich Gartenhause -- Diener -- Tochter finden -- Mutter ausgehen -- Vater sechzehn tot -- 
  Franz bemerken Fenster weiß rund Arm -- schön Hand -- Zither spielen -- 
  begegnen alt Mann -- fast achtzig alt scheinen -- verlassen Gartenhaus -- Garten Wohnhause -- 
  Franz treten Zimmer -- 
  Mädchen legen Zither weg -- bemerken -- entgegen -- 
  stehen erstaunt -- erkannt Augenblick -- 
  Franz zitteren -- Sprache wiederfinden -- Stunde -- seligste Leben herbeigewünschen -- überraschen unerwartet -- 
  Wesen -- nachgeeilen -- Geburtsdorfe sprechen -- Seele lieben -- verlieren glauben -- 
  scheinen fast bewegen -- Brief Gräfin -- durchflog schnell -- sprechen Ort -- anderthalb sehen sprechen -- 
  teuer Brieftasch -- reichen -- hören Garten Waldhorn spielen -- 
  Franz lang aufrecht halten -- sinken schön bewegt Gestalt Knie -- weinend küßte Hand -- 
  wunderbar Stimmung ergreifen -- halten vertrocknet Blume schweigend staunend Hand -- beugen Hinab -- -- 
  O -- wiedersehen -- stammelnd -- allenthalben Euer Bild folgen .-- Blume -- rufen Sternbald -- erinnern Knabe -- -- 
  -- wissen fassen -- 
  -- sinken kopf Schoß -- holder Gesicht herabgebeugen -- Waldhorn phantasiert herzdurchdringend Tön -- drücken küßen -- schließen Fester -- verlieren staunend Entzück -- 
  Franz wissen -- träume -- Einbildung -- 
  Waldhorn verstummen -- sammeln -- 
  -- fast wissen -- Lieb stehen -- 
  -- denken -- Marie holdseligen Erröt -- 
  begreifen ewig -- längstgekannt Freund -- fremd -- 
  Seele -- Herz fremd -- rufen Sternbald -- 
  -- Augenblick beginnen Leben -- o -- wunderbar -- 
  begreifen -- 
  -- glücklich -- -- 
  süß Geliebte -- 
  -- Suchtest -- 
  Findest -- 
  beschämt Hand drücken -- 
  alt Mann -- melden -- ausgehen müssen -- Franz betrachten erstaunen -- erriet -- müssen -- musizieren -- Kindheit grün Rasenplatze sehen -- 
  Baum rauschen draußen wunderbar -- hört Ferne Geräusch Landstraße -- jeder Leben erscheinen traurig -- freudig glorreich -- 
  -- Rückkehr Mutter erwarten -- versprechen -- Geliebte folgend besuchen -- 
  Feld schweifen umher -- -- Garten -- Zimmer -- 
  Stadt -- besinnen -- Weg kommen -- 
  Stube Zither küssen -- greifen Ton hinein -- lieb Entzück antwortet Sprache Musik -- 
  Natur vernehmen Gruß Glückwunsch -- 
  Sebastian schreiben -- Ruhe -- 
  fing -- Gedanke verlassen -- schreiben folgender nieder -- 
  Sanft umfang verlangen -- Abendwolken ziehen -- O -- grüßen holder Glück -- -- Blick -- längst gepflanzt Blume blühn -- 
  Abendrot winken herunter -- 
  Hoff munt -- Wind eilen -- verkünden_es Ferne -- Blick nieder freundlich Stern -- 
  -- grüßend niederschaute -- -- singen -- gelingen -- 
  Ton rühren Laute -- unsichtbar Geisterhand durchklingen -- 
  erregen Spiel -- Wort verkünden -- Kennst -- vertraute -- Gefühl -- quälend -- beglückend Herz entzünden -- 
  O tön -- Lied finden -- Leid -- Glück -- bewegen -- Klang Lust erregen -- 
  Glück -- Freude singen -- alt -- wonnevoll Stunde -- 
  fern verschwinden -- Geist Entzück festgebunden -- Beengt -- beschränken golden Schwing -- 
  lieb Klang sie_es -- Ton rühren -- 
  Herz strebendem Drang dein Melodie entführen -- 
  Zitherklang entgegen -- Geist Netz Tön gefangen -- fühlt beben -- bangen -- Entzück überströmen -- golden Regen -- 
  sitzen Zimmer -- warten -- Liebe führen hinein -- Erklang alt Waldhorn drein -- 
  voll Klang Herz durchdrang -- Liebe vertrauen -- Ton Herz durchschauen -- 
  verstumm Ton -- Lautenklang Leben -- Herz verklären schönst schön -- Wundervollem Glanz Webe Hingegebe -- 
  Teil -- 