Franz Sternbald Wanderung -- 
  altdeutsch Geschichte herausgegeben Ludwig Tieck -- 
  -- 
  Berlin Johann Friedrich Unger -- 1798 -- 
  Vorrede -- 
  folgend Buch lieb Kind Muße Phantasie hegn übergeben -- geliebt Leser -- Wunsch -- gefallen mögen -- 
  Kunst liebst -- erdulden nachsichtig -- Findest -- 
  meister Werk Laune -- Jüng Kunst -- denken -- unermüdet Streben Meisterwerke hinandrängen wollet -- euer wechselnd Gemüt wunderbar Stimmung beherrschen -- begreifen -- Widerspruch lösen möchten -- Stunde ängstigen -- 
  widme Blatt besonderer Liebe herzlich Wunsch -- hie Wolke schwinden -- euer Aussicht verdecken -- 
  rechnen chronologisch Fehler strengen -- behandle Buch Geschichte Staat -- 
  Schwäche empfinden selber Ideal erreichen -- Inneren stehen -- 
  Erfindung -- Dichter Künstler Mund legen -- zittre -- Stottre lassen -- fühle_es -- kenn Natur -- fassen -- 
  Franz Sternbald Wanderung -- 
  Buch -- 
  Kapitel -- 
  Tor Stadt -- Sebastian -- Stille Stand frei umsah -- 
  -- antworten seufzend Franz Sternbald Freund -- -- 
  -- 
  früh -- allzufrüh -- 
  Mensch sehen Wort -- Sebastian legen Freund zärtlich Hand Stirn fühlen -- heiß -- 
  -- schmerzen Kopf besorgt -- Franz antworten -- -- -- trennen -- 
  -- rufen Sebastian wehmütig Erzürn -- -- Meil begleiten -- 
  geben Hand gehen stillschweigend schmal Weg nebeneinander -- 
  schlagen Nürnberg zählen aufmerksam Schlag -- obgleich wissen -- Stunde -- werfen Morgenrot Flamme hoch gehen undeutlich Schatten Gegend treten umher ungewiss Dämmerung heraus -- 
  still feierlich -- Franz gut Stunde Saus Braus -- Getümmel tausend Abwechselung verlieren -- 
  Meister schläft arbeiten Träumen -- Gemälde stehen Staffelei warten -- 
  tun leid -- Petrus ausmalen helfen -- 
  fällen -- fragen Sebastian -- 
  maßen -- rufen Franz -- fast bedünken -- Apostel meinen -- Deg rasch Hand nachh Lebensfurcht Verleugnen lassen -- Hahn müsster Buß Gedächtnispredigt halten lassen -- beherzt Furchtsamer -- starr gutmütig Apostel aussehen Meister Dürer hingestellen -- 
  Bild lassen -- Sebastian -- wenden deinen Fleiß denken -- schlecht Gemälde -- 
  versprechen -- 
  Antwort erwart Freund Hand drücken stark -- Sebastian -- dein Johannes aufheben behalten -- Geld böte -- 
  Rede Fußsteig kommen -- nähern Weg durch Korn führen -- 
  rot Licht zitteren Spitze Halme Morgenwind rührt Welle -- 
  jung Maler unterhielt Werk Plan Zukunft -- Franz verlassen Nürnberg vaterländisch Stadt -- Fremde Kenntnis erweitern mühselig Wanderschaft vollendet Meister zurückkehren -- 
  Sebastian bleiben wohlverdient Albrecht Dürer Name Land ausbreiten -- 
  Sonne Majestät hervor Sebastian Franz sehen abwechselnd Türm Nürnberg -- Kuppel Fenster blendend Schein Sonne glänzen -- 
  jung Freund fühlen stillschweigend Druck Abschied -- warten -- sehen kommend Augenblick Furcht entgegen -- wissen -- trennen müssen glauben -- 
  Korn stehen schön -- Franz ängstigend schweigen unterbrechen -- schön Ernte -- 
  diesmal -- antworten Sebastian -- miteinander Erntefest besuchen -- seither geschehen -- hingeh -- fehlst lustig Pfeife Schalmeigetöne bitter Vorwurf -- kommen -- 
  jung Franz stehen Wort Träne Auge -- Szene sehen -- brüderlich Gesellschaft erleben -- schnell Gedächtnis -- Sebastian hinzu setzen -- Ferne leiben behalten -- Fasse -- fallen Fragenden laut Schluchze Hals ergießen tausend Träne -- zitteren -- -- Herz zerspringen -- 
  Sebastian halten fest arme geklammert weinen -- alt -- hart Konstitution -- 
  Kommen -- Freund fassen -- sehen -- 
  Franz antworten -- trocknet Träne -- Gesicht zeigen -- 
  liegen Schmerze -- Mensch schämt -- Träne Busenfreunde -- gehören -- verbergen -- 
  erinnern -- Reise sprechen -- unerwartet kommen -- Franz wünschen höchst Glück ansehen -- 
  Sebastian begreifen -- traurig sein -- Grund vorgefallen -- langgewünschen Augenblick herbeigekommen -- 
  Glück Mensch -- freuen -- Ferne zuwandeln -- nahe ergreifen Hand -- schaudern -- Hand Todes fassen -- 
  Wahrheit gestehen -- fahren Franz fort -- glaubst seltsam gestern Abend Sinn -- 
  Gedanke Pracht Rom -- Glanz Italien Vorgemalt -- Arbeit verlieren -- vorstellt -- unbekannt Fußsteigen -- schattig Wald wanderen -- fremd Stadt nie_gesehener Mensch Blick begegnen -- -- bunt -- ewigwechselnd Welt unbekannt Begebenheite -- Künstler -- sehen -- hoch gelobt Land Römer -- einst Held wahrhaftig wandeln -- Bild Träne entlocken -- sieh -- Gedanke gefangen nehmen -- zuweilen wissen -- -- -- 
  -- rufen manchmal -- geben -- nahen -- alt -- wohlbekannen Staffelei sitzest -- -- all Herrlichkeit hineinleben sehen -- erfahren -- aufwachen -- geschehen -- Zeit Italien träumsen -- -- -- -- -- bekommsen Sinn -- Gefühl -- treu -- lebendig urkräftig aufzufassen -- -- 
  -- Herz Geist innerlich ausdehnt arme zukünftig erhasch -- reißen -- -- Franz -- 
  sagen -- antworten -- -- selber ergründen -- 
  gestern Abend rund Tisch unser Dürer sitzen Lehre Reise -- Hausfrau indes Braten schneiden Kuchen erkundigen -- Abreise backen -- essen Konntest -- Seite Betrachtetest -- o Sebastian -- arm ehrlich Herz zerreißen -- 
  Hausfrau -- gescholten -- unser brav Meister Dürer betrüben -- Wäsche eingepacken -- rühren -- abreisen -- 
  Mahlzeit endigen -- fröhlich -- vorher vornehmen -- 
  Abschied Meister Albrecht -- hart Träne reden -- fallen -- danken -- vortrefflich Mann -- herrlich malen -- letzter Woche -- gleich -- empfinden -- werfen nieder -- 
  fort -- gingst stillschweigend Schlafkammer -- Stube -- 
  Abend -- hereintreen -- selber -- Licht Boden stellen -- -- Franz -- Bette letztenmal Ordnung legen -- wirfst hinein siehst Kissen -- Sorge klagtest -- öfter süß Schlummertest -- siehst -- -- Sebastian -- Mensch -- Kind -- 
  fast -- stehen groß Unglück bevor -- Mensch begegnen -- sogar alt lichtscher Zärtlichkeit -- wehmütig Gefühl Hand putzt lang Docht Licht -- 
  überzeugen -- gut Dürer zärtlich Abschied nehmen -- heftig Vorwurf -- denken -- welch vortrefflich Mann Auge -- entfernt -- wüs -- kindlich Liebe -- brennend Verehrung -- Bewunderung Nähme -- 
  alt Giebel hinüber -- eng dunkel Hof -- hören schwarz Wolke unordentlich Himmel ziehen -- -- 
  Sebastian -- Haus würfeen -- eu Freund Gesellschafter dürfen -- Unwürdiger verstoßen -- verschmähen verachten -- -- regen Busen -- 
  Plan -- Hoffnung -- vorüber ziehen denken -- freuen -- 
  Ruhe -- Dürer Gemach hören drinnen schlafen -- o umarmt -- genügen -- dableiben -- Verreise denken vergnügen -- -- -- 
  -- Sieh fröhlich Licht Morgen spielen -- trag Empfindung dunkel Nacht -- 
  früh Glück vergessen -- neu glücklich -- -- 
  -- laß Augenblick still stehen -- horch -- schön Gebüsch flüstern -- -- singen nochmal altdeutsch Lied Reise -- 
  Sebastian stehen sogleich still singen -- vorher hust -- folgend Vers -- 
  Reis -- bequem Feld Berg Tal Welt -- Fremd Stadt allzumal Mußt Gesundheit nehmen -- 
  Freund aufzufind Läßt alt dahint -- Früh wach sehen Wanderer Weint dahint Freude -- wiederfinden -- 
  Eltern -- Schwester -- Bruder -- Freund -- liebchen weinen -- Laß wein -- traurig froh Wechselt Leben Nimmer -- O -- 
  Heimat bleiben treu bied -- Kehrst Treuer -- Reise Scheiden Bringt Wiedersehen Freude -- 
  Franz hoch Gras setzen singen letzter Vers inbrünstig -- stehen kommen Stelle Sebastian umkehren -- 
  Gruß -- rufen Franz -- -- kennen leben -- 
  hsen -- fragt Sebastian -- 
  umkehren -- 
  halten fest umschlossen -- 
  einer -- rufen Sebastian -- qualten lassen -- 
  Franz wünschen Abschied Herzen vorüber -- -- Herz gegenwärtig Minute erdrücken -- sehnt Einsamkeit -- Walde Freund entfernt Schmerz ausweinen -- 
  Sebastian verlängert Augenblick Abschied -- neu Leben -- Gegend trösten lassen -- kennen genau wozu zurückkehren -- 
  versprechen -- rufen -- 
  -- -- 
  Franz -- fahren klagend fort -- lassen -- wissen -- begegnen -- Gesicht sehen setz Liebe -- ungewiss Spiel -- 
  weit Ferne deinen einfältig Freund Sebastian denken -- 
  -- klug vornehm Leute -- -- Abschied nehmen -- verachten -- 
  O liebster Sebastian -- rufen Franz schluchzend -- 
  Nürnberg lieben -- fahren fort -- dein Meister lieben -- wacker Albrecht -- 
  Klüger fühlen -- 
  O versprich -- Mensch bleiben -- Glanz fremde verführen lassen -- teuer -- angehen -- 
  O Sebastian Franz -- Welt klug überklug -- Kind bleiben -- 
  Sebastian -- 
  O einst fremd abgebettelt Sitte kämsen -- wüsstest Herz warm schlüg -- kalt Blut Dürer Grabstein hinsehen könntest höchstens Arbeit Inschrift sprächest -- -- o wiedersehen -- Bruder erkennen -- 
  Sebastian -- -- rufen Franz heftig -- kenn -- lieb Vaterland Stube -- worin Meister wohnen Natur Gott -- 
  hängen -- -- -- 
  Sieh -- -- alt Eichenbaum versprech -- Hand -- 
  Umarmt gehen stumm auseinander -- Weile stehen Franz still -- laufen Sebastian umarmen -- 
  -- Bruder -- -- Dürer Ecce homo fertig -- schreiben umständlich glaub Göttlichkeit Bibel -- wissen -- manchmal übel dachtesen -- 
  -- Sebastian trennen -- kehrt -- wandt Gesicht -- Wald treten -- 
  Kapitel -- 
  Sebastian Stadt zurückkehren Franz -- lassen Träne Lauf -- 
  Leb -- tausendmal -- still -- sehen -- 
  Arbeiter Feld Bewegung -- tätig rühren -- Bauer fahren vorüber -- Dorf Getümmel -- Scheuer arbeiten -- 
  Mensch begegnen -- dachen Franz wissen einzig Albrecht Dürer -- Werk Kopf einnehmen -- erreichen einzig Tracht -- wissen -- Malerei fühlen unglücklich -- 
  wissen einsehen -- leben -- einsam verlassen treiben emsig Geschäft -- -- -- 
  Sonne indes steigen Brannte Heiß herunter -- Schatten Baum -- Arbeiter gehen Mittagsesse Haus -- 
  Franz denken -- Sebastian Albrecht Dürer Tisch setzen -- sprechen -- 
  beschließen nächster Gehölz still liegen -- mitgenommen Vorrat hervorzuholen -- 
  erquickend kühl Duft -- grün Blatt entgegen weht -- Wäldche hineintreten -- 
  still rauschen Baum schallen manchmal lieblich Einsamkeit ferner Bach -- durch Gehölz fließen -- 
  Franz setzen weich Rase ziehen Schreibtafel heraus -- Auswanderung anzumerken -- holt frisch Atem -- -- Abwesenheit Freund trösten -- finden -- -- 
  breitet Tafel aß Wohlbehag mitgenommen Vorrat -- fühlen schön ruhig Gegenwart -- umgeben -- 
  Wandersmann Straße gehen grüßt Franse freundlich jung rotbackig Bursche -- scheinen müde Franz bitten -- niederzusetz Vorlieb nehmen -- 
  jung reisend sogleich Vorschlag -- verzehrt Mut Mittagsmahlzeit tranken Wein -- Franz Nürnberg mitnehmen -- 
  Fremde erzählen hierauf unser Freund -- Schmiedegesell Wanderschaft begreifen -- gehen -- hochberühmt Stadt Nürnberg Augenschein nehmen Handwerk kunstreich Meister lernen -- 
  treiben Gewerbe -- fragt -- Erzählung geendigen -- 
  Maler Franz -- Nürnberg auswandern -- 
  Maler -- rufen -- -- Kirche Kloster Bild verfertigen -- 
  -- antworten Franz -- Meister O -- Schmidt -- wünschen -- Mann Arbeit sehen -- vorstellen -- 
  glauben -- Gemäld Kirche alt sein -- Leute leben -- dergleichen können -- 
  Grade umgekehrt -- Franz -- Kunst hoch steigen -- jemals -- sagen -- malen -- früh Meister vermochen -- Manier edl -- Zeichnung richtig Ausarbeitung weit Fleißiger -- jetzig Bild wirklich Mensch ungleich ähnlich sehen -- vormaligen -- 
  -- ernähren -- fragt Schmidt -- 
  hoffen -- antworten Franz -- Kunst Welt bringen -- 
  Grund nützen -- fahren fort -- 
  nehmen -- Franz innerlich Rede böse -- 
  menschlich Auge Herz finden Wohlgefallen -- Bibel Gemälde verherrlichet -- Religion unterstützen -- edl Kunst verlangen -- 
  -- Gesell -- -- Not entbehren -- Unglück entstehen -- Krieg -- Teuerung -- Mißwach -- Handel Wandel bleiben gehörig Ordnung -- Schmiedehandwerk Fall -- worauf Reise -- dünken -- müssten Besorgnis Welt hineingeh -- ungewiß -- Arbeit finden -- 
  Franz wissen Antwort schweigen still -- nachdenken -- Beschäftigung Mensch nützlich -- Trieb überlassen -- 
  betrüben -- hoch Wert Kunst zweifeln können -- wusste widerlegen -- 
  heilig Apostel Lukas Maler -- fahren -- 
  -- Schmidt verwunderen -- denken -- Handwerk alt -- 
  Möchtet -- fahren Franz hochrot Gesicht fort -- Freund Vater hättet -- Herz liebten müßten Wanderschaft -- könnten lang lang sehen -- möchten Bild -- Auge ständ -- Miene jeder Wort zurückriefen -- sprechen -- 
  schön herrlich -- gefärbt Schatten besitzen -- teuer -- 
  Schmied nachdenkend Franz öffnen schnell Mantelsack wickelen Bild -- Abreise malen -- 
  Seht hierher -- fahren fort -- sehen Stunde liebst Freund getrennt trag Gestalt herum -- teur Lehrer Albrecht -- Dürer nennen -- sehen -- freundlich -- -- Jugend aussehen -- 
  Schmied betrachtet Gemäld aufmerksam bewundert Arbeit -- Köpfe Auge stehen -- beinahe glauben -- lebendig Mensch sehen -- 
  schön -- sprechen jung Maler -- männiglich bemühen -- Kunst hoch treiben wahr natürlich Menschenangesicht darstellen -- 
  übrig Apostel damalig Christ herrlich lieblich Erquickung Lukas Erlöser tot -- Maria Magdalena übrig hinmalen -- glauben Auge sehen Hand erfassen -- 
  unser Zeitalter überaus schön -- Freund Mann -- kühn Streiter -- wacker Doktor Luther trefflich konterfeien -- lieb Mensch Bewunderung erhöhen -- 
  längst tot -- Enkel spät Urenkel wissen -- jetzig Held Mann malen antreffen -- 
  O wahrlich -- Albrecht segnen loben -- Mühe geben Frage aufwerfen -- wozu Kunst nützen -- 
  betrachten -- Schmied -- -- wahrlich -- -- Eisen hämmern -- 
  wünschen -- -- bleiben wobei künftig Mensch gedenken können -- überaus künstlich Schmiedearbeit -- wissen -- finden -- -- Handwerksgenosse kommen -- 
  Art freilich leichtes saure Arbeit -- einer -- 
  denken -- sehen -- Nacht arbeiten Schweiß verdrießen lassen Stande brächt -- lang dauern -- Mühe wert -- erinnern -- neu unerhörte erfinden -- entdecken -- halten glücklich Mensch -- gelingen -- 
  Wort hören Franzen Zorn völlig -- Schmiedegeselle gewogen erzählen mancherlei Nürnberg -- erfahren jung Schmied Flandern kommen Messys nennen -- 
  Gefallen -- fragt Fremde -- 
  -- Franz -- 
  schreiben Wort geben euren Meister euer jung Freund -- besuch Arbeit zusehen lassen -- vorstellen -- Farbe künstlich übereinander legen -- 
  nachsehen -- euer Bild ähnlich -- 
  nötig -- Franz -- 
  -- erzählen Gruß bringen -- gewiß lassen Herzenslust zusehen -- 
  -- sprechen -- Träne Auge stehen -- 
  schied hierauf Straße -- 
  Abend -- fallen jung Sternbald Gegenstand Gemälde -- Gedanke ordnet Liebe Vorstellung verweilen -- röt Abend -- schwermütig Träumerei -- fühlen einsam weit Welt -- Kraft -- Hilfe selber -- 
  dunkel_geworden Baum -- Schatten Feld ausstreckten -- rauchend Dach Dorfs Stern Himmel hervortran -- rühren Innig -- bewegen wehmütig Mitleid selber -- 
  kehrt Schenke Dorfs -- begehrt Abendessen Ruhestelle -- 
  Lampe auslöschen -- stellen an Fenster liegen -- Gegend Nürnberg sollen -- vergessen -- rufen -- lieben -- 
  O liebster Sebastian -- Herzen -- 
  glücklich fühlen -- deutsch -- Albrecht Freund -- -- 
  verstoßt -- Eurer unwürdig -- 
  legen nieder -- verrichtet Abendgebet schlief Beruhigter -- 
  Kapitel -- 
  wecken munter Girr Taube Fenster -- manchmal Stube hineinsah Flügel schlagen -- wegflog kommen -- Hals nickend abgehen -- 
  Lindenbäume werfen Sonne schräge strahlen Gemach Franz stehen kleiden hurtig -- fest Auge rein blau Himmel Plan lebendig -- Herz schlagen hoch -- Gefühl Brust erklangen geläutert -- 
  Farbenpalette Tafel stehen dreist kühn Figur hingezeichnen -- Brust bewegn -- 
  frisch Künstler Stärkung Strahlen Frührot regnen Begeisterung herab -- 
  Abend lösen schmelzen Gefühl -- wecken Ahnung unerklärlich Wunsch -- fühlen nah -- jenseits Leben anderer Kunstreicheres liegen -- inwendig Genius schlagen Sehnsucht Flügel -- frei hineinzuschwärm Land -- golden Abendwolken liegen -- 
  Franz singen Morgenlied -- fühlt Müdigkeit gestrig Weg -- setzen frisch Kraft Reise fort -- 
  reg Geflügel singen Gebüschen -- betaut Gras duftet Blatt funkelen Kristall -- 
  schnell Schritt schön Wiese -- Geschmetter Lerchen ziehen hinweg -- fast -- 
  Reise -- selber -- trefflich -- Freiheit Natur -- Regsamkeit Kreatur -- rein weit Himmel Menschengeist zusammenfass Gedanke zusammenstellen -- o glücklich -- eng Heimat verlassen -- Vogel Fittich prüfen unbekannt -- schön Zweig schaukeln -- 
  Welt entwickeln Gemüte -- frei Natur umh kühn Sprache hineinreden -- Ton Herz treffen Empfindung anrührt -- 
  glauben -- Maler -- -- Sinn Kunst zuwenden -- Wunsch -- übrig Welt aufgeben -- 
  zaghaft -- Sebastian -- selber vertrauen -- 
  mittage ruht Dorfe -- schön Lage -- treffen Bauer -- Wagen Meile Wohnort fahren gedachten -- 
  Franz einig lassen mitnehmen -- 
  Bauer alt Mann erzählen unterwegs unser Freund Haushaltung -- Frau Kind -- 
  siebzig alt Lauf Leben mancherlei erfahren -- wünschen sehnlich -- Tod berühmt Stadt Nürnberg sehen -- Hingekommen -- 
  Franz Reden alt Mann rühren -- sonderbar -- gestrig Nürnberg verlassen -- alt Bauer sprechen -- Fremder Wunderweit entlegen Ort -- auserwählte betrachten -- gelingen -- dorthin -- 
  untergang Sonne kommen Behausung Bauer -- Kind springen entgegen -- erwachsene arbeiten Feld -- alt Mutter erkundigen eifrig verwandter Mann besuchen -- müde Frage beantworten überaus treuherzig -- 
  Abendessen zubereiten Haus geschäftig -- 
  Franz bekommen bequemst Stuhl -- auszuruhen -- müde -- 
  Abendrot glänzen Grase Tür Kind spielen -- niedergeregnet Gold funkeln Scheibe -- lieblich rot angesicht Knabe Mädchen -- knurrend setzt Hauskatz Franz schmeicheln vertraulich -- Franz fühlen glücklich -- beengt Stube selig frei -- vorig trüb Stunde erinnern -- glauben -- können Leben betrüben -- 
  Dämmerung einbrechen -- fangen Herde Küche Heimchen friedlich Gesang -- Wasserbach singen Birk Nachtigall heraus -- Franz Glück still Häuslichkeit -- beschränkt Ruhe nahe empfinden -- 
  Sohn kommen Feld nehmen fröhlich Mut Abendmahlzeit -- sprechen bevorstehend Ernte -- Zustande Wiese -- 
  Franz lernen Befinde Eigenschaft jeder Haustier -- Pferd Ochsen kennen -- 
  Kind alte ehrfurchtsvoll -- fühlen -- Geist schön Eintracht beherrschen -- 
  finst -- vermehrt eisgrau Nachbar Gesellschaft -- Kind herumdrängen verlangt -- Geschichte erzählen -- alte mischen bat -- heilig Märtyrer vorsagen -- neue -- erzählen -- öfter hören -- -- 
  Nachbar willig tragen Geschichte heilig Genoveva -- heilig Laurentius tief Andacht -- verlieren -- 
  Franz überaus rühren -- 
  Nacht fing Brief Freund Sebastian -- herzlich Wirten Abschied -- folgend Stadt -- Brief Freund beschließen -- 
  teilen unser Leser Brief -- 
  Liebster Bruder -- 
  -- kurz dünken -- 
  eigentlich schreiben unterlassen -- Herz sagen -- Brief finden Solltest -- denken -- unaufhörlich Bild teuer Meister Lehrer stehen -- 
  Schmiedegesell besuchen -- treffen -- denken freundlich aufnehmen meinetwillen -- 
  schreiben Brief Nacht -- Schein Vollmond -- Seele überaus beruhigen -- Dorfen Bauer -- Meile hierher fahren -- 
  Haus schlafen -- fühlen Munter -- wach bleiben -- Sebastian -- treiben Leben Mensch Sache -- 
  meisten gänzlich Zweck verfehl -- suchen finden -- Gefundene -- glücklich -- 
  finden -- -- Glück -- 
  leben Bauer zufrieden wahrhaft glücklich -- 
  bloß glücklich -- Zustand gewöhnen -- besseres kennen -- finden -- -- innerlich herzen vergnügen Unzufriedenheit fremd -- 
  Nürnberg wünschen Tod sehen leben nahe -- rühren -- -- 
  -- sprechen golden denken Weg mal sonderbaren buntgrell Farbe -- 
  O teuer Sebastian -- dicht unser Fuß liegen wundervoll Land -- jenseits Ozean jenseits Sündflut sehnsüchtig Auge suchen -- 
  -- redlich selber umgehen -- 
  ängstigen unser Verhältnis -- bissch Brot -- selber Ruhe verzehren -- 
  treten manchmal heraus schütteln -- qualten drücken -- hol frisch Atem fühlen himmlisch Freiheit -- eigentlich angeboren -- 
  Krieg Schlacht -- Zänkereie Verleumdung vergessen -- lassen Auge zudrücken -- Welt kunterbunt hergehen toll Verworren durcheinander schieben -- himmlisch Friede Gelegenheit fänden -- herab senk süß lieblich Flügel umarmen -- 
  Wirrwarr gewöhnlich Welthandel verstricken -- ziehen selber Flor Spiegel -- Wolke herunterhängen -- Gottheit Natur himmlisch Angesichter zeigen -- Eitelkeit Welt desto wichtig finden -- 
  Menschengeist Staube aufrichen getrost Stern hinblick Verwandtschaft empfinden -- 
  Kunst lieben -- lieben -- Verworrenheit erlösen -- selig Frieden Kunst verwanden -- 
  glaubst -- malen -- Zustand Seele ausdrücken -- wecken -- 
  Ruhig fromm Herde -- alt Hirt Glanz Abendsonne Engel Ferne Kornfelder -- Geburt Herrn -- Erlöser -- Friedensfürst verkündigen -- 
  wild erstarren -- erschreckn durcheinandergeworfen Figur -- freudig Sehnsucht müsst himmlisch hinschauen -- Kind müsst zart Händlein golden Strahl hindeuen -- Botschafter ausströmten -- 
  Anschauer müsste Bild hineinwünsch Prozeß Plan -- Weisheit politisch Konnexione viertelstündchen vergessen -- -- -- schreiben denken -- 
  Laß manchmal -- Sebastian -- gut freundlich Natur anwehen -- Brust engen -- schau Mensch zuweilen -- Strudel Leben wenigster bemerken -- heiß süß Frömmigkeit willkommen -- alt Eiche Schein Abendsonne -- heimchen zwitschern Feldtaube girren -- niederkommen -- 
  Nenne weich phantastisch -- raen -- wissen -- Sache denken -- vernünftig Härter -- 
  -- Nachbar besucht Abendessen erzählt einfältig Art Legende Märtyrer -- 
  Künstler Urteil Bauer Kind manchmal Schule -- kalt Gelehrsamkeit Künstlichkeit erholen -- Herz Einfalt auftäte -- einzig wahr Kunst -- 
  Erzählung viele lernen -- Gegenstand -- Maler darstellen müssen -- Licht erscheinen -- 
  wissen Kunstgemälde -- rührendst Gegenstand unnützen schön Figur -- Gemäldegelehrsamkeit trefflich ausgedacht Stellung einbauen -- Auge lernen -- Herz empfinden -- worauf vorzüglich müssen absehen -- 
  Meister größ Größe -- Gegenstand darstellen -- verschönern -- verlier Nebending -- 
  denken -- vielgeliebt Albrecht vorgesagen -- fühlen sprechen -- 
  -- Grüße -- aufhören -- müde -- 
  komm Stadt -- Brief schließen abschicken -- 
  -- ankommen -- -- Se¬ -- bastian -- Wort sagen dürfen überflüssig -- 
  ewig Auf- abtreiben Gedanke -- 
  Ruhe -- manchmal Vorbeifliege küßen -- einheimisch -- Glück sagen -- Künstler -- Welt angesehenen zählen -- Name Achtung Liebe sprächen -- 
  sehen -- fühlen -- ewig gönnen -- 
  -- Zaume halten -- Entwurf -- Hoffnung -- Zutrau Empfindung -- leer wüsen Seele -- rauh Landschaft -- Brücke wild Waldstrom zusammengerissen -- 
  Weg Mut -- ordentlich herrlich Gestalt schützen erwehren -- Phantasie aufstiegen -- überschüttet Glanze -- überdrängen Kraft erobert beherrscht Geist -- freuen lang Leben wünschen -- Welt -- Kunstfreunde geliebt -- Sebastian -- ausführlich hinzumalen innerlich unwiderstehlich Gewalt beherrschen -- 
  Stadt -- Mauer -- Emsigkeit Mensch sehen -- Gemüte zugeschütten -- Platz Freude wiederfinden -- Erscheinung steigen -- 
  wissen -- -- Sinn gänzlich verwirrt -- 
  zutrauen scheinen Raserei -- inwendigen Bild abschmacken -- -- fügen -- Auge Wohlgefall finden -- 
  Brief verdrießen -- Stolz beschämt -- -- 
  -- Sebastian -- einig -- 
  -- -- 
  Lebe bleiben Freund grüß Meister Albrecht -- 
  Kapitel -- 
  Franz Stadt Brief Dürer Mann abgeben -- Vorsteher ansehnlich Fabrik -- 
  treffen Geschäft -- Herr Zeuner Brief flüchtig elsan jung Sternbald sprechen -- bitten -- Mittagsessen -- 
  Franz betrüben Gasse Stadt -- fühlen fremd -- 
  Zeuner zurückstoßend kalt -- freundlich Aufnahme erwarten -- Brief teuer Lehrer bringen -- 
  Mittagsessen -- Zeuner Haus -- eins groß Stadt -- Bangigkeit schriten Treppe hinauf prächtig verziert Vorsaal -- Haus merken -- reich Manne befinden -- 
  Saal führen -- stattlich Versammlung Herr Dame -- schön Kleid antun Augenblick Essen warten scheinen -- 
  bemerkn -- zufälligerweise Gespräch anfingen -- brechen -- hören -- Maler -- 
  treten Herr Haus herein -- drängen höflich freundlich Glückwünsche herum -- freundlich bewillkommen -- Franz Vorbeigehen -- 
  Ecke Fenster zurückziehen -- Bangigkeit schlagend Herz Gas hinunt -- erstenmal -- Gesellschaft befinden -- 
  Welt -- anständigen -- wohlgekleidet unterrichtet Leute tausend nichtswürdig Gegenstand -- Malerei reden hören -- glauben -- Mensch Herz liegen müssen -- -- vertrauen Freund Albrecht Dürer -- aufmerksam -- 
  setzen Tisch -- sitzen fast unten -- 
  Wein beleben Gespräch Gesellschaft munter -- Frau erzählt Putze Mann mannigfaltig Geschäft -- Hausherr lassen weitläufig -- Fabrik verbessern Gewinn einträglich -- 
  gut Franz ängstigen -- -- abwesend reich Leute vorzüglich Ehrfurcht sprechen -- fühlen -- Geld einzig -- Schatz -- 
  fast Wort mitsprechen -- 
  jung Frauenzimmer zuwider -- züchtig still -- vorstellen -- setzen Verlegenheit -- fühlt Armut -- Mangel Umgang erstenmal Leben bitter Art -- 
  Angst trinken Wein durchkreuzend Gespräch ungemein erhitzen -- 
  hören -- sprechen -- groteskest Figur beschäftigt Phantasie -- Tafel aufheben -- stehen mechanisch -- fast wissen -- 
  Gesellschaft verfügt angenehm Garten -- Franz setzen abseits Rasenbank nieder -- -- Gesträuch Baum umh Mensch trösten -- Zuwider -- 
  Brust frei -- wiederholt Gedanke Lied -- Jugend lernen einfallen -- 
  Hausherr -- stehen gehen sprechend schattig Gang -- 
  Reise -- fragt Zeuner -- 
  -- antworten Franz -- Vorjetzt Flandern Italien -- 
  malerkunst geraten -- 
  selber sagen -- plötzlich -- wissen -- Trieb -- bilden -- fühlen -- 
  -- Zeuner -- jung lassen raten -- 
  Jugend zuweilen Zeichne -- alt -- -- führen können -- 
  legen eifrig ernsthaft Geschäft widmen -- sehen -- -- 
  Fabrik Arbeiter stehen -- Aufsicht -- Führ Rechnung treu Leute brauchen -- 
  -- gut Gehalt eintreten -- Aufseher sterben -- 
  sicher Brot Auskommen -- verheiraten sogleich antreffen ungewissen zukünftig Ferne suchen -- -- 
  euer Reise einstellen bleiben -- 
  Franz antworten -- 
  Geschick Kunst -- fahren fort -- gewinnen -- 
  Meister -- führen kümmerlich höchst armselig Leben -- 
  Eurem Lehrer -- 
  erkennen -- belohnen -- 
  fleiße hinübergrämen -- froh Stunde -- ergötzen -- achten -- Vermögen -- reich -- angeseh Einfluß -- bürgerlich Geschäft widmen -- 
  euer Vorschlag annehmen -- rufen Franz -- 
  -- 
  -- -- 
  -- antworten Franz -- unmöglich glauben -- 
  Zeichn Bilde sogleich unterlassen -- wollten -- -- unmöglich kräftig Trieb verspüren -- 
  Wüstenicht -- anfingen -- unterließe -- euer Rechnung verderben -- Gedanke richten bleiben -- Stellung Min ausdrücken -- euer Arbeiter Modell -- wären schlecht Künstler -- ernsthaft Geschäft verdorben -- -- Ehrfurcht Reichtum -- nimmer kunstlos Leben bequemen -- 
  Albrecht Dürer -- gereichen Mensch -- Vorwurf -- 
  arm -- Armut glückselig -- 
  halten -- hinstell sagen -- Christuskopf malen -- Haupt Erlöser göttlich Mine Kurzem stehen ansiehen Andacht Ehrfurcht zwingen -- auflegen -- 
  sehen -- Mann verachtet Dürer -- 
  Franz bemerken -- Rede Gesicht Wirt Unwille verziehen -- Abschied weinend Auge wirtshause -- 
  Fenster Bildnis Albrecht Dürer aufstellen -- Stube treten -- fallen laut weinend klagend nieder schließen Arm -- drückt Brust bedeckt Küsse -- 
  -- -- -- ehrlich Meister -- rufen -- lern Welt Gesinnung kennen -- 
  -- glauben -- sagtest -- 
  -- Mensch undankbar Herrlichkeit Freude genießen gibst -- 
  freilich Sorge stet Arbeit Furchen Stirn ziehen -- -- 
  kenn Falte -- 
  unglückselig Geist lieb Verehrung eingeblasen -- lächerlich Wunder übrig Mensch herumstehen -- Rede antworten wissen -- Frage verstehen -- 
  Trieb getreu bleiben -- tun -- arm verachten -- hindern -- Mangel umkommen -- 
  Sebastian -- lieben -- 
  Brief Dürer Freund Pirckheimer -- angesehen Mann Stadt abgeben -- 
  unentschlossen -- selber hintragen -- 
  -- eilig abzugeben Abend Stadt zuwider -- verlassen -- 
  weisen Frage abgelegen Haus -- groß Ruhe Stille herrschen -- 
  Diener führen geschmackvoll Zimmer -- ehrwürdig alt Mann sitzen -- -- Brief richten -- 
  freu -- Greis -- Nachricht lieben Freund Pirckheimer erhalten -- verzeiht -- jung Mann -- Auge schwach -- müßn -- vorzulesen -- 
  Franz schlagen Brief auseinander La Herzklopfe -- Pirckheimer edlen hoffnungsvoll jung Maler rühmen -- Schüler Albert Dürer nennen -- 
  Wort Träne zurückdrängen -- 
  Schüler Mann -- teuer Albrecht -- rufen alte entzücken -- o herzen willkommen -- 
  umarmt Wort jung Mann -- schmerzlich Freude mäßigen -- laut schluchzt erzählen -- 
  Greis trösten -- setzen -- 
  O -- alt Mann -- überaus köstlich Werk wahrhaft einzig Mann ergötzen -- Augo Kraft -- 
  Unglück Erde trösten -- 
  O sehen -- 
  Franz vergessen -- Sonnenuntergang Stadt verlassen -- bleiben -- alt Abendessen bitten -- 
  spät Nacht müssen Albrecht Werk -- erzählen -- Pirckheimer Entwürf -- 
  Franz ergötzt Gespräch müde -- Frage erzählen -- Freut -- Greis Kunst schätzen -- Lehrer Wärme sprechen -- 
  spät gehen auseinander -- Franz fühlen trösten glücklich -- Zimmer abging -- Mann betrachten -- gemäld Gedanke arbeiten -- 
  Kapitel -- 
  treffen unser jung Freund Dorfen Tauber -- 
  Umweg -- Eltern besuchen -- Knabe zwölf zufälligerweis Nürnberg kommen inständig Bitte Meister Albrecht Lehre bringen -- Nürnberg weitläufig verwandte unterstützen -- 
  Eltern -- Bauer -- Nachricht bekommen -- 
  -- Wäldchen stehen -- Dorfe liegen -- 
  Spielplatz -- still Einsamkeit Abends voll nachdenken wandeln -- Schatten dicht zusammenwuchs rote sinkend Sonne tief unten Baumstämme äugelen zuckend Strahl spielen -- 
  Trieb entzünden -- betreten Wald Empfindung heilig Tempel treten -- 
  Lieblingsbaum -- trennen -- suchen Emsigkeit -- 
  dick Eich ausgebreitet Zweig -- Kühlung Schatten geben -- 
  finden Baum rasen Fuße weich frisch -- ehemals -- 
  vieler Gefühl Kindheit erinnern Stelle -- wünschen -- krausen Wipfel sitzen weit Land hineinzuschauen -- Sehnsucht Vogel nachgesehn -- Zweig Zweig springen dunkelgrün Blatt scherzen -- Haus rückkehren -- ewig froh Leben glänzend Stunde angeschien -- frisch Luft einatmet Gesang zurückgaben -- Abend Morgenrot sehen -- Schule streng Lehrer -- 
  fallen -- vormals denken -- kindisch Begriff Empfindung gehen vorüber reichten Hand hießen herzlich willkommen -- heftig Innerst erschrak -- alt Baume stehen denk empfind -- Mensch -- 
  zwischenliegenden -- vermocht -- fallen Augenblick stehen Knabe -- Kindheit liegen nah -- nah -- übrig vorbeifliegend Traum halten -- 
  Wind rauschen herüb Äste Baum -- Gefühl -- fernst dunkelsen Erinnerung herübergewehen Vorhang fallen Franzen Seele lieb Vergangenheit -- 
  frommen Empfindung Eltern -- Unterricht Buch geben -- Spielzeug fallen Zärtlichkeit leblos Gestalt -- 
  -- selber schaun langsam -- 
  -- Vergangenheit lebendig innere aufsteigen -- 
  -- Eltern -- fast -- -- vergessen -- 
  -- Kunst teuersen Gefühl verhärten -- 
  -- Trieb beschäftigen -- vorbaut Aussicht übrig Leben verdecken -- 
  stehen Gedanke malerstub Albrecht Kopie kommen Gedanke -- setzen Freund Sebastian hören schnell -- sprechen -- Natur -- Himmel -- rauschend Wald Lieblingsbaum scheinen Atem Leben Gemälde herzugeben -- Vergangenheit Zukunft bekräftigt Trieb denken empfinden -- wert -- Kunstlieb führen -- 
  schnell Schritt Baum scheinen nachrufen -- Busch treten Erscheinung hervor zurückhalten -- taumelt Erinnerung -- verlieren Labyrinth seltsam Empfindung -- 
  frei Platz Walde -- plötzlich stehen still -- 
  wussen -- inne halten verweilte nachdenken -- 
  -- besinnen -- leiben -- unaussprechlich teuer -- Blume Grase nicken freundlich Erinnerung helfen -- 
  -- gewißlich -- selber -- suchen emsig glänzend Bild -- schwarz Wolke innerst Seele zurückhalten -- 
  einemmal brach Träne Auge -- hört Feld herüber einsam Schalmeie Schäfer -- wussten -- 
  Knabe Walde gehen -- Platz Blume suchen -- Wagen fahren halten still -- Frau steigen heben Kind herunter -- gehen grün Platz Franz vorüber -- 
  Kind -- lieblich blond Mädchen -- Franz bitten Blume -- schenken -- Lieblinge zurückzubehalten -- indes alt Bedienter Waldhorne bleisen -- Ton hervorbracht -- jung Franz äußerst wunderbar Ohr klingen -- 
  verging -- Franz vergessen -- fuhren fremde fort -- erwacht Entzück gewöhnlich Empfindung -- gewöhnlich Spiel -- gewöhnlich Leben hinüber -- 
  klingen holden Waldhornstöne Existenz hinein -- stehen Mond hold Angesicht Kind -- Blume schenken -- Schlummer Hand ausstrecken -- dünken -- erhielen Mädchen -- 
  Liebe Holde entlehnt Bild -- schön -- tragen Gestalt hinüber -- engeln hören -- glauben kennen -- -- überzeugen -- Feldblumen einst Erkennungszeichen -- 
  deutlich denken -- Einfiel -- lang gänzlich vergessen -- setzen grün Gras nieder weinen -- drückt heiß Gesicht Boden küßen Zärtlichkeit Blume stehen -- 
  hören Trunkenheit Melodie Waldhorns -- Wehmut -- Schmerz Erinnerung süßen ungewiss Hoffnung fassen -- 
  wahnsinnig -- törichn Herz -- rufen -- 
  unsichtbar Hand fahren zärtlich grausam Sait innere hinweg -- scheucht Traum Wundergestalte -- Seufzer Träne verklungen Lied fern Hinterhalte hervor -- 
  O Geist -- fühlen -- streben Überirdischem -- Mensch gönnen -- 
  magnetisch Gewalt ziehen unsichtbar Himmel Herz bewegen Ahnung durcheinander -- längst ausgeweint Freude -- unmöglich Wonn -- Hoffnung -- Erfüllung zugeben -- 
  Mensch -- Bruder klagen -- Gemüt zugerichten -- Wort verstehen -- 
  gebrechen Kraft -- übrig Mensch verleihen -- Leben notwendig bleiben -- matte selber Gewinn -- Mut verzehren -- wünschen Kenne -- 
  Jakob sehen Traum Himmelsleiter Engel -- hinaufsteig -- glänzend Paradies schauen -- Schlaf Glied bezwungen -- sehen hören -- Ahne hoffe lieben -- Traumgestalt -- 
  schlagen Glock Dorfe -- 
  stehen trocknet Auge -- -- Hütte Kirche grün Laub zuschimmern -- 
  Garten vorbei -- Zaun Herüber Hing Zweig voll rot schön Kirsche -- 
  unterlassen -- abzubrech kosten -- Frucht Baumes Kindheit erfreuet -- Zweig -- freundlich entgegenstreckten -- Frucht schmecken -- 
  Kindheit Mensch blanken -- glänzend -- vielfarbig Früchte süß lieblich Geschmack anlocken -- Leben liebzugewinnen -- Schulmeister Schule -- Süßigkeit Kind Lust lernen beibringen -- nachher verlieren Mensch froh Vorgefühl Leben -- Lockungen gewohnt abstumpfen -- 
  Franz Kirchhof lesen Kreuze vorbeigehen schnell -- Name Vater Mutter anschreiben -- fühlen zuversichtlich -- 
  Mauer Turms -- beengt -- Haus Eltern kennen -- 
  zittert Tür anfaßte -- gewöhnlich -- Tür öffnen -- 
  Stube sitzen Mutter verbunden Kopf weinen -- erkennen weinen heftig -- Vater liegen Bette krank -- 
  umarmt gepreßt Herzen -- erzählen -- -- sprechen durcheinander fragt -- wussen reden -- 
  Vater matt bleich -- 
  Franz vorstellen -- rühren zufrieden geben -- 
  alt Mann sprechen sterben -- Hoffnung Seligkeit -- fragt jung Franz -- Gott treu Anhing -- lehren -- 
  Franz drücken Hand -- 
  irdisch Leben suchen -- Ewigkeit -- 
  liegen Grenze -- Eurer Andacht stören -- gewiß Mühe geben -- Eitelkeit entfernen -- 
  Liebster Sohn -- Vater -- sehen -- Lehre verlieren gehen -- 
  arbeiten -- Sinn denken -- Leben -- Joch eingespennen -- hoch Auge verlieren -- 
  redlich Gewerbe -- ernähren -- laß Nahrung -- Bekleidung letzter Gedanke Deines Leben -- trachte irdisch Ruhm -- eitel -- bleiben -- Tod fordern -- 
  Mahl -- -- heilig Geschichte -- weltlich Gemüt Andacht erwecken -- 
  Franz aß Mittage -- alte scheinen Abend erholen -- 
  Mutter gewöhnen -- Franz -- seinetwegen -- vernachlässigt Vater beinahe -- 
  Franz unzufrieden -- kranke glühend Liebe gut Sohn zeigen -- letzter Stunde häufen -- lang Leben begleiten -- fühlen verworr Herz matt -- selber erschrak -- 
  denken tausend Gegenstand zerstreut -- vorzüglich Gemälde kranke -- trauernd Söhn wehklagend Mütter -- bittersen Vorwurf -- 
  Sonne Untergange neigen -- Mutter hinaus -- Garten -- entfernt -- Gemüse holen Abendmahlzeit -- 
  alte lassen Sohn Sessel Haustür tragen -- rot Abendstrahlen bescheinen lassen -- 
  stehen Regenbog Himmel -- Westen regnet Abend golden Strömen nieder -- 
  Schaf weideen -- Birke säuselten -- Vater scheinen stark -- 
  sterben gerne -- rufen -- Tod sehen -- 
  Franz antworten -- Sonne sinken tief scheinen alte feurig Gesicht -- wegwenden seufzen -- 
  Gott Auge blicken letzen strafen Lüge -- -- 
  vorüber -- Franz verstehen Wort -- glauben bemerken -- Vater Gedanke beunruhigen -- 
  -- hinuntersinken -- rufen alt -- hinunt lieb Gott Sonne -- 
  O schön herrlich Erde -- jenseits schön -- Gott Allmacht Bürge -- 
  Bleibe fromm -- Franz -- hören aufmerksam -- entdecken -- 
  Franz treten nah -- alt -- Sohn -- lieb Kind -- -- 
  Mutter -- Ferne hören -- lauter Stimme geistlich Lied singen -- alte brechen schnell sprechen gleichgültig Ding -- 
  -- heimlich Franz -- -- 
  Herde kommen Feld Schnitter -- fröhlich -- Franz Gedanke versinken -- betrachten alt Verhältnis selber -- Gespräch anfangen -- letzter Wort vermeintlich Vater schallt Ohr -- erwartet Ungeduld -- 
  finst -- alt hineingetragen -- legen nieder schlafen -- Franz aß Mutter -- 
  plötzlich hört Atemzug Vater -- eilen hinzu verschieden -- 
  sehen stumm -- Brigitte weinen -- 
  -- 
  sterben Abschied nehmen -- seufzend -- Priester Einsegnung entschlafen -- -- 
  -- weit Erde sprechen -- Mund stumm -- 
  Leid klagen -- sagen Baum blühen -- Frucht abnehmen -- -- 
  -- 
  alt Vater -- vorbei unser Umgang -- unser abendgesprächen -- -- finden -- 
  sanft -- 
  Träne machen stumm -- Franz trösten -- 
  Gedanke betend Einsiedler -- verehrungswürdig Märtyrer -- leiden arm Menschheit gehen mannigfaltig Bild Geist vorüber -- 
  Sachtes Kapitel -- 
  leich alte liegen Kammer Stroh ausbreiten -- Franz stehen sinnend Tür -- 
  Nachbar treten Herzu trösteen -- Brigitte weinen neu -- sprechen -- Herz -- Auge vertrocknen -- tausend Bild ziehen Sinn -- selber verstehen -- sprechen -- wünschen Sebastian herbei -- klagen -- 
  Begräbnis -- Brigitte weinen klagen laut Grab Erde zudecken -- genau -- fast einzig lieben -- 
  wünschen sterben -- Gesellschaft -- Gespräch fortsetzen -- abbrechen -- 
  Franz schweifen indes Feld umh -- betrachtet Baum benachbart Teich spiegelten -- 
  Landschaft Vergnügen beschauen -- vergönnen -- mannigfaltig Farbe Schattierung -- Süß Ruhe -- Wirkung Baumschlag Natur entdecken -- klar Wasser gewahr -- 
  ergötzt wunderbar Perspektive bilden -- Himmel Wolkenbilder -- zart blaue -- kraus Figur zitternd Laube schwamm -- 
  Franz ziehen Schreibtafel hervor -- Landschaft anfangen zeichnen -- wirklich Natur erscheinen trock Abbildung Wasser -- strich Papier genügen -- nachbildeten -- -- 
  kommen Landschaft zeichnen -- notwendig Zugabe historisch Bild ansehen -- empfinden -- leblos Natur Vollendet ausmachen können -- Darstellung würdig -- 
  Unbefriedigt Hütte Pflegevater -- 
  Mutter entgegen -- ungewohnt Einsamkeit lassen wussten -- 
  setzen Bank Haus stehen -- unterredeen mancherlei Ding -- 
  Franz Gegenstand -- jeder Wort hören -- niedergeschlag -- weidend Herde -- ziehend Ton Winde Baum -- frisch Gras sanft Hügel wecken Poesie Seele -- 
  Vater Mutter verlieren -- Freund verlassen -- verwaist verachten -- Land -- Kunst sprechen -- fast Mut Leben verlassen -- 
  Mutter Hand -- 
  Sohn -- weit Welt hineingeh -- raten tun -- bringen Gewinn -- 
  Fremde tun Mensch -- Haus gehören -- blühen Wohlfahrt -- fremd Mensch -- Vaterland -- weg Deutschland verlassen -- indessen anfangen -- 
  malen unsicher Brot -- selber -- alt grau -- Jugend vergehen -- mußt obenein Flüchtling Land wandern -- 
  Bleibe -- Sohn -- sieh -- Feld Zustande -- Garten einrichten -- Hauswesen Ackerbaues annehmen -- helfen -- führst sicher ruhig Leben -- weißen dein Unterhalt hernimmst -- 
  heiraen -- finden Gelegenheit -- lernst -- Arbeit Vater fortsetzen -- 
  sagen -- Sohn -- 
  Franz schweigen Weile still -- Vorschlag überlegen -- Vorstellung schwer Seele fallen -- haftet -- 
  liegen Herr Zeuner neu Gedanke -- Gesellschaft -- fühlt Beängstigung -- erleiden -- 
  -- lieb Mutter -- -- 
  Seht -- Gelegenheit Reise warten -- kommen -- Hand lassen -- 
  ängstlich sorgsam Geld -- habhaft -- sammeln -- Dürer sagen -- aufgäbe -- 
  Mutter Antwort betrüben -- weichherzig -- 
  suchst Welt -- Sohn -- 
  -- heftig antreiben ungewiss Glück erproben -- 
  Feldbau Schöne -- Gott frei Welt hantieren stark gesund -- 
  Liebe könntest -- glücklich -- Kommst -- essen Frau ernährst Kind ziehest lieben Ehre -- 
  zeitlich Wesen -- gewiß -- Zukunft ungewiß -- 
  Franz -- herzlich Freude Brot essen -- selber ziehen -- Wein trinken -- Pferd Kühen Haus -- Woche arbeiten Sonntags rasen -- 
  Sinn stehen Ferne -- liebst Eltern -- gehst Unglück verliersen gewiß -- Gesundheit -- 
  -- lieb Mutter -- rufen Franz -- verstehen sagen -- 
  -- Leinwand nehmen Farbe minder Geschicklichkeit aufzutragen -- täglich Unterhalt erwerben -- sehen -- Stunde sogar sündhaft -- beginnen -- 
  denken Erwerb niemals Kunst denken -- selber hassen zuweilen verfallen -- 
  -- zärtlich -- lieben -- lieb Hantierung -- 
  vergönnen -- Meister sehen Ferne verehren -- Name gehören -- 
  erleben -- beständig Bild sehen -- lernen -- Meister hören -- ungekannt Gegende feilch Herz streifen -- kein ruhig Leben genießen -- 
  tausend Stimme rufen herzstärkend Ferne -- ziehend Vogel Haupt wegfliegen -- scheinen Boten Ferne -- Wolke erinnern Reise -- Gedanke -- Pulsschlag treiben vorwärts -- junge ruhig sitzen Wachstum Getreide abwarten -- Einzäunung Garten besorg Rüben pflanzen -- 
  -- lassen Sinn -- bitte reden -- qualten -- 
  -- Brigitte halb Unwille -- wissen Gereuet -- hierher wünschest -- ist_es spät -- teuer schätzest schmähst Verachtest -- 
  fragen -- lieb Mutter -- fahren Franz fort -- 
  Vater sterben Rechenschaft geben -- Sohn -- brechen -- 
  wissen Herkunft -- 
  -- Franz -- Mutter -- Vater anvertrauen -- 
  kennen lernt Heiratet -- warst -- alt -- -- einzig Kind verstorben Frau seisen -- 
  verwundre -- Mann sprechen -- 
  Franz bleiben Herkunft Ungewißheit -- Gedanke beschäftigt -- Stunde verdrießlich traurig -- 
  Erntefest indes herangekommen -- Leute Dorfe fröhlich -- bedacht vergnügen -- Kind hüpfen umh erwarten -- 
  Franz vornehmen Einsamkeit zuzubringen -- Gedanke beschäftigen -- Fröhlichkeit übrig Mensch bekümmern -- 
  Woche -- Pflegevater zubrachen -- versinken -- Freude -- -- ereignen -- vorher vermuten -- 
  Erntefest erhalten Brief Sebastian -- vorher ausmachen schreiben -- Dorfe -- 
  lang Winternächte trüb Frühlingstag starr Erde -- erheitern Franzen Gemüt Brief Hand halten -- plötzlich Freund Sebastian selber anrühren -- Arm fliegen -- Mut -- fühlen verlassen -- Erbrach Siegel -- 
  erstaunt Freute gleich -- drinnen anderer Schreiben Albrecht Dürer finden -- erwarten -- 
  ungewiß -- Brief lesen -- schlagen Sebastian Brief auseinander folgendermaßen lauten -- Liebster Franz -- 
  -- gedenken unser Gespräch -- kurz entfernt -- dünken -- 
  Haus schicken fügen -- leer eng -- sagen ändern -- 
  schön traurig Kornfelder zurückgehen -- Stelle betreten gehen -- Stadt nähern -- o Franz -- sagen Herz empfinden -- 
  Leben taub Reiz -- vorher niemals glauben -- leiben -- 
  Stunde geiz -- unbeseh ungenossen verschwenden te -- -- 
  Hand nehmen erinnern -- Palette -- Pinsel -- wehmütig -- begreifen zugehen -- 
  Stadt hineinkommen -- gewohnt Treppe unser Haus hinaufstieg -- liegen stehen früh verlassen -- Träne enthalten -- weich -- 
  halte hart vernünftig -- Franz -- nennen -- -- äußern -- 
  verdrießlich -- maulen -- -- wünschen Staffelei -- Porträt -- -- weg -- gelingen Zug -- spüren mindeste Lust Malen -- 
  Meister Dürer betrübt gewöhnlich -- Haus still -- fühlen -- Abreise Epoche unser Leben anfehen -- 
  Schmidt besuchen -- Bursch -- lachen -- freuen -- 
  Unermüdet zusehen -- wundert Male langsam Stelle gehen -- 
  setzen nachher selber nieder zeichnen paar Verzierung -- ziemlich geraten -- reut Schmiedehandwerk erlernen Malerei legen -- 
  Meister Dürer meinen -- anfingen -- selber halb halb entschließen -- 
  Nürnberg verlassen -- sprechen loben -- 
  deiner Empfindung regieren zernichen lässn -- tun weh -- Überspannung rauben Kraft Entschluß -- sagen -- Suchst -- 
  mußt zornig -- Mensch einrichten -- 
  streben Härter -- ruhig Leben führen -- Leben -- arbeit Strom wechselnd Empfindung -- notwendig stören -- abhalten -- 
  Leb -- schreiben fleißig -- fremd -- geschehen -- 
  Teil denken fühlst -- überzeugen -- beständig mitempfindend Herz schlagen -- Ton Deinigen beantworten -- 
  -- 
  währen sehen -- 
  traurig jedesmal Stunde vorkommen -- Lebhaftigkeit denken -- schrecklich leer Richtigkeit Trennung Innerst fühlen -- 
  menschlich Leben dürftig Sache -- Glanz Schatten -- erdfarben Firnis vertragen -- 
  Adieu -- 
  Gott -- 
  -- -- Brief wackeren Albrecht Dürer lauten -- Schüler Freund -- 
  -- Gott fallen -- leben -- Zwischenraum gänzlich trennen -- 
  Abwechselungen Leben -- kommen -- denken schreiben -- 
  Liebe -- herzlichsten Wunsch Weg geben -- allmächtig Gott leit Schritt -- 
  Bleibe Redlichkeit treu -- Freude Leben überstehen -- mancherlei leiden suchen Irre -- 
  freuen -- Kunst fleißig denksen -- vertrauen -- übermütig selber -- 
  Zag überfällen -- Jugend -- eher schlimm Zeichen -- 
  Wunderbares darinnen -- Maler übrig Mensch hineingehören -- treiben Geschäftigkeit -- Welthandel Ereignis Stelle rücken -- übrig Handwerker Fall -- befällen Einsamkeit kunstlos Mensch -- schier Mut verlassen -- 
  einzig Wort plötzlich hören -- Stande -- schaffend wirkend Kraft zurückzuliefern -- Gott Segen obendrein -- Großherzigkeit Arbeit -- 
  -- 
  menschlich Geschäftigkeit laufen Grund hinaus -- sagen -- Mensch unnütz -- nützlich -- 
  Erde Glück einrichten -- Platz finden -- Klein -- Vornehm Geringe -- 
  jünger ergehen -- gut Stunde -- 
  Wärst Anlage Talent -- Würdest leer Herz niemals empfinden -- 
  weib lassen grüßen -- 
  Bleibe Wahrheit treu -- Hauptsache -- 
  fromm Empfindung -- schön -- leiten -- Vernunft regieren lassen -- 
  eigentlich -- gewiß wahrlich fromm andächtig -- -- dürftest Falsch Herz aufnehmen -- selber hintergingen -- unvermerkt Mangel wahr Frömmigkeit entstehen -- 
  sagen -- tadeln -- geschehen -- gut Mensch dergleichen bemerken -- Gott Unsterblichkeit Rührung froh Erhebung Seele denken -- weichherziger Zerknirschung erhaben Mutigkeit -- Zustand Weichlichkeit verfallen -- tröstend wahr Andacht verlassen -- Kleinsinn überlassen bleiben -- 
  sagen -- gelten -- -- herzlich -- verfallen könntest -- Gedanke hegst -- warm brünstig Seele Bibel lesen heilig Geschichte -- gewißlich Maler -- einst stolz -- 
  Suche sehen -- betracht Kunstsache genau -- gewöhnen Sicherheit arbeiten erfinden -- Vortrefflich Erkennst -- dasjenig -- Tadel zugeben dürfen -- 
  Freund Sebastian melancholischer Mensch reisen -- denk geben Woche verstrichen -- 
  Gehabe -- denken fleißig -- -- -- 
  Franzen Geist ergießen Heiterkeit Stärke -- fühlen Mut Kraft -- 
  albrechts Stimme berührt Hand stärkend Gottheit -- fühlen Ader Gehalt künftig arbeitreich Leben -- 
  alt längst vergessen Buch aufschlagen -- Belehrung unerwartet Trost leiden antrifft -- kommen Zeit Gedanke Franzen Seele -- alt Entwürfe neu gefielen -- 
  -- -- Brief zusammenfalten -- sorgfältig Schreibtafel legen -- -- wissen Meister halten -- verzagen -- 
  folgend -- Erntefest feiern -- 
  Franz Widerwillen froh aufgeregt Menschengetümmel -- suchen Freude -- Fest zugegen -- 
  erinnern gut Kupferstiche Albrecht Dürer -- tanzend Bauer darstellen -- überaus fallen -- suchen Klang Flöt possierlich Gestalt -- finden -- Gelegenheit bemerken -- Natur Albrecht Zeichnung legen wissen -- 
  Fest schön warm -- Sturm unangenehm Winde freundlich Engel zurückhalten -- 
  Ton Flöt Hörner gehen lieblich Schar ruhig ungestört sanft Luft -- 
  Freude Wiese allgemein -- tanzend Paar -- scherzt neckt jung Bauer Liebst -- schwatzt alte erinnern Jugend -- 
  Gebüsch stehen still frisch grün überaus anmutig -- Ferne liegen krause Hügel Obstbäume bekränzen -- 
  -- Franz -- suchen Schüler Meister Gemälde -- wissen niemals suchen müßen -- 
  fallen -- Staffelei unbefangen Haufen niederzusetzen -- Natur darstellen -- 
  abgerissen Fragment alt Historie Göttergeschichte -- weder Schmerz Freude erregen -- kalt Figur Legende -- ansprechen -- Maler heiligen Mann selber -- Begeisterung arbeiten -- 
  Gestalt wörtlich Abänderung niedergeschrieben -- lernen -- schön -- Erquickung einfach Natürlichkeit verbergen liegen -- 
  schweifen weit Ferne -- staubbedeckt unkenntlich Vorzeit herum -- ergötzen -- 
  Erde Darstellung wert -- 
  Vorwelt malen -- 
  groß Geist hoch Ehrfurcht Herz hineinbannen -- euer Stück ernst feierlich Stimme anreden -- hold Strahl weltlichen Freude Gemälde herausbrechen -- 
  frei herzlich Stunde Bäuerlein -- Spiel Ergötzung lieben -- 
  Anblick Bild ält klüg -- kindisch Fröhlicher -- 
  streiten Franz selber -- unterhieln Geist Kunst -- arbeiten -- 
  begegnen -- wobei Malerei denken -- Art -- Beschäftigung Natur Mensch hören -- wiederzufinden -- 
  Antwort -- nirgends treffen Lücke -- Einsamkeit Kunst -- Gesellschaft sitzen -- führen still Gespräch -- -- Welt bemerken -- einfältigeren Gemüter geläufig -- weshalb geschehen -- beschränkt Leute unverständig albern halten -- 
  bemerken Entging -- Wahrheit Feinheit Witz setzen Mensch erstaunen -- 
  Franz Sternbald -- wissen sagen erwachsen Kind -- kindisch erwachsene -- 
  O -- Auge verhüllen -- Torheit Armseligkeit Mensch -- lieb Unbefangenheit ergeben -- 
  Seliges Leben Mensch leben -- übrig umh Innere einzudring vermögen -- beherrschen -- 
  Meister -- Winter beständig Sommer hineinscheinen -- vergessen -- Mensch -- Geist Opfer bringen -- Herz Opfer Altar weltlich Eitelkeit niederlegen -- 
  leiben -- Franz Sternbald -- -- Jugend Seele -- Geschichte schreiben -- litt beseligen -- 
  Abend -- rot Schimmer bebend Gebüschen hing -- Empfindung sanft schön -- 
  wiederholen Brief Dürer Gedanke -- zeichnen schön Abendwolken Gedächtnisse -- 
  Garten Laube frisch Bauermädch setzen -- lebhaft sprechen -- 
  liegen Abendrot Wang -- -- -- küßen -- schön -- 
  fragen -- Reise gedächen -- erstemal ungern Reise sprechen -- 
  Italien -- fragt unwissend Gertrud -- 
  O -- Franz -- Stadt -- Dorf -- Berg liegen Italien -- 
  währen -- ehe -- 
  müßen -- fragt Gertrud -- 
  -- -- antworten -- denken lernen Malerkunst -- 
  alt Gebäude -- vortrefflich Mann besuchen -- erfahren -- ehe Meister halten -- 
  -- 
  denken -- Franz -- währen -- -- längst vergessen -- Freund verwandte sterben -- Burschen Mädchen fröhlich singen -- alt Kind -- 
  Menschenleben -- Kürze Leben betrübt Verwandlung vorgehen -- 
  Gertrud Eltern abgerufen -- Haus -- Franz bleiben Laube -- 
  freilich -- -- Schöne -- ruhig leben -- früh still Land aufsuchen einheimisch -- 
  Ruhe gönnen -- tun -- -- 
  alt -- wissen selber -- 
  Siebend Kapitel -- 
  fast Ankunft Dorfen Franz Arbeit vornehmen -- nämlich Geringeres -- Geburtsort Gemälde hinterlassen -- 
  Gedanke Verkündigung Geburt Christi liegen Sinn -- bilden -- malen fleißig -- 
  fehlt Seelenruh -- Brief schildern -- betäuben -- bildend Kraft erlag Umstand -- 
  fühlen lebhaft -- -- glücklich Minute kühn edl Kunstwerk entwerfen -- nachher unermüdet Emsigkeit -- ermattenden Reiz Neuheit durchführen -- 
  mitten Arbeit verzweifelt Vollendung -- unbeendigt stehen lassen -- Dürer Brief Kraft Erquickung schenken -- 
  endigen schnell -- erwarten -- 
  Leser -- Bild Franzen beschreiben -- 
  dunkl Abendrot liegen fern Berg -- Sonne untergegangen -- bleichrot Schein liegen alt jung Hirt Herde -- Frau Mädchen -- Kind spielen Lämmer -- 
  Ferne gehen Engel hoch Korn -- erleuchtet Glanze Landschaft -- 
  Hirt sehen still Sehnsucht -- Kind streckten Hand Engel -- Angesicht Mädchen stehen Rosenrotem Schimmer -- fern Strahl Himmlischen erleuchten -- 
  jung Hirte umgewenden -- verschränkt arme tiefsinnig Gesicht untergegangen Sonne -- Freude Welt -- Glanz Tag -- anmutig erquickend Strahl verschwinden sein -- alt Hirte fassen Arm umdrehen -- Freudigkeit zeigen Morgenwert herschriten -- 
  Franz untergegangen Sonne -- gleichsam neuaufgehende darstellen -- alt Hirte jungen beruhigen -- sagen -- 
  -- selig nunmehr sterben -- Herr sterben -- -- 
  zart trostreich fromm Sinn Franz vernünftig fühlend Beschauer Gemälde bringen suchen -- 
  vollenden -- stehen nachdenkend still Werk -- 
  Empfand wunderbar Beklemmung gewohnen -- ängstigter -- teuer Werk -- mehrere Woche vieler Liebe arbeiten -- Abschied nehmen -- 
  glänzend Bild Begeisterung Arbeit Seele gänzlich hinweggelöschen -- fühlen trüb leer Inneren -- Entwurfe -- Bild ausfüllen -- 
  -- selber -- unser lebend Freund scheiden -- befreundet Licht Seele Abschied nehmen -- 
  gleichen Lebenslauf Spiel -- unaufhörlich verlieren -- halb verrückt stets neue einsetzen kostbar -- niemals Gewinn austauschen -- 
  wunderbar -- Geist treiben -- innerer Entzückung Werk Hand offenbaren -- -- vollenden -- unser Fleiß selber erkennen -- 
  Malergerät stehen unordentlich Bild herum -- Sonne scheinen glänzend frischaufgetragen Firnis -- hören taktmäßig Klappe Dreschflegel Scheuer -- Ferne Vieh Anger brüllen -- Dorfglock bescheiden Schläg Tag -- Tätigkeit -- menschlich Arbeit Augenblick seltsam -- lächelnd Hütte verlassen -- geliebt Walde zueilten -- innerer Verwirrung erholen -- 
  Walde legen Gras nieder -- weit Himmel -- überblickt Lebenslauf -- schämen tun -- 
  betrachten jeder Werk Künstler Monument -- schön Stunde Existenz widmen -- jeder weh himmlisch Geist -- bildend Sinn Entzückunge bringen -- Farbe -- Schatten sprechen hervor -- 
  alt -- rufen -- gescheh Rede würdig -- fühlen Trieb -- Mutlosigkeit -- frisch tätig Geist Lehrer verleihen -- Beginn zaghaft -- Bildung Spur zagend Geist tragen -- 
  kehrt Abend -- la Pflegemutter fromm Gesänge alt Buch -- Kindheit lieben -- 
  fromm Gedanke Ahnung reden -- betrachten sinnend rund Tisch Furchen Narbe -- finden Figur manchmal Abend heimlich Messer eingeritzen -- lächelen Versuch Zeichenkunst -- 
  Mutter -- alt Brigitte -- künftig Sonntage gemäld Kirche aufstellen -- müßn Gottesdienst versäumen -- 
  gewiß -- Sohn -- antworten alt -- Bild sonderlich Erbauung dienen -- Altargemälde erkennen -- erwecken Rührung ansehen -- 
  sagen -- alt Bild -- 
  vergehen -- lieb Mutter -- antworten Franz seufzend -- übrig Welt -- 
  -- Spur jetzig Meister antrifft -- unerbittlich -- unkünstlich Hand Denkmale auslöschen -- 
  schlimm -- Brigitte -- mühselig Arbeit vergeblich -- unterscheiden Kunst -- nennst -- Gewerbe Erde -- 
  Mann -- Altarblatt abnehmen -- gewiß gefreut -- Arbeit fertig -- meinen -- umsonst -- vergessen -- vergeblich arbeiten -- 
  irdisch Tätigkeit -- antworten Franz -- Seele Unsterblichkeit schaffen -- Gedanke Gott Höchste -- lernen Leben Ewigkeit -- folgen -- 
  schön Kunstwerk hervorbringen -- unvergänglich -- 
  Sonntage Franz Arbeitsleuten früh Kirche -- 
  alt Bild -- Franz wischen Staub -- betrachten vieler Rührung -- 
  stellen Kreuzigung -- Figur verlosch -- eins Gemälde -- Öl arbeiten -- Kopf hart -- Gewänder steif -- Zettel Sprüche gehen Mund Person heraus -- 
  Sternbald bemühen -- Name Meister entdecken -- vergebens -- sorgt -- Bild weggeworfen -- verschließen Schrank Kirche -- künftig Kunstfreund alt Überbleibsel wiederfinden können -- 
  Gemälde befestigen -- Glocke fing erstenmal ruhig Dorf läuten -- Bauer Bäuerinn Stube -- besorgen emsig festlich Anzug -- 
  hören Arbeiter -- schön Heiterer glänzt Dach -- alt Weide stehen ruhig See -- Wind rühren -- 
  Franz Wiese Kirchhofe liegen -- ziehen ruhig heit Luft -- stillentzückend Gedanke regiert Geist -- 
  Walde -- empfinden seltsam Beklemmung -- Augenblick glauben -- merkwürdig -- verflog ungewisse Ahnung Seele -- zuweilen nächtlich Mensch wandeln -- Schein morgens schnell entfliehen -- 
  Gemälde beschäftigen -- Fremd kennen -- 
  Seele Künstler wunderlich Träumerei befangen -- Gegenstand Natur -- bewegen Blume -- ziehend Wolke Erinnerung -- Wink Zukunft -- 
  Heereszug Luftgestalt wandeln Sinn -- übrig Mensch Eingang antreffen -- Geist Dichter ewig bewegt Strom -- murmelnd Melodie Augenblick schweigen -- Hauch rühren lassen Spur -- Lichtstrahl spiegeln -- bedürfen lästig Materie wenigsen -- hängen meisten selber -- Mondschimmer Abendrot Bild kleid -- unsichtbar Harfen nie_gehörte Ton locken -- Engel zart Geist herniedergleiten -- Hörer Bruder grüßen -- himmlisch Gruß vernimmen irdisch Geschäft greifen -- selber -- 
  beklemmt Zustand Künstler liegen Wink nie_betretene Bahn -- Geist Liede folgen -- ungekannt Ferne herübertönen -- 
  Ängstlichkeit Vorgefühl unendlich Mannigfaltigkeit Kunst -- Künstler glauben -- leiden -- Unglück Freude ahnden -- 
  Glocke letztenmal läuten -- Kirche anfüllen -- Sternbald Mutter gewöhnlich Platz einnehmen -- 
  Franz stellen Mitte Kirche Orgelspiel Gesang heben -- Kirchtür Fransen -- Gesäusel Baum tönen Herein -- 
  Franz Andacht verlieren -- Gesang ziehen Wog Kirche -- ernst Ton Orgel schwollen majestätisch herauf -- sprechen melodisch Sturmwind Hörer herab -- Auge gesang Bild richten -- 
  Franz erstaunt Schönheit rührend Bedeutsamkeit Figur -- seinigen -- empfinden Ehrfurcht -- andächtig Schauer Gemälde -- 
  scheinen -- Orgeltön Farbengebilde bewegt spräch mitsäng -- fern Engel nah kommen -- Zweifel -- Bangigkeit Strahl Gemüte hinwegleuchtet -- Empfand unaussprechlich Wonne Gedanke Christ -- 
  Bild gleiten Blick grün Kirchhofe Türe -- -- Baum Gesträuch außerhalb Frömmigkeit beten -- umarmend Andacht ruhen -- 
  Gräber scheinen leis Stimme Abgeschieden herauszusing -- Geisterstimm ernst Orgeltön nachzueilen -- Baum jenseits Kirchhof stehen betrübt einsam heben Zweig gefaltet Hand empor -- freundlich legt Fenster Sonnenstrahl Kirche hinein -- 
  unförmlich steinern Bild Mauer stumm -- fliegend Kind Orgel verziern -- scheinen Unschuld Leier spielen -- Herr -- Schöpfer Welt loben -- 
  Sternbald Gemüt unaussprechlich Seligkeit anfüllen -- Empfand erstenmal harmonisch Einklang Kraft Gefühl -- ergriff beschirmt Geist Welt regieren Ordnung halten -- gestehen deutlich -- Andacht hoch rein Kunstgenuß -- menschlich Seele schönsen erhabenst Stunde fähig -- 
  Welt -- mannigfaltigst Begebenheite -- Unglück Glück -- nieder hoch -- scheinen Augenblick zusammenzufließen -- Kunstmäßig Ebenmaße ordnen -- 
  Träne fließen Auge -- -- Welt -- zufrieden -- 
  Nürnberg Franz Erquickung -- Getümmel Markt -- verworren geräuschvoll Leben still Kirche retten -- gestehen -- Pfeiler -- erhaben Chor betrachten Gewühl vergessen -- empfund heilig Einsamkeit jeder Gemüt wirken müssen -- rein -- erhaben Entzückung nossen -- 
  Orgel schweigen -- vernehmen Ferne Wiese Schnaube Pferd schnellrollend Wagen -- 
  Franz heben Auge -- Augenblick eilt Fuhrwerk Kirche vorüber -- Rad fahren -- Wagen fallen -- alt Mann jung Frauenzimmer stürzen herab -- 
  Franz eilen sogleich hinaus -- jung Mädchen aufrichten unbeschädigen -- Mann scheinen Fall betäuben -- erholen -- 
  Franz erschrocken geschäftig fremde bedienen -- Fuhrmann richten indessen Wagen -- 
  Fremde betrachten unser Freund aufmerksam -- scheinen erschrocken -- bitten -- erholen -- 
  wusste sagen -- blau Auge Mädchen begegnen -- errötet -- alt Mann still -- 
  Stande -- Franz ängstigen -- fortfahren -- gehen nah Baum -- Kirche tönt Gesang entgegen -- 
  steigen fremde -- jung Maler fühlen Herz heftig klopfen -- schön Mädchen danken -- fliegen Wagen fort -- 
  -- Gestalt undeutlich Fuhrwerk unterscheiden -- 
  nahn fern Gebüsch -- Wagen verschwinden -- betäuben -- 
  erwacht -- Grase gestehen -- zierlich Brieftasch liegen -- 
  schnell -- entfernen -- Zweifel -- fremde gehören müssen -- 
  unmöglich Wagen nachzueilen -- fragen -- wohin wenden -- wus Name reisend -- Frauenzimmer Tochter Gattin Mannes -- 
  beunruhigen -- Brieftasch Hand halten -- 
  müssen behalten -- teuer -- wagen eröffnen -- eilt geliebt Walde -- setzen Platz nieder teuer -- zitternd Hand -- Auge fallen -- Gebind wild vertrocknet Blume -- 
  blicken -- besann -- Traum können -- zurückhalten -- küßen Blume weinen heftig -- innerlich ertönt Gesang Waldhorns -- Kindheit gehören -- 
  Genius -- schützend Engel -- rufen -- Vorübergegang finden -- zufrieden geben -- 
  Platze Blume wachsen -- vierzehn Sommer indessen Erde gehen -- Platz halten teuer Geschenk Hand -- 
  O wiedersehen -- 
  Zufall -- begegnen -- 
  Stunde -- Leben Mensch gewaltsam schnell Anlauf nehmen -- Blüte plötzlich aufbrechen verändern Mensch -- 
  Sternbald -- erholen -- wünschen -- dürstet wunderbar Begebenheite -- Zukunft glänzend Blumenfeld -- genügt Freude -- unzufrieden -- fühlen überselig -- 
  enthalten Taschenbuch -- woraus Name Aufenthalt geliebter erfahren -- 
  Seite stehen -- -- Antwerpe schön Bild Luka leiden sehen -- dicht -- -- -- unbeschreiblich schön Kruzifix Albert Dürer -- -- 
  küssen Blatt wiederholtenmahlen -- Empfindung bemeistern -- 
  seltsam erfreulich -- Engelsgestalt -- fernab Traum Kindheit sehen -- Dürer verehren genau kennen -- Schüler Freund -- 
  Schicksal scheinen wunderbar Konzert -- sinnen -- Entzück müde -- 
  Kapitel -- 
  Franz Sebastian Begebenheiten schreiben merkwürdig -- verfloss Aufenthalt Geburtsort widmen -- besuchen Platz -- Kindheit -- Abschied Mutter -- 
  Weg -- schreiben Sebastian folgend Brief -- 
  Liebster Bruder -- 
  manchmal fragen groß Ungewißheit -- -- plötzlich Zutun seltsam Labyrinth verwickeln -- 
  Eltern nehmen -- wissen angehören -- Freund verlassen -- glänzend Engel Freund rechnen -- vorbeifliegend Schattenbild wahrnehmen -- 
  treten Verwicklung Weg -- übrig Mensch einfach Lebenslauf fortsetzen -- -- 
  glauben manchmal -- schäm Gedankens -- Kunst Glücke genügen dürfen -- hoch Stufe kommen -- 
  sagen Vertrauen -- lieb Sebastian -- antworten -- -- legst Palette Pinsel weg -- suchst gewöhnlich Tätigkeit Mensch nützlich Brot erwerben -- 
  täte -- dergleich Gedanke fallen Last -- 
  trübselig -- menschlich Leben unendlich scheinend Verwicklung armseligst Mechanismus umgetrieben -- kümmerlich Sorge setzen Bewegung -- meister dünken rechts -- Beweggrund heftig ängstlich Tätigkeit setzen -- 
  wissen Äußerung ansehen -- fühlen -- notwendig Fleiß Mensch -- -- Edel nennen -- 
  Mensch Künstler sein -- Kunst verständ -- rein Gemüt befleck Gewühl Leben abängstigen dürfen -- sein gewiß viele glücklich -- 
  Freiheit Ruhe wahrhaftig groß Seligkeit -- 
  beglücken müssen Künstler fühlen -- reinsten Empfindung Geschöpf darstellen unternähme -- 
  -- erhabene wagen -- falsch Enthusiasmus -- Kleinigkeit Spielwerk schließen -- Bahn finden -- herrlich Erscheinung wandeln dürfen -- 
  Mensch abgetrieben -- Mühseligkeite -- Neid -- Eigennutz -- Plan -- Sorge verfolgen -- Herz -- Kunst Poesie -- Himmel Natur Göttliches ansehen -- 
  Brust Andacht Erdensorg vermischen -- glauben klüg -- vertausch Jämmerlichkeit -- 
  siehst -- führ alt Klage -- Unrecht -- 
  sehen alt -- wünschen -- 
  Sebastian -- manchmal unaussprechlich Furcht selber -- empfind Beschränktheit -- wünschen -- Gefühl verlieren -- Seele verweben scheinen -- eigentlichst ausmachen -- 
  denken ändern -- sterben Solltest -- 
  --- Stolz Festigkeit -- 
  vorwärts -- weichherzig Kind bleiben -- -- 
  glauben fast -- Geist leichtesn untersinkt verlieren -- blöde bescheiden betrachten -- kalt Vertrauen Altar Göttin hinzutreen -- dreist Gabe fordern -- drängen unwürdige -- tragen Besseren Sieg -- 
  manchmal lachen -- Welt ernsthaft betrachten -- Sinn -- -- Schwing Seele ereilen Tracht -- wonach Hand ausstrecken -- 
  wohin führen Liebe -- Verehrung Künstler Werk -- 
  Meister kaltblütig Staffelei setzen -- gewöhnlich Albrecht arbeiten -- Werk Lauf lassen -- überzeugen -- müssen dünken -- 
  Wanderung bringen wunderbar Stimmung hervor -- 
  Dorfen -- sehen Nebel fern Berg liegen -- matte Schimmer bewegen Dunst -- Wald Berg treten plötzlich Schleier hervor -- 
  sehen Wagen Wanderer Straße forteilen -- fern Turm Stadt Ziel -- wonach mannigfaltig Richtung streben -- 
  befind Haufen -- übrig wissen -- vorüber kenn -- unsichtbar Geist verschieden Interesse beherrschen -- beneiden bemitleiden auf Geratewohl -- 
  denken mannigfaltig Weg Wald -- Berg -- Strom vorüber -- reisend umsehen -- Heimat Fremde fühlen -- umherschauen Bruder Seele suchen -- finden -- Wald Stadt -- bergüb Strom vorbei Reise finden -- 
  suchen -- Unglücklichst -- Kunst leben verlernen -- Leben bestehen -- hoffen -- suchen -- Augenblick -- aufgeben -- Augenblick unser Tod -- 
  -- wahrhaft Elend hinsterben wissen empfinden -- woran Leben verlieren -- 
  suchen erwarten -- Entzückung Verehrung Herrlichkeit Busen bewahren -- schön Wahnsinn schön Leben -- 
  Vernünftige Berauscht betrachten -- furchtsam verachtend Weg -- -- Gegend Blick durchwanderen -- 
  schau Osten Westen entdecken -- ängstig -- Nähe -- wissen -- 
  sehen -- sprechen -- verlangen Wort ausdrücken -- wüs sagen -- plötzlich wiederfänden -- 
  sagen Empfindung -- wissen -- dein Freund lächelst -- 
  -- spotten Solltest -- -- 
  reizend Zug denken -- heilig Unschuld Auge -- zart Wang -- -- Gemälde -- treu -- einfach jetzig Gestalt besitzen -- 
  Tod Trennung bejammern -- süßen Zug -- sanft Linie beweinen -- vertilgen -- ungeschickt Künstler Bild verderben -- schön ausarbeiten -- 
  sehen -- -- -- 
  Lied alt Minnesänger -- wissen -- erinnerst -- 
  Wohlauf gehen vielgrün Wald -- stehen rot frisch -- Entlade bangen Sorge sehen Lied fröhlich Zweig schallen -- 
  blitzen funkeln Sonnenschein grün Gebüsch hinein munt zwitschern Vögelein -- 
  -- gehen nimmer vielgrün Wald -- Lied süß Nachtigall schallen -- Träne sehnen Bewegt bange -- strebend Brust -- Walde -- Walde wohnen Lust -- 
  Sonnenschein hüpfend Vögelein Marter Pein -- 
  einst finden Frühling grünend Tal -- blüht duftet Rose zumal -- waldesgrün Erschiene eichenforst wild süß Gebilde -- 
  blitzt Sonnenschein -- singen Vögelein rufen Geliebte -- 
  Frühling Hand Hand -- Weste küßten Gewand Füßen süßen Viol Primeln hingekniet still vorüberziehen -- gehen Ton -- Stimme wach -- 
  treffen wundersüß Blick -- woher -- wohin golden Glück -- 
  schön -- Ton -- rauschend Baum -- golden Traum -- 
  Eichengrund -- 
  Grüßt süß Mund -- 
  tot -- gesund -- 
  schwand alt Sorge kehren -- treffen Maid -- schön grünen stets Hain -- 
  Liebe süß Küs -- 
  Glänzendschönst Zier Wohne stets -- vielgrünen Walde -- 
  hinaus Morgenlicht süß Liebe -- Baum herab Schrie laut Herab -- weinen klagen laut -- nimm Braut -- Morgenschein Vögelein -- Angst Pein -- 
  suchen -- bergwärts -- talwärts -- fremd Strom fließen -- -- liebend bang Herz Nimmer finden Gegenwart süßen -- Einsam bleiben Wald Winter kalt -- Vöglein -- Sonnenschein Flohen Walde -- 
  Sommer fliegen nieder -- Oftmals Zug Vögel -- Wald Grün kleiden -- Niemal süß Maid -- 
  -- 
  -- 
  trägst grausam Neid -- 
  -- fremd Ungekannter wissen -- entgegen -- Jugend gewich -- schön Wang erblichen -- hinab Eichengrund Kenne rot Mund -- 
  O Leide Fremde -- 
  kennen wandern -- 
  Jüngling -- wandle munt Wald hinunter -- mag_es -- Treulieb -- entgegen Ziehet Blühet Knospe Frühling -- 
  niemals treff verloren Jugend -- Sonnenschein Nachtigall Hain Qual Pein -- 
  find kindisch Ausdruck Reimen -- 
  einst vielgrün Wald abgestorben -- 
  Gedicht niederschreiben -- fühlen -- Dichter entstehen -- 
  vermagst Wesen innerst Herz bewegen -- aussprechen -- 
  neulich Kupferstich unser Albert sehen -- Abwesenheit -- Zeichnung neu -- 
  kennen -- lesend Einsiedler -- 
  -- 
  kennen Stube -- Tisch rund Scheibe -- Dürer Bild Wohnung abschreiben -- 
  rund Scheibe betrachten -- Sonnenschein Täfelung Decke zeichnen -- eremit sitzen Dürer Tisch -- 
  schön -- Meister frommen Vorliebe nahe umgibt -- Nachwelt Konterfei Zimmer geben -- bedeutend -- Zug Andacht Einsamkeit ausdrücken -- 
  gehen Weg Kapelle hinein verweil -- Gemäld Zeichnung betrachten -- 
  Unerfahrenheit -- Vorliebe Alter -- sehen selten schlecht Bild -- ehe Fehler entdecken -- sehen Vorzug -- 
  gemeiniglich jung Künstler entgegengesetzt Gemütsart finden -- wissen Tadel -- 
  fromm Ehrfurcht unser treuherzig Vorfahr -- zuweilen schön erhaben Gedanke weniger Umstand ausdrücken -- 
  Brief schließen -- 
  Möge Himmel teuer Albert gesund erhalten -- 
  Brief dürfen ernst Sinn schwerlich fallen -- 
  Laß Nachricht bekannte hören -- 
  fern Liebe Ungekannt Nacht Schatten -- -- wozu -- bleiben vaterländisch Matt -- 
  süß Flötenstimmus Rufen golden Stern -- Woge schwimmen -- Liebe -- Ferne -- 
  Bild knietesen -- gibst -- Sinn glühtest -- Schatten erlabst -- Geist Zukunft denken -- Entzück Kunst nennen -- Morgenrot lachen -- abgewanden -- -- Verzagen fort scheuchen -- männlich wagen -- Ziel einst erreichen -- 
  Kette sprungen -- frei Geist -- Knechtschaft kühn entschwung Wollust-Ozean -- 
  Rückwärt fliehen zage Bangen -- Muse reichen Hand -- Führen sicher verlangen Gotter Himmelsland -- 
  O Kunst Liebe Sterbliche messen -- -- 
  scheuvermählt Trieb Künstler vergessen -- 
  ungeschickt Zeile gestern angenehm Walde dichten -- Seele hingewandt -- erröten -- -- Sebastian -- niederzuschreiben -- Gedanke Seele verheimlichen -- -- 
  Leb -- -- 
  Buch -- 
  Kapitel -- 
  wandeln Geist gut alt -- besuchen Künstler Held -- vergessen -- 
  hören les Meister -- niederländisch Kunst berühmt machten -- Lukas Leiden -- Engelbrecht -- Johann Mabuse -- übrig -- Freude euer Werk betrachten -- meister vorübergehen -- 
  Geist Leser willig Zeit folgen -- kindlich Vorliebe betren -- 
  jetzig Welt trennen -- nahe liegen -- Mensch Kleinste wichtig -- 
  liebend Empfindung mitteilen Feder Hand -- alt Buch aufschlagen lassen -- Blick geliebt Bildnissen fest halten -- Zug mine alt Meister Gedächtnisse einpragen -- 
  hndern ungeduldig Blatt verlassen -- Sinn Begebenheite hingeben -- fast berühren -- 
  widme unbedeutend Geschichte jung Seele -- Liebe selber beschäftigen -- Strome weltbegebenheite hingegeben -- Innigkeit Gestalt innerer Phantasie ergötzen -- ungern wirklich Welt Träumen stören -- 
  -- -- d Kunst entzücken -- Trieb spüret -- euer Herz Meisterwerken Held Vorzeit entgegendrängen -- euer Vaterland lieben -- voreilig Enthusiasmus -- Vorsatz -- euer Bruder verdammen -- -- euer Geist großscheinend Gegenstand zurückziehen -- Kleinigkeit Liebe betrachten -- schreiben -- 
  red Gedanke -- glauben verstehen -- Dünkel fremd -- groß Geist menschlich Natur gebären -- hinausschwingen -- 
  Buch weihen Tröst -- glauben -- irgendwo -- gerne zuhören -- 
  Mittag Franz Sternbald frei Feld Baume sitzen Stadt Leiden betrachten -- liegen -- 
  früh ausgewandert -- zeitig erreichen -- ruht -- wunderbar -- Stadt -- weltberühmt -- hoch Türm Bild stehen -- öft Bild sehen -- 
  Figur Vordergrund Prospekt stellen -- selber zeichnen malen liegen Baume -- Auge Stadt wenden -- 
  Leben erscheinen Traumgesicht -- Mühe Gegenständen umgaben überzeugen -- 
  Bild -- Versammlung Mensch getreu lebhaft Phantasie aufbewahren neu hinstell -- Augenblick ungewiß -- umgeben -- Schöpfung Einbildung -- 
  halten Schreibtafel Hand -- Grase liegen fremd gefunden -- 
  Umriß Kopfe entwerfen -- ausstrich -- Ähnlichkeit liegen scheinen -- Gesicht fremd Mädchen vorstellen -- Phantasie unaufhörlich beschäftigen -- 
  rufen Umstand -- jeder Wort sprechen -- Gedanke -- lieblich Mine -- süßlachend Mund -- unaussprechlich Grazie Bewegung -- ziehen Gedächtnis -- fühlen entfremden -- entfernt -- ewig geschied -- hell -- funkelnd Gras -- klar Wasser trübe melancholisch -- blüht duftet weniger verwelkt Blume -- süß Zärtlichkeit betrachten -- lehnen Stamm Baum Zweig Blatt rauschen lispeln -- Trost zusprechen -- dunkel Prophezeiung Zukunft sagen -- 
  Franz hören aufmerksam Ton verständ -- Natur reden Kläng fremd Sprache -- fühlen Bedeutsamkeit Wort -- merken wunderbar Akzent -- 
  hören zeichnen -- strich Ausdruck -- betrachtet Turm Stadt -- Schieferdäch Sonne hell glänzen -- 
  Straße betreten -- selber -- Lukas sehen -- Albrecht Dürer vieler Liebe sprechen -- Kind Künstler -- Name sechzehnten kennen -- 
  sprechen hören lernen -- neust Werk sehen -- sagen bewundre -- schämen dürfen -- Auge treten -- 
  dennoch tun -- Künstler nennen -- -- schäm trefflich Manne -- 
  stehen eilig nähert schnell Schritt Stadt -- stehen nah Tor -- Leute eingehen -- fremd Taschenbuch vermissen -- merken -- aufsteh Baume liegen lassen -- erschrak heftig -- schnelleren Schritt -- 
  Baum entfernen -- Auge wiederfinden -- laufen Atem -- 
  entdeckt Ferne -- bemerken Wanderleute Stelle scheinen -- 
  Angst -- Baum erreichen möchten -- beschreiben -- überzeugen Taschenbuch nimmermehr zurückgeben finden -- 
  -- Schreibtafel liegen Grase -- heben eilig -- werfen nieder Baum -- betrachten küssen -- Wanderer gehen vorbei umzusehn -- 
  Franz fühlen Herz heftig schlagen -- Schweiß fließen Stirn hinab -- froh Tafel erstenmal finden -- rühren Innig -- beinahe verlieren -- 
  Wanderer beinahe Auge verschwinden -- beschließen Baume -- leiben -- ruhen -- Mittagshitze vorüber -- 
  bemerken Schlief -- Stille -- lieblich Geräusch Blatt -- Gewässer Entfernung -- luden -- 
  hören leis Schlummer hinein -- dünkt Wiese gehen fremd Blume stehen -- sehen -- 
  Blume Feldblumen gewachsen tragen -- frisch -- verdunkelt Farbe Glanz übrig -- 
  Franz grämt Schönheit -- pflücken -- Wiese -- Laube sitzend -- Lehrer Albert Dürer wahrnehmen -- winken scheinen -- 
  schnell hinzu -- nah -- bemerken deutlich -- Albrecht emsig Gemälde arbeiten -- Kopf fremde -- Gesicht sprechen ähnlich -- 
  Franz wissen Lehrer sagen -- Auge Gemälde hingeheften -- -- Verlegenheit Aufmerksamkeit lächeln anfingen -- 
  nachdachen -- dunkel Walde übrig verschwinden -- lieblich Stimme rufen Name -- Gebüsch herausfinden -- Wald grün Dunkler -- Sebastian Stimme Stimme Fremden deutlich -- rufen Ängstlichkeit -- Gefahr befände -- 
  fürchten -- dichen Baum Gebüsch kommen entsetzlich -- zagen -- wünschen frei hell Feld antreffen -- 
  Mondschein -- 
  Schimmer erregen -- klingen silbern Wipfel süß Getön nieder -- Furcht verschwinden -- Wald brennen Sanft schönsen Glanze -- Nachtigalle wach -- fliegen dicht vorüber -- singen süß Kehl -- bleiben Tackt Musik Mondschein -- 
  Franz fühlt Herz öffnen -- Klaus Felsen Waldbruder wahrnehmen -- andächtig Auge Himmel aufhieben Hand falten -- 
  Franz treten nah -- Hörst lieblich Orgel Natur spielen -- Einsiedel -- ben tun -- 
  Franz Anblicke hingerissen -- Tafel Palette malen unbemerkt Eremit -- Andacht -- Wald Mondschimmer -- gelingen sogar -- begreifen -- Ton Nachtigall Gemälde hineinzubringen -- 
  Freude empfinden -- -- Bild fertig -- sogleich Dürer zurückzureisen -- sehen beurteilen mögen -- 
  Augenblick verlassen Lust malen -- Farbe erlosch Finger -- Frost überfiel -- wünschen Wald verlassen -- 
  Franz erwachen unangenehm Empfindung -- letzter warm Herbst -- Sonne dunkelrot Wolke Stadt -- kalt Herbstwind streichen Wiese -- 
  Franz Stadt -- Traum liegen stets Gedanke -- schön mondglänzend Wald -- Eremit -- Stimme Freund tönt Ohr -- 
  Gedrängen Tore -- eilt Feld -- benachbart Dorf Stadt -- beobachtet mannigfaltig Gesicht -- hören einzeln abgerissen Gespräch Name nennen -- kurz Geschichte Sprechende erfahren -- 
  Stadt -- Empfand seltsam -- fremd Ort -- unbekannt Mensch -- schweifen -- Mond stehen hell Himmel scheinen Dächer Kirche frei Platz -- kehrt Herberge -- 
  Franz fühlen müde Bette -- einschlafen -- 
  Scheibe Mond stehen Kammerfenster -- betrachten sehnsüchtig Auge -- suchen glänzend Runde -- Flecken Berg Wald -- scheinen erhaben Türme entdecken -- See segelnden Schiff -- -- -- rufen innerlich Stimme Brust -- Heimat Wunsch -- lieb Haus -- wohnen Glück -- herab scheinen nieder -- sehen wehmütig -- -- 
  verschließen Auge -- erscheinen Fremde Reiz -- winken -- liegen schön Dunkler Lindengang blühen -- süßest Duft verbreiten -- 
  hinein -- folgen Schüchter -- Blume -- erzählen -- 
  umfing zart arme -- Mond Glanze nah -- scheinen hell Angesicht -- gestand Liebe -- unaussprechlich glücklich -- 
  -- Traum setzen Franz fort -- frühsen Erinnerung Kinderjahr kommen -- schön Empfindung einst -- ziehen vorbei begrüßen -- 
  Schlaf Ausruhn schön Welt -- Seele Schauplatze hinwegwenden -- eilen unbekannt magisch -- lieblich Licht spielen -- leiden erscheinen -- dehnen Geist Flügel auseinander fühlen himmlisch Freiheit -- Unbegrenztheit nirgends beengen qualten -- 
  erwachen sehen voreilig Verachtung schönern -- Traum Tageslebe hineinweben -- fortgefahren Menschentätigkeit Abend aufhören -- Bahn wandeln -- 
  erkundigt Franz glühend Gesicht Wohnung berühmt Luka leiden -- 
  benet Straße Haus -- hochschlagend Herzen -- 
  ansehnlich Haus führen -- Magd -- Herr Malerstube befinden arbeiten -- 
  Franz bitten -- hineinführen -- 
  Tür öffnen -- Franz -- freundlichen -- ziemlich jung Mann Gemälde sitzen -- fleißig arbeiten -- stehen hingen vielerlei Schildereie -- Farbenkast -- Zeichnung Anatomie -- Ordnung -- 
  Maler stehen Franse entgegen -- Schüler Auge Gesicht berühmt Meister -- vermögen Verwirrung Wort hervorzubringen -- 
  fassen -- nennen Name Name Lehrer -- 
  Lukas heißen Herzen willkommen -- setzen Werkstatt nieder -- Franz erzählt Reise -- sprechen merkwürdig Gemälde unterwegs antreffen -- 
  beschaut Sprech aufmerksam Bild -- Lukas arbeiten -- heilig Familie -- treffen darinnen viel Dürerschen Arbeit -- Fleiß -- Genauigkeit ausmalen -- scheinen Lukas Bild Dürer streng Zeichnung fehlen -- dünken -- sein Umris dreist sicher ziehen -- Lukas Lieblich anmutige Wendung Gestalt -- Färbung -- Dürer mangelen -- 
  Geist -- glauben -- müsst Künstler nahe verwandt -- Simplizität Zusammensetzung -- Verschmähung unnütz Nebenwerk -- rührend echt deutsch Behandlung Gesicht Leidenschaft -- Streben Wahrheit -- 
  Lukas Gespräch munter -- fröhlich Mann -- Auge lebhaft -- schnellveränderlich Mine begleitet erklären jeder Wort -- 
  Franz betrachten -- Einbildung denken -- -- stark -- ernsthaft Mann erwarten -- -- behend -- fast kränklich Figur -- Rede Geprag lustig frei Gemüt tragen -- 
  freuen ungemein kennen lernen -- rufen Lukas Lebhaftigkeit -- Ding wünschen euer Meister sehen -- wissen Erfreulicheres begegnen -- taten -- Werkstatt hereinträn -- Mensch Welt neugierig -- halten groß Künstler Zeit hervorbringen -- 
  fleißig -- 
  arbeiten fast -- antworten Franz -- kennen größeres Vergnügen Arbeit -- 
  Emsigkeit -- manchmal Gesundheit Schaden tun -- 
  glauben -- antworten Lukas -- zeugen Kupferstiche fast unbegreiflich Sorgfalt -- ausgehen lassen -- 
  Sauberes sehen Arbeit -- leiden Fleiße Wahrheit eigentlich Ausdruck Darstellung niemals -- Emsigkeit bloß zufällig Zier -- Wesen Sache -- 
  begreif mannigfaltig Art Arbeit -- klein fein Gemälde lebensgroß Bild -- Holzstich -- Kupferarbeit -- sauber Figur Holz erhaben Arbeit geschnitten -- zierlich -- trotz Vollendung Arbeit vergessen -- mühselig Stunde denken -- Künstler zubringen -- 
  wahrlich Albert äußerst wunderbar Mann -- halten Schüler glücklich -- vergönnen -- Auge Laufbahn eröffnen -- 
  Franz rühren -- Lehrer Rede -- Lob -- Verehrung Meister Munde Künstler setzen Herz gewalsam Bewegung -- 
  drücken Luka Hand -- Träne -- glauben -- Meister -- glücklich schätzen -- Dürer Haus betreten -- 
  seltsam Sache fleiße -- fahren Lukas fort -- treiben Nacht Arbeit -- manchmal Stunde -- Minute reuen -- Stube zubringen -- 
  Jugend -- Spiele -- Erzählung -- dergleich zeitvertreibend Ding Gefallen finden -- 
  neu Bild liegen manchmal Sinn -- schlafen -- 
  wissen groß Freude -- Gemälde -- arbeiten -- Stande bringen -- fertig -- Gedanke ruht -- Bild merken -- Hand geübt dreister -- einstellen -- anfangs Mühe erringen erkämpfen müssen -- 
  O Sternbald -- manchmal Stundenlang schwatzen -- Maler -- hoffen -- -- 
  glücklich Mann -- antworten Franz -- 
  Künstler Wert bewußt -- Zuversicht Werk -- gewohnen Element gehorch -- 
  Meister -- sagen -- 
  fassen -- Drang edel Kunst empfinden -- Geist unaufhörlich antreiben -- Welt -- seltsam fremdest Gegenstand sogar Malerei sprechen -- hoch Begeisterung steigen -- tief sinken Mut -- Ausführung -- 
  -- Übung wiederholt Fleiß scheu -- Stolz -- Vortrefflichst hervorzubring Tadel zulassen dürfen -- Angst -- Scheu -- Anbetung nennen -- beider Kunst Gegenstand -- darstellen Unternehme -- 
  erlauben -- Lukas -- sprechen -- Bild malen -- 
  ziehen Staffelei herbei vermischt Farbe Palette auftragen -- 
  -- Geschwatz stören -- Franz -- Arbeit äußerst kunstreich -- 
  -- Lukas -- tun Gefallen fahren fort -- 
  -- Franz -- Tat unser Erlöser Herrlichkeit denken -- Apostel -- Verehrungswürdigen sehen -- umgaben -- göttlich Milde lehren sprechen -- heilig Mann christlich Kirche denken -- kühn Mut Leben Freude verachtet -- hingeben übrig Mensch Sehnsucht -- Wunsch ablocken -- innerst Bekenntnis Herzens -- Bewußtsein Wahrheit behaupten -- mitteilen -- -- erhaben Gestalt himmlisch Glorie sehen -- bedenk -- einzeln auserwählter gönnen -- voll Gefühl -- Held Sohn Gott eigentümlicher Gestalt Farbe übrig Mensch offenbaren -- Werk Hand schwach Geister Offenbahrung mitteilen -- Entzückung herrlich Gemälde erinnern -- sehen -- entschwinden Mut -- wagen -- auserwählt Geister zuzurechnen arbeiten -- fleißig -- verlieren leeres untätig Staun -- 
  brav -- Meister Lukas -- Bild aufzusehen -- fügen -- Mut bekommen -- 
  Lehrer -- fahren Franz fort -- tadeln -- niemals helfen -- Kindheit -- 
  Nürnberg -- Gegenwart teuer Albrecht -- Freund -- bekannt Gerät umgeben -- aufrecht erhalten -- 
  lernt Gewohnheit -- Pinsel führen -- fühlen -- Ort betreten -- Mensch aufmunteren -- gebahnt Straße ausgehen -- rechts links umzusehn -- 
  freilich Erzählung hören -- verständig Mann kennen lernen Irre -- finden zurecht -- 
  Abreise Nürnberg ändern -- 
  innerlich Bild vermehren Schritt tun -- Baum -- Landschaft -- Wandersmann -- Aufgang Sonne Untergang -- Kirche besuch -- Gesang hören -- wirken quälend schön Geschäftigkeit Busen -- Landschaft -- heilig Geschichte -- einzeln Gestalt darstellen -- Farbe genügen -- Abwechslung mannigfaltig -- fühlen Edle Werk anderer Meister -- Gemüt nunmehr verwirrt -- unterstehen -- selber Arbeit -- 
  Lukas halten Weile malen inne betrachtet Sternbald aufmerksam -- Rede erhitzen -- -- Freund -- glauben unrecht Weg -- 
  euer Verfassung ziemlich vorstellen -- niemals Gemütsstimmung -- 
  frühst Jugend heftig Trieb empfinden bilden -- Künstler -- liegen Nachahmung klar Sinn -- zweifelhaft zögert -- Zeichnung -- 
  Arbeit liegen anderer Entwurf deutlich kopfe -- schnell unverzagt vorig ausführt -- zahlreich Werk entstehen -- alt -- euer Zag -- euer Verehrung Gegenstand -- dünken -- Unkünstlerisch -- Maler -- malen -- beginnen Endigen -- euer Entzückung Tafel tragen -- 
  -- müßen Anlage Poet -- Dichter Ruhe arbeiten -- 
  -- Erlaubt -- sagen -- 
  jeh Künstler wundern -- Wallfahrten Italien -- gelobt Land Kunst anstellen -- -- erzählen -- billig verwundern -- 
  Eure verderben -- 
  Eurer Reizbarkeit Gegenstand erblicken -- zerstreuen -- groß Mannigfaltigkeit euer Kraft niederschlagen -- verschieden Richtung suchen -- Richtung genügend -- 
  -- Künstler Italien schätzen lieben -- sagen -- jeder Land Kunst -- -- -- 
  Meister treten Fußstapfen -- verbessern mangelhaft -- schwer -- -- vaterländisch Kunst hoch Vortrefflichkeit hingeführen -- 
  Italiener -- Italiener nimmermehr deutsch empfinden -- 
  raten -- stellen euer Reise Italien bleiben vaterlande -- -- 
  meint -- Italischen Bild deutsch Auge sehen -- 
  Italiener Kraft Vortrefflichkeit Eure Albert Dürer jemals erkennen -- wiederstrebend Natur niemals Mittelpunkt vereinigen -- 
  hingehen -- jeder Gemälde -- Manier Lust erwecken -- ewig Abwechslung arbeiten -- niemals üben -- Italiener -- deutsche bleiben -- streben -- Mutlosigkeit Verzagtheit stark -- ergreifen -- 
  finden Ausspruch hart -- wert -- wünschen euer Bestes -- 
  Glaube -- Künstler -- -- ruhig Geist überlassen -- unermüden fleißig -- 
  sehen euer Albert Dürer -- Italien -- -- kurz Aufenthalt Venedig Rechnung bringen -- denken leisten -- 
  Meister Niederlanden Italien sehen -- einheimisch Natur Kunst ziehen -- mittelmäßig -- fremd Manier nachahmen -- nimmermehr gelingen -- erzwungene herauskommen -- stehen -- Gegend ausnimmt -- 
  Sternbald -- gewiß Antik -- verstehen -- Fach wahr nordisch Natur -- erreichen -- wahrer lieblich ausdrücken -- Künstler -- 
  Ziel wonach streben -- gewiß poetisch Zweck vorstellen -- 
  Franz Leben niederschlagen -- 
  glauben empfind Verdienst -- Verehrung Kunst -- Begier Italien Werk sehen -- einzig Verdienst halten -- vernichtet verehrungswürdig Meister gänzlich -- 
  erstenmal erscheinen Beginn töricht unnütz -- 
  -- Meister -- rufen -- beinahe überzeugen -- Künstler verdorben -- euer Vortrefflichkeit fühlen -- stark empfind Unwert -- führen verloren Leben -- vernünftig Tätigkeit hinaufranken -- unglückselig Trieb eingehauchen -- nützen -- Freude verbittern -- köstlichst Gericht Leben Albernes Nüchternes zuzubereiten -- 
  meinen -- Lukas Lächeln -- freundlich Gesicht stehen -- Merk -- heftig Charakter entspringen -- freilich -- Mensch ändern -- 
  geben zufrieden -- Wort Wort einzeln Mann -- irren -- 
  -- Franz groß Lebhaftigkeit -- fühlen lebendig Herz -- sollten hören -- Verehrung Meister sprechen -- sollten Wissen vortrefflich vorkommen -- welcher Gewicht jeder Eurer Wort -- 
  Künstler messen -- 
  Stimme hören -- verdienen sitzen -- sprechen -- Freundschaft Güte erhalten -- 
  jung -- Lukas -- euer Wesen ungemein leiben -- Mensch -- meister betrachten Kunst Spielwerk -- Kind -- albern bleiben derlei Posse beschäftigen -- -- 
  lassen -- überdies müde malen -- 
  Kupferstich Eurem Albert erhalten -- unbekannt -- 
  heilig Hubertus -- Jagd Hirsch Kruzifixe Geweih begegnen -- Anblicke bekehren Lebensweise ändern -- 
  Seht hierher -- merkwürdig Blatt -- bloß schön Ausführung -- vorzüglich Gedanke halber liegen -- 
  Gegend Wald -- Dürer hoch Standpunkt annehmen -- weshalb Unverständiger tadeln -- dicht Wald -- Baum wahrnähmen -- natürlich Anblick Auge fallen dürfen -- nimmermehr Gefühl völlig Einsamkeit ausdrücken darstellen geschehen -- Auge breit übersehen -- einzeln Hügel lichen Waldgegende -- 
  glauben -- Leute -- gut Wille vernünftig Verstand -- gewählt Gegenstand Albernes tadeln dürfen -- Rittersmann unvernünftig Bestie knaten -- 
  -- aufrichtig Meinung sagen -- fällen groß Vergnügen reichen -- 
  unschuldige -- Fromme Lieblich Jagdmann knaten -- Hirschlein kindisch Physiognomie unbefangen drein sehen -- Kontrast heilig Ehrfurcht Mannes -- erwecken Gedande Gott Barmherzigkeit -- grausamen Vergnügen Jagd -- dergleichen -- 
  beobachten Art Ritter niederknaten -- wahr -- fromm rührendsen -- Zierlichkeit zeigen -- Bein Arm verschiedentlich stellen wissen -- Annehmlichkeit Figur gleichsam entschuldigen -- närrisch Bild Gegenstand -- 
  zierlich Maler vorkommen -- sowohl verschiedentlich Bild malen -- vielmehr Gegenstand brauchen Verschränkung Niedlichkeit zeigen -- putz edl Malerkunst -- frei Spiel -- Bahn gönnen -- 
  Hubertus beschaffen -- 
  zusammengelegt Bein -- Hinkniet -- gleichförmig aufgehoben Hand wahrste sehen -- spielend Anmut heutig Welt schätzen -- 
  Lukas sprechen mancherlei -- besucht Freund Stadt -- Franz Tische setzen -- 
  lachter erzählen -- Malerei sprechen -- 
  Kapitel -- 
  Franz halten lang leiden anfangs vornehmen -- Meister Lukas Konterfeie malen übergeben -- Franz Zufriedenheit beendigen -- 
  Kunst unterhalten -- 
  Franz lieben Lukas ungemein -- Stunde vertrauen fassen Lehrer -- fühlt Gegenwart demütigen -- freist Gedanke fesseln -- Lukas fröhlich Laune ängstigen -- Art freuen pflegen -- gänzlich verschieden -- 
  kämpft Verehrung -- niederländisch Meister empfinden -- scheinen Augenblick Handwerker -- hurtig erfinderisch Geist betrachten -- rastend Eifer -- lieb Vortrefflichen -- schämen Mißtrauen -- 
  Lukas Werkstelle besuchen -- -- erstaunen -- glich Freude -- -- Lehrer -- geschätzt Dürer niederländisch Maler sitzen -- 
  scheinen Blendwerk Auge -- Dürer stehen schließen herzlich Arm -- Maler überaus fröhlich sehen -- Frage Antwort durchkreuzten -- hindert lebhaft Luka Weise Gespräch -- still Ruhe -- fing neu Verwunder freuen -- 
  rieb Hand -- laufen Geschäftigkeit -- zeigen Albert Bild -- Frage worauf Antwort wissen -- 
  Franz bemerken -- lebhaft Unruhe Albert Gelassenheit -- still Art freuen -- schön kontrastieren -- 
  nebeneinander stehen ergötzt Franz gänzlich Verschiedenheit Künstler -- Werk berühren scheinen -- 
  Dürer schlank -- lieblich majestätisch fallen lockig Haar Schläfe -- Gesicht ehrwürdig freundlich -- Miene verändert Ausdruck langsam -- schön braun Auge sehen feurig Sanft Stirn hervor -- 
  Franz bemerken deutlich Umriß Albert Gesicht auffallend gleichen -- Erlöser Welt malen pflegen -- 
  Lukas erscheinen Albert -- Gesicht verändert Augenblick -- Auge lebhaft ausdrucksvoll -- hellbraun Haar liegen schlicht Kopf -- 
  Albert erzählen -- unpäßlich fühlen -- weit Reise Niederlanden scheuen -- Gesundheit herstellen -- 
  Hausfrau begleiten -- Sebastian unser Franz Brief -- selber gefährlich -- krank Reise unternehmen -- mitnehmen -- 
  sehen -- Meister Lukas -- -- vornehm Bewegungsgrund Reise -- wünschen -- wissen -- Maler besuch -- Wohnort Weg liegen -- kenn -- berühmt Meister Lukas merkwürdig -- 
  Lukas danken springen Stube -- voll Freude Albert Dürer -- 
  zeigen neu Bild -- Albert loben verständig -- 
  kupferstich Niederländer schenken -- Lukas suchen Vergeltung Blatt hervor -- Albrecht Hand -- 
  sehen -- -- Blatt -- Kupferstich erklären -- Konterfei Tüllen Eulenspiegel -- seltsam Mann Gedanke vorstellen -- 
  -- Gelehrsamkeit befassen -- Buch verachten -- Sitte Zucht zuwider verdammen -- mangeln -- gestehen -- ergötzen -- 
  Schalkheit Knechtes Eulenspiegel -- Streich geben kuriosen Gedanke Veranlassung -- ordentlich angetrieben fühlen -- seltsam Konterfei Kupfer bringen -- 
  Wacker ausrichten -- Albert Dürer -- danken höchlich euer Geschenk -- 
  berüchtigt Schalksknecht erschaffen -- gewißlich ausgeseh -- schielend Auge verdreht Nase drücken seltsam Gemüt vortrefflich -- Lippe Witz beissend -- herrlich andeuten -- erwünscht häßlich Gesicht verzerren zuwider -- vieler Kunst ausrichten wissen gerne beschauen -- Posschen Kerl ordentlich leiben gewinnen -- 
  Art Dankbarkeit -- Meister Lukas -- mühsam Kupfer bringen -- Schwänk herzlich lachen -- 
  -- verstehen Mensch Kunst -- Till Narrenstreichen freuen -- sogar lachen ernsthaft nehmen -- gefällt Buch -- Unedles -- Bekenntnis ablegen -- fehlen Übung Possierliche verstehen fassen -- gewöhm -- Gemälde sehen ehe eins richtig Urteil fassen -- 
  -- Meister -- antwortet Dürer -- meister Leute wahrlich Ernsthaft Lächerliche fremd -- 
  glauben -- Verständnis müssen Zutun -- allerwenigst Fall -- 
  überlassen Rohheit Augenblick damalig Gefühl -- tadeln loben unbesehen -- 
  malerkunst -- kosten -- Gemüse Suppe kosten pflegen -- Magd Salz tun -- sprech Urteil -- Einsicht Kenntnis gehören -- besorgt -- 
  lachen denken -- -- 
  verstehen -- Anlage Natur -- fallen Poet -- 
  denken einfältig Sinn -- Vers müssen -- wunderen selber -- dichtkunst verfallen -- 
  zierlich Kupferblatt -- stach mühsam herum Vers zierlich Buchstabe -- 
  moralisch Gedicht vorstellen -- unterstehen -- Welt Lehre geben -- 
  fertig -- sehen -- erbärmlich geraten -- 
  leiden gelehrt Pirckheimer ausstehen -- Verwegenheit vergeben -- 
  -- 
  Schuster bleiben Leiste -- 
  Albert -- Pinsel Hand -- kommst verständig Mann -- Feder gebärdest Tor -- -- 
  sagen Kunst legen -- ansteh Esel Lautenschlag -- 
  müßt Leid aufhalten -- Lukas -- sprechen -- Ding euer Urteil vernehmen -- wissen Mensch Welt unterreden -- 
  bleiben gewiß -- antwortet Dürer -- Franz fortgezogen -- Reise vorsetzen -- Geld erübrigen -- Aufgespart -- 
  Gespräch mittagsstunde herangekommen -- jung hübsch Frau treten herein -- Weib Niederländer -- erinnern Mann freundlich Gesicht -- essen -- Gast Speisestub treten -- 
  folgen -- setzen Tisch -- 
  Hausfrau Albert Dürers heißen Franz Sternbald freundlich willkommen -- Franz liebenswürdig sehen -- Reise heit -- Gesicht blühend Voller -- 
  Lukas scheinen Tisch Platz -- wissen gutmütig essen Trinke einladen -- Einladung auszuschlag Stande -- erweisen überaus artig Dürer Frau -- wissen Art tausend Schmeicheleie sagen -- 
  Dürer ernst Unbeholfener -- schön jung Frau Lukas setzen eher Verlegenheit -- unterhalten -- Sitte ernst deutsch -- Scherz selber darbieten -- halten unnütz Mühe aufsuchen -- 
  Franz heilig Stimmung -- -- Auge geliebt Lehrer abwenden -- vollends beständig Sinn liegen -- früh abreisen müssen Dürer lang sehen können -- Reisegesellschaft finden -- Billig Antwerpe nehmen -- 
  müßn erlauben -- rufen Lukas fröhlich -- Meister Albrecht -- verzeihen -- vertraut tun -- Eurem Taufname nennen -- -- euer Konterfei abnehmen -- Reiset -- liegen besitzen -- treu fleißig malen -- Mühe geben -- 
  malen -- Albrecht -- gewiß euer Gesicht leiben -- ich_es Nürnberg nehmen -- 
  Wißt einrichten -- antworten Lukas -- 
  Malt euer Bildnis meinigen -- tauschen nachher -- besitzen -- Arbeit -- 
  -- Dürer -- wissen kopfe ziemlich Bescheid -- etlichemal malen gestochen -- Kopey ähnlich finden -- 
  worüber billig wundern -- fahren fort -- -- Meister Lukas jung -- Kunstsache Welt ausgehen lassen -- Name -- scheinen dreißig alt -- 
  Lukas -- 
  dreißig alt -- -- 
  -- fleißig malen -- fast Kupfer gestochen -- Albrecht früh anfangen -- wissen Kupferstecher -- 
  -- rufen Franz Sternbald voll Verwunderung -- glauben sechzehnn hätten euer Werk beginnen -- erstaunen erregen -- 
  -- erzählen Lukas -- zeichnen Bild allerhand natürlich Sache sprechen -- 
  Sprache Ausdruck Reißkohle scheinen natürlich Wirklich -- 
  unglaublich fleißig -- interessiert Welt -- übrig Wissenschaft -- Sprache dergleichen -- völlig gleichgütig -- verhassen -- Unterricht zuzubringen -- 
  zeichnen -- genau Ding -- Auge kommen -- nachher nachahmen -- 
  groß Freude -- Eltern Mensch Person erkannten kopieren -- 
  Spiel Vergnügen -- Knabe Last verachten Weg -- Beginn kindisch vorkommen -- verspottet -- nannt alt Mann -- 
  erkundigen -- Kupferstiche entständ -- geschickt Leute -- machen Kunst -- begreifen -- 
  Bild -- öffentlich herausgeben -- Leute Mißfiel -- taten Eltern inständig Bitte Meister Engelbrecht Lehre -- fahren fort arbeiten -- sechzehnn einigermaßen -- Werk suchen -- 
  wahres Wunderkind -- Meister Lukas -- Albert Dürer -- Art freilich erstaun -- Welt Arbeit sehen -- 
  -- Lukas lebhaft -- verdanken -- 
  Vorbild -- gabt neu Feuer -- manchmal Mut verlieren -- glauben -- eifrigsen Künstler Stunde -- hervorbringen -- selber ausruhen -- Arbeit Hand ordentlich widerstehen -- hören -- eins Eurer Kupferblätter -- Fleiß frisch Anmut -- 
  gestehen -- meister Erfindung danken -- wissen zugehen -- einzeln Figur Sache stehen klar Auge -- Zusammenfüg -- wahr historisch Zusammenhäng -- Bild fertig -- deutlich Sinn hinstell -- anderer Blatt Hande nehmen -- fallen darstellen -- hie verbessern -- Bild sehen -- entwickeln neu Seele -- eher Ruhe lassen -- fertig -- 
  liebsen euer Bild nachmachen -- Albrecht -- Sinn -- antreffen -- 
  meister Gedanke führen -- wissen -- meister Bild ausführen -- darstellen versuchen -- 
  manchmal Eitelkeit -- verzeiht freimütig Stolz -- gerad Mann -- euer Vorstellung verbessern Auge angenehm -- 
  wissen -- Albert gutmütigst Freundlichkeit -- versicheren -- lernen -- 
  Eurem Körper behend Gewandter -- Pinsel Grabstichel -- 
  wissen gewiß Anmut Wendung Stellung Körper euer Bild bringen -- fehlen -- Zeichnung Eurigen hart rauh aussehen -- erlauben sagen -- Geschien -- wären paarmal unnötigerweise wahr Einfalt Gegenstand abgewichen -- 
  gedenken paar kupferstiche -- vorne Leute Mäntel stehen -- Zuschauer Rücken zuwenden -- natürlich Angesicht zukehren -- 
  einfältig Urteil neue anbring Mantelfigur Kontrastierung übrig Person Bild verstärken -- zwingen heraus -- 
  -- Albert -- Lukas -- sehen schlau Kopf -- Münze geben wissen -- 
  öfter ertappen -- Bild verdorben -- euer Platte sehen -- 
  verlieren Gedanke Auge -- wahr gut -- putzen Bild herum -- Ding -- fremd Auge ansehen -- Papier Leinwand selber finden wissen -- 
  glücklich Erfindung Gebot stehen -- fast unmöglich Fehler fallen -- -- 
  -- Albrecht -- Gedanke -- Erfindung Eurem Kopfe -- 
  irren -- Albrecht -- erfindungsreich halten -- 
  Bild bloß Vorsatz entstehen -- zufällig Gelegenheit veranlaßen -- 
  Gemäld loben hören -- heilig Geschichte erzählen hören -- regen plötzlich -- neu Gelüst empfinden -- darstellen -- 
  eigentlich Erfinde gewiß selten -- wunderbar Gabe -- Unerhörtes hervorzubringen -- 
  erfinden scheinen -- gewöhnlich alt vorhanden Ding zusammengesetzen -- gewissermaßen neu -- eigentlich Erfinder setzen Geschichte Gemälde -- teils Erfahrung -- teils eingefallen -- erinnern -- lesen -- gehören -- Eins fassen -- 
  -- Lukas -- eigentlichst verstand Luft greifen gewiß Seltsamst Mensch begegnen -- 
  Art Verrückung -- Wahnsinnig erfinden Fieberträume -- 
  Natur einzig Erfinderin -- leihen Künsten Schatz -- ahmen Natur -- Begeisterung -- Ersinn -- Tracht Vortrefflichen -- Achtgebe Säugling -- Bewegung Mutter Auge lassen -- -- 
  Wißt -- Albrecht -- Schluß Bemerkung ziehen -- Sache -- Poet Maler -- Künstler darstellen -- Unnatürliche geben können -- Mensch allertollst Gedanke verfallen -- -- Darstellung Mitteilung fähig -- 
  Feld wahrhaft Unnatürlich hoch Mauer scheiden -- Blick dringen -- 
  Künstlerwerk Unnatürlichkeit -- Albernheit Unsinn -- wahrnehmen glauben -- gesund Vernunft Gefühl empören -- müssen rühren -- Sache ungehörig unvernünftig Art zusammensetzen sein -- Teil gemengt -- hineingehören -- übrig verbinden -- 
  müssen hoch Geist -- -- fehlerhaft -- Möglich Vortrefflich Würdig hervorbilden -- 
  Dürer nickt kopf Beifall -- Gespräch fortsetzen -- Lukas Frau ausraufen -- 
  lieben Leute -- hören euer gelehrt Gespräch -- Weiber Wort verstehen -- 
  sitzen ernsthaft Kirche -- versparen euer Wissenschaft Mittagsessen vorüber .-- schenken hierauf Glas Wein -- erkundigt Dürer -- Reise neue sehen gehören -- 
  Albrecht erzählen -- Franz Sternbald sitzen tief Gedanke -- 
  letzter Wort Lukas scheinen Schlüssel -- Auflösung Zweifel liegen -- Gedanke deutlich fassen -- Lehrmeister ähnlich Äußerung Kunst gehören -- Buch antreffen -- scheinen sogar -- Dürer Gedanke geben wert -- Folge bemerk -- liegen -- 
  jetzig Gespräch geben -- vorzüglich Niederländerin anfing Nürnberger Tracht verschieden Stände erkundigen -- Anzug Dürerschen Hausfrau kopf Fuß musteren -- 
  plötzlich springen Lukas Behendigkeit Tisch -- fallen Frau Hals -- rufen -- liebst Kind -- mußt vergönnen -- Meister Albrecht Malereikunst anfangen -- Frage einfallen -- 
  sünd -- Mann Haus -- Herz sprechen -- 
  Meinetweg halten -- antworten -- nürnbergisch Frau sagen -- 
  gewohnen -- Dürer Frau -- dergleich Tisch gewöhnlich Gespräch -- 
  Mann letzter -- Neuigkeit Stadt erfahren -- zuweilen erzählen -- wissen -- müssen Martin Luther zugetragen -- 
  Mann vergessen -- rufen Dürer -- voll Glas Höhe heben -- leben -- Doktor Martin Luther leben -- Kirche -- Heil Fromme -- 
  Lukas stoßen lächelen -- 
  ketzerisch Gesundheit -- -- Gefallen trinken -- 
  fürcht -- Welt Trübsal überstehen -- ehe Lehre durchdringen -- 
  Albrecht antworten -- 
  Schweiß unser Angesicht Brot essen -- verlohnen heit -- Qual Trübsal ihretwegen aushalten -- 
  Meinung -- antworten Lukas -- eigentlich Theologe Doktor gehören -- verstehen -- 
  -- vorher -- Meister Albrecht -- Frage -- -- 
  euer Bild fallen -- manchmal neu Tracht alt Geschichte abkopieren -- wunderlich Kleidunge ersinnen -- 
  ebenfalls nachahmen -- artlich dünken -- 
  Albrecht antworten -- 
  dergleich überlegt Vorsatze tun -- Weg kurz scheinen -- antikisch Tracht Land Zeitalter studieren -- 
  -- Bild ansehen -- längs_tvergessen Kleidungsstück -- dargestellt Geschichte empfinden -- Bekleidung gleichsam notwendig Übel -- 
  rücken biblisch heidnisch Geschichte manchmal Zuschauer dicht Auge -- Figur Gewänder auftreten lossein selber wahrnehmen -- 
  verlieren Gegenstand Fremde -- Tracht -- gehörig auswählen -- malerisch -- 
  denken alt Kleidungsart -- Geschichte lesen -- rühren entzücken -- 
  gerne sehen -- Christus wandeln -- selber -- 
  Mensch sogenannter Kostüm erinnern -- vergessen gerne -- 
  Darstellung alt Gewänder überdies unser Gemälde tot fremd -- Künstler gebärden -- Tracht setzen Verlegenheit -- sehen -- Übung Falt Masse werfen -- Auge mitarbeien -- Imagination -- sonderlich interessiert -- 
  Modell Gewänder ausspannen -- nimmermehr -- Künstler Wirklichkeit leisten -- 
  scheinen -- suchen -- Tracht Mensch physiognomisch brauchen -- Ausdruck Bedeutung Figur erhöhen -- 
  machen Einbildung Gewand Kleidung -- niemals tragen -- 
  gestehen -- setzen wild böse Kerl Mütz seltsam Form auf's Haupt -- geben Aussen Abzeichen -- hoch Zweck -- Figur Hand Fuß Körper sprechen -- 
  völlig Eurer Meinung -- Lukas finden -- Sitt annehmen -- nachdenken -- 
  Sache Raphael Sanzius sehen -- Ähnliches bemerken -- 
  wozu -- rufen Albrecht -- gelehrt Umständlichkeit -- genau Studium alt vergessen Tracht -- Nebensach bleiben -- 
  Wahrlich -- Respekt Malerei -- derlei Erkundigung Fleiß verwenden -- vollends -- akkurat erreichen -- 
  Trinkt -- trinken -- Lukas -- leer Glas füllen -- wie_es -- mancherlei Ding abgeben -- glauben -- Eure hoch Sinn unwürdig -- 
  wenden Mühseligkeit -- Geschichte fein zierlich Holz schneiden -- dergleichen -- 
  wissen -- wie_es zugeht -- antworten Albrecht -- 
  sehen -- Freund Lukas -- Mensch wunderlich Wesen -- zuweilen denken -- Sinn -- wunderbarlich Menschengeist Mensch herausstreben -- tausend Mannigfaltige offenbaren -- 
  suchen herum -- treffen Dichter Sprache -- Spielmann Anzahl Instrument Sait -- Künstler Finger Farbe -- 
  probieren gelingen -- unbeholfen Werkzeug hantieren anfangen -- keinmal -- Besseres -- 
  Himmel gelassen Blut schenken -- niemals ungeduldig -- 
  fang neue -- kehr alte -- 
  mal -- befällen gewöhnlich nachh Gelüst -- Zierlich Holz schnitzeln -- nachh Tagelang sitzen -- Arbeit Stelle fördern -- 
  Kupferstichen -- 
  Mühe verwenden -- -- 
  Suche frei schnell arbeiten -- wechseln allerhand Manier -- bleiben neue -- 
  Liebe Fleiß Mühseligkeit scheinen überdies -- deutsche angeboren -- gleichsam Element -- Wohlbefinden -- 
  Kunstwerk Nürnberg aufzuweisen -- tragen Spur -- Meister sonderbar Liebe führen -- Nebenzweig vernachlässigen -- gering schätzen -- übrig Deutschland Niederlanden sagen -- 
  -- Lukas -- Eurem Schüler Sternbald abgerat Italien -- gewiß Kunst bringen -- 
  Franz begierig Dürer antworten -- 
  -- zweifle behaupten -- Meister Lukas -- 
  wissen -- Wissenschaft letzter -- töricht -- halten -- leisten entdecken -- Kunst vollbringen -- 
  glauben -- künftig Zeit Sache darstellen -- Geschichte Empfindung ausdrücken -- Art Vorstellung -- 
  Lukas schütteln zweifelhaft Kopfe -- 
  sogar überzeugen -- fahren Albrecht fort -- Mensch leisten vermögen -- Zeitalter -- 
  Erinnert -- vorher Erfindung sprechen -- 
  alt Wohlgemut Ketzerei geschien mal euer Lehrer Engelbrecht schwerlich Erfindung Manier verfallen -- geläufig -- 
  Schüler übertreffen -- 
  Arbeit gewinnen -- rufen Lukas -- 
  ausfüllen -- Dürer lassen -- -- 
  niemals bringen -- 
  jeder Bild stehen Platz -- eigentlich entbehren -- Rücksichte -- Sache ausdrücken -- Bild antrifft -- 
  finden -- zukünftig Maler Gemäldo verächtlich sprechen -- Fleiß -- verkennen -- 
  Meister -- -- sprechen Fehler Auge fallen -- sehen -- unmöglich sehen -- 
  schlimme rühren bloß gut Zustande Kunst -- erzürnen -- 
  sehen Gegenteil gerne -- Franz Sternbald Italien besuchen -- denkwürdig Kunstsache genau betrachten -- Anlage Malerei bemerken -- 
  Maler -- gewiß -- Deutschland bleiben -- 
  glauben -- Kunstgeister -- Anblick Mannigfaltig ungemein Statten -- Bildung entstehen -- sehen -- Weg auffinden -- Betrete -- glauben fast -- Sternbald gehören -- 
  lassen reisen -- alt -- wirken Veränderung -- Neuheit -- 
  glauben -- Reise Kunst lernen -- 
  Franz Zeitlang Verwirrung leben -- Lerne eigentlich Arbeit stören -- glauben -- sanft Gemüt aussetzen -- gewiß dergleichen überleben -- nachher Zeitpunkt de -- sto groß Nutzen ziehen -- -- 
  Dorf reisen -- Franz -- aufhalten -- sagen -- Freude empfinden -- 
  Kirche Blatt aufstellen -- wozu Kraft zugetrauet -- dünken -- beweiset -- Weg einschlagen -- 
  -- Meister Lukas -- Gemälde unmöglich beschreiben -- Verkündigung Heilande -- Hirt Feld geschehen -- 
  Franz wunderbar Erleuchtung angebrachen -- Bild rührend -- worauf niemals fallen -- 
  zierlich lieblich -- verdrängen Sache -- darstellen -- 
  Bild ergötzen -- sagen -- lernen -- 
  Hirte -- untergegangen Sonne nachsiehen -- falsch zeichnen -- klein Figur -- 
  Bild erwecken heilig andächtig Empfindung -- glücklich schätzen -- Franz Schüler -- 
  Wort arm Franz niemals aussprechen -- scheinen verdienen -- Schamrot -- innerlich erfreut -- überglücklich -- gleichsam geistig Kraft bewegt -- Tätigkeit rufen -- 
  Empfand Fülle Busen -- mannigfaltigst Gedanke übermeisteren -- 
  Luka -- Weile geschwiegen -- brechen Weinflasche -- selber lustig Gebärde Tisch herum -- einschenken -- 
  Fröhlich rufen -- lassen Munter -- irdisch Leben dauern -- wissen währen -- 
  Albrecht trank lachen -- 
  leicht Gemüt -- Meister -- scherzend -- Gram niemals anhaben -- 
  Wahrlich -- Lukas -- Gesundheit Leben fühlen -- Ding -- hernach -- 
  Weib -- Essen Trinken -- Arbeit -- sehen -- Ding beständig vergnügen -- Höherem streben -- 
  -- Meister Albrecht ernsthaft -- geläutert wahr Religion -- Glaube Gott Seligkeit -- 
  sprech Tisch niemals -- Lukas -- -- 
  groß Ketzer -- -- 
  -- rufen Lukas -- lassen Ding fahren -- wissen -- 
  arbeiten -- fröhlich -- 
  Wein Ader kopfe lebendig -- gelingen Hand kühn Zug -- wild Gebärde -- nüchtern Überlegung -- 
  erlauben -- Tisch Zeichnung entwerfen -- ausarbeiten -- nämlich Saul -- Spieß David werfen -- 
  dünken -- sehen wild Mensch deutlich -- erschrocken mutig David -- Umstehenden -- 
  -- Dürer -- Arbeit -- kühn Entschluß fassen -- 
  vergönnen Gegenteil Schlaf -- müde Reise -- 
  Tisch aufheben -- 
  Lukas führen Albert Ruhebette -- Frau gehen anderer Zimmer -- Ruhe allerhand erzählen -- begeben Werkstätte -- 
  Franz eilen Sebastian Brief hinunter Garten -- Meister Lukas zugehören -- 
  Gesträuche Gewächs stehen schön Ordnung -- Herbst entblättern -- frisch grün -- sein aufbrechen -- 
  Gang reinlich halten -- spät Herbstblume stehen schön Flore -- 
  Franzen Gemüt völlig erheiteren -- fühlt holdselig Gegenwart scherzen -- Zukunft freundlichen Gebärde -- 
  öffnet Brief lesen -- Trauter Bruder -- 
  weh tun -- unser Dürer begleiten -- Niederlanden antreffen -- 
  Krankheit gefährlich -- halten Reise -- 
  Sehnsucht einsamen Lager Stunde lebendig -- wissen -- Empfindung denken -- 
  Blume Frühling wiederkommen -- entfernt -- wissen zuverlässig -- wiedersehen -- 
  mühevoll leer menschlich Leben -- 
  les Brief wiederholt malen -- dünken -- verständ -- Meinung -- 
  malen -- les Buch fleißig -- lerne -- wissen -- erscheinen neu -- 
  Übel -- Mensch schwer ankommen -- Einfältigst ordentlich verstehen -- meinen -- jedesmalig Lebensart -- augenblicklich Gedanke hindern -- wiederfinden -- dünken -- 
  mündlich sprechen -- hören -- sagen -- lang fort -- empfind Abwesenheit -- -- Dürer reden -- sprechen -- 
  Held römisch Altertum wandeln Größe Gemüt -- genes -- Versuch anstellen -- Geschichte malen -- 
  beschreiben -- Heldenalter lebendig regen -- Geschichte Sache -- Neugier angehen -- Welt entwickeln -- 
  vorzüglich Cäsar Geschichte bilden -- nennen Mann -- Ehrfurcht verdienen -- 
  nachen ausruft -- trägst Cäsar Glück -- sinnend Rubikon stehen -- Vorhaben erwägen -- fortschreiten -- bedeutend Wort -- Würfel werfen -- 
  bewegen Herz Entzück -- Gedanke versammeln Mann -- Weise verherrlichen -- 
  lieb sehen -- Stadt Alpen ziehen -- Gesellschafter fragen -- Neid Verfolgung Plane Haus sein -- hoch Größe tiefsinnig Wort -- Glaube -- -- Rom -- 
  bloß Ehrgeiz -- nennen -- Erhabenst -- wozu Mensch empor schwingen -- 
  freilich -- Rom -- Welt beherrscht -- Grund -- unbedeutend Stadt -- 
  hoch Ruhm -- groß Verehrung Held -- Erdkreis huldigen -- -- 
  niemals vergessen -- 
  Ähnliches -- 
  liegen Seele Cäsar Wort -- kühn anscheinend Höchste -- scheinbar Niedrigst zusammenstellt -- 
  Ehrgeiz -- Ehrgeiz Gemein Verächtlich empfinden -- Leben führen -- hoch anschlägt -- unbedeutend Bürger -- Leben gleichsam mitmachen -- hergebracht Gewohnheit -- Fülle Herrlichkeit -- gleichsam Zugabe -- angeworfen Zierat -- Ruhm -- glorwürdig Tat -- erhaben Streben hineinlegt -- 
  wünsche übrig Mensch Kühnheit erstaunen -- sehen Alltäglichkeit Beschränktheit -- Wonne Entzück fassen -- kaltblütig -- nehmen zurückhaltend Verachtung -- aufdrängt -- 
  fallen Gedanke -- wahrhaft Mann engherzig Kleinmütigkeit sprechen -- einkommen lassen -- Riese Koloß Goldwaage abwägen -- 
  begreifen -- Sylla hoch Glanze Regiment plötzlich niederlegt -- Privatmann -- sterben -- 
  vorstellen -- menschlich Geist -- hoch nämlich -- Freude Welt ersättig -- such -- wünschen -- 
  genügen bloß -- Wunsch zerspaltet tausend -- Stolz -- schlecht Eitelkeit Jahrhundert durchleben träumen -- Lebenslauf lassen -- 
  deutlich -- Cato Brutus gerne sterben -- Geist Glanz verlöschen sehen -- Leben fesselten -- 
  -- les -- Ermahntest -- heilig Schrift -- les -- teuer -- 
  unbeschreiblich Prediger Salomo erquicken -- Gedanke Seele einfältig erhaben ausdrücken -- Eitelkeit menschlich Treiben durchschauen -- erleben -- Vergänglich -- nichtige entdecken -- unser Herz Genüget -- Streben Ruhm -- Größe Weisheit -- Eitelkeit -- schließen -- 
  sagen -- -- Mensch fröhlich Arbeit -- -- 
  Mensch Mühe Sonne -- 
  Geschlecht vergehet -- -- Erde bleiben ewiglich -- 
  Sonne -- laufen Ort -- aufgehen -- 
  Wind Mittag -- herum Mitternacht -- herum Ort anfehen -- 
  Wasser laufen Meer -- Meer voller -- Ort herfließen -- fließen -- 
  voll Mühe -- ausreden -- 
  Auge sehen nimmer -- Ohr höret nimmer -- 
  geschehen -- 
  hernach geschehen -- 
  ist_es -- tun -- 
  hernachn -- geschehen neue Sonn -- 
  -- nachher -- Mensch -- essen trinken -- Seele Ding Arbeit -- 
  gute -- Sünder -- 
  bös Ding -- -- Sonn geschehen -- -- Herz Mensch voll Arg -- Torheit Herz -- dieweil leben -- sterben -- 
  -- Lebendig wissen sterben -- tote wissen -- verdienen -- Gedächtni vergessen -- Liebet -- Hasset -- neiden -- Welt -- Sonn geschehen -- 
  gehen -- ess Brot Freude -- trinken dein Wein gut Mut -- Werk fällen Gott -- 
  Laß Kleid wissen -- Haupt Salbe mangeln -- 
  Brauchen Leben Weibe leiben -- eitel Leben -- Gott Sonne geben -- eitel Leben währet -- Leben -- Arbeit -- tusen Sonn -- 
  vorhanden -- tun frisch -- Tod -- hinfährst -- weder Werk -- Kunst -- Vernunft Weisheit -- -- 
  -- Liebster Franz -- lernen -- hoch bringen Mensch gewiß niemals -- Weisheit -- 
  Nürnberger Hans Sachs kennen lernen -- wacker Mann schön Dichter -- Kunst Meistersänger legen -- bringen -- Freund Reformation -- herrlich Gedicht abfassen -- 
  Bürger Schumacher allhier -- 
  Leb -- gib Nachricht -- Brief niemals weitläufig -- 
  -- Sebastian -- 
  Brief setzen Franse tief Nachsinn -- Gemüte eindringen -- fühlen fast Fremdartig Schreibart -- Geist wiedersetzen -- 
  quälen -- gewaltsam Eindrucke Seele fallen -- frei Bewegung rauben -- 
  liegen Gesinnung Betrag Meister Lukas Gedanke -- Sebastian Brief scheinen übereinzustimmen -- Augenblick Gefühl Welt einsam -- 
  Wunderlich seltsam Leben Jugend -- kennen -- 
  verlangen -- übrig Welt -- einzig Instrument -- Empfindung Tag zusammenstimmen -- messen fremdartigst Natur -- unzufrieden -- allenthalben Disharmonie hören glauben -- 
  -- suchen Aussenwert freundlich Widerhall antworten -- ängstigen -- ausbleiben -- 
  Haus -- 
  Dürer munt -- suchen Meister Lukas Malerstube -- 
  sitzen Zeichnung -- ziemlich kommen -- 
  Franz verwunderen kunstreich Mann -- kurz arbeiten -- Zeichnung beinahe fertig -- groß Feuer entwerfen -- 
  Dürer betrachten -- scheinen -- Meister Lukas -- gut Trunk arbeiten lassen -- versuchen -- steigen Wein Kopf -- verdunkeln Gedanke -- 
  stören lassen -- Lukas -- anfangs wunderlich -- dreist fortfahren -- finden Arbeit hinein -- Alsdann geraten gewißlich -- 
  Künstler bleiben Frau Abend -- setzen Gespräch fort -- 
  Franz gedrücken Gedanke -- abreise -- Dürer unvermutet Weise finden -- plötzlich zweitenmal verlassen -- sprechen -- Grund -- bescheiden -- 
  spät -- Mond aufgegang Trennt -- 
  Franz Lukas Abschied -- begleiten Lehrer Hausfrauen Herberge -- 
  Frau Lebewohl -- 
  Dürer -- durchstrich Straße -- kommen Spaziergang Stadt -- 
  Mond scheinen schräg Baum beinahe entblättern -- stehen still -- Franz fallen Meister Träne Brust -- 
  -- Dürer -- Arm schließen -- 
  O Liebster -- liebst Albrecht -- schluchzen Franz -- zufrieden geben -- aussprech -- verehr Liebe -- 
  wünschen sehen -- sagen -- Gewalt -- 
  O liebster Meister -- glauben Wort -- glauben Träne -- 
  Franz zurücktreten -- Dürer Hand -- -- 
  glauben -- -- rufen Franz -- anderer Mann übrig Mensch -- fühlen -- Eur Gleichen antreffen -- 
  hängen Herz -- vertrauen -- vertrauen -- 
  Dürer lehnen nachdenkend Stamm Baumes -- Gesicht beschatten -- 
  Franz -- langsam -- machen -- Abwesenheit traurig -- niemals Schüler -- Freund antreffen -- 
  Freund -- einzig -- voll Seele lieben -- einzig -- lieben -- 
  -- Albrecht -- Franz -- vergehen -- 
  Dürer fahren fort -- 
  Wahrheit -- Sohn -- lieben -- 
  Meinst -- getreu Anhänglichkeit Kindheit Herz geruhen -- 
  O weißen -- Abend Nürnberg -- -- Abschied abkürzen -- täte -- -- 
  umarmen freiwillig -- Franz fühlen teuer Lehrer weinen -- 
  Herz brechen -- 
  übrig Mensch -- Dürer -- lieben -- Irdisches Gedanke -- 
  Stelle äußerlich hart -- tun übrig -- Herz wissen -- 
  Pirckheimer Patrizier -- reich Mann -- brav -- schätzen Kunst -- fleißig aufräumen -- 
  weib kennen -- stille nachgeben -- meinen -- machen -- 
  Sebastian -- Herz meinig verwanden -- 
  übrig Laß schweigen -- 
  wahrlich -- einzig Erde -- 
  Franz begeistern -- 
  O größeres Glück begegnen -- Liebe erkennen -- inniglich tragen -- 
  Wacker -- Dürer -- laß frommes Herz allerwege bleiben -- -- 
  Komme Deutschland Nürnberg -- dünken -- wissen groß Freude -- künftig leben -- 
  verlassen Waise -- Eltern -- angehörige -- Franz -- -- 
  wünsch -- Albrecht -- wiederfindest -- glauben -- Seele -- -- treiben -- 
  Stunde ernsthaft betrüben -- sterben wünschen -- nachher Scherze lustig scheinen -- 
  wissen -- fleißig -- Schaden tun -- Kraft Seele abstumpfen -- gewiß büßen -- ändern -- 
  brauchen liebst Franz -- Ursache sagen -- 
  Frau -- weltlich sinnen -- qualten ewig Sorge Zukunft -- glauben -- niemals arbeiten -- Geld sammeln -- arbeit Ruhe -- unlustig Seele -- Lust stellen Arbeit -- 
  Frau empfinden Wahrheit himmlisch Wort -- Christus aussprechen -- Sorget eu Leben -- essen trinken -- euren Leib -- anziehen -- 
  Leben Speise -- 
  Leib Kleidung -- 
  Gott Gras Felde kleiden -- stehen -- Ofen werfen -- sollen vielmehr -- 
  O Kleingläubige -- 
  sollen Sorge sagen -- 
  essen -- 
  trinken -- 
  womit kleiden -- -- 
  leben -- liebst Freund -- -- sollst begleiten -- Stelle trennen -- 
  Franz halten Hand -- 
  wiedersehen -- -- Deutschland zurückkommen -- 
  -- müßen leben -- -- -- -- vaterland -- 
  trennen -- Dürer -- sterben -- -- 
  -- Lebensmühe -- -- Sorge -- 
  kommen -- 
  segnen hierauf jung Freund -- beten inbrünstig Himmel -- 
  Franz sprechen Gedanke Wort -- fromm Entzückung -- umarmt -- Dürer Schatten weg -- 
  Franz -- Mondschimmer Baum dämmeren ungewiß -- 
  plötzlich stehen Schatten still -- bewegen rückwärts -- 
  Dürer stehen Franz -- Hand -- -- 
  künftig schreibst -- nennen dein Brief -- dein Freund -- Schüler -- -- 
  Wort fort -- Franz verlieren gänzlich Auge -- 
  Nacht kalt -- Wächter Stadt ziehen vorüber singen -- Glocke schlagen feierlich -- 
  Franz irren Zeitlang umh -- begeben Herberge -- schlafen -- 
  Kapitel -- 
  -- 
  Franz Gesellschaft finden -- Kanal Schiff Rotterdam fahren -- größeres nehmen -- vollends Antwerpe -- 
  hell Wetter -- Boot steigen -- Gesellschaft scheinen Laune -- 
  Franz betrachtet Reihe -- fallen -- jung Mensch -- alt scheinen -- ungemein schön Gesicht Gebärden -- 
  Franz fühlen jünger alt Leute hinziehen -- sprechen letzter ungern -- selten Empfindung einstimmen -- 
  alt Leute empfand Beschränkung quälend -- merken -- lebhaft -- jugendlich -- gemeiniglich Ding entzücken -- fremd bleiben -- zuweilen gewiß Mitleid -- tyrannisierend Duldung hinabblicken -- Gefühl Stürmen vorüberschiffen müssen -- ruhig kalt Land fest Fuß fassen -- 
  vollends demütigen -- Gegenstand lieben -- verehren -- Lob Tadel -- Anpreisung Nachsicht scheinbar Gerechtigkeit austeilten -- Liebe fast übrig bleiben -- 
  gewohnt voll Herz zahlen -- Liebe messen einschränken -- dulden -- voll Strömen gelobt Land Kunst -- Land Verheißung -- ergießen -- lieben -- Wohler -- -- 
  Auge Jünglinge zurückziehn -- lustig hell braun Auge gelockt Haar -- frei Stirn bunen -- fremdartig Tracht machen Gegenstand Franzen Neugier -- 
  Schiff fahren fort -- links eben Land hinein -- 
  Gesellschaft scheinen Nachdenkend müde -- früh aufstehen -- Jüngling schaun unbefang Auge umher -- 
  ältlich Mann ziehen Buch hervor -- fing lesen -- währte schlummeren -- 
  übrig schiene Gespräch wünschen -- 
  Herr Vanse schlafen -- Nachbar -- Lese bekommen -- 
  schläft -- Nachbar -- hören -- Vans -- ermuntern -- 
  sollten erzählen -- Iustig Lied singen -- 
  heiser -- -- wissen selber -- eigentlich singen aufgeben -- 
  fremd Jüngling -- 
  erbiet Lied singen -- wissen -- Herr Poesie genau nehmen -- 
  versicheren -- geschehen -- fahren fort -- 
  -- bissch Freude verbittern -- Lied sing -- hübsch Umschweif ausdrücken -- Art fallen -- 
  Eurer Erlaubnis anfangen -- 
  Reise Vergnügen -- Gesundheit -- Stadt liegen -- Berg Waldung stehen -- 
  jenseits -- jenseits -- Himmel heit -- Treibt rege Sehnsucht -- 
  Schau -- laß trüb Blick -- 
  Sieh -- liegen weit Welt -- Stadt bleiben Gauen -- Sinn gefangen halten -- 
  Himmel -- grün Flur -- lieblich Natur Mädchen nimmer quälen -- Kommst Mensch -- 
  Nirgend Liebe fehlen -- lieb Gewinn -- 
  Laß trüb Blick -- Allenthalbe blühen Glück -- 
  munt -- Freund -- munt -- Mädchen warten -- Treiben Fluß rasch hinunter -- dünken -- locken Ton -- 
  günstig Wind -- Sturm schweigen -- Lüfte säuseln lind -- Siehst Sonne -- Glänzen Bach -- 
  -- spielen Licht Freundlich -- 
  Wald Funkelschein -- Sieht Quell -- Kuckt Flut hinein -- tausend Strom hell -- 
  lieb Licht -- Wandelt -- Löschet nimmer -- dorten -- -- -- 
  Liebst Morgenpracht -- schwarz Nacht diamanten Bahn -- Sonne Weg beginnen -- 
  Vogel jubeln laut -- Begrüße fröhlich Tag Braut -- Wolke Füße schmiegen -- Brand golden Feuer fliegen -- 
  Sonne Wagen lenken -- Morgenrot erbleichen -- O Freund -- eilig Mittag weichen -- Meer Göttin senken -- 
  funkeln Schimmer See Land -- Erde Himmel -- Flimmer Glanz verbinden -- 
  prächtig Rubin Sapphir -- Siehst Abendhimmel prangen -- Golden Geschmeid hängen -- Edelsteine Hals Nacken zieren -- hold Glut schön Wang -- 
  Drängt leisem Licht Chor Stern -- sehen -- -- 
  Jubel Lerchen Lied -- Tönt Fels Meer Gesänge -- -- 
  Liebe entschwinden -- Mußt weibisch verzagen -- dreist Glück wagen -- aufgefund -- Rausch klagen -- 
  Empfand -- empfinden -- 
  vergessen Frühling wiederzukommen -- Störch ziehen -- Schwalben Wiese -- 
  Winter Herrschaft nehmen -- erwachen lächeln golden Kind -- 
  suchen Spielzeug -- alt Winter zusammengestören -- putzen Wald grün Flamme -- Nachtigall Lied lehren -- 
  rühren Obstbaum rötlich Hand -- klettern hinauf Aprikosenwand -- Schnee Blüte Blatt dringen -- schütteln froh Köpfchen -- Arbeit gt -- 
  -- schläft waldig Grund haucht Atem -- süßen -- zart rot Mund Grase Viol Erdbeere sprießen -- 
  rötlich bläulich lachen Tal -- erwachen -- 
  verschlossen Garten Steigt über Gitter Eile -- Schlüssel warten -- Wand steil -- 
  Ränmt Schnee Weg -- schneiden Buxbaum-Geheg -- feiern Abend -- schaufeln arbeiten Mondlicht -- 
  rufen -- 
  säumen Spielkamerad Erde bleiben -- 
  einladen -- fröhlich vertreiben -- 
  Lilie -- reichen weiß Finger -- Tulpe stehen dick Kopfputz -- Rose treten bescheiden nah -- aurikelch Blume -- vornehm gering -- 
  bunt Teppich sticken -- Liebe treten Jasminlaube hervor -- 
  dank Mensch -- jauchzet Vögel Chor -- fühlen beglücken -- 
  küssen Frühling zart Blumenwang -- scheiden -- 
  -- 
  sterben süß verlange -- welken Häuptern stehen -- 
  Frühling sprechen -- vollenden -- schwalben herbestellen -- tragen Welt -- Indien duftend Gefilde ruhn -- 
  klein -- Obst pflücken -- Stock schwer Traube entkleid -- Sense golden Korn schneiden -- Herbst schicken -- 
  lieb Spiele -- Kind ernst Arbeit sinnn -- Winter überdrüssig -- kommen Eurer Freude -- 
  Blume -- Vögel nehmen -- ernten kelteren -- -- 
  Ade -- ade -- Liebe -- Frühling ewiglich nah -- 
  Lied schön gesung -- Vans -- -- Text genau nehmen -- letzter hängen zusamnen -- 
  -- Fremd -- indessen kennen Sprichwort -- 
  Schelm gibt_es -- 
  gut schön Zusammenhäng finden -- Franz -- 
  Hauptgedanke fröhlichen Anblick Welt -- Lied trüb Gedanke Melancholie abziehen -- Vorstellung -- 
  Zusammenhäng Rede -- wandeln fort -- Gedanke schön heit Stunde bilden -- 
  selber Poet -- rufen Fremde -- 
  Franz rot -- -- Maler -- Antwerpe -- Italien gesonnen -- 
  Maler -- schrie Vansen -- Sternbald genau betrachten -- 
  O geben euer Hand -- 
  nah -- 
  Franz Verlegenheit -- wissen -- sagen -- Niederländer fahren fort -- 
  Künsten Welt ergötzen Kunst Malerei meisn -- begreifen -- Mensch kalt -- 
  Poesie Musik -- flüchtig vorüberrauschen -- anrühren -- 
  vernehm Ton -- vergessen -- -- -- Klang Wort -- wissen niemals -- -- 
  Spielwerk -- handhaben -- 
  verstehen edl Malerkünstler -- Sache Person unmittelbar Auge stellen -- freundlich Farbe -- Wirklichkeit Lebendigkeit -- Auge -- klügst edel Sinn Mensch -- Augenblick auffaßt verstehen -- 
  öfter Figur sehen -- bekannt -- sagen -- Freund -- leben -- übrig Mensch -- 
  lieben Maler ungemein -- gleichsam Schöpfer -- schaffen darstellen -- lüsten -- 
  Augenblick bemühen Vanse Sternbald -- nennen Name -- dringend bitten -- Antwerpe Haus besuchen -- malen -- 
  fortgesetzt Reise geraten Franz unbekannt Jünglinge Gespräch erfahren -- Rudolph Florestan nennen -- Italien -- England besuchen -- Heimat zurückkehren denken -- 
  Jüngling beschließen Reise -- fühlen Zug Freundschaft -- schnell vereinigen -- 
  vergnügen -- Rudolph -- Deutschland -- euer Landsleuter leben -- halb deutsch -- lieb euer Nation -- 
  Franz versichern -- freu Bekanntschaft -- 
  äußern Verwunderung Rudolph jung -- Welt sehen -- 
  erstaunen -- -- Spanien -- 
  unruhig Geist treiben umher -- Weile still Heimat sitzen -- reisen -- krank -- 
  Reise -- geschehen -- Haus sehn -- vornehm -- Ferne herumzustreifen -- indessen dauern dergleich Vorsatz niemals -- fremd Land hören lesen -- alt Lust aufwachen -- 
  Gesellschaft -- sollen -- Fahrt verkürzen -- Geschichte Märche erzählen -- 
  traut Rudolph -- Stande -- begehren erfüllen -- ersuchen -- Franz vereinigt Bitte -- 
  -- antworten Rudolph -- Geschichte Liede -- fallen -- 
  behauten -- gewiß unterhalten -- sollen getrost anfangen -- 
  Rudolph -- 
  lieb Geschichte -- erzählen -- lieb Rede -- 
  alt Herr kümmern dergleich Neuigkeit -- O -- Vansen -- find Geschichte Art unnatürlich -- Erzählung vortragen -- gewöhnlich aufheben -- -- mißfallen -- 
  fortgehen -- ergötzen -- 
  -- rufen Rudolph -- -- meister Mensch -- wissen eigentlich -- vorstellen -- fühlen Hang Seltsamen Wunderbar -- alltäglich -- lieb Entzück reden hören -- Schranke Billigkeit halten -- 
  -- Geschichte anfangen -- selber Schuld -- erwarten -- 
  Sonne -- jung Edelmann -- Ferdinand nennen -- frei Feld spaziern -- 
  beschäftigen -- Pracht morgens betrachten sehen -- Morgenrot licht Gold Himmel brennend zusammendrängten -- Höherleuchtet -- 
  verlassen gewöhnlich Schloß -- unverheiratet leben -- Eltern sterben -- 
  setzen benachbart Wäldche nieder -- la italienisch Dichter -- lieben -- 
  Sonne heraufgestiegen -- einsam Waldplatze begeben -- Ferne Reuter heransprengen -- 
  Hute Kleide Reuters glänzt Gold edelgestein Schein morgens -- näh -- glauben Ferdinand vornehm Ritter sehen -- 
  Fremde riten eiligst vorüber -- verschwinden Walde -- Diener folgen -- 
  Ferdinand wundert Eile -- Füßen Grase Glänzende -- 
  hinzu -- heben Bild Mädchen -- kostbaren Diamant einfassen -- 
  Walde -- aufmerksam betrachten -- setzt gewohnt Stelle nieder -- vergessen Buch herauszuziehn -- Bild beschäftigen -- 
  Edelmann Landsmann -- fragt Vanse -- 
  -- denken -- antworten Rudolph -- deutsch -- -- erinneren deutlich -- Frank -- 
  -- fahren fort -- 
  Haus -- aß -- 
  Leopold -- vertrautest Freund besuchen -- sprechen -- 
  Gedanke -- fragen Leopold -- 
  -- antworten -- Antwort müssen Freund zufrieden -- 
  verstrich Woche -- Ferdinand Wort sparsamer -- 
  Freund besorgen -- bemerken -- Ferdinand Gesellschafter vermeiden -- fast beständig Walde -- Wiese -- Gespräch Weg -- 
  Abend hören Leopold folgend Lied singen -- 
  harren -- Herz brechen -- 
  niemals Schmerze Busen sprechen -- 
  gehen Irre -- 
  eile schnell Gewirre -- 
  wozu träge Weile -- 
  irgendwo finden -- Such Ferne -- Wald -- blühend Linden -- lächeln Stern -- 
  Leopold hören aufmerksam rätselhaft Liede -- Wald hinein -- treffen Freund Träne -- 
  Anblicke erschüttern -- reden -- Liebster -- bekümmern -- Wort leiden anvertrauesen -- 
  sehen täglich -- Leben aufzehrt -- unwissend leiden -- raten trösen -- 
  nennst dein Freund -- 
  -- Deine vertrauen würdig achtest -- 
  gelten -- lieb Probe stellen -- Fürchtest -- entdecken -- 
  unglücklich -- Findest sicher Trost -- Busen Freund -- 
  Fehler bewußt -- verzeihen willig Liebe -- 
  Ferdinand Weile -- antworten -- 
  Keines -- Freund -- Fall -- wunderseltsam Sache belasten Herz gewaltsam -- anvertrauen -- schämen -- 
  fürcht Vernunft -- fürchten -- sagen -- selber täglich stündlich sagen -- fürcht -- dein Freund -- unbegreiflich Torheit liebst -- 
  anvertrauen -- 
  Sieh Gemälde -- Woche finden -- Sinn gänzlich umwandeln -- 
  höchst Glück -- selber finden -- leben vorher Seele -- kennen Glück Welt -- Glück Welt fertig -- 
  -- unbekannt Wesen Morgenwolk Hand reichen -- süß Stimme Name nennen -- 
  Bild groß Feind finden -- Minute Ruhe lassen -- Schritt verfolgen -- übrig Freuden Erde -- Armselig Verächtliches darstellen -- 
  Auge hinwegwenden -- befällen marternd Sehnsucht -- Blick -- süßen Mund -- schön Auge antreffen -- ergreifen schrecklich Beklemmung Herz -- unnütz Kampf -- Streben Wunsch vergeh Leben verzehren -- -- 
  endigen -- kommend aufmach Land durchziehn -- aufzufinden -- Gemälde besitzen -- 
  irgendwo -- Liebe kennen lernen -- sterb öd Einsamkeit -- erwidern Liebe -- 
  Leopold stehen staunend -- betrachtet Freund -- rufen -- Unglücklicher -- 
  wohin verirren -- 
  Schmerz Sterblichen verbluten -- 
  sagen -- 
  raten -- 
  Wahnsinn bemeisteren -- Hilfe spät -- 
  Original Bilde weit Erde finden -- bloß Imagination Maler -- zierlich Köpfche hervorbringen -- leben -- sterben -- Gatinn -- alt voll Runzel -- kennen -- 
  Glaubst -- Gefallen Wunder Pygmalion erneuern -- 
  -- Helena Griechenland -- ägyptisch Kleopatra liebtest -- 
  Bedenke -- laß Leidenschaft unterjochen -- offenbar völlig aberwitzig -- 
  -- Vernunft Labyrinth erretten -- wundern -- unterdrücken -- kommen -- 
  -- Mann wahrlich völlig -- rufen Vansen -- neugierig -- verliebt Schwärmer antworten -- 
  gewiß -- anderer -- einsehen -- Freund meinen -- wunderlich Abenteuer fahren lassen -- 
  Rudolf fahren fort -- 
  Ferdinand schweigen Weile still -- -- Liebster Freund -- Wort Weise beruhigen -- Herz kennsen -- ausgehen -- 
  geben -- vollkommen vernünftig sprechen -- helfen -- 
  Antwort -- fühlen elend -- gehen Bild aufsuchen -- Seele regieren -- 
  vernünftig -- gewiß Traum lieben -- dein Rat hören -- Nacht schlaflos Lager wälzen -- 
  Helena -- ägyptisch Kleopatra lieben -- heiß brennend Liebe Herzen -- gehen -- weit Welt aufsuchen -- Bild suchen -- nirgendwo -- Rede nützen -- 
  -- leben -- Herz -- leben -- still Ahnung erwarten -- 
  finden -- Stern günstig herunter scheinen -- arme zurückbringen -- Glück preisen -- jetzig Begin unvernünftig schelten -- 
  Sieh hängen bloß Glück Zufall -- vernünftig unvernünftig handeln -- Leute schelten loben -- Rat -- vernünftig -- folgen -- 
  wagen -- gewinnen -- Schritt tun -- Reise vollbringen -- Glück Probe stellen -- erfahren -- günstig -- 
  getrost Weg einschlagen -- sehen -- wohin führen -- 
  kommen vergnügen -- -- 
  hierauf Freund Leopold Arm -- drücken herzlich -- 
  Laß -- -- traurig -- siehst gewiß -- bleiben gewiß -- 
  verändern unterwegs Gemüt -- mannigfaltig Welt wechselnd Gestalt erblicken -- betrüben -- 
  Gefühl wunderbarlich Herzen bemeisteren -- plötzlich loslassen -- 
  gehen Haus -- folgend treten Ferdinand seltsam Wanderschaft -- 
  Leopold Träne -- halten Leidenschaft Freund Wahnsinn -- begleiten -- Ferdinand zugeben -- 
  wissen -- wohin Weg richten -- Straße fort -- treffen -- 
  Seele unaufhörlich geliebt Bild beschäftigen -- reizendst Gestalt hinschweben folgen unwillkürlich -- 
  Wälder sitzen still dichtet wunderbar Lied wunderbar Leidenschaft -- hören Gesang Nachtigalle -- vertiefte verlieren selber -- Nacht Walde bleiben müssen -- 
  zuweilen erwacht tief Schlafe -- überdachen Vorsatz kält Blut -- wünschen -- Traumgestalt -- bestrebt -- Zustand Seele erinnern -- ehe Bildnis Grase finden -- unmöglich -- 
  wanderen fort -- verirrt Straße -- dick Wald geraten -- scheinen -- 
  -- treffen Ausweg -- Gehölz dicht -- Vögel schrien lärmten seltsam Tön still Einsamkeit -- 
  Ferdinand dachen Freund -- scheinen selber Unternehmen wahnsinnig -- -- folgend Schlos kehren -- 
  Nacht -- Verblendung plötzlich nehmen -- verschwinden Leidenschaft -- erwachen schwer Traume -- 
  wandert Nacht -- Mond werfen Schimmer Zweig hinein -- Freund vergnügen versöhnt stehen -- denken künftig ruhig Leben -- 
  Betrachtung brechen -- Sonne sandt früh Strahl grün Gebüsch -- neu Mut Heiterkeit wach -- 
  betrachtet Gemälde -- wissen -- -- 
  Entschlüs fangen wanken -- jeder Leben erscheinen leer nüchtern -- wünschen denken -- 
  wohin wenden -- rufen -- 
  O Morgenrot -- zeig Weg -- rufen Lerchen -- ziehen Bahn voran -- wissen mögen -- wohin irr Fuß setzen -- 
  Seele schwanken Leid Freude -- Entschluß Wurzel fassen -- wissen -- wissen suchen -- 
  gewöhnlich Wunsch begnügen -- 
  selber sprechen -- treten Walde heraus -- schön Ebene angenehm Hügel liegen -- 
  Ferne stehen Kruzifix Kapell Glanz Morgensonne -- 
  wunderbar Trieb wandeln -- Inhalt Gedanke aufsuchen -- ergriff Jüngling neu Gewalt -- 
  Entfernung weiß Gestalt grün Wiese bewegen -- Fortging -- Unterschied -- Pilgerin -- 
  Gegenwart Mensch ziehen lang Einsamkeit -- verdoppeln Schritt -- 
  nah kommen -- Pilgerin Kruzifix Weg niederknien -- Hand Höhe heben -- andächtig beten -- 
  Reuter nächster Hügel heruntergestürzen -- nah -- Ferdinand -- vorübersprengen -- geliebt Bildnis finden -- 
  Reuter steigen schnell -- nähert Betende -- genau Blick betrachten -- ergriff ungestüm Bewegung -- 
  streckt Hand rufen Hilfe -- 
  Diener kommen Pferd -- Befehl Herr Pilgerin bemächtigen -- 
  Ferdinands Herz Anblick bewegen -- ziehen Degen stürzen Räuber -- Wehr setzen -- 
  kurz Gefecht verwunden Reuter -- sinken nieder -- erschrocken Diener nehmen sogleich -- 
  Ohnmacht liegen -- tragen Pferd -- führen -- nächster Ort Hilfe suchen -- 
  Pilgerin Kampfs benutzen -- indessen feldeinwärts fliehen -- 
  Ferdinand Erblickre ziemlich Entfernung -- 
  eilen -- -- retten -- Pilgerin -- ungehindert Eure Weg fortziehen -- Räuber -- 
  Angst antworten -- dankt scheu Blick -- 
  glauben kennen -- erinnern -- sehen -- 
  herzlichsten schuldig -- -- Wundertätigen Bilde Mutter Gott wallfahrten -- Räuber überfiel -- 
  O einholt -- 
  begleiten -- Ferdinand -- völlig Sicherheit -- fürchten -- tot -- schwer verwunden -- 
  kehren Straße -- Weg Irre -- 
  Gewitter heraufgezogen -- Hagelschauer fallen nieder -- 
  Wanderer rettet Platzreg Kapelle -- dicht Walde stehen -- Pilgerin ängstlich -- Donnerschlag Berg widerhalln -- Ferdinand suchen beruhigen -- scheinen Gedanke beschäftigen -- 
  hören Gewitter -- lieblich Regenbog stehen Himmel -- Wald frisch grün -- Blatt funkelen Tropfen -- Schwüle Tage vorüber -- Natur durchweht kühl Atem -- Baum -- Blume fröhlich -- 
  stehen sehen erfrischt Welt hinaus -- Pilgerin lehnen Ferdinands Schulter -- 
  -- Sinn auftäten -- Gemüte drückend Schwüle fortzögen -- erkennen lieb Gesicht -- vertraulich nahe -- Original Gemäldes -- heftig Sehnsucht suchen -- 
  freuen Durstende -- schmachtend heiß Wüste umherirrn -- Quell Nähe rieseln hören -- verirrt Wandersmann -- spät Abend Glocko Herde vernimmen -- abendlich Getös nah Dorf -- Mensch alt Herzensfreund entgegen treten -- 
  Ferdinand ziehen Gemälde hervor -- Pilgerin erkennen -- 
  erzählen -- jung Ritter Nachbarschaft malen lassen -- -- Ferdinand befreien -- elternlos -- arm Bauer auferzogen -- entschließen -- lieb Ritter entfliehen -- lieben können -- 
  -- -- heilig Wundertätig Marienbild Wallfahrt -- euer Schutz geraten -- verdanken -- 
  Ferdinand Entzück sprechen -- traut Überzeugung -- gesucht Schatz erbeuten -- erzählt fremde -- Leonore nennen -- Bildnis finden -- bewegen -- Entschluß fassen -- Welt aufsuchen -- sterben -- Gemüt beruhigen -- 
  hören geduldig lächeln -- geendigen -- Hand -- -- wahrlich -- Ritter -- unendlich schuldig -- Freundschaft empfinden -- tragen -- 
  -- lassen Herberge suchen -- Abend brechen Herein -- 
  untergehend Sonne färbt Wolke Gold Purpur -- Weg führen Wald -- kühl Abendwind naß Blatt bewegen -- 
  Ferdinand führen Pilgerin -- drücken Hand klopfend Herz -- stumm -- 
  Nacht nähern -- treffen Dorf Hütte -- Mädchen bange -- Wald dicht -- einzeln Stern treten blau Himmel hervor -- 
  hören plötzlich abseits geistlich Lied ertönen -- gehen Schalle -- sehen Entfernung Klause Einsiedels -- Licht brannt Zelle kniet Kruzifix nieder -- lauter Stimme singen -- 
  hört Weile Liede -- Nacht hereingebroch -- übrig Welt still -- gehen Hand Hand nah -- 
  Zelle stehen -- fragen Ferdinand Mädchen leise -- Liebst -- 
  schlagen Auge nieder -- drücken Hand -- wagt drückt Kuß schön Mund -- widersetzen -- 
  Zitternd treten Eremit hinein -- bat Nachtlager verirrt Wanderer -- 
  alt Einsiedels heißen willkommen -- lassen niedersitzen -- tragen Mal Milch Früchte -- erquicken -- 
  Ferdinand Glückseligkeit bewußt -- fühlt Welt -- geschehen -- gehören gleichsam Lebenslauf -- entzückend Kuß -- Sinn rauben -- beginnen neu Gestirn -- Sonne emporzuleucht -- vorig Licht matt Finsternis -- 
  weisen Einsiedel Leonore Lager -- Ferdinand müssen leer Hütte begeben -- 
  Ferdinand Nacht schlafen -- glücklich Zukunft treten Lager -- erhalten Auge wach -- müde Hinunter sehen -- glücklich Reiche Liebe wandeln -- 
  Leonoren Stimme scheinen beständig wiederzutönen -- glauben nahe -- strecken Arm -- rufen laut weinen -- -- 
  Mondschimmer erblaßen -- Morgenröte Himmel heraufspielen -- verlassen Hütte -- setzen Baume nieder singen -- 
  gewiß Glückes -- 
  Hand Lippe -- 
  süß Gruß Blick -- 
  woher golden Schein -- 
  trübe hing dicht Schleier Busch Wald -- 
  -- Frühlingsfeier -- 
  Wald Tönen leer -- 
  Rührt Wind Zweig -- Treibt Wolke über Feld -- -- 
  Dumpf -- öd -- tot schweigen -- Natur gefangen halten -- -- 
  Busen bange -- Stimmlein sprechen -- Seufzt tief harren -- Klagt -- Sonne -- kommen heran -- 
  dicht Schatten -- Wolke hingen tief -- Dunkler schwärzten Matt -- Feld eng Grab -- 
  Nebel werfen Blick Ferne schauen -- kommen -- Finsternis vorgebauen -- 
  werfen weinend nieder -- Wünscht Unmut tot -- Tod Lerchenlieder -- Abgestorbe Sonnenschein -- -- leben wüssen Dunkelheit -- Schrecken weben -- Freude abwärts streben -- selber Angst Leid -- -- 
  plötzlich war_es -- Sait -- Abendwind vorüberschweben Harfentön weben -- Blume hinzuschreien -- fernst -- fernst Grenze teilen dunkel Nacht -- Sonnenblick voll Pracht Wand Nebelkränze -- 
  atmen wagen -- Schoß Strahl -- golden Pfeil Schnell Glühendroter Eile Ort klagen -- 
  schreckenfroh Schein -- Kriegte Mut neu Leben -- Frühling -- 
  Freude geben -- 
  erglüht Wog -- Funkel grün Flur -- Morgenrot springen kühn Bogen -- Glänzend -- taumelnd Natur -- 
  Waldung bleiben träge -- Vögel springen -- Jubelt Gehege -- Jagt munter Lauf -- -- 
  Jauchzen Lust verlieren Dachte -- sterben -- Fühlt neugeboren golden Freudenmeer -- 
  -- nah -- Sehnsucht Rang -- Augo Fühle -- Lebensdrang -- 
  Klage verschwinden -- Fort Seufzer bang Schwarm -- tanzen golden Stunde -- Liebe fest verbinden Ruhe Glücke Arm -- -- 
  letzter Wort geendigen -- Ritter Dickicht -- gestern Feld verwunden -- Diener folgen -- 
  Kampf neu beginnen -- Eremit Klause treten -- 
  hören verwundeten Bertram nennen -- erkundigt Ort Aufenthalt verwandte -- 
  Fremde nennen beide -- Einsiedler fallen weinend Hals -- Sohn nennen -- 
  -- Vater Welt zurückziehen -- übergeben Sohn Bruder -- Unruhe Krieg Wohnort ändern -- Einsiedler nah -- glauben -- 
  Nachricht Tochter überkäme -- rufen Einsiedler -- unaussprechlich glücklich -- 
  Leonore treten Tür -- Geräusch vernehmen -- 
  Ferdinand -- Bertram stürzen sogleich herbei -- Pilgerin gewahr -- 
  Einsiedler betrachten aufmerksam -- fragen -- woher Ohrring -- tragen -- 
  Leonore erzählt Geschichte -- Bauer erziehen -- sterben -- gutherzig arm Leute nehmen -- Krieg ebenfalls Wohnort vertreiben -- 
  Tochter -- alt Eremit -- übergeben Bauer -- Wohnsitze Feind siegreich Heer vertreiben -- 
  O glücklich -- 
  Krieg -- rufen Vans -- 
  O -- antworten Rudolph hastig -- müßen Sache genau nehmen -- Geschichte Krieg -- müßt fragen -- -- 
  -- 
  geschehen -- 
  Erzählung Luft greifen -- Geschichte -- -- interessieren -- 
  Erlauben -- Franz bescheiden -- widersprechen -- hierin anderer Meinung -- 
  Erzählung -- märch -- Ort bestimmen -- lebendig -- Erde befreundet Geister bevölkern -- nachh Boden betren -- lieb Fabel -- gleichsam einweihen -- Stein -- Baum poetisch Bedeutung -- 
  -- 
  Höre Begebenheit -- Name Geschichte nennen -- fallen poetisch Schatten Gedächtnis -- Zeitraum -- 
  -- Rudolf -- -- weder Ort bekümmern -- 
  lassen Hussitenkrieg -- Verwirrung Familie anrichten -- 
  Schluß Geschichte finden -- 
  voll Freude -- Leonore Ferdinand gegenseitig Liebe glücklich -- Eremit bleiben Walde -- zuredeen -- Welt kehren -- 
  vermehrt Person Gesellschaft -- Leopold -- ausgereist -- Freund aufsuchen -- 
  erzählt Glück -- stellen Leonore Braut -- 
  Leopold freuen -- -- 
  liebst Freund -- danken Himmel -- weit Glück Verstand -- 
  -- begegnen Sterbliche -- erwidern Ferdinand -- elend müssen Mensch -- geben -- Verstand Glück -- -- 
  schweigen Rudolf -- 
  Herr Erzählung eingeschlafen -- Franz nachdenkend -- 
  fast hören -- beziehen -- treffen Erzählung Geschichte -- 
  Sonderbar war_es -- Schluß beruhigen -- Glück vertrauen -- Geliebte Eltern finden lassen -- 
  Franz Rudolf Reise vertraut -- freut -- Gesellschaft Italien -- 
  Rudolf lustig -- Mut verlassen -- Franz Stunde erquicklich -- fast beständig mißtrauen selber -- 
  fügen -- Meile Antwerpe Schiff Zeitlang still liegen müssen -- Boot aussetzen -- Franz Rudolf beschließen Rest Reise Land -- 
  schön -- 
  Sonne breitet hell Ebene -- Rudolf Willens -- Dorfe -- Mädchen besuchen -- kennen lernen -- 
  mußt glauben -- Franz -- -- geliebter Italien untreu -- vergessen -- unmöglich -- lernt Niederländerin wunderlich Weise kennen -- schnell -- Andenken Stunde teuer -- 
  froh Gemüt glücklich Gabe Himmel -- antworten Franz -- bleiben neu -- Freude veralten -- Welt zufrieden -- 
  -- rufen Franz -- Welt schön -- -- 
  ernsthaft Klage zuwider -- wenigster Mensch wissen -- wünschen -- 
  Blind sehen -- sehen -- blind -- 
  traurig verdrießlich -- 
  O -- -- 
  kehren Mensch Stunde -- wissen -- selber anfangen -- herumgreifen -- Talent Kenntnisse -- Narrheit suchen -- tröst -- helfen -- 
  närrisch Herz Quelle Übel -- 
  dauern Zustand -- 
  grämen -- Bianca denken -- krank -- sterben -- vergessen -- machen Vorwurf -- Reise drängen -- unternehmen -- 
  -- helfen Sorge -- 
  werfen Baum -- ziehen Instrument hervor -- Italiener Cornetto nennen -- blies lustig Stückchen -- 
  Franz setzen -- 
  Liebst Waldhorn vorzüglich -- fragen -- 
  lieb Instrument -- antworten Rudolf -- Name -- -- jeglich Eigentümlich -- übrig abgeht -- 
  trefflich Freude -- einer hören -- Empfindung nachzugeh -- Herz erregen -- 
  Geduld -- Lied singen -- -- Charakter etlicher Instrument ausdrücken -- 
  Denke eben Land gebirgig -- abwechselnd Waldszen -- 
  kommst Hügel herunter -- einsam Tal liegen -- Hörst Schalmei spielen -- 
  Schalmeiklang -- 
  Himmelblau -- Hellbegrünte Frühlingsau -- Lerchenlieder -- Erde nieder -- 
  Frisches Blut -- Liebe Mut -- Gesang Hüpfend schäfch Bergeshang -- 
  froh zufried Welt -- Gott bescheiden -- Liebchen hienied -- Sorge Dunkel stellen -- 
  fern liegen Tal Welt Herrlichkeit -- wohnen zumal Frieden Freude -- -- 
  Herzeleid -- Größe Geld nagend Herzeleid -- 
  Mai -- treu -- fahren Frühling Sommer -- Bräutigam -- Sommer -- Ehestand schönerer Glück -- 
  Frisch froh -- -- O -- 
  Vergehen -- verwehen -- 
  Lied fällen -- Franz -- führen gewiß kindlich Sprache -- Klang Schalmei dergleich Sinn kommen -- 
  -- Rudolf -- wundervoll Schall Posthorn bewegen fühlen -- 
  trüb Stunde -- selber reisen -- schreiben folgendes nieder -- 
  Posthornsschall -- 
  weg -- weg -- Schmerz weg -- Wald -- eilen -- Niederwärt -- Aufwärt -- Klüft vorüber steil Gebirge rasseln tief Grund -- Ruhe finden -- 
  Pfeifender Wind -- Treib geschwind -- Schnell schnell Roß Dickicht hinein -- Laß -- o laß trüb Stunde -- eilend verschwinden -- Rastlos nimm Stillstand -- 
  suchen -- 
  Bergeshöhe -- 
  Schatten Buche -- 
  sehen -- 
  Stunde verfliegen -- wechseln Nacht -- Schmerz besiegen -- Freude erliegen stürmenden -- 
  -- -- Stillstand -- Strom brausen -- steil moosig Felswand Wind Woge Niedersaust -- 
  Walddunkel schatten -- Wolke jagen -- Nacht bang Zag schwarz Träum gattet -- 
  Tal nieder -- bergauf -- Echo sprechen -- grüßt herüber -- -- Treiben -- -- -- trüb Lauf -- 
  käme fremd Ort wundervoll Land Auge -- wechselnd weiße Einsamkeiten tückisch bereiten -- 
  Kenne trüben leiden -- leiden -- leiden -- 
  verlieren Schall -- Rudolf -- einsam Luft -- brechen plötzlich -- entstehen -- hören unmelodisch Wagen rasseln -- 
  dichtet Lied Beängstigung Gemüt -- -- 
  denken schön dicht Wald -- Waldhorn tief Tön sprechen -- voll -- ruhig Brust Gesang hervorströmt -- 
  Waldhornsmelodie -- 
  Hörst -- sprechen Wald -- Baumgesang -- Wellenklang -- -- Komme find Ruhe -- 
  Ruhe Gedanke -- lieben -- Sieh -- Zweig schwanken -- Echo Ton wiedergeben -- 
  Spricht_es herüb Herz -- 
  getrost gehen Tal -- Weide Schmerze -- Glücke allzumal -- 
  wandelst grün Waldnacht -- treiben Welt -- -- Weißt -- Sonnenaufgang wachen -- Denkst -- empfindest Holdigit -- 
  Trara -- 
  Springe munter Klang Berg -- grün Gebüsch -- Fühlst Größe -- Ruhm Drang -- Schlagen Herz Liebe frisch -- 
  versprechen -- treu Tod -- Wort brechen -- -- Not -- 
  süßen -- hold Mund -- Gram nehmen -- Küssest gesund -- 
  -- fahren Rudolf fort -- schweizerisch Alphorn gehören -- 
  -- gewiß Liede Schweizer Fremd -- unnenbar Sehnsucht Heimat empfinden -- ähnlich Vaterlandsliebe Niederländer -- 
  neulich Schweizerlied verfertigen -- 
  Alphornlied -- 
  treu Schweizer hingeraten -- 
  Vergisst Vaterland -- 
  lieb Vaterland -- 
  wohlbekannt Berg -- frisch grünend Tal -- 
  Wandelst fremde -- 
  grüßt vaterländisch Gruß -- 
  umherschaun -- 
  Schneegipfel -- 
  klingen lustig Horn -- 
  findest Landsmann -- 
  Herüber sehnen Sinn -- bied Gruß warten -- Alpe stehen -- Sennenhütte -- weit blau See -- hoch frei Gebirg -- 
  Komme edl Sprößling Tells -- Freigeborener -- still Täl herab -- einfach Mal -- Vaterlandsliebe köstlich -- 
  Suchst -- 
  Freund -- Geliebte -- 
  Nimmer schlagen Schweizerherz entgegen -- 
  Rudolf stehen -- 
  Leb -- schnell -- kalt Sitz -- -- Mädchen warten -- sprechen -- England hinübergehen -- 
  Leb -- Antwerpe sehen -- 
  eilen schnell -- Franz setzen Weg Stadt fort -- 
  -- müssen Dorfe Antwerpe übernachten -- 
  Sonne steigen prächtig herauf -- Franz niedersetzen -- folgend Vers Schreibtafel einschreiben -- 
  Dichter Stimme -- 
  Dichter -- 
  anlachst -- holder Morgenrot -- Mut herab Seele glühst -- fühle_es -- Sorge tot -- Sinn golden Kette ziehst -- 
  Stimme -- 
  schöneer rote -- Morgenstrahlen -- einst Angesicht Purpur malen -- 
  Dichter -- 
  O erwachen verlangen -- gönnen -- gönnen Stunde Ruhe -- Wolke sehen Bild hängen lächeln wehmutsvoll -- 
  O trübe -- Abendschein wandeln -- dicht Eiche -- dunkel Buche Unmut fliehen -- Einsamkeit suchen -- 
  Stimme -- 
  hoffst zart Abendschimmer -- 
  Unmut ruhen Busen nimmer -- 
  Dichter -- 
  Harfentöne retten Waldhornsklang einheimisch -- 
  Sinn Flötenwollust beten -- 
  lull Zaubermelodium -- 
  Stimme -- 
  Tone klingen -- süß Bild Seele bringen -- 
  Dichter -- 
  schlafen -- Schlummer hüllen -- 
  Herzens bang Sehnsucht stillen -- 
  Stimme -- 
  Kennst Traum -- erwach -- Auge schnell Träne füllen -- verlangen Brust anfachen -- 
  nimm Sehnsucht stillen -- 
  -- -- ziehen -- nirgends entfliehen -- 
  Dichter -- 
  -- gewaltig Zauberin -- quälst marterst Tod -- 
  Stimme -- 
  Erinnerung heiß -- -- denk schön Stunde -- 
  schnell -- schnell verschwinden -- 
  Dichter -- 
  quälen -- gibst tröstend Wort -- 
  ängstest Fort fort -- 
  bange Qual wenden -- 
  Verfolgung enden -- 
  Stimme -- 
  wiedersiehst -- schön Morgenrot entgegen Glühst -- enden Not -- 
  freuen Abendschein -- Musik Gespielin -- Nennst Holde -- Blüht Paradies -- 
  selber vertrauen -- Sehnst Himmelsauen -- 
  Kapitel -- 
  Handelstätigkeit Antwerpe Franz neu Schauspiel -- 
  wunderbar -- Mensch verlaufen -- ewig bewegt Meer darstellen -- jeglicher Vorteil Auge -- 
  fallen Kunstgedanke -- Menge Schiff -- Betriebsamkeit -- Geld gewinnen -- Spannung Gemüt Handel -- Versammlung Börse -- Unmöglich -- still Kunst ergeben sollen -- 
  hören -- Schiff kommen Abgegang -- Name vornehmsn Kaufleut Knabe geläufig -- Spaziergang setzen Handelsleute kaufmännisch Gespräch Spekulation fort -- 
  Franz Anblicke Leben betäuben -- niederschlagen -- 
  Vanse leben Kaufmann Range -- unbedeutend Geschäft -- Stadt -- Aufmerksamkeit Sparsamkeit ziemlich Vermögen sammeln -- 
  Sternbald suchen -- Haus Freund Schutzort -- still Asyl tobend Gewühl Stadt -- 
  Vansen wohnen abseits -- Garten Haus -- sprechen selten kaufmännisch Geschäft -- Eitelkeit -- begreifen -- Spekulation mitteilen -- 
  lieben -- Kunst sprechen -- suchen Ehre -- Kenner gelten -- 
  Sternbald kindlich Gemüt schließen Mann -- Unbefangenheit halten -- -- Vansen Liebe Malerei blind Trieb -- zufälligerweise Kunst werfen -- 
  angefang Gemälde kaufen -- Kenntnis erwerben -- Eitelkeit Sucht sammeln aufzuhäufen -- müde -- Gemälde Meister bekümmern -- 
  treiben meister Mensch Wissenschaft Beschäftigung -- Künstler irren -- verwanden Geist -- Verehrer Kunst suchen -- 
  Vanse einzig Tochter -- ungemein lieben -- 
  gelten Nachbarschaft schön -- Gesicht liebenswürdig -- 
  Kaufmann bitten unser jung Maler -- Bildnis Tochter malen -- Franz hurtig Arbeit -- 
  Phantasie angespannen -- fordern -- Bild rücken schnell fort -- gelingen ungemein -- 
  indes Gemälde sehen -- Italien bringen -- bemühen -- Färbung verbessern -- 
  Franz bemerken -- Tochter traurig -- suchen erheitern -- lassen -- malen -- Instrument lustig Lied spielen -- gewöhnlich verkehrt Wirkung -- traurig -- weinen -- Vater suchen Melancholie geflissentlich verbergen -- 
  Franz -- Vertrauen Leidende eindrängen -- kannt Kunst -- verschmähen -- Nehmer Geheimniss -- Gegenwart Verlegenheit -- 
  Vansen Haus versammelt Leute verschiedensen Charakter -- Art Akademie bilden -- Wirt Redensart lernen -- nachher glänzen -- 
  Franz hört Gespräch Aufmerksamkeit -- verschieden Meinung schnell gehören -- 
  vorzüglich ziehen alt Mann -- zuhören -- jeder Worte Geprag fest Sinn tragen -- 
  Abend fing Wirt -- -- -- Kunst reden -- herrlich Genuß preisen -- gut Gemälde empfänder -- 
  stimmen -- alte schweigen still -- ausdrücklich Meinung fragen -- -- 
  ungern sprechen -- denken -- Meinung -- tun innerlich wehe -- spüre gewiß Mitleid Mensch -- ernsthaft Verehrung sogenannter Kunst reden hören -- 
  unnütz Spielerei -- schädlich Zeitverderb -- 
  bedenk -- Mensch versammelt Gesellschaft können -- Vereinigung stark unüberwindlich müssen -- dienen -- ausüben dürfen -- Nutzen befördern -- betracht menschlich Gesellschaft -- -- wissen -- sagen -- 
  scheinen fast -- Vereinigung entstehen -- allgemein -- gegenseitig verschlimmern -- 
  Aufmunterung Tugend -- Abhärtung Krieg -- Liebe Vaterland Religion -- Religion Vaterland -- glauben Steh -- häufen -- gemein Nutzen sehen -- Gut erlaub te unerlaubt Art -- v tändeln Steckenpferde -- 
  Kunst züglich scheinen ordentlich erfund -- gut Kraft Mensch erlahmen -- abzutöten -- 
  gaukelnd Nachäffung -- armselig Nachahmung Wirklichkeit -- worauf hinausläufen -- ziehen Mensch ernst Betrachtung -- verleiten -- angeboren vergessen -- 
  inner Geist Tugend antreeben -- lehren mannigfaltig Künstler verspoten -- Erhabenheit göttlichen Sprache anredet -- unterlassen Reimer Poet -- Nichtswürdigkeite überschreien -- 
  namentlich gepriesen Malerei reden -- Maler -- Figur -- Baum Tier flach Leinwand hinzeichnen -- hoch angeschlagen -- Mensch -- Mund Vögel Tiergeschrei nachzuahmen verstehen -- 
  Künstelei frommen -- Wirklichkeit erreichen -- 
  Maler erlernen Meister gewiß Fertigkeit -- Handgriff -- anbringen -- gutmütig Kind -- stellen Machwerk -- verwundern -- 
  Genuß Kunst Rede -- Schönheit -- begreifen -- 
  Mensch Begeisterung kennen -- Schöpfung schön Stunde entstehen -- Gewinst niedersetz Farbe Farbe streichen -- Figur zusammengebetteln -- Lohn Geld empfangen -- 
  knechtisch Arbeit edel Seele wirken -- selber Mal -- 
  dienen -- höchstens Sinnlichkeit -- tracht -- elend Begierd erwecken -- lächeln verzerrt Gestalt abzuzwingen -- verursachen -- 
  -- Fall anwenden können -- Kunst beschäftiget -- 
  Franz Unwillen lang halten -- rufen -- unwürdig Künstler sprechen -- Künstler -- Göttlichkeit Beruf selber kennen -- euer Auge wenden -- wagen -- übrig verkennen -- 
  O Albert Dürer -- dulden -- schön Lebenslaufe sprechen -- 
  gut Bild sehen -- Auge Göttlichkeit verschließen bleiben -- erkühnen -- lästern -- 
  -- Staat zn Zweck dienen -- gewiß Zeitraum nötig -- Bürger -- Freiheit -- Vaterland -- Waffe -- bürgerlich Freiheit -- lieben -- bedenken -- Staat jeder Gemüt Grund -- allgemein Bild aufrecht erhalten -- 
  Gut -- derentwillen Freiheit Mensch teuer -- Regung Kraft -- Entwicklung Schatz Geist -- kostbarsen Kleinodie aufgeopferen -- Freiheit bewahren -- 
  Zweck verlieren -- streben -- 
  herrlich Erscheinung -- Menschengeist kühn tausend Richtung -- tausend mannigfaltig Strömen -- Röhr künstlich Springbrunnen -- Sonne entgegen spielen sehen -- 
  Geist -- erfreulich -- lassen unschuldig kindisch Kunst Gang -- 
  -- reinsten -- lieblichsen -- unbefangen Weise Hoheit Menschenseele offenbaren -- ernst Weisheit -- fromm Kind -- unschuldig Spiel jeder rein Gemüt rühren erfreuen -- 
  drücken Mensch deutlichsen -- Spiel Ernst mischen Ernst Lieblichkeit mildern -- 
  wozu Staat -- versammelt Gesellschaft nützen -- 
  schöne tief erniedrigen -- nützen -- 
  neu Feuer fachen Mann -- edeln einzeln Busen -- haufen staunt dumm -- begreifen fühlen -- betrachten gesehen Tier -- belächeln Erhabenheit -- halten Fabel -- 
  verehren Welt -- Geist huldigen -- 
  Niedrige verstehen Pöbel -- verächtliche achten -- 
  Zufälle Nichtswürdigkeite Wohltäter Menschengeschlecht -- häuslich Nutzen arm Welt anschlägst -- 
  drückst Wort Nutzen -- 
  essen -- Trinken Kleidung hinauslaufen -- sicher Schlafe -- -- Schiff regi -- bequem Maschine erfind -- essen -- 
  sagen -- wahrhaft hoch nützen -- Nützlichsein göttlich Natur fremd -- fordern -- -- Erhabenheit entadeln -- gemein Bedürfnis Menschheit herüberwürdigen -- 
  freilich bedürfen Mensch viele -- Geist Knecht Knechtes -- Körper erniedrigen -- 
  Hausherr sorgen -- Sorge Unterhalt Lebenslauf -- 
  halt Kunst Unterpfand Unsterblichkeit -- geheim Zeichen -- ewig Geist wunderbarlich erkennen -- Engel streben offenbaren -- treffen Menschenkräfte -- überzeugen -- wirken regieren lieblich Weise -- -- schön Traum -- süß Glaube beizubringen -- 
  entstehen Ordnung -- wirkend Harmonie Kunst -- 
  Weise Weisheit erhärten -- Held Aufopferung bewähren -- -- kühn -- auszusprech -- Märtyrer Tod besiegeln -- Maler Pinsel auswirken bekräftigen -- 
  himmlisch Strahl -- Geister müßig Ruhe erlauben -- glänzend Tätigkeit wecken -- 
  schönsn -- erhabensten Stunde -- Meister Werk zubringen -- legen bildlich Liebe hinein -- Welt Herz drücken -- Urschönheit -- erhaben Bild Hoheit -- niederknaten -- treffen verwandte Geist lieblich Zeichen -- Barbar unverständlich -- winken entzücken -- fühlen Geist Brust emporsteigen -- gedenken Schöne -- -- einst bewegen -- irdisch Bild -- entzücken -- lieblich Schatten Himmel herab fallen Gemüt -- erregen bunt Welt Wohllaut -- süß Harmonie -- O Holde Natur leiben -- Pracht morgens -- Schimmer Abends sehen -- Schönheit Menschengestalt ansprechen -- können lieblich Kunst unfreundlich bezeigen -- 
  Kunst -- bestreben -- Werter teuer -- befreunden -- äußerer Welt -- hart stehen -- unser weich Herz versöhnen -- 
  -- unmöglich -- Sinn Mensch freiwillig abwend -- Mißverständniss -- himmlisch Genusse zurückhalten -- 
  zweifelt -- Künstler schön Wahne -- Welt -- Empfindung Herzen Kunst verflichen -- führen Leben Kunst -- Kunst abstürbe -- wissen -- übrig Leben anfangen -- 
  erwähnen Schändlich -- arm Künstler nötigen sehen -- Lohn arbeiten -- Werk Geist fortgeben -- Körper fortzuhelfen -- eher beklagen -- verachten -- 
  kennen Empfindung -- Mann liebst Werk -- innig vertraut -- Fleiß -- lieb mühevoll Stunde anlächeln -- aufopfern -- verstoßen -- entfremden -- niemals wiedersiehen -- bloß schnöde Gewinst -- Familie umgiben -- Nahrung fordern -- 
  bejammern -- unser irdisch Leben Geist Materie abhängig -- 
  O wahrlich -- größ Glück wünschen -- Himmel vergönnt -- arbeiten -- Lohn denken -- Vermögen besäße -- Rücksicht Kunst leben -- Träne ausgepreßen -- Künstler bezahlen lassen -- Ergießunge Herzen Handel treiben -- kalt Seele Not Begegnung Sklave erfahren -- 
  Franz halten Weileein -- Träne abtrocknen -- fahren fort -- 
  Kunst Vorwurfe gereichen -- unwürdig Mensch nahe treten -- Priester aufdrängen -- 
  Abweg Irrtum geben -- beweisen Erhabenheit -- 
  Handwerker Art vortrefflich -- mechanisch Künste Erfindung gut -- göttlich Malerei -- 
  tief sinken -- hoch steigen -- 
  vergönnen -- Weg verfehlen -- Göttlich erreichen -- Offenbarung mitteilen -- 
  euer Sache wacker verteidigen -- alt -- einwenden -- 
  Gespräch Nachricht unterbrechen -- Vansen Tochter plötzlich krank -- 
  Vater groß Unruhe -- schicken sogleich Arzt -- besuchen geliebt Sara -- 
  Arzt -- versichern -- Gefahr besorgen -- spät -- Gesellschaft auseinander -- 
  Franz Wohnung -- begleiten übrig -- 
  entfernt -- alt Manne -- 
  vergeben -- fing -- Hitze -- jung Mensch unbesonnen widersprechen -- -- sagen -- geschehen -- 
  vergeben -- alt -- wacker Mensch -- freuen -- 
  -- Franz -- lassen -- fallen alte -- zungen Unrecht -- 
  trachen -- redlich -- Hauptsache -- 
  Franz -- böse -- reichen Zeichen euer Hand -- reuen Heftigkeit -- 
  alte drücken Hand herzlich -- umarmen -- -- glücklich Sohn bleiben herzlich Liebe Gute -- 
  Franz hierauf vergnügen Herberge -- 
  Kapitel -- 
  Winter beinahe verflossen -- Rudolf Florestan indes Antwerpe zurückgekommen -- 
  Franz Bild ausarbeiten -- besuchen Freund Vanse fleißig -- Tochter herstellen -- bleiben traurig mißvergnügt -- 
  treffen Vansen -- Sonntag Kaufmann Geschäft -- 
  willkommen -- rufen Maler entgegen -- längst Sache sprechen -- wozu gelegen treffen -- 
  setzen Vanse fahren vertraulichen Tone fort -- 
  kennen Lerne -- Sternbald -- hochschätzen -- jugendlich Schwärmerei -- Zeit fortreißen -- gewiß verlieren -- 
  sehen -- einzig -- allenfalls -- lieb -- Mensch wert halten -- 
  bekennen Kunst -- Jugend vorzüglich verehren -- 
  nah -- 
  wissen -- sonderbar Betragen Tochter bemerken -- unser Haus -- Sara melancholisch -- Lustigkeit -- sehen -- Sinn umgewandt -- 
  aufrichtig -- fällen -- Franz versichern -- liebenswürdig finden -- Vater fahren fort -- fest vornehmen -- Vorsatz -- gewiß weich -- geschickt Maler Eidam -- 
  bloß -- Mann finden -- 
  wissen -- Antwort -- lassen ausreden -- 
  keineswegs Eurer Reise zurückhalten -- munteren vielmehr selber -- Italien besuchen studieren -- 
  Tochter lieben -- versprechen -- Vermögen Reise bequem nützlich -- 
  -- besitzen -- sichern Mangel -- 
  Eurer Kunst -- wünschen -- Kraft obliegen -- berühmt -- Tochter glücklich Wunsch erfüllen -- 
  Franz heftig bewegen -- danken wärmst Ausdrückus Kaufmanne Wohlwollen -- bitten -- entscheidend Antwort verlangen Zöger übel deuten -- 
  verlassen -- schweifen tausend Vorstellung Straße umher -- 
  nah wirklich Leben treten -- innerer poetisch verdrängen -- fühlte Angezog zurückgestoßen -- schön Bild Phantasie stehen hell -- rücken tief Hintergrund hinab -- 
  bieten sichr Zukunft -- unverhofft -- Lebensweise -- Wunsch -- fordern -- Schatten -- Traumbild aufzuopfern -- -- 
  fürchten -- Lebenslauf bestimmen selber Grenze setzen -- Sehnsucht rufen Ferne hinein -- seltsam Ton lockt versprach golden Glück -- warten -- 
  Stimmung besucht Freund Rudolf -- 
  vertraut -- Geschichte -- wunderbar Liebe entdecken -- Sebastian -- dergleichen vertrauen -- 
  erzählt Vansen Vorschlag bitten Rat -- 
  hierin raten -- rufen Rudolf lachend -- Ratgebe überall unnütz Sache -- vollends Ehe -- Mensch Glück -- Frage früh -- weißen -- Mädchen -- 
  Franz stutzen -- 
  Wort Ehe erwecken überdem mancherlei Vorstellung -- 
  Szene ruhig Häuslichkeit -- Kind umgaben -- hört Gespräch Schwiegervater Freund -- fühlen frisch Jugend verschwinden eingelerntn ernster Verhältnis Leben -- wunderbar Gefühl Wunsch -- zauberisch Bild geliebter -- Abschied nehmen Herz hing glühend -- 
  klar geschäftig -- Pracht Morgenrot erwachen -- Rede ausgeklungen Liede -- 
  Brust beängstigen -- wissen lassen verlassen unmutig lachend Florestan -- 
  Leben -- denken selber -- Taumel Jugend verflogen -- nehmen Leben Empfang -- scheu Weg tren -- 
  -- schön Traum liegen -- 
  Vansen Haus -- 
  Tochter spielen Zither -- 
  naht Verlegenheit -- Mädchen bemerken Angst fragen -- krank -- 
  Franz Begriff -- erzählen -- Vater vertrauen -- Sara Magd heimlich Botschaft erhalten -- erschrecken scheinen -- 
  Magd entfernt Sara weinend Sternbald -- -- liebst Freund -- Gewalt -- leiden klagen -- vertrau -- vertrauen mißbrauchen -- 
  O Sternbald -- Woche leiden unaussprechlich -- 
  -- Mitleide tragen -- bemerken -- sagen -- 
  wohnen jung Schmied -- kennen -- lieben krank liegen -- 
  Krankheit schlimm -- fürchten -- Vater verheiraten -- arm -- Handwerker Verzweiflung nahe -- 
  O gütig besuch Tröst -- 
  glauben -- -- brav -- 
  würden gewiß Freund -- kennen sollten -- lieben -- nahe -- 
  Franz rühren -- lassen Haus bezeichnen sogleich -- 
  armselig Stube -- kranke Bette liegen -- Papier -- zeichnen -- 
  Sternbald nah -- erstaunen -- Schmied -- Nürnberg Auswanderung sprechen -- 
  O Freund -- rufen -- werfen -- vergessen Aufgesucht -- 
  jung Schmiedegesell erkennen ebenfalls eröffnet Franz -- Absicht kommen -- 
  Messys weinen -- hören -- zärtlich Sara besorgt -- 
  O Maler -- rufen -- glauben -- ausgestanden -- sprechen -- 
  euer Dürer -- Ruhe selber -- -- Sinn zöge arbeitet -- Malerei -- Zeichnung denken müssen -- Welt finden Gefallen -- Schmiedearbeit Last -- 
  zeichnen täglich -- Krankheit lassen -- seht -- herrlich Figur Luka leiden -- 
  Franz betrachten -- jung Mensch kopieren Franz verwunderen -- Unterricht bringen -- 
  Messys fahren fort -- 
  Antwerpe -- 
  Dürer Werkstätte Kopf -- -- Hammer schämen -- verdarb Arbeit -- fort -- 
  Tochter unser Nachbar -- einfallen -- reich vornehm Mädchen ansehen -- lieben -- 
  bös Geist ausging -- Grund richten -- -- 
  Auge abwenden -- an zeichnen denken -- Gesicht Papier entwerfen -- 
  auf's Feld -- -- ansehen -- o nötig -- allenthalben Auge hingebannen -- -- 
  Gesicht dachen ihrig -- Mensch -- ähnlich sein -- 
  bemerken Leidenschaft -- freundlich -- -- vorbeiging -- -- Blitz anrühren -- geschehen -- wissen -- glauben -- 
  Vater Leiden Geschäft reisen dorthin -- wissen -- Unterfing -- Abends anzureden -- lassen -- sprechen nachher schallt Ton Rede -- einzeln Wort Ohr -- wissen -- -- 
  öfter -- gehen heimlich spazieren -- vertraulich -- gestehen -- Himmel -- 
  fing Kräfte arbeiten -- abends sprechen -- zeichnen Bild -- stellen Haus lassen Nacht heranrücken -- 
  O geschwätzig Kind -- 
  ehe versahen Vater -- 
  unser Zusammenkünft -- manchmal vorbeigehen grüßen -- 
  Decke fallen Auge Herz springen -- 
  Unterschied -- reich Vater verachten müssen -- Stande -- 
  hören -- Sara verheiraten -- -- geschehen gewiß -- 
  anfangen -- 
  Handwerk Abscheu -- -- worauf freuen -- Meister Gelegenheit künstlich Arbeit -- Springbrunn -- Gitterwerk -- dergleichen Unternehmen -- kläglich -- 
  wissen -- Welt -- 
  Maler -- alt -- Sara sehen -- hoffen -- gehen Grund -- 
  krank schwach -- sterben hoffen -- 
  Franz weinend -- -- hoffen -- glauben -- gewiß -- Maler -- Liebe Kunst behalten -- 
  zeichnen -- Lehre wäretn -- -- Maler -- 
  Eure Geliebte hoffen -- Vater achten Malerei Malerkünstler Eidam -- -- arm -- Tochter antragen -- 
  trösten -- sammeln Lust Leben Kraft -- glücklich -- 
  Messys schüttelt kopf -- glauben können -- Franz fahren fort -- trösten -- beruhigen -- 
  Sternbald eilen sogleich Vans -- Flasche Wein Laune antreffen -- 
  Antwort bringen -- Franz -- müßn Geduld zuhören -- 
  erzählen hierauf Geschichte Freundes sprechen gegenseitig Liebe jung Leute -- 
  wollten -- schließen -- arm Mensch -- -- Schmied besitzen -- euer Tochter geben -- wollten Zurückkunft warten -- tun -- Glück Eurer einzig Tochter begründen -- jung -- versicher -- Messys weniger Maler -- Ehre -- euer Wunsch erfüllen -- 
  überzeugen -- Malt -- fragt Vanse -- 
  gewiß -- Sternbald -- sehen Zeichnung -- wahrlich gut leer verraten -- 
  zeigen hierauf Bild -- Messys Hand mitbringen -- Vanse betrachtet prüfend Blick -- scheinen zufrieden -- 
  brav jung Mensch -- rufen -- könnten bewegen -- -- uneigennützig -- 
  arm Teufel grüßt -- -- gesund sprechen -- 
  Franz springen -- 
  Vorsaal begegnen Sara -- weniger Wort erzählen -- eilt Messys -- 
  getrost -- rufen -- -- Vater bewilligen Tochter -- Malerei legen -- 
  gesund -- selber besuchen -- 
  kranke wissen -- hören sehen -- 
  Franz müssen Versicherung öfters wiederholen -- 
  überzeugen -- springen kleiden schnell -- 
  springen tanzt Stube herum -- wobei alt niederländisch Bauernlied singen -- umarmen küssen Sternbald -- weinen treiben seltsam Spiel Freude -- jung Maler innig bewegen -- 
  machen hierauf Weg Vansen Haus -- 
  Straße taumelt kranke -- ungewohnt frei Luft umfing -- Franz unterstützen kommen -- 
  Haus sehen -- Sara -- Messys gebärden Verrückter -- schreien laut -- unvermutet Blaß -- 
  kommen Vater Zimmer -- freundlich -- 
  Messys verlegen blöden -- 
  lieben Tochter -- Kaufmann -- versprechen -- Malerei legen -- geschickt Mann zeigen -- Bedingung versprechen -- müßt Reise trefflich studieren -- Endzweck Weise unterstützen -- 
  Ding müßt suchen gesund -- 
  Liebenden kommen hierauf Gegenwart Vater fühlen unaussprechlich glücklich -- 
  Messys müssen gut Wohnung beziehen fast herstellen -- 
  wissen -- unser Freund danken -- 
  letzter Februar Sonnenwärme brechen neblig Luft -- 
  Franz Rudolf machen Reise -- 
  Ehe Antwerpe verlassen -- erhalten Franz Vansen ansehnlich Geschenk -- Kaufmann lieben jung Maler zärtlich -- 
  Sternbald Florestan halten Tor Stadt -- hört Klok Ferne schlagen Rudolf singen lauter Stimme -- Wohlauf -- 
  rufen Sonnenschein Hinaus Gott frei Welt -- 
  munt Land hinein wandeln Berg Feld -- 
  bleiben Strom ruhig stehen lustig rauschen fort -- Hörst Windes munteres Wehen -- 
  brausen Ort Ort -- 
  reisen Mond -- Sonne -- Guckt übern Berg Meer -- matt Lauf -- 
  Mensch -- sitzest stets daheim sehnst Fern -- frisch wandl Hain sieh Fremd -- 
  wissen Glück blühen -- gehen Such -- Abend -- fliehen -- betreter Spur -- 
  Laß Sorge Bangigkeit Himmel blau -- wechseln Freude stets Leid -- Glück tau -- 
  schließen Himmel -- Gerät Liebe Frucht -- Jeglich Herz bekommen emsig suchen -- 
  Teil -- 
  Nachschrift Leser -- 
  Buch Name Verfasser Herzensergießung kunstliebend Klosterbruder erscheinen -- Leser Ton Stelle Teil erklären -- 
  meister Gespräch -- mehrere verstorben Freund Wackenroder führen -- betrafen Kunst -- unser Empfindung einig müde -- Gedanke gegenseitig wiederholen -- 
  zergliedernd Kritik -- verehrend Enthusiasmus entgegenstehen -- unser Gespräch Ansicht Kunst Künstler entstehen Herzensergießung Klosterbruder -- 1797 herauskamen -- 
  Freund suchen Buch Gedanke innig Kunstlieb niederzulegen -- wählen absichtlich Maske religiös Geistliche -- fromm Gemüt -- andächtig Liebe Kunst frei ausdrücken -- Vortrag meister Aufsätz gehören -- 
  Hand Vorrede -- Sehnsucht Italien -- S. 23 -- 
  Brief Maler Antonio Antwort -- S. 52 -- Brief jung deutsch Maler S. 179 -- Bildnisse Maler -- S. 194 -- 
  Buch vornehmen -- Geschichte Künstler schreiben -- entstehen Plan gegenwärtig Roman -- 
  gewiß Sinn gehören Freund Werk -- Krankheit hindert -- Stelle -- ausarbeiten -- übernehmen -- 
  Leser verlieren gewiß -- Beihilfe führen -- 